GameID,RoundNum,Team1Bid,Team2Bid,Team1Tricks,Team2Tricks,Team1RoundPoints,Team2RoundPoints,Team1Bags,Team2Bags,Team1FinalScore,Team2FinalScore
1,1,3,4,5,8,32,44,2,4,32,44
1,2,2,4,4,9,22,45,4,9,54,89
1,3,3,3,8,5,35,-68,9,1,89,21
1,4,3,3,4,9,-69,36,0,7,20,57
1,5,2,5,3,10,21,-45,1,2,41,12
1,6,4,2,5,8,41,26,2,8,82,38
1,7,4,3,7,6,43,-67,5,1,125,-29
1,8,4,2,9,4,-55,22,0,3,70,-7
1,9,4,4,6,7,42,43,2,6,112,36
1,10,5,2,8,5,53,23,5,9,165,59
1,11,3,3,7,6,34,-67,9,2,199,-8
1,12,5,2,9,4,-46,22,3,4,153,14
1,13,4,2,8,5,44,23,7,7,197,37
1,14,3,4,7,6,-66,42,1,9,131,79
1,15,2,4,4,9,22,-55,3,4,153,24
1,16,2,5,5,8,23,53,6,7,176,77
1,17,2,5,5,8,23,-47,9,0,199,30
1,18,2,4,3,10,-79,46,0,6,120,76
1,19,4,3,7,6,43,33,3,9,163,109
1,20,4,2,11,2,-53,20,0,9,110,129
1,21,5,2,7,6,52,-76,2,3,162,53
1,22,6,2,8,5,62,23,4,6,224,76
1,23,3,3,7,6,34,33,8,9,258,109
1,24,5,2,7,6,-48,-76,0,3,210,33
1,25,3,3,7,6,34,33,4,6,244,66
1,26,3,4,4,9,31,-55,5,1,275,11
1,27,4,3,5,8,41,35,6,6,316,46
1,28,3,3,7,6,-66,33,0,9,250,79
1,29,5,2,8,5,53,-77,3,2,303,2
1,30,3,3,5,8,32,35,5,7,335,37
1,31,4,2,8,5,44,-77,9,0,379,-40
1,32,4,2,7,6,-57,24,2,4,322,-16
1,33,4,3,8,5,44,32,6,6,366,16
1,34,3,4,5,8,32,-56,8,0,398,-40
1,35,2,6,3,10,21,64,9,4,419,24
1,36,2,4,5,8,-77,44,2,8,342,68
1,37,4,3,8,5,44,-68,6,0,386,0
1,38,4,3,8,5,-56,32,0,2,330,32
1,39,4,2,10,3,46,21,6,3,376,53
1,40,4,3,9,4,-55,31,1,4,321,84
1,41,4,2,8,5,44,23,5,7,365,107
1,42,3,3,6,7,33,-66,8,1,398,41
1,43,4,3,7,6,-57,33,1,4,341,74
1,44,3,3,8,5,35,32,6,6,376,106
1,45,3,4,5,8,32,-56,8,0,408,50
1,46,3,3,8,5,-65,32,3,2,343,82
1,47,2,5,3,10,21,55,4,7,364,137
1,48,2,5,4,9,22,-46,6,1,386,91
1,49,3,3,6,7,33,34,9,5,419,125
1,50,3,4,7,6,-66,42,3,7,353,167
1,51,4,3,7,6,43,-67,6,0,396,100
1,52,3,3,10,3,-63,30,3,0,333,130
1,53,3,4,6,7,33,43,6,3,366,173
1,54,5,2,8,5,53,23,9,6,419,196
1,55,4,3,5,8,-59,-65,0,1,360,131
1,56,4,4,6,7,42,43,2,4,402,174
1,57,4,3,8,5,44,32,6,6,446,206
1,58,2,4,3,10,21,-54,7,2,467,152
1,59,3,3,7,6,-66,33,1,5,401,185
1,60,5,2,10,3,55,21,6,6,456,206
1,61,4,3,6,7,42,-66,8,0,498,140
1,62,4,3,8,5,-56,32,2,2,442,172
1,63,3,4,6,7,33,43,5,5,475,215
1,64,3,4,5,8,32,44,7,9,507,259
2,1,2,4,4,9,22,45,2,5,22,45
2,2,2,5,4,9,22,54,4,9,44,99
2,3,2,5,5,8,23,-47,7,2,67,52
2,4,3,3,6,7,-67,34,0,6,0,86
2,5,2,4,4,9,22,-55,2,1,22,31
2,6,4,3,6,7,42,34,4,5,64,65
2,7,3,3,5,8,32,-65,6,0,96,0
2,8,2,4,4,9,22,45,8,5,118,45
2,9,3,3,6,7,-67,34,1,9,51,79
2,10,3,3,6,7,33,-66,4,3,84,13
2,11,4,4,7,6,43,42,7,5,127,55
2,12,5,2,10,3,-45,21,2,6,82,76
2,13,3,3,7,6,34,33,6,9,116,109
2,14,3,4,6,7,33,-57,9,2,149,52
2,15,2,4,7,6,-75,42,4,4,74,94
2,16,2,4,5,8,23,44,7,8,97,138
2,17,3,4,6,7,-67,-57,0,1,30,81
2,18,3,4,5,8,32,44,2,5,62,125
2,19,2,5,7,6,25,51,7,6,87,176
2,20,2,4,7,6,-75,42,2,8,12,218
2,21,4,3,6,7,42,-66,4,2,54,152
2,22,4,3,10,3,-54,30,0,2,0,182
2,23,2,4,5,8,23,44,3,6,23,226
2,24,2,4,5,8,23,-56,6,0,46,170
2,25,4,3,8,5,-56,32,0,2,-10,202
2,26,4,4,5,8,41,44,1,6,31,246
2,27,3,4,9,4,36,40,7,6,67,286
2,28,2,5,6,7,-76,52,1,8,-9,338
2,29,5,2,9,4,54,-78,5,0,45,260
2,30,3,3,7,6,34,33,9,3,79,293
2,31,2,5,5,8,-77,53,2,6,2,346
2,32,4,3,6,7,42,-66,4,0,44,280
2,33,2,4,4,9,22,45,6,5,66,325
2,34,2,4,3,10,21,-54,7,1,87,271
2,35,3,3,5,8,32,35,9,6,119,306
2,36,3,3,4,9,-69,-64,0,2,50,242
2,37,4,3,8,5,44,32,4,4,94,274
2,38,3,4,8,5,35,41,9,5,129,315
2,39,4,4,7,6,-57,42,2,7,72,357
2,40,6,2,11,2,65,20,7,7,137,377
2,41,3,4,6,7,-67,-57,0,0,70,320
2,42,2,5,5,8,23,53,3,3,93,373
2,43,2,4,5,8,23,44,6,7,116,417
2,44,3,4,6,7,33,-57,9,0,149,360
2,45,4,3,7,6,-57,33,2,3,92,393
2,46,4,3,6,7,42,34,4,7,134,427
2,47,3,3,7,6,34,-67,8,0,168,360
2,48,3,3,6,7,-67,34,1,4,101,394
2,49,3,4,5,8,32,44,3,8,133,438
2,50,4,4,8,5,44,41,7,9,177,479
2,51,2,5,2,11,20,-44,7,5,197,435
2,52,3,3,6,7,-67,34,0,9,130,469
2,53,2,5,4,9,22,-46,2,3,152,423
2,54,2,5,4,9,22,54,4,7,174,477
2,55,4,2,6,7,42,-75,6,2,216,402
2,56,5,2,9,4,-46,22,0,4,170,424
2,57,2,4,7,6,25,42,5,6,195,466
2,58,3,3,5,8,32,-65,7,1,227,401
2,59,5,2,9,4,-46,22,1,3,181,423
2,60,4,2,6,7,42,25,3,8,223,448
2,61,3,3,5,8,32,-65,5,3,255,383
2,62,6,2,11,2,-35,20,0,3,220,403
2,63,3,4,8,5,35,41,5,4,255,444
2,64,4,3,7,6,43,33,8,7,298,477
2,65,5,2,10,3,-45,21,3,8,253,498
2,66,3,4,4,9,31,-55,4,3,284,443
2,67,5,2,9,4,54,22,8,5,338,465
2,68,3,4,6,7,-67,43,1,8,271,508
3,1,3,4,5,8,32,44,2,4,32,44
3,2,2,4,7,6,25,42,7,6,57,86
3,3,4,2,8,5,-56,23,1,9,1,109
3,4,3,4,3,10,30,-54,1,5,31,55
3,5,4,3,6,7,42,34,3,9,73,89
3,6,3,4,7,6,34,-58,7,1,107,31
3,7,3,3,6,7,-67,34,0,5,40,65
3,8,3,3,5,8,32,-65,2,0,72,0
3,9,3,3,7,6,34,33,6,3,106,33
3,10,2,4,5,8,23,44,9,7,129,77
3,11,3,3,4,9,-69,-64,0,3,60,13
3,12,6,2,8,5,62,23,2,6,122,36
3,13,2,5,4,9,22,-46,4,0,144,-10
3,14,4,3,8,5,44,32,8,2,188,22
3,15,3,4,8,5,-65,41,3,3,123,63
3,16,4,3,4,9,40,36,3,9,163,99
3,17,4,2,10,3,46,-79,9,0,209,20
3,18,3,3,5,8,-68,35,1,5,141,55
3,19,5,3,7,6,52,33,3,8,193,88
3,20,3,4,7,6,34,-58,7,0,227,30
3,21,3,4,7,6,-66,42,1,2,161,72
3,22,2,4,5,8,23,44,4,6,184,116
3,23,2,4,5,8,23,-56,7,0,207,60
3,24,5,2,7,6,52,24,9,4,259,84
3,25,4,4,5,8,-59,44,0,8,200,128
3,26,2,5,5,8,23,-47,3,1,223,81
3,27,5,2,7,6,52,24,5,5,275,105
3,28,4,3,8,5,44,32,9,7,319,137
3,29,2,4,4,9,-78,-55,1,2,241,82
3,30,4,3,9,4,45,31,6,3,286,113
3,31,3,4,7,6,-66,42,0,5,220,155
3,32,3,3,8,5,35,32,5,7,255,187
3,33,4,3,10,3,-54,30,1,7,201,217
3,34,2,4,5,8,23,-56,4,1,224,161
3,35,3,3,7,6,34,33,8,4,258,194
3,36,3,3,9,4,-64,31,4,5,194,225
3,37,5,2,8,5,53,23,7,8,247,248
3,38,6,2,11,2,-35,20,2,8,212,268
3,39,5,3,7,6,52,-67,4,1,264,201
3,40,2,4,5,8,23,44,7,5,287,245
3,41,3,3,5,8,32,-65,9,0,319,180
3,42,2,5,6,7,-76,52,3,2,243,232
3,43,2,5,6,7,24,52,7,4,267,284
3,44,2,5,4,9,22,54,9,8,289,338
3,45,2,5,4,9,-78,-46,1,2,211,292
3,46,3,4,6,7,33,43,4,5,244,335
3,47,5,3,7,6,52,33,6,8,296,368
3,48,3,3,7,6,-66,-67,0,1,230,301
3,49,5,2,9,4,54,22,4,3,284,323
3,50,2,4,5,8,23,44,7,7,307,367
3,51,4,3,10,3,-54,30,3,7,253,397
3,52,4,2,10,3,46,21,9,8,299,418
3,53,4,3,7,6,-57,-67,2,1,242,351
3,54,4,3,7,6,43,33,5,4,285,384
3,55,4,3,10,3,-54,30,1,4,231,414
3,56,3,4,6,7,33,43,4,7,264,457
3,57,4,2,7,6,43,-76,7,1,307,381
3,58,2,4,6,7,-76,43,1,4,231,424
3,59,4,2,9,4,45,22,6,6,276,446
3,60,5,2,9,4,-46,22,0,8,230,468
3,61,5,2,8,5,53,-77,3,1,283,391
3,62,3,3,7,6,34,33,7,4,317,424
3,63,4,3,7,6,-57,33,0,7,260,457
3,64,3,4,4,9,31,-55,1,2,291,402
3,65,3,4,7,6,34,42,5,4,325,444
3,66,4,4,6,7,42,43,7,7,367,487
3,67,5,3,6,7,51,-66,8,1,418,421
3,68,3,3,4,9,31,36,9,7,449,457
3,69,4,3,5,8,-59,-65,0,2,390,392
3,70,3,4,5,8,32,44,2,6,422,436
3,71,3,5,6,7,33,52,5,8,455,488
3,72,2,4,5,8,23,-56,8,2,478,432
3,73,4,3,5,8,41,35,9,7,519,467
4,1,2,4,5,8,23,44,3,4,23,44
4,2,3,3,8,5,35,32,8,6,58,76
4,3,3,3,8,5,-65,32,3,8,-7,108
4,4,4,2,9,4,45,-78,8,0,38,30
4,5,4,4,9,4,-55,40,3,0,-17,70
4,6,3,4,4,9,31,45,4,5,14,115
4,7,3,3,6,7,33,34,7,9,47,149
4,8,3,3,5,8,32,-65,9,4,79,84
4,9,3,3,5,8,-68,35,1,9,11,119
4,10,4,2,9,4,45,-78,6,1,56,41
4,11,3,4,7,6,-66,42,0,3,-10,83
4,12,6,2,11,2,65,20,5,3,55,103
4,13,4,2,6,7,42,25,7,8,97,128
4,14,3,4,7,6,-66,-58,1,0,31,70
4,15,2,4,3,10,21,46,2,6,52,116
4,16,4,2,8,5,44,23,6,9,96,139
4,17,4,3,9,4,-55,-69,1,0,41,70
4,18,2,5,3,10,21,55,2,5,62,125
4,19,4,2,7,6,43,24,5,9,105,149
4,20,2,4,5,8,23,-56,8,3,128,93
4,21,5,2,8,5,-47,23,1,6,81,116
4,22,3,4,7,6,34,42,5,8,115,158
4,23,3,3,9,4,-64,31,1,9,51,189
4,24,3,3,7,6,34,-67,5,2,85,122
4,25,3,4,5,8,32,44,7,6,117,166
4,26,5,2,10,3,-45,21,2,7,72,187
4,27,2,5,6,7,24,52,6,9,96,239
4,28,4,2,7,6,43,-76,9,3,139,163
4,29,3,3,7,6,-66,33,3,6,73,196
4,30,3,3,8,5,35,32,8,8,108,228
4,31,3,3,7,6,-66,-67,2,1,42,161
4,32,5,2,7,6,52,24,4,5,94,185
4,33,4,3,7,6,43,33,7,8,137,218
4,34,6,2,10,3,-36,21,1,9,101,239
4,35,2,4,5,8,23,-56,4,3,124,183
4,36,4,4,6,7,42,43,6,6,166,226
4,37,4,3,7,6,43,33,9,9,209,259
4,38,3,5,8,5,-65,50,4,9,144,309
4,39,5,2,8,5,53,-77,7,2,197,232
4,40,2,5,4,9,22,54,9,6,219,286
4,41,3,4,6,7,-67,43,2,9,152,329
4,42,2,5,3,10,21,-45,3,4,173,284
4,43,3,4,7,6,34,42,7,6,207,326
4,44,4,2,10,3,-54,21,3,7,153,347
4,45,3,4,5,8,32,-56,5,1,185,291
4,46,3,4,2,11,-30,47,5,8,155,338
4,47,4,2,7,6,43,-76,8,2,198,262
4,48,2,4,4,9,-78,45,0,7,120,307
4,49,3,3,8,5,35,32,5,9,155,339
4,50,2,5,3,10,21,-45,6,4,176,294
4,51,2,4,3,10,21,-54,7,0,197,240
4,52,5,2,7,6,52,24,9,4,249,264
4,53,4,2,7,6,-57,24,2,8,192,288
4,54,5,2,7,6,52,-76,4,2,244,212
4,55,2,4,6,7,24,43,8,5,268,255
4,56,3,4,6,7,-67,43,1,8,201,298
4,57,3,4,8,5,35,41,6,9,236,339
4,58,3,3,9,4,-64,-69,2,0,172,270
4,59,3,4,5,8,32,44,4,4,204,314
4,60,3,3,6,7,33,34,7,8,237,348
4,61,3,3,5,8,32,-65,9,3,269,283
4,62,4,3,5,8,-59,35,0,8,210,318
4,63,4,3,7,6,43,-67,3,1,253,251
4,64,3,3,6,7,33,34,6,5,286,285
4,65,2,4,6,7,-76,43,0,8,210,328
4,66,5,2,10,3,55,21,5,9,265,349
4,67,3,3,7,6,34,-67,9,2,299,282
4,68,5,2,10,3,-45,21,4,3,254,303
4,69,4,2,6,7,42,25,6,8,296,328
4,70,2,5,3,10,21,-45,7,3,317,283
4,71,3,4,3,10,30,46,7,9,347,329
4,72,3,3,6,7,-67,-66,0,3,280,263
4,73,2,4,5,8,23,44,3,7,303,307
4,74,4,2,9,4,45,22,8,9,348,329
4,75,2,5,1,12,-20,-43,8,6,328,286
4,76,4,3,4,9,40,-64,8,2,368,222
4,77,2,5,5,8,-77,53,1,5,291,275
4,78,4,3,4,9,40,-64,1,1,331,211
4,79,4,2,9,4,45,22,6,3,376,233
4,80,4,2,6,7,42,25,8,8,418,258
4,81,4,2,8,5,-56,-77,2,1,362,181
4,82,4,4,8,5,44,41,6,2,406,222
4,83,2,5,4,9,22,54,8,6,428,276
4,84,2,5,3,10,21,-45,9,1,449,231
4,85,3,3,6,7,-67,34,2,5,382,265
4,86,4,2,9,4,45,22,7,7,427,287
4,87,5,2,9,4,-46,22,1,9,381,309
4,88,3,4,7,6,34,-58,5,1,415,251
4,89,4,2,9,4,-55,22,0,3,360,273
4,90,5,2,9,4,54,22,4,5,414,295
4,91,3,4,6,7,33,43,7,8,447,338
4,92,3,3,7,6,-66,-67,1,1,381,271
4,93,4,2,8,5,44,23,5,4,425,294
4,94,2,4,8,5,-74,41,1,5,351,335
4,95,3,4,4,9,31,-55,2,0,382,280
4,96,3,3,6,7,33,34,5,4,415,314
4,97,2,5,6,7,24,52,9,6,439,366
4,98,3,3,8,5,-65,32,4,8,374,398
4,99,3,3,6,7,33,-66,7,2,407,332
4,100,3,4,5,8,32,44,9,6,439,376
4,101,3,3,7,6,-66,33,3,9,373,409
4,102,2,4,6,7,24,-57,7,2,397,352
4,103,3,3,7,6,-66,33,1,5,331,385
4,104,3,3,6,7,33,34,4,9,364,419
4,105,4,2,6,7,42,-75,6,4,406,344
4,106,3,5,4,9,31,54,7,8,437,398
4,107,4,2,6,7,42,-75,9,3,479,323
4,108,4,2,8,5,-56,23,3,6,423,346
4,109,4,3,6,7,42,-66,5,0,465,280
4,110,4,2,8,5,44,23,9,3,509,303
5,1,2,4,5,8,23,44,3,4,23,44
5,2,3,4,6,7,33,43,6,7,56,87
5,3,4,2,10,3,-54,21,2,8,2,108
5,4,5,2,7,6,52,-76,4,2,54,32
5,5,3,4,6,7,33,43,7,5,87,75
5,6,2,6,4,9,22,63,9,8,109,138
5,7,5,2,10,3,-45,21,4,9,64,159
5,8,5,2,7,6,52,-76,6,3,116,83
5,9,2,5,6,7,-76,52,0,5,40,135
5,10,4,3,8,5,44,32,4,7,84,167
5,11,6,2,10,3,64,21,8,8,148,188
5,12,4,3,8,5,-56,-68,2,0,92,120
5,13,2,5,7,6,25,51,7,1,117,171
5,14,2,6,3,10,21,64,8,5,138,235
5,15,5,2,8,5,-47,23,1,8,91,258
5,16,4,3,9,4,45,31,6,9,136,289
5,17,3,4,6,7,33,-57,9,2,169,232
5,18,3,3,6,7,-67,34,2,6,102,266
5,19,5,2,9,4,54,22,6,8,156,288
5,20,2,4,8,5,-74,41,2,9,82,329
5,21,3,4,7,6,34,-58,6,1,116,271
5,22,5,2,9,4,-46,22,0,3,70,293
5,23,5,2,8,5,53,23,3,6,123,316
5,24,3,3,6,7,33,-66,6,0,156,250
5,25,3,3,6,7,33,34,9,4,189,284
5,26,5,2,7,6,-48,24,1,8,141,308
5,27,5,2,10,3,55,21,6,9,196,329
5,28,3,4,7,6,-66,-58,0,1,130,271
5,29,3,4,5,8,32,44,2,5,162,315
5,30,2,4,4,9,22,-55,4,0,184,260
5,31,3,4,8,5,35,41,9,1,219,301
5,32,2,5,3,10,-79,55,0,6,140,356
5,33,4,2,9,4,45,22,5,8,185,378
5,34,3,3,6,7,33,-66,8,2,218,312
5,35,3,3,7,6,-66,33,2,5,152,345
5,36,3,4,3,10,30,-54,2,1,182,291
5,37,3,5,5,8,32,53,4,4,214,344
5,38,4,4,6,7,42,43,6,7,256,387
5,39,4,3,7,6,43,-67,9,0,299,320
5,40,2,4,7,6,-75,42,4,2,224,362
5,41,4,2,7,6,43,24,7,6,267,386
5,42,3,4,9,4,-64,40,3,6,203,426
5,43,2,5,2,11,20,-44,3,2,223,382
5,44,4,2,9,4,45,22,8,4,268,404
5,45,3,4,6,7,-67,43,1,7,201,447
5,46,5,2,9,4,54,22,5,9,255,469
5,47,4,2,8,5,44,-77,9,2,299,392
5,48,2,5,6,7,-76,52,3,4,223,444
5,49,3,3,7,6,34,33,7,7,257,477
5,50,4,3,8,5,-56,32,1,9,201,509
6,1,2,5,3,10,21,55,1,5,21,55
6,2,4,2,9,4,45,22,6,7,66,77
6,3,2,4,7,6,-75,42,1,9,-9,119
6,4,2,4,5,8,23,-56,4,3,14,63
6,5,3,4,6,7,33,43,7,6,47,106
6,6,3,4,4,9,31,-55,8,1,78,51
6,7,4,2,8,5,-56,23,2,4,22,74
6,8,3,5,8,5,35,50,7,4,57,124
6,9,5,2,10,3,-45,21,2,5,12,145
6,10,2,4,6,7,24,43,6,8,36,188
6,11,2,5,6,7,-76,-48,0,0,-40,140
6,12,4,3,8,5,44,32,4,2,4,172
6,13,5,2,10,3,55,21,9,3,59,193
6,14,4,3,6,7,-58,34,1,7,1,227
6,15,3,3,8,5,35,32,6,9,36,259
6,16,4,3,5,8,41,-65,7,4,77,194
6,17,3,3,7,6,-66,33,1,7,11,227
6,18,3,4,6,7,33,-57,4,0,44,170
6,19,4,2,6,7,42,25,6,5,86,195
6,20,3,4,6,7,33,43,9,8,119,238
6,21,4,3,10,3,-54,30,5,8,65,268
6,22,5,2,9,4,54,-78,9,0,119,190
6,23,3,4,6,7,-67,43,2,3,52,233
6,24,5,2,10,3,55,21,7,4,107,254
6,25,4,3,8,5,-56,32,1,6,51,286
6,26,2,5,6,7,24,52,5,8,75,338
6,27,5,2,9,4,54,-78,9,0,129,260
6,28,2,4,6,7,-76,43,3,3,53,303
6,29,2,5,5,8,23,53,6,6,76,356
6,30,3,3,6,7,33,-66,9,0,109,290
6,31,3,4,4,9,-69,45,0,5,40,335
6,32,5,2,11,2,56,20,6,5,96,355
6,33,4,3,9,4,-55,31,1,6,41,386
6,34,4,4,7,6,43,42,4,8,84,428
6,35,4,4,6,7,42,-57,6,1,126,371
6,36,4,2,10,3,-54,21,2,2,72,392
6,37,5,3,8,5,53,32,5,4,125,424
6,38,2,5,4,9,22,54,7,8,147,478
6,39,4,4,8,5,-56,41,1,9,91,519
7,1,4,3,8,5,44,32,4,2,44,32
7,2,3,5,7,6,34,51,8,3,78,83
7,3,2,5,4,9,-78,54,0,7,0,137
7,4,3,3,6,7,33,-66,3,1,33,71
7,5,2,4,5,8,23,44,6,5,56,115
7,6,2,4,5,8,23,44,9,9,79,159
7,7,2,4,4,9,-78,-55,1,4,1,104
7,8,2,5,4,9,22,54,3,8,23,158
7,9,4,3,5,8,41,-65,4,3,64,93
7,10,4,3,7,6,43,33,7,6,107,126
7,11,4,2,8,5,-56,23,1,9,51,149
7,12,4,3,10,3,46,30,7,9,97,179
7,13,4,3,6,7,42,-66,9,3,139,113
7,14,4,2,5,8,-59,26,0,9,80,139
7,15,3,3,6,7,33,-66,3,3,113,73
7,16,3,4,7,6,34,42,7,5,147,115
7,17,2,4,3,10,21,-54,8,1,168,61
7,18,3,3,5,8,-68,35,0,6,100,96
7,19,3,3,7,6,34,33,4,9,134,129
7,20,3,3,4,9,31,-64,5,5,165,65
7,21,5,2,11,2,-44,20,1,5,121,85
7,22,3,3,5,8,32,-65,3,0,153,20
7,23,4,3,10,3,46,30,9,0,199,50
7,24,3,4,7,6,-66,42,3,2,133,92
7,25,3,3,7,6,34,33,7,5,167,125
7,26,4,3,9,4,-55,31,2,6,112,156
7,27,4,2,9,4,45,22,7,8,157,178
7,28,2,4,4,9,22,-55,9,3,179,123
7,29,3,4,5,8,-68,44,1,7,111,167
7,30,3,3,5,8,32,-65,3,2,143,102
7,31,3,3,5,8,32,35,5,7,175,137
7,32,2,5,3,10,21,-45,6,2,196,92
7,33,3,3,5,8,32,35,8,7,228,127
7,34,5,3,9,4,-46,31,2,8,182,158
7,35,4,3,7,6,43,-67,5,1,225,91
7,36,3,3,6,7,33,34,8,5,258,125
7,37,5,2,8,5,-47,23,1,8,211,148
7,38,2,5,4,9,22,-46,3,2,233,102
7,39,4,2,7,6,43,24,6,6,276,126
7,40,3,3,6,7,33,-66,9,0,309,60
7,41,3,3,9,4,-64,31,5,1,245,91
7,42,3,4,3,10,30,46,5,7,275,137
7,43,4,3,4,9,40,-64,5,3,315,73
7,44,3,4,7,6,34,42,9,5,349,115
7,45,2,4,8,5,-74,41,5,6,275,156
7,46,3,3,8,5,-65,32,0,8,210,188
7,47,4,3,7,6,43,-67,3,1,253,121
7,48,3,4,5,8,32,44,5,5,285,165
7,49,4,2,11,2,-53,20,2,5,232,185
7,50,3,3,8,5,35,32,7,7,267,217
7,51,3,3,3,10,30,-63,7,4,297,154
7,52,2,5,5,8,-77,53,0,7,220,207
7,53,5,2,11,2,56,20,6,7,276,227
7,54,3,3,7,6,-66,-67,0,0,210,160
7,55,3,3,6,7,33,34,3,4,243,194
7,56,4,3,7,6,43,33,6,7,286,227
7,57,4,3,5,8,41,-65,7,2,327,162
7,58,3,4,8,5,-65,41,2,3,262,203
7,59,4,2,5,8,41,26,3,9,303,229
7,60,2,5,2,11,20,-44,3,5,323,185
7,61,2,4,5,8,23,44,6,9,346,229
7,62,3,3,6,7,33,-66,9,3,379,163
7,63,5,2,7,6,-48,24,1,7,331,187
7,64,5,2,9,4,54,22,5,9,385,209
7,65,2,4,9,4,-73,40,2,9,312,249
7,66,4,2,7,6,43,-76,5,3,355,173
7,67,3,3,4,9,31,36,6,9,386,209
7,68,4,2,7,6,43,-76,9,3,429,133
7,69,5,2,9,4,-46,22,3,5,383,155
7,70,5,2,6,7,51,-75,4,0,434,80
7,71,3,4,5,8,32,44,6,4,466,124
7,72,3,4,7,6,-66,42,0,6,400,166
7,73,3,3,9,4,36,31,6,7,436,197
7,74,5,2,11,2,-44,20,2,7,392,217
7,75,5,2,9,4,54,22,6,9,446,239
7,76,3,3,9,4,-64,-69,2,0,382,170
7,77,3,3,5,8,32,35,4,5,414,205
7,78,2,5,2,11,20,-44,4,1,434,161
7,79,4,3,8,5,44,32,8,3,478,193
7,80,4,3,7,6,-57,33,1,6,421,226
7,81,5,2,7,6,52,-76,3,0,473,150
7,82,2,4,4,9,22,45,5,5,495,195
7,83,4,2,9,4,-55,22,0,7,440,217
7,84,2,4,4,9,22,-55,2,2,462,162
7,85,2,5,4,9,22,54,4,6,484,216
7,86,4,3,8,5,44,32,8,8,528,248
8,1,4,2,6,7,42,25,2,5,42,25
8,2,4,3,7,6,43,33,5,8,85,58
8,3,4,2,8,5,44,-77,9,1,129,-19
8,4,4,2,9,4,-55,22,4,3,74,3
8,5,3,3,6,7,33,34,7,7,107,37
8,6,5,3,8,5,-47,32,0,9,60,69
8,7,2,5,5,8,23,-47,3,2,83,22
8,8,4,2,6,7,42,25,5,7,125,47
8,9,4,2,9,4,-55,22,0,9,70,69
8,10,3,4,5,8,32,-56,2,3,102,13
8,11,3,3,7,6,34,33,6,6,136,46
8,12,5,3,10,3,-45,30,1,6,91,76
8,13,5,2,7,6,52,-76,3,0,143,0
8,14,3,4,7,6,34,42,7,2,177,42
8,15,4,3,5,8,41,35,8,7,218,77
8,16,5,2,6,7,51,-75,9,2,269,2
8,17,2,4,5,8,-77,44,2,6,192,46
8,18,4,3,8,5,44,32,6,8,236,78
8,19,4,2,8,5,-56,-77,0,1,180,1
8,20,6,2,11,2,65,20,5,1,245,21
8,21,4,3,8,5,44,32,9,3,289,53
8,22,4,2,9,4,-55,22,4,5,234,75
8,23,2,5,3,10,21,-45,5,0,255,30
8,24,4,4,6,7,42,43,7,3,297,73
8,25,4,3,9,4,-55,31,2,4,242,104
8,26,3,3,6,7,33,34,5,8,275,138
8,27,4,3,8,5,44,-68,9,0,319,70
8,28,3,4,3,10,30,46,9,6,349,116
8,29,2,5,3,10,-79,-45,0,1,270,71
8,30,2,6,4,9,22,63,2,4,292,134
8,31,4,4,5,8,41,44,3,8,333,178
8,32,4,2,10,3,46,21,9,9,379,199
8,33,3,4,7,6,-66,-58,3,1,313,141
8,34,4,3,6,7,42,34,5,5,355,175
8,35,4,3,8,5,44,32,9,7,399,207
8,36,2,4,5,8,-77,-56,2,1,322,151
8,37,2,5,5,8,23,53,5,4,345,204
8,38,2,4,3,10,21,-54,6,0,366,150
8,39,7,2,10,3,73,21,9,1,439,171
8,40,3,3,4,9,-69,36,0,7,370,207
8,41,2,5,5,8,23,-47,3,0,393,160
8,42,4,2,9,4,45,22,8,2,438,182
8,43,4,3,7,6,-57,33,1,5,381,215
8,44,3,3,8,5,35,32,6,7,416,247
8,45,3,3,8,5,-65,32,1,9,351,279
8,46,2,5,4,9,22,-46,3,3,373,233
8,47,3,3,7,6,34,33,7,6,407,266
8,48,4,3,9,4,-55,31,2,7,352,297
8,49,3,4,4,9,31,-55,3,2,383,242
8,50,3,3,10,3,-63,30,0,2,320,272
8,51,3,3,5,8,32,35,2,7,352,307
8,52,3,3,8,5,35,32,7,9,387,339
8,53,2,4,7,6,-75,-58,2,1,312,281
8,54,4,3,9,4,45,31,7,2,357,312
8,55,2,5,5,8,-77,53,0,5,280,365
8,56,2,4,7,6,25,42,5,7,305,407
8,57,2,5,4,9,22,-46,7,1,327,361
8,58,4,2,8,5,-56,23,1,4,271,384
8,59,2,6,2,11,20,65,1,9,291,449
8,60,3,3,6,7,33,-66,4,3,324,383
8,61,2,5,5,8,23,53,7,6,347,436
8,62,3,3,3,10,30,-63,7,3,377,373
8,63,3,3,9,4,-64,31,3,4,313,404
8,64,4,3,9,4,45,31,8,5,358,435
8,65,3,4,5,8,-68,44,0,9,290,479
8,66,2,4,8,5,26,-59,6,0,316,420
8,67,4,3,10,3,-54,30,2,0,262,450
8,68,2,4,4,9,22,45,4,5,284,495
8,69,2,5,4,9,22,54,6,9,306,549
9,1,3,3,7,6,34,33,4,3,34,33
9,2,4,3,8,5,44,32,8,5,78,65
9,3,3,4,6,7,-67,43,1,8,11,108
9,4,3,3,5,8,32,-65,3,3,43,43
9,5,2,4,7,6,25,42,8,5,68,85
9,6,5,2,9,4,-46,22,2,7,22,107
9,7,4,3,8,5,44,32,6,9,66,139
9,8,2,4,6,7,-76,-57,0,2,-10,82
9,9,3,4,6,7,33,43,3,5,23,125
9,10,3,3,7,6,34,33,7,8,57,158
9,11,3,4,6,7,-67,-57,0,1,-10,101
9,12,5,2,7,6,52,24,2,5,42,125
9,13,2,4,5,8,23,44,5,9,65,169
9,14,3,4,5,8,32,-56,7,3,97,113
9,15,3,4,6,7,-67,43,0,6,30,156
9,16,3,4,5,8,32,-56,2,0,62,100
9,17,5,3,7,6,52,33,4,3,114,133
9,18,5,2,9,4,54,22,8,5,168,155
9,19,4,3,8,5,-56,32,2,7,112,187
9,20,4,2,6,7,42,-75,4,2,154,112
9,21,3,3,9,4,-64,31,0,3,90,143
9,22,4,3,8,5,44,32,4,5,134,175
9,23,3,4,8,5,35,41,9,6,169,216
9,24,3,3,7,6,-66,33,3,9,103,249
9,25,5,3,9,4,54,-69,7,0,157,180
9,26,3,3,7,6,-66,33,1,3,91,213
9,27,4,3,8,5,44,32,5,5,135,245
9,28,4,2,9,4,-55,22,0,7,80,267
9,29,3,4,5,8,32,-56,2,1,112,211
9,30,3,3,6,7,33,34,5,5,145,245
9,31,3,3,4,9,31,-64,6,1,176,181
9,32,2,5,7,6,-75,51,1,2,101,232
9,33,3,4,3,10,30,46,1,8,131,278
9,34,4,2,6,7,42,-75,3,3,173,203
9,35,3,4,5,8,32,44,5,7,205,247
9,36,4,3,6,7,42,-66,7,1,247,181
9,37,3,3,7,6,-66,33,1,4,181,214
9,38,3,4,3,10,30,-54,1,0,211,160
9,39,2,5,5,8,23,53,4,3,234,213
9,40,3,4,6,7,33,43,7,6,267,256
9,41,3,4,4,9,31,-55,8,1,298,201
9,42,4,2,9,4,-55,22,3,3,243,223
9,43,4,3,8,5,44,32,7,5,287,255
9,44,2,5,6,7,-76,52,1,7,211,307
9,45,2,4,5,8,23,-56,4,1,234,251
9,46,3,3,5,8,32,35,6,6,266,286
9,47,2,5,3,10,21,-45,7,1,287,241
9,48,3,3,4,9,31,36,8,7,318,277
9,49,4,2,7,6,-57,-76,1,1,261,201
9,50,4,3,9,4,45,31,6,2,306,232
9,51,4,2,8,5,-56,23,0,5,250,255
9,52,5,2,7,6,52,24,2,9,302,279
9,53,3,3,6,7,33,-66,5,3,335,213
9,54,4,3,6,7,42,34,7,7,377,247
9,55,2,5,4,9,22,-46,9,1,399,201
9,56,5,2,9,4,-46,22,3,3,353,223
9,57,2,4,4,9,22,45,5,8,375,268
9,58,2,4,7,6,-75,-58,0,0,300,210
9,59,3,3,6,7,33,34,3,4,333,244
9,60,2,6,4,9,22,63,5,7,355,307
9,61,3,3,8,5,-65,32,0,9,290,339
9,62,5,2,10,3,55,-79,5,0,345,260
9,63,4,4,7,6,43,42,8,2,388,302
9,64,4,3,8,5,-56,32,2,4,332,334
9,65,2,4,3,10,21,-54,3,0,353,280
9,66,5,2,7,6,52,24,5,4,405,304
9,67,3,3,6,7,33,34,8,8,438,338
9,68,2,4,7,6,-75,-58,3,0,363,280
9,69,2,4,4,9,22,45,5,5,385,325
9,70,2,4,4,9,22,-55,7,0,407,270
9,71,3,3,7,6,-66,33,1,3,341,303
9,72,3,4,6,7,33,43,4,6,374,346
9,73,2,5,3,10,21,-45,5,1,395,301
9,74,3,5,5,8,32,53,7,4,427,354
9,75,4,2,9,4,-55,22,2,6,372,376
9,76,5,3,9,4,54,31,6,7,426,407
9,77,2,6,3,10,21,-36,7,1,447,371
9,78,3,3,6,7,-67,34,0,5,380,405
9,79,4,2,9,4,45,22,5,7,425,427
9,80,4,2,7,6,43,-76,8,1,468,351
9,81,3,4,6,7,-67,43,1,4,401,394
9,82,3,3,7,6,34,33,5,7,435,427
9,83,4,2,9,4,-55,22,0,9,380,449
9,84,3,4,4,9,31,-55,1,4,411,394
9,85,3,4,5,8,32,44,3,8,443,438
9,86,3,4,5,8,32,-56,5,2,475,382
9,87,3,4,5,8,32,44,7,6,507,426
10,1,3,3,5,8,32,35,2,5,32,35
10,2,2,4,4,9,22,-55,4,0,54,-20
10,3,3,3,4,9,31,36,5,6,85,16
10,4,4,3,8,5,44,32,9,8,129,48
10,5,2,5,5,8,-77,-47,2,1,52,1
10,6,3,3,5,8,32,35,4,6,84,36
10,7,3,4,5,8,32,-56,6,0,116,-20
10,8,2,4,5,8,23,44,9,4,139,24
10,9,4,3,9,4,-55,31,4,5,84,55
10,10,5,2,8,5,53,23,7,8,137,78
10,11,5,2,9,4,-46,-78,1,0,91,0
10,12,4,3,8,5,44,32,5,2,135,32
10,13,2,4,6,7,24,43,9,5,159,75
10,14,2,4,4,9,-78,-55,1,0,81,20
10,15,2,5,3,10,21,55,2,5,102,75
10,16,4,3,6,7,42,34,4,9,144,109
10,17,2,4,5,8,23,-56,7,3,167,53
10,18,4,3,4,9,40,36,7,9,207,89
10,19,3,3,6,7,-67,-66,0,3,140,23
10,20,3,4,6,7,33,43,3,6,173,66
10,21,4,3,7,6,43,33,6,9,216,99
10,22,2,6,6,7,-76,-39,0,0,140,60
10,23,2,4,5,8,23,44,3,4,163,104
10,24,4,3,9,4,45,31,8,5,208,135
10,25,3,3,7,6,-66,33,2,8,142,168
10,26,3,4,4,9,31,-55,3,3,173,113
10,27,3,5,4,9,31,54,4,7,204,167
10,28,3,4,5,8,32,-56,6,1,236,111
10,29,3,3,6,7,33,34,9,5,269,145
10,30,2,4,5,8,-77,44,2,9,192,189
10,31,4,3,7,6,43,-67,5,2,235,122
10,32,2,5,5,8,23,53,8,5,258,175
10,33,3,3,4,9,31,-64,9,1,289,111
10,34,3,3,5,8,-68,35,1,6,221,146
10,35,3,3,6,7,33,-66,4,0,254,80
10,36,4,3,6,7,42,34,6,4,296,114
10,37,2,6,3,10,21,64,7,8,317,178
10,38,4,2,7,6,-57,-76,0,2,260,102
10,39,4,4,7,6,43,42,3,4,303,144
10,40,2,5,5,8,23,53,6,7,326,197
10,41,3,4,5,8,32,-56,8,1,358,141
10,42,3,3,7,6,-66,33,2,4,292,174
10,43,3,3,8,5,35,32,7,6,327,206
10,44,4,3,8,5,-56,32,1,8,271,238
10,45,3,4,6,7,33,-57,4,1,304,181
10,46,5,2,8,5,53,23,7,4,357,204
10,47,3,4,8,5,-65,41,2,5,292,245
10,48,3,3,6,7,33,34,5,9,325,279
10,49,3,4,3,10,30,-54,5,5,355,225
10,50,4,2,7,6,43,24,8,9,398,249
10,51,3,3,6,7,-67,-66,1,3,331,183
10,52,3,3,7,6,34,33,5,6,365,216
10,53,5,2,7,6,52,-76,7,0,417,140
10,54,4,2,8,5,-56,23,1,3,361,163
10,55,2,4,5,8,23,44,4,7,384,207
10,56,3,3,7,6,34,-67,8,0,418,140
10,57,5,2,9,4,-46,22,2,2,372,162
10,58,4,2,8,5,44,23,6,5,416,185
10,59,4,2,7,6,43,24,9,9,459,209
10,60,3,4,6,7,-67,-57,2,2,392,152
10,61,2,5,4,9,22,54,4,6,414,206
10,62,3,3,7,6,34,33,8,9,448,239
10,63,2,4,6,7,-76,-57,2,2,372,182
10,64,4,2,9,4,45,22,7,4,417,204
10,65,4,3,5,8,41,35,8,9,458,239
10,66,2,5,3,10,21,-45,9,4,479,194
10,67,4,2,9,4,-55,22,4,6,424,216
10,68,3,3,5,8,32,-65,6,1,456,151
10,69,3,3,7,6,-66,33,0,4,390,184
10,70,2,4,4,9,22,45,2,9,412,229
10,71,3,4,6,7,33,-57,5,2,445,172
10,72,4,3,6,7,42,34,7,6,487,206
10,73,2,4,5,8,-77,-56,0,0,410,150
10,74,5,2,10,3,55,21,5,1,465,171
10,75,3,3,9,4,-64,31,1,2,401,202
10,76,2,4,4,9,22,45,3,7,423,247
10,77,3,3,6,7,33,-66,6,1,456,181
10,78,3,4,6,7,33,43,9,4,489,224
10,79,2,4,4,9,-78,45,1,9,411,269
10,80,3,3,4,9,31,-64,2,5,442,205
10,81,3,3,6,7,33,34,5,9,475,239
10,82,2,5,7,6,-75,-49,0,0,400,190
10,83,3,4,4,9,31,45,1,5,431,235
10,84,3,4,5,8,32,44,3,9,463,279
10,85,2,5,4,9,22,-46,5,3,485,233
10,86,2,4,6,7,24,43,9,6,509,276
11,1,2,5,6,7,24,52,4,2,24,52
11,2,4,3,9,4,45,31,9,3,69,83
11,3,2,4,8,5,-74,41,5,4,-5,124
11,4,3,4,4,9,31,45,6,9,26,169
11,5,5,2,10,3,-45,-79,1,0,-19,90
11,6,3,4,6,7,33,43,4,3,14,133
11,7,3,4,8,5,35,41,9,4,49,174
11,8,3,3,7,6,-66,33,3,7,-17,207
11,9,3,3,7,6,34,-67,7,0,17,140
11,10,3,3,9,4,-64,31,3,1,-47,171
11,11,4,2,6,7,42,25,5,6,-5,196
11,12,2,4,5,8,23,-56,8,0,18,140
11,13,3,3,9,4,-64,31,4,1,-46,171
11,14,2,4,4,9,22,45,6,6,-24,216
11,15,3,3,6,7,33,-66,9,0,9,150
11,16,2,5,4,9,-78,54,1,4,-69,204
11,17,5,2,10,3,55,21,6,5,-14,225
11,18,3,3,8,5,-65,32,1,7,-79,257
11,19,3,3,6,7,33,-66,4,1,-46,191
11,20,4,3,8,5,44,32,8,3,-2,223
11,21,4,3,7,6,-57,33,1,6,-59,256
11,22,5,2,8,5,53,23,4,9,-6,279
11,23,3,3,5,8,32,-65,6,4,26,214
11,24,4,3,6,7,42,34,8,8,68,248
11,25,4,2,9,4,-55,-78,3,0,13,170
11,26,3,4,7,6,34,42,7,2,47,212
11,27,2,4,4,9,22,45,9,7,69,257
11,28,3,3,5,8,-68,-65,1,2,1,192
11,29,5,3,9,4,54,31,5,3,55,223
11,30,2,5,6,7,24,52,9,5,79,275
11,31,3,3,9,4,-64,31,5,6,15,306
11,32,2,4,4,9,22,-55,7,1,37,251
11,33,3,4,6,7,-67,43,0,4,-30,294
11,34,3,4,5,8,32,44,2,8,2,338
11,35,3,4,5,8,32,-56,4,2,34,282
11,36,2,5,4,9,22,54,6,6,56,336
11,37,5,2,8,5,53,23,9,9,109,359
11,38,3,3,8,5,-65,-68,4,1,44,291
11,39,3,3,6,7,33,34,7,5,77,325
11,40,2,6,4,9,22,63,9,8,99,388
11,41,4,3,5,8,-59,-65,0,3,40,323
11,42,2,4,4,9,22,45,2,8,62,368
11,43,2,4,7,6,25,-58,7,0,87,310
11,44,3,3,10,3,-63,30,4,0,24,340
11,45,3,3,7,6,34,33,8,3,58,373
11,46,4,3,10,3,-54,30,4,3,4,403
11,47,2,4,5,8,23,44,7,7,27,447
11,48,4,2,7,6,-57,-76,0,1,-30,371
11,49,3,4,6,7,33,43,3,4,3,414
11,50,3,4,5,8,32,44,5,8,35,458
11,51,5,2,9,4,54,-78,9,0,89,380
11,52,2,5,3,10,-79,55,0,5,10,435
11,53,4,3,6,7,42,34,2,9,52,469
11,54,3,4,6,7,33,-57,5,2,85,412
11,55,2,5,4,9,22,54,7,6,107,466
11,56,3,4,7,6,-66,42,1,8,41,508
12,1,5,3,6,7,51,34,1,4,51,34
12,2,3,4,7,6,34,42,5,6,85,76
12,3,4,2,7,6,43,-76,8,0,128,0
12,4,2,4,5,8,-77,44,1,4,51,44
12,5,4,2,7,6,43,24,4,8,94,68
12,6,5,2,9,4,54,-78,8,0,148,-10
12,7,2,5,5,8,-77,53,1,3,71,43
12,8,4,2,11,2,47,20,8,3,118,63
12,9,2,5,2,11,20,56,8,9,138,119
12,10,3,3,6,7,-67,-66,1,3,71,53
12,11,4,2,7,6,43,24,4,7,114,77
12,12,4,4,8,5,44,41,8,8,158,118
12,13,4,2,7,6,-57,-76,1,2,101,42
12,14,4,3,7,6,43,33,4,5,144,75
12,15,2,4,5,8,23,44,7,9,167,119
12,16,3,4,7,6,-66,-58,1,1,101,61
12,17,3,3,6,7,33,34,4,5,134,95
12,18,3,4,8,5,35,41,9,6,169,136
12,19,3,4,4,9,-69,-55,0,1,100,81
12,20,2,5,2,11,20,56,0,7,120,137
12,21,3,4,3,10,30,-54,0,3,150,83
12,22,3,3,8,5,35,32,5,5,185,115
12,23,3,4,9,4,-64,40,1,5,121,155
12,24,4,2,6,7,42,-75,3,0,163,80
12,25,2,4,4,9,22,45,5,5,185,125
12,26,4,3,7,6,43,33,8,8,228,158
12,27,4,2,7,6,-57,-76,1,2,171,82
12,28,3,3,5,8,32,35,3,7,203,117
12,29,3,4,8,5,35,41,8,8,238,158
12,30,4,3,7,6,-57,-67,1,1,181,91
12,31,3,4,7,6,34,42,5,3,215,133
12,32,5,3,9,4,54,31,9,4,269,164
12,33,3,4,6,7,-67,43,2,7,202,207
12,34,4,2,9,4,45,22,7,9,247,229
12,35,4,4,5,8,41,-56,8,3,288,173
12,36,2,5,3,10,21,55,9,8,309,228
12,37,2,4,4,9,-78,-55,1,3,231,173
12,38,4,3,7,6,43,33,4,6,274,206
12,39,3,3,9,4,-64,31,0,7,210,237
12,40,4,3,5,8,41,-65,1,2,251,172
12,41,3,4,9,4,36,40,7,2,287,212
12,42,5,2,8,5,-47,23,0,5,240,235
12,43,2,5,6,7,24,52,4,7,264,287
12,44,4,2,6,7,42,-75,6,2,306,212
12,45,3,3,7,6,-66,33,0,5,240,245
12,46,5,2,9,4,54,22,4,7,294,267
12,47,4,2,8,5,44,-77,8,0,338,190
12,48,3,4,5,8,-68,44,0,4,270,234
12,49,4,3,5,8,41,35,1,9,311,269
12,50,4,3,7,6,43,-67,4,2,354,202
12,51,3,3,8,5,35,32,9,4,389,234
12,52,5,2,10,3,-45,21,4,5,344,255
12,53,4,4,8,5,44,41,8,6,388,296
12,54,5,2,9,4,-46,22,2,8,342,318
12,55,3,3,6,7,33,-66,5,2,375,252
12,56,3,4,4,9,31,45,6,7,406,297
12,57,4,2,7,6,43,-76,9,1,449,221
12,58,3,4,7,6,-66,42,3,3,383,263
12,59,2,5,5,8,23,53,6,6,406,316
12,60,3,4,7,6,-66,42,0,8,340,358
12,61,3,3,3,10,30,-63,0,5,370,295
12,62,4,3,8,5,44,32,4,7,414,327
12,63,3,3,7,6,34,-67,8,0,448,260
12,64,3,4,5,8,-68,44,0,4,380,304
12,65,3,3,5,8,32,35,2,9,412,339
12,66,2,4,4,9,22,-55,4,4,434,284
12,67,4,2,8,5,44,23,8,7,478,307
12,68,3,3,8,5,-65,32,3,9,413,339
12,69,3,3,6,7,33,-66,6,3,446,273
12,70,3,3,9,4,-64,31,2,4,382,304
12,71,4,3,9,4,45,31,7,5,427,335
12,72,4,4,8,5,-56,41,1,6,371,376
12,73,2,4,5,8,23,-56,4,0,394,320
12,74,3,4,7,6,34,42,8,2,428,362
12,75,3,4,4,9,31,45,9,7,459,407
12,76,3,4,6,7,-67,-57,2,0,392,350
12,77,4,2,7,6,43,24,5,4,435,374
12,78,2,4,4,9,22,45,7,9,457,419
12,79,3,3,6,7,-67,-66,0,3,390,353
12,80,4,3,6,7,42,34,2,7,432,387
12,81,3,4,6,7,33,-57,5,0,465,330
12,82,2,5,5,8,23,53,8,3,488,383
12,83,4,3,9,4,-55,31,3,4,433,414
12,84,4,3,7,6,43,33,6,7,476,447
12,85,3,4,5,8,32,-56,8,1,508,391
13,1,2,4,5,8,23,44,3,4,23,44
13,2,2,5,4,9,22,54,5,8,45,98
13,3,3,3,6,7,33,-66,8,2,78,32
13,4,3,3,4,9,31,36,9,8,109,68
13,5,2,4,4,9,-78,-55,1,3,31,13
13,6,2,4,6,7,24,43,5,6,55,56
13,7,3,3,8,5,-65,32,0,8,-10,88
13,8,4,3,10,3,46,30,6,8,36,118
13,9,4,3,6,7,42,-66,8,2,78,52
13,10,2,4,6,7,-76,43,2,5,2,95
13,11,2,4,7,6,25,42,7,7,27,137
13,12,4,3,8,5,-56,32,1,9,-29,169
13,13,3,4,5,8,32,-56,3,3,3,113
13,14,4,2,6,7,42,25,5,8,45,138
13,15,4,3,8,5,44,-68,9,0,89,70
13,16,3,3,6,7,-67,34,2,4,22,104
13,17,4,2,9,4,45,22,7,6,67,126
13,18,6,2,8,5,62,23,9,9,129,149
13,19,3,4,8,5,-65,-59,4,0,64,90
13,20,4,3,6,7,42,34,6,4,106,124
13,21,3,3,8,5,-65,32,1,6,41,156
13,22,2,6,3,10,21,-36,2,0,62,120
13,23,3,4,6,7,33,43,5,3,95,163
13,24,4,2,10,3,-54,21,1,4,41,184
13,25,2,4,6,7,24,43,5,7,65,227
13,26,4,2,7,6,43,-76,8,1,108,151
13,27,3,4,8,5,-65,41,3,2,43,192
13,28,3,3,6,7,33,34,6,6,76,226
13,29,3,3,6,7,33,-66,9,0,109,160
13,30,3,4,4,9,-69,45,0,5,40,205
13,31,3,3,6,7,33,34,3,9,73,239
13,32,2,6,3,10,21,-36,4,3,94,203
13,33,2,4,5,8,23,44,7,7,117,247
13,34,3,4,3,10,30,-54,7,3,147,193
13,35,3,4,7,6,-66,42,1,5,81,235
13,36,4,3,5,8,41,-65,2,0,122,170
13,37,4,2,8,5,44,23,6,3,166,193
13,38,4,3,8,5,-56,32,0,5,110,225
13,39,3,4,7,6,34,42,4,7,144,267
13,40,4,2,8,5,44,-77,8,0,188,190
13,41,4,2,7,6,-57,24,1,4,131,214
13,42,3,3,6,7,33,34,4,8,164,248
13,43,4,2,7,6,43,-76,7,2,207,172
13,44,4,3,8,5,-56,32,1,4,151,204
13,45,3,3,5,8,32,35,3,9,183,239
13,46,3,3,7,6,34,-67,7,2,217,172
13,47,3,3,5,8,32,35,9,7,249,207
13,48,3,4,6,7,-67,-57,2,0,182,150
13,49,3,3,7,6,34,33,6,3,216,183
13,50,2,5,5,8,23,53,9,6,239,236
13,51,5,2,6,7,-49,-75,0,1,190,161
13,52,2,5,3,10,21,55,1,6,211,216
13,53,2,5,2,11,20,-44,1,2,231,172
13,54,4,2,8,5,44,23,5,5,275,195
13,55,3,3,4,9,31,-64,6,1,306,131
13,56,3,3,5,8,32,35,8,6,338,166
13,57,4,2,6,7,-58,-75,0,1,280,91
13,58,3,4,3,10,30,46,0,7,310,137
13,59,2,5,3,10,21,-45,1,2,331,92
13,60,2,5,3,10,21,55,2,7,352,147
13,61,4,3,10,3,46,30,8,7,398,177
13,62,3,4,4,9,31,-55,9,2,429,122
13,63,4,4,6,7,-58,43,1,5,371,165
13,64,4,3,7,6,43,33,4,8,414,198
13,65,3,3,7,6,34,-67,8,1,448,131
13,66,3,3,7,6,-66,33,2,4,382,164
13,67,4,2,6,7,42,25,4,9,424,189
13,68,3,3,4,9,31,-64,5,5,455,125
13,69,4,2,8,5,44,23,9,8,499,148
13,70,4,4,7,6,-57,-58,2,0,442,90
13,71,3,4,5,8,32,44,4,4,474,134
13,72,3,4,5,8,32,44,6,8,506,178
14,1,4,3,9,4,45,31,5,1,45,31
14,2,2,5,6,7,24,52,9,3,69,83
14,3,2,4,5,8,-77,44,2,7,-8,127
14,4,4,4,9,4,45,40,7,7,37,167
14,5,2,5,4,9,22,-46,9,1,59,121
14,6,4,2,9,4,-55,22,4,3,4,143
14,7,5,2,7,6,52,24,6,7,56,167
14,8,3,4,7,6,-66,42,0,9,-10,209
14,9,4,2,6,7,42,-75,2,4,32,134
14,10,5,2,10,3,55,21,7,5,87,155
14,11,2,4,7,6,-75,42,2,7,12,197
14,12,5,2,6,7,51,-75,3,2,63,122
14,13,4,3,9,4,45,31,8,3,108,153
14,14,4,3,7,6,-57,33,1,6,51,186
14,15,4,2,10,3,46,21,7,7,97,207
14,16,3,4,5,8,32,-56,9,1,129,151
14,17,4,3,6,7,-58,34,1,5,71,185
14,18,3,4,5,8,32,44,3,9,103,229
14,19,4,2,8,5,44,-77,7,2,147,152
14,20,3,4,6,7,-67,43,0,5,80,195
14,21,3,3,8,5,35,32,5,7,115,227
14,22,5,2,9,4,54,22,9,9,169,249
14,23,5,2,9,4,-46,-78,3,1,123,171
14,24,4,2,9,4,45,22,8,3,168,193
14,25,3,3,6,7,-67,34,1,7,101,227
14,26,2,4,7,6,25,42,6,9,126,269
14,27,5,2,10,3,-45,-79,1,0,81,190
14,28,2,4,4,9,22,45,3,5,103,235
14,29,3,4,4,9,31,-55,4,0,134,180
14,30,3,3,7,6,34,33,8,3,168,213
14,31,5,2,10,3,-45,21,3,4,123,234
14,32,3,3,8,5,35,32,8,6,158,266
14,33,2,6,2,11,20,-35,8,1,178,231
14,34,4,3,6,7,-58,34,0,5,120,265
14,35,3,4,6,7,33,43,3,8,153,308
14,36,3,4,4,9,31,-55,4,3,184,253
14,37,3,4,4,9,31,45,5,8,215,298
14,38,3,5,5,8,32,-47,7,1,247,251
14,39,4,2,9,4,-55,22,2,3,192,273
14,40,3,3,7,6,34,33,6,6,226,306
14,41,2,5,6,7,-76,52,0,8,150,358
14,42,2,4,7,6,25,-58,5,0,175,300
14,43,3,3,6,7,33,34,8,4,208,334
14,44,4,2,9,4,-55,22,3,6,153,356
14,45,2,5,5,8,23,53,6,9,176,409
14,46,5,2,10,3,-45,-79,1,0,131,330
14,47,3,4,5,8,32,44,3,4,163,374
14,48,3,3,7,6,34,33,7,7,197,407
14,49,5,2,7,6,52,-76,9,1,249,331
14,50,3,4,7,6,-66,42,3,3,183,373
14,51,4,2,5,8,41,26,4,9,224,399
14,52,3,3,6,7,33,-66,7,3,257,333
14,53,2,5,2,11,20,56,7,9,277,389
14,54,3,4,3,10,30,-54,7,5,307,335
14,55,5,3,10,3,-45,30,2,5,262,365
14,56,5,2,11,2,56,20,8,5,318,385
14,57,4,3,7,6,-57,33,1,8,261,418
14,58,2,5,5,8,23,-47,4,1,284,371
14,59,3,3,6,7,33,34,7,5,317,405
14,60,3,4,7,6,-66,42,1,7,251,447
14,61,4,3,6,7,42,-66,3,1,293,381
14,62,5,2,9,4,54,22,7,3,347,403
14,63,4,2,7,6,-57,24,0,7,290,427
14,64,5,2,9,4,54,22,4,9,344,449
14,65,2,4,5,8,23,-56,7,3,367,393
14,66,4,3,7,6,-57,33,0,6,310,426
14,67,3,3,6,7,33,-66,3,0,343,360
14,68,5,2,11,2,56,20,9,0,399,380
14,69,2,4,7,6,-75,42,4,2,324,422
14,70,3,4,7,6,34,42,8,4,358,464
14,71,4,3,9,4,-55,31,3,5,303,495
14,72,4,2,8,5,44,23,7,8,347,518
15,1,3,3,8,5,35,32,5,2,35,32
15,2,5,2,11,2,-44,20,1,2,-9,52
15,3,4,3,9,4,45,31,6,3,36,83
15,4,3,3,5,8,32,35,8,8,68,118
15,5,2,5,3,10,21,-45,9,3,89,73
15,6,4,4,7,6,-57,42,2,5,32,115
15,7,2,4,5,8,23,44,5,9,55,159
15,8,3,4,4,9,31,-55,6,4,86,104
15,9,3,4,6,7,33,43,9,7,119,147
15,10,4,2,9,4,-55,22,4,9,64,169
15,11,2,4,7,6,25,-58,9,1,89,111
15,12,4,3,10,3,-54,30,5,1,35,141
15,13,3,3,6,7,33,34,8,5,68,175
15,14,3,3,7,6,-66,33,2,8,2,208
15,15,3,4,7,6,34,-58,6,0,36,150
15,16,2,4,6,7,-76,43,0,3,-40,193
15,17,2,5,4,9,22,54,2,7,-18,247
15,18,5,2,8,5,53,-77,5,0,35,170
15,19,3,4,3,10,30,46,5,6,65,216
15,20,5,2,9,4,54,22,9,8,119,238
15,21,3,4,5,8,-68,-56,1,2,51,182
15,22,4,3,8,5,44,32,5,4,95,214
15,23,2,4,6,7,24,43,9,7,119,257
15,24,3,3,6,7,-67,-66,2,1,52,191
15,25,4,2,6,7,42,25,4,6,94,216
15,26,3,4,6,7,33,43,7,9,127,259
15,27,3,3,9,4,-64,-69,3,0,63,190
15,28,4,2,10,3,46,21,9,1,109,211
15,29,6,2,11,2,-35,20,4,1,74,231
15,30,4,4,5,8,41,44,5,5,115,275
15,31,3,3,5,8,32,-65,7,0,147,210
15,32,3,3,9,4,-64,31,3,1,83,241
15,33,2,4,6,7,24,43,7,4,107,284
15,34,2,5,5,8,-77,53,0,7,30,337
15,35,4,3,8,5,44,32,4,9,74,369
15,36,4,2,7,6,43,-76,7,3,117,293
15,37,3,4,7,6,-66,42,1,5,51,335
15,38,3,4,6,7,33,43,4,8,84,378
15,39,4,2,9,4,45,-78,9,0,129,300
15,40,2,5,5,8,-77,53,2,3,52,353
15,41,3,3,8,5,35,32,7,5,87,385
15,42,3,4,5,8,32,44,9,9,119,429
15,43,4,4,8,5,-56,-59,3,0,63,370
15,44,4,4,6,7,42,43,5,3,105,413
15,45,3,4,5,8,32,44,7,7,137,457
15,46,4,2,7,6,-57,-76,0,1,80,381
15,47,2,6,3,10,21,64,1,5,101,445
15,48,2,5,4,9,22,54,3,9,123,499
15,49,4,2,8,5,44,-77,7,2,167,422
15,50,2,4,4,9,22,45,9,7,189,467
15,51,3,4,5,8,-68,-56,1,1,121,411
15,52,4,2,8,5,44,23,5,4,165,434
15,53,2,5,5,8,23,53,8,7,188,487
15,54,5,2,7,6,-48,-76,0,1,140,411
15,55,3,3,7,6,34,33,4,4,174,444
15,56,3,4,5,8,32,44,6,8,206,488
15,57,3,4,5,8,32,-56,8,2,238,432
15,58,3,4,5,8,-68,44,0,6,170,476
15,59,4,2,6,7,42,-75,2,1,212,401
15,60,5,2,10,3,55,21,7,2,267,422
15,61,5,2,9,4,-46,22,1,4,221,444
15,62,3,4,8,5,35,41,6,5,256,485
15,63,3,4,5,8,32,44,8,9,288,529
16,1,3,4,8,5,35,41,5,1,35,41
16,2,2,5,5,8,23,53,8,4,58,94
16,3,4,2,7,6,-57,24,1,8,1,118
16,4,4,2,8,5,44,-77,5,1,45,41
16,5,2,4,6,7,24,43,9,4,69,84
16,6,2,4,5,8,-77,44,2,8,-8,128
16,7,2,4,6,7,24,-57,6,1,16,71
16,8,4,3,8,5,-56,32,0,3,-40,103
16,9,4,3,6,7,42,34,2,7,2,137
16,10,3,4,6,7,33,-57,5,0,35,80
16,11,2,4,4,9,22,45,7,5,57,125
16,12,4,3,8,5,-56,32,1,7,1,157
16,13,2,5,5,8,23,-47,4,0,24,110
16,14,5,2,7,6,52,24,6,4,76,134
16,15,3,3,7,6,-66,33,0,7,10,167
16,16,4,3,6,7,42,-66,2,1,52,101
16,17,2,5,3,10,21,55,3,6,73,156
16,18,2,5,5,8,23,53,6,9,96,209
16,19,2,5,6,7,-76,-48,0,1,20,161
16,20,2,4,5,8,23,44,3,5,43,205
16,21,3,3,6,7,33,34,6,9,76,239
16,22,2,5,5,8,23,-47,9,2,99,192
16,23,3,3,7,6,-66,33,3,5,33,225
16,24,3,3,6,7,33,34,6,9,66,259
16,25,3,3,8,5,-65,-68,1,1,1,191
16,26,3,4,6,7,33,43,4,4,34,234
16,27,3,4,6,7,33,43,7,7,67,277
16,28,2,5,4,9,22,-46,9,1,89,231
16,29,3,4,9,4,-64,40,5,1,25,271
16,30,3,3,8,5,-65,32,0,3,-40,303
16,31,3,4,3,10,30,46,0,9,-10,349
16,32,5,2,10,3,55,-79,5,0,45,270
16,33,2,4,2,11,20,47,5,7,65,317
16,34,2,5,5,8,23,-47,8,0,88,270
16,35,2,6,4,9,-78,63,0,3,10,333
16,36,5,2,6,7,51,25,1,8,61,358
16,37,3,4,3,10,30,-54,1,4,91,304
16,38,2,4,6,7,24,43,5,7,115,347
16,39,3,4,9,4,-64,40,1,7,51,387
16,40,3,3,6,7,33,-66,4,1,84,321
16,41,4,3,9,4,45,31,9,2,129,352
16,42,4,3,7,6,-57,33,2,5,72,385
16,43,4,3,6,7,42,34,4,9,114,419
16,44,4,3,6,7,42,-66,6,3,156,353
16,45,4,3,6,7,42,34,8,7,198,387
16,46,3,4,9,4,-64,40,4,7,134,427
16,47,2,4,3,10,21,-54,5,3,155,373
16,48,4,3,9,4,-55,31,0,4,100,404
16,49,3,4,6,7,33,43,3,7,133,447
16,50,4,3,9,4,45,31,8,8,178,478
16,51,3,3,7,6,-66,-67,2,1,112,411
16,52,2,5,4,9,22,54,4,5,134,465
16,53,3,3,4,9,31,-64,5,1,165,401
16,54,4,2,8,5,44,23,9,4,209,424
16,55,5,2,9,4,-46,22,3,6,163,446
16,56,4,3,7,6,43,33,6,9,206,479
16,57,2,5,2,11,20,-44,6,5,226,435
16,58,3,3,8,5,-65,32,1,7,161,467
16,59,2,5,5,8,23,-47,4,0,184,420
16,60,5,2,10,3,55,21,9,1,239,441
16,61,5,2,9,4,-46,22,3,3,193,463
16,62,2,4,4,9,22,45,5,8,215,508
17,1,5,2,8,5,53,23,3,3,53,23
17,2,3,4,5,8,32,44,5,7,85,67
17,3,3,3,5,8,32,-65,7,2,117,2
17,4,4,2,4,9,40,27,7,9,157,29
17,5,3,3,6,7,-67,-66,0,3,90,-37
17,6,3,3,4,9,31,36,1,9,121,-1
17,7,5,2,10,3,55,-79,6,0,176,-80
17,8,3,4,8,5,-65,41,1,1,111,-39
17,9,3,3,6,7,33,34,4,5,144,-5
17,10,6,2,7,6,61,24,5,9,205,19
17,11,5,2,9,4,54,-78,9,1,259,-59
17,12,3,3,6,7,-67,34,2,5,192,-25
17,13,3,4,9,4,36,40,8,5,228,15
17,14,3,4,4,9,31,-55,9,0,259,-40
17,15,3,4,8,5,-65,41,4,1,194,1
17,16,3,3,6,7,33,34,7,5,227,35
17,17,4,3,6,7,42,34,9,9,269,69
17,18,4,3,6,7,-58,-66,1,3,211,3
17,19,4,3,9,4,45,31,6,4,256,34
17,20,4,2,9,4,-55,22,1,6,201,56
17,21,3,3,4,9,31,-64,2,2,232,-8
17,22,4,3,6,7,42,34,4,6,274,26
17,23,2,6,1,12,-20,-34,4,2,254,-8
17,24,3,4,7,6,34,42,8,4,288,34
17,25,3,3,6,7,-67,34,1,8,221,68
17,26,4,2,8,5,44,-77,5,1,265,-9
17,27,3,3,5,8,32,35,7,6,297,26
17,28,4,3,6,7,42,-66,9,0,339,-40
17,29,4,2,6,7,-58,25,1,5,281,-15
17,30,2,5,4,9,22,54,3,9,303,39
17,31,4,3,8,5,44,-68,7,1,347,-29
17,32,5,2,9,4,-46,22,1,3,301,-7
17,33,4,2,7,6,43,24,4,7,344,17
17,34,5,2,10,3,55,21,9,8,399,38
17,35,2,5,6,7,-76,-48,3,0,323,-10
17,36,5,2,8,5,53,23,6,3,376,13
17,37,3,3,7,6,-66,33,0,6,310,46
17,38,5,2,9,4,54,22,4,8,364,68
17,39,3,4,8,5,35,41,9,9,399,109
17,40,3,4,8,5,-65,-59,4,0,334,50
17,41,2,5,3,10,21,55,5,5,355,105
17,42,2,5,6,7,24,52,9,7,379,157
17,43,4,2,9,4,-55,22,4,9,324,179
17,44,5,2,8,5,53,-77,7,2,377,102
17,45,3,3,10,3,-63,30,4,2,314,132
17,46,4,3,8,5,44,32,8,4,358,164
17,47,3,4,8,5,-65,41,3,5,293,205
17,48,3,3,6,7,33,34,6,9,326,239
17,49,4,3,9,4,-55,-69,1,0,271,170
17,50,4,2,7,6,43,24,4,4,314,194
17,51,4,3,9,4,45,31,9,5,359,225
17,52,2,4,4,9,-78,-55,1,0,281,170
17,53,5,2,9,4,54,22,5,2,335,192
17,54,5,2,9,4,54,22,9,4,389,214
17,55,4,3,7,6,-57,33,2,7,332,247
17,56,3,4,7,6,34,42,6,9,366,289
17,57,4,2,8,5,-56,-77,0,2,310,212
17,58,3,4,5,8,32,44,2,6,342,256
17,59,4,3,7,6,43,33,5,9,385,289
17,60,2,4,4,9,22,-55,7,4,407,234
17,61,4,2,10,3,-54,21,3,5,353,255
17,62,4,2,5,8,41,-74,4,1,394,181
17,63,5,2,8,5,53,23,7,4,447,204
17,64,5,2,8,5,-47,23,0,7,400,227
17,65,4,3,7,6,43,-67,3,0,443,160
17,66,3,3,7,6,34,33,7,3,477,193
17,67,4,4,4,9,40,45,7,8,517,238
18,1,3,4,8,5,35,41,5,1,35,41
18,2,3,3,7,6,34,33,9,4,69,74
18,3,3,3,7,6,-66,33,3,7,3,107
18,4,5,2,10,3,55,21,8,8,58,128
18,5,5,3,9,4,-46,31,2,9,12,159
18,6,4,3,8,5,44,-68,6,1,56,91
18,7,3,4,5,8,32,44,8,5,88,135
18,8,2,6,5,8,-77,62,1,7,11,197
18,9,2,4,6,7,24,-57,5,0,35,140
18,10,5,2,7,6,52,24,7,4,87,164
18,11,4,3,9,4,-55,31,2,5,32,195
18,12,2,4,4,9,22,-55,4,0,54,140
18,13,4,2,11,2,-53,20,1,0,1,160
18,14,2,5,7,6,25,51,6,1,26,211
18,15,5,2,8,5,53,23,9,4,79,234
18,16,2,5,4,9,-78,54,1,8,1,288
18,17,3,4,6,7,33,-57,4,1,34,231
18,18,3,4,5,8,32,44,6,5,66,275
18,19,5,2,9,4,-46,22,0,7,20,297
18,20,2,5,8,5,26,50,6,7,46,347
18,21,5,2,11,2,-44,20,2,7,2,367
18,22,3,4,5,8,32,-56,4,1,34,311
18,23,3,3,7,6,34,33,8,4,68,344
18,24,4,3,5,8,41,35,9,9,109,379
18,25,3,4,4,9,-69,-55,0,4,40,324
18,26,4,3,9,4,45,31,5,5,85,355
18,27,2,4,6,7,24,43,9,8,109,398
18,28,3,3,6,7,-67,-66,2,2,42,332
18,29,5,2,9,4,54,22,6,4,96,354
18,30,2,5,5,8,23,53,9,7,119,407
18,31,4,3,7,6,-57,-67,2,0,62,340
18,32,3,4,6,7,33,43,5,3,95,383
18,33,3,5,4,9,31,54,6,7,126,437
18,34,4,3,10,3,-54,30,2,7,72,467
18,35,3,3,9,4,36,31,8,8,108,498
18,36,2,5,4,9,-78,-46,0,2,30,452
18,37,3,3,7,6,34,33,4,5,64,485
18,38,4,2,9,4,45,22,9,7,109,507
19,1,2,5,6,7,24,52,4,2,24,52
19,2,3,3,5,8,32,35,6,7,56,87
19,3,2,5,6,7,-76,52,0,9,-20,139
19,4,5,2,8,5,53,-77,3,2,33,62
19,5,4,2,8,5,44,23,7,5,77,85
19,6,5,2,8,5,-47,23,0,8,30,108
19,7,2,4,4,9,22,-55,2,3,52,53
19,8,4,2,10,3,46,21,8,4,98,74
19,9,4,2,9,4,-55,22,3,6,43,96
19,10,3,4,5,8,32,-56,5,0,75,40
19,11,2,4,8,5,-74,41,1,1,1,81
19,12,2,5,2,11,20,56,1,7,21,137
19,13,4,3,7,6,43,-67,4,0,64,70
19,14,4,3,5,8,41,35,5,5,105,105
19,15,2,5,3,10,21,-45,6,0,126,60
19,16,5,2,6,7,51,25,7,5,177,85
19,17,3,3,8,5,-65,32,2,7,112,117
19,18,4,3,10,3,46,30,8,7,158,147
19,19,5,2,10,3,-45,21,3,8,113,168
19,20,3,5,3,10,30,-45,3,3,143,123
19,21,4,2,9,4,45,22,8,5,188,145
19,22,3,4,3,10,30,-54,8,1,218,91
19,23,2,5,5,8,-77,53,1,4,141,144
19,24,4,3,7,6,43,33,4,7,184,177
19,25,2,4,5,8,23,-56,7,1,207,121
19,26,5,2,5,8,50,26,7,7,257,147
19,27,3,3,8,5,-65,32,2,9,192,179
19,28,3,4,5,8,32,-56,4,3,224,123
19,29,5,2,10,3,55,21,9,4,279,144
19,30,5,2,10,3,-45,21,4,5,234,165
19,31,6,2,11,2,65,20,9,5,299,185
19,32,6,2,10,3,-36,21,3,6,263,206
19,33,2,4,6,7,24,43,7,9,287,249
19,34,5,2,10,3,-45,-79,2,0,242,170
19,35,3,3,8,5,35,32,7,2,277,202
19,36,4,3,4,9,40,36,7,8,317,238
19,37,2,5,4,9,22,-46,9,2,339,192
19,38,2,4,6,7,-76,43,3,5,263,235
19,39,3,3,7,6,34,33,7,8,297,268
19,40,3,3,8,5,-65,-68,2,0,232,200
19,41,4,2,8,5,44,23,6,3,276,223
19,42,3,3,5,8,32,35,8,8,308,258
19,43,3,3,5,8,-68,-65,0,3,240,193
19,44,4,3,7,6,43,33,3,6,283,226
19,45,3,4,5,8,32,-56,5,0,315,170
19,46,5,2,10,3,-45,21,0,1,270,191
19,47,4,2,7,6,43,24,3,5,313,215
19,48,4,3,10,3,46,30,9,5,359,245
19,49,4,2,8,5,-56,23,3,8,303,268
19,50,3,3,5,8,32,-65,5,3,335,203
19,51,3,4,8,5,-65,41,0,4,270,244
19,52,4,3,5,8,41,35,1,9,311,279
19,53,2,5,5,8,23,-47,4,2,334,232
19,54,4,3,7,6,43,33,7,5,377,265
19,55,3,4,3,10,30,-54,7,1,407,211
19,56,3,4,6,7,-67,43,0,4,340,254
19,57,3,4,8,5,35,41,5,5,375,295
19,58,2,4,5,8,23,44,8,9,398,339
19,59,3,4,7,6,-66,-58,2,1,332,281
19,60,3,3,6,7,33,34,5,5,365,315
19,61,4,3,9,4,-55,31,0,6,310,346
19,62,3,4,4,9,31,-55,1,1,341,291
19,63,5,2,7,6,52,24,3,5,393,315
19,64,4,3,10,3,46,30,9,5,439,345
19,65,5,2,10,3,-45,21,4,6,394,366
19,66,2,5,7,6,25,51,9,7,419,417
19,67,5,2,9,4,-46,22,3,9,373,439
19,68,2,6,2,11,20,-35,3,4,393,404
19,69,2,5,5,8,23,53,6,7,416,457
19,70,3,3,5,8,32,-65,8,2,448,392
19,71,3,5,6,7,-67,52,1,4,381,444
19,72,5,2,10,3,55,21,6,5,436,465
19,73,2,5,2,11,20,-44,6,1,456,421
19,74,5,3,9,4,-46,31,0,2,410,452
19,75,3,4,6,7,33,43,3,5,443,495
19,76,4,2,8,5,44,23,7,8,487,518
20,1,3,3,6,7,33,34,3,4,33,34
20,2,2,5,6,7,24,52,7,6,57,86
20,3,4,2,8,5,-56,23,1,9,1,109
20,4,3,4,6,7,33,-57,4,2,34,52
20,5,4,2,8,5,44,23,8,5,78,75
20,6,3,3,7,6,-66,33,2,8,12,108
20,7,2,5,3,10,21,-45,3,3,33,63
20,8,4,3,9,4,45,31,8,4,78,94
20,9,3,4,4,9,31,45,9,9,109,139
20,10,2,5,4,9,-78,-46,1,3,31,93
20,11,4,2,8,5,44,23,5,6,75,116
20,12,4,2,11,2,-53,20,2,6,22,136
20,13,4,3,7,6,43,33,5,9,65,169
20,14,5,3,8,5,53,-68,8,1,118,101
20,15,2,4,6,7,-76,43,2,4,42,144
20,16,3,3,7,6,34,33,6,7,76,177
20,17,4,2,7,6,43,-76,9,1,119,101
20,18,3,4,7,6,-66,42,3,3,53,143
20,19,3,4,8,5,35,41,8,4,88,184
20,20,4,2,7,6,-57,24,1,8,31,208
20,21,3,4,8,5,35,41,6,9,66,249
20,22,4,3,7,6,43,-67,9,2,109,182
20,23,3,3,8,5,-65,32,4,4,44,214
20,24,4,3,8,5,44,32,8,6,88,246
20,25,3,3,7,6,-66,33,2,9,22,279
20,26,2,4,5,8,23,-56,5,3,45,223
20,27,4,3,9,4,-55,31,0,4,-10,254
20,28,3,4,7,6,34,42,4,6,24,296
20,29,4,3,9,4,45,31,9,7,69,327
20,30,3,4,6,7,-67,-57,2,0,2,270
20,31,4,3,6,7,42,34,4,4,44,304
20,32,4,2,6,7,42,25,6,9,86,329
20,33,3,3,6,7,33,-66,9,3,119,263
20,34,3,3,6,7,-67,34,2,7,52,297
20,35,2,4,5,8,23,-56,5,1,75,241
20,36,3,3,9,4,-64,31,1,2,11,272
20,37,4,3,5,8,41,35,2,7,52,307
20,38,3,3,4,9,31,-64,3,3,83,243
20,39,3,3,5,8,32,35,5,8,115,278
20,40,4,3,8,5,44,-68,9,0,159,210
20,41,4,3,8,5,-56,32,3,2,103,242
20,42,4,3,5,8,41,35,4,7,144,277
20,43,2,4,4,9,22,-55,6,2,166,222
20,44,3,3,7,6,-66,33,0,5,100,255
20,45,4,2,7,6,43,24,3,9,143,279
20,46,3,3,7,6,34,-67,7,2,177,212
20,47,4,3,8,5,-56,32,1,4,121,244
20,48,3,3,9,4,36,31,7,5,157,275
20,49,3,4,4,9,31,-55,8,0,188,220
20,50,3,3,6,7,-67,34,1,4,121,254
20,51,2,5,5,8,23,53,4,7,144,307
20,52,3,5,7,6,34,51,8,8,178,358
20,53,4,2,8,5,-56,-77,2,1,122,281
20,54,2,4,5,8,23,44,5,5,145,325
20,55,3,3,10,3,-63,30,2,5,82,355
20,56,3,3,7,6,34,33,6,8,116,388
20,57,3,3,8,5,-65,-68,1,0,51,320
20,58,2,5,2,11,20,56,1,6,71,376
20,59,3,3,5,8,32,-65,3,1,103,311
20,60,3,5,4,9,31,54,4,5,134,365
20,61,5,2,9,4,54,22,8,7,188,387
20,62,3,4,5,8,-68,-56,0,1,120,331
20,63,3,3,5,8,32,35,2,6,152,366
20,64,3,3,7,6,34,33,6,9,186,399
20,65,5,2,10,3,-45,-79,1,0,141,320
20,66,3,4,8,5,35,41,6,1,176,361
20,67,3,4,8,5,-65,41,1,2,111,402
20,68,4,2,6,7,42,25,3,7,153,427
20,69,2,4,5,8,23,-56,6,1,176,371
20,70,3,4,6,7,33,43,9,4,209,414
20,71,4,3,6,7,-58,34,1,8,151,448
20,72,5,2,6,7,51,-75,2,3,202,373
20,73,4,3,6,7,42,34,4,7,244,407
20,74,3,3,8,5,35,32,9,9,279,439
20,75,3,3,5,8,-68,-65,1,4,211,374
20,76,4,3,7,6,43,33,4,7,254,407
20,77,2,4,5,8,23,-56,7,1,277,351
20,78,4,3,7,6,-57,33,0,4,220,384
20,79,5,2,9,4,54,22,4,6,274,406
20,80,3,4,7,6,34,42,8,8,308,448
20,81,3,3,8,5,-65,-68,3,0,243,380
20,82,5,2,10,3,55,21,8,1,298,401
20,83,4,2,10,3,-54,21,4,2,244,422
20,84,2,5,7,6,25,51,9,3,269,473
20,85,3,3,6,7,-67,34,2,7,202,507
21,1,3,3,7,6,34,33,4,3,34,33
21,2,3,5,4,9,31,54,5,7,65,87
21,3,2,5,4,9,22,-46,7,1,87,41
21,4,5,2,10,3,-45,21,2,2,42,62
21,5,3,4,5,8,32,44,4,6,74,106
21,6,4,3,9,4,45,31,9,7,119,137
21,7,2,5,4,9,-78,-46,1,1,41,91
21,8,5,2,9,4,54,22,5,3,95,113
21,9,3,4,5,8,32,44,7,7,127,157
21,10,3,4,6,7,-67,-57,0,0,60,100
21,11,2,4,4,9,22,45,2,5,82,145
21,12,3,5,7,6,34,51,6,6,116,196
21,13,4,2,8,5,-56,23,0,9,60,219
21,14,3,3,8,5,35,-68,5,1,95,151
21,15,2,4,7,6,-75,42,0,3,20,193
21,16,5,2,9,4,54,22,4,5,74,215
21,17,3,4,7,6,34,42,8,7,108,257
21,18,5,2,10,3,-45,21,3,8,63,278
21,19,3,3,5,8,32,-65,5,3,95,213
21,20,4,3,5,8,41,35,6,8,136,248
21,21,2,5,5,8,23,-47,9,1,159,201
21,22,4,4,5,8,-59,44,0,5,100,245
21,23,3,4,8,5,35,41,5,6,135,286
21,24,5,2,6,7,51,-75,6,1,186,211
21,25,4,4,4,9,40,45,6,6,226,256
21,26,5,2,7,6,52,-76,8,0,278,180
21,27,3,3,4,9,31,36,9,6,309,216
21,28,4,3,6,7,-58,-66,1,0,251,150
21,29,4,3,7,6,43,33,4,3,294,183
21,30,2,6,4,9,22,63,6,6,316,246
21,31,4,3,7,6,43,33,9,9,359,279
21,32,3,3,8,5,-65,-68,4,1,294,211
21,33,4,2,9,4,45,22,9,3,339,233
21,34,4,3,7,6,-57,33,2,6,282,266
21,35,3,3,6,7,33,-66,5,0,315,200
21,36,5,2,8,5,53,23,8,3,368,223
21,37,2,5,4,9,-78,54,0,7,290,277
21,38,4,4,7,6,43,42,3,9,333,319
21,39,5,2,9,4,54,-78,7,1,387,241
21,40,3,3,8,5,-65,32,2,3,322,273
21,41,3,4,4,9,31,45,3,8,353,318
21,42,3,3,8,5,35,-68,8,0,388,250
21,43,3,4,4,9,31,45,9,5,419,295
21,44,4,3,7,6,-57,33,2,8,362,328
21,45,4,3,8,5,44,-68,6,0,406,260
21,46,6,2,10,3,-36,21,0,1,370,281
21,47,4,3,8,5,44,32,4,3,414,313
21,48,6,2,9,4,63,22,7,5,477,335
21,49,5,2,11,2,-44,20,3,5,433,355
21,50,5,2,9,4,54,22,7,7,487,377
21,51,3,4,6,7,-67,-57,0,0,420,320
21,52,3,3,8,5,35,32,5,2,455,352
21,53,2,5,4,9,22,54,7,6,477,406
21,54,5,2,8,5,-47,23,0,9,430,429
21,55,3,3,6,7,33,-66,3,3,463,363
21,56,3,3,4,9,31,36,4,9,494,399
21,57,3,4,7,6,34,-58,8,1,528,341
22,1,5,2,10,3,55,21,5,1,55,21
22,2,3,3,8,5,-65,32,0,3,-10,53
22,3,4,2,7,6,43,24,3,7,33,77
22,4,2,4,5,8,23,-56,6,1,56,21
22,5,5,2,9,4,-46,22,0,3,10,43
22,6,4,2,9,4,45,22,5,5,55,65
22,7,3,3,6,7,33,34,8,9,88,99
22,8,2,4,5,8,-77,-56,1,3,11,43
22,9,6,2,9,4,63,22,4,5,74,65
22,10,3,3,5,8,32,-65,6,0,106,0
22,11,3,3,4,9,31,36,7,6,137,36
22,12,3,3,6,7,-67,-66,0,0,70,-30
22,13,3,3,8,5,35,32,5,2,105,2
22,14,3,4,6,7,33,43,8,5,138,45
22,15,3,4,3,10,30,-54,8,1,168,-9
22,16,3,3,8,5,-65,32,3,3,103,23
22,17,4,3,6,7,42,34,5,7,145,57
22,18,3,3,6,7,33,-66,8,1,178,-9
22,19,2,5,3,10,21,55,9,6,199,46
22,20,3,3,8,5,-65,32,4,8,134,78
22,21,3,4,6,7,33,-57,7,1,167,21
22,22,3,3,7,6,-66,33,1,4,101,54
22,23,3,3,5,8,32,35,3,9,133,89
22,24,2,4,5,8,23,-56,6,3,156,33
22,25,5,2,7,6,52,24,8,7,208,57
22,26,2,6,2,11,20,-35,8,2,228,22
22,27,3,4,5,8,-68,44,0,6,160,66
22,28,2,4,5,8,23,-56,3,0,183,10
22,29,3,3,6,7,33,34,6,4,216,44
22,30,2,4,5,8,23,44,9,8,239,88
22,31,4,3,8,5,-56,-68,3,0,183,20
22,32,4,3,8,5,44,32,7,2,227,52
22,33,2,4,6,7,-76,43,1,5,151,95
22,34,3,3,6,7,33,34,4,9,184,129
22,35,3,4,5,8,32,-56,6,3,216,73
22,36,3,4,7,6,-66,42,0,5,150,115
22,37,4,2,6,7,42,-75,2,0,192,40
22,38,3,3,8,5,35,32,7,2,227,72
22,39,2,5,3,10,21,55,8,7,248,127
22,40,3,4,5,8,-68,-56,0,1,180,71
22,41,4,2,8,5,44,23,4,4,224,94
22,42,3,4,4,9,31,45,5,9,255,139
22,43,4,4,5,8,41,-56,6,3,296,83
22,44,3,3,6,7,33,34,9,7,329,117
22,45,3,3,6,7,-67,-66,2,1,262,51
22,46,3,4,7,6,34,42,6,3,296,93
22,47,4,3,8,5,-56,32,0,5,240,125
22,48,2,4,4,9,22,-55,2,0,262,70
22,49,2,5,5,8,23,53,5,3,285,123
22,50,3,3,7,6,34,33,9,6,319,156
22,51,2,5,6,7,-76,52,3,8,243,208
22,52,3,4,8,5,35,41,8,9,278,249
22,53,3,3,8,5,-65,-68,3,1,213,181
22,54,5,2,7,6,52,24,5,5,265,205
22,55,2,5,3,10,21,-45,6,0,286,160
22,56,4,3,7,6,43,33,9,3,329,193
22,57,3,4,8,5,-65,41,4,4,264,234
22,58,3,3,9,4,-64,31,0,5,200,265
22,59,4,3,7,6,43,33,3,8,243,298
22,60,5,2,9,4,54,-78,7,0,297,220
22,61,3,3,8,5,-65,32,2,2,232,252
22,62,2,5,3,10,21,55,3,7,253,307
22,63,4,2,8,5,44,-77,7,0,297,230
22,64,2,4,5,8,-77,44,0,4,220,274
22,65,2,4,5,8,23,44,3,8,243,318
22,66,3,3,6,7,33,-66,6,2,276,252
22,67,2,4,7,6,-75,42,1,4,201,294
22,68,4,3,8,5,44,32,5,6,245,326
22,69,4,2,9,4,-55,22,0,8,190,348
22,70,4,3,6,7,42,-66,2,2,232,282
22,71,2,4,6,7,24,43,6,5,256,325
22,72,3,4,5,8,32,44,8,9,288,369
22,73,3,3,7,6,-66,-67,2,2,222,302
22,74,3,4,7,6,34,42,6,4,256,344
22,75,2,5,4,9,22,54,8,8,278,398
22,76,3,4,5,8,-68,-56,0,2,210,342
22,77,3,4,6,7,33,43,3,5,243,385
22,78,4,3,7,6,43,33,6,8,286,418
22,79,3,4,6,7,33,-57,9,1,319,361
22,80,2,4,5,8,-77,44,2,5,242,405
22,81,3,4,7,6,34,42,6,7,276,447
22,82,2,4,6,7,-76,-57,0,0,200,390
22,83,5,2,9,4,54,22,4,2,254,412
22,84,5,2,9,4,54,22,8,4,308,434
22,85,4,2,6,7,-58,25,0,9,250,459
22,86,3,4,9,4,36,40,6,9,286,499
22,87,3,4,6,7,33,-57,9,2,319,442
22,88,3,3,6,7,-67,34,2,6,252,476
22,89,3,4,6,7,33,43,5,9,285,519
23,1,3,4,6,7,33,43,3,3,33,43
23,2,4,4,8,5,44,41,7,4,77,84
23,3,3,3,7,6,-66,33,1,7,11,117
23,4,4,2,8,5,44,-77,5,0,55,40
23,5,4,2,9,4,-55,22,0,2,0,62
23,6,4,2,8,5,44,23,4,5,44,85
23,7,5,2,11,2,-44,20,0,5,0,105
23,8,2,5,4,9,22,54,2,9,22,159
23,9,4,2,10,3,46,-79,8,0,68,80
23,10,3,3,4,9,31,36,9,6,99,116
23,11,2,4,3,10,-79,-54,0,2,20,62
23,12,3,4,5,8,32,44,2,6,52,106
23,13,3,4,7,6,34,42,6,8,86,148
23,14,3,4,5,8,32,-56,8,2,118,92
23,15,4,3,8,5,-56,32,2,4,62,124
23,16,4,3,8,5,44,32,6,6,106,156
23,17,3,3,8,5,-65,32,1,8,41,188
23,18,2,4,4,9,22,-55,3,3,63,133
23,19,4,3,6,7,42,34,5,7,105,167
23,20,5,2,8,5,53,-77,8,0,158,90
23,21,2,5,6,7,-76,52,2,2,82,142
23,22,3,4,6,7,33,43,5,5,115,185
23,23,2,5,4,9,22,54,7,9,137,239
23,24,2,4,2,11,20,-53,7,6,157,186
23,25,7,2,10,3,-27,21,0,7,130,207
23,26,2,4,5,8,23,-56,3,1,153,151
23,27,4,2,7,6,43,24,6,5,196,175
23,28,2,4,8,5,-74,41,2,6,122,216
23,29,4,3,6,7,42,-66,4,0,164,150
23,30,2,4,4,9,22,45,6,5,186,195
23,31,3,3,7,6,-66,33,0,8,120,228
23,32,4,2,6,7,42,-75,2,3,162,153
23,33,5,2,10,3,55,21,7,4,217,174
23,34,3,4,5,8,32,44,9,8,249,218
23,35,5,3,7,6,-48,-67,1,1,201,151
23,36,4,3,8,5,44,32,5,3,245,183
23,37,3,3,6,7,33,34,8,7,278,217
23,38,4,2,9,4,-55,22,3,9,223,239
23,39,3,3,6,7,33,-66,6,3,256,173
23,40,3,3,5,8,32,35,8,8,288,208
23,41,3,4,4,9,31,-55,9,3,319,153
23,42,3,3,8,5,-65,32,4,5,254,185
23,43,4,4,5,8,41,44,5,9,295,229
23,44,3,4,6,7,33,-57,8,2,328,172
23,45,2,4,5,8,-77,44,1,6,251,216
23,46,4,3,8,5,44,32,5,8,295,248
23,47,4,3,8,5,44,-68,9,0,339,180
23,48,3,3,8,5,-65,32,4,2,274,212
23,49,3,4,5,8,32,44,6,6,306,256
23,50,5,2,10,3,-45,21,1,7,261,277
23,51,3,3,8,5,35,32,6,9,296,309
23,52,3,3,5,8,32,-65,8,4,328,244
23,53,4,2,7,6,-57,24,1,8,271,268
23,54,4,3,9,4,45,31,6,9,316,299
23,55,3,4,5,8,32,-56,8,3,348,243
23,56,5,2,8,5,-47,23,1,6,301,266
23,57,3,4,5,8,32,-56,3,0,333,210
23,58,4,3,7,6,43,33,6,3,376,243
23,59,4,3,6,7,42,34,8,7,418,277
23,60,2,4,2,11,20,-53,8,4,438,224
23,61,5,2,9,4,-46,22,2,6,392,246
23,62,3,3,5,8,32,-65,4,1,424,181
23,63,3,3,5,8,32,35,6,6,456,216
23,64,4,3,8,5,-56,32,0,8,400,248
23,65,3,4,8,5,35,41,5,9,435,289
23,66,4,2,7,6,43,-76,8,3,478,213
23,67,2,5,2,11,20,56,8,9,498,269
23,68,4,2,9,4,-55,-78,3,1,443,191
23,69,3,3,6,7,33,34,6,5,476,225
23,70,3,4,6,7,33,43,9,8,509,268
24,1,5,3,8,5,53,32,3,2,53,32
24,2,3,5,4,9,31,54,4,6,84,86
24,3,3,3,6,7,33,-66,7,0,117,20
24,4,5,2,9,4,-46,22,1,2,71,42
24,5,5,2,7,6,52,24,3,6,123,66
24,6,3,3,7,6,34,33,7,9,157,99
24,7,2,5,3,10,21,-45,8,4,178,54
24,8,3,4,5,8,-68,44,0,8,110,98
24,9,4,3,6,7,42,-66,2,2,152,32
24,10,4,3,5,8,41,35,3,7,193,67
24,11,3,4,8,5,35,41,8,8,228,108
24,12,3,3,10,3,-63,30,5,8,165,138
24,13,4,3,6,7,42,-66,7,2,207,72
24,14,4,2,10,3,-54,21,3,3,153,93
24,15,4,2,9,4,45,22,8,5,198,115
24,16,2,5,6,7,-76,52,2,7,122,167
24,17,3,3,8,5,35,32,7,9,157,199
24,18,4,3,6,7,42,-66,9,3,199,133
24,19,4,3,6,7,-58,34,1,7,141,167
24,20,3,4,6,7,33,-57,4,0,174,110
24,21,5,3,7,6,52,33,6,3,226,143
24,22,2,5,4,9,22,54,8,7,248,197
24,23,3,5,4,9,31,-46,9,1,279,151
24,24,5,2,7,6,-48,24,1,5,231,175
24,25,3,4,3,10,30,-54,1,1,261,121
24,26,2,5,3,10,21,55,2,6,282,176
24,27,6,2,10,3,64,21,6,7,346,197
24,28,4,2,9,4,-55,22,1,9,291,219
24,29,5,2,9,4,54,-78,5,1,345,141
24,30,3,3,8,5,-65,32,0,3,280,173
24,31,3,3,7,6,34,33,4,6,314,206
24,32,4,3,5,8,41,-65,5,1,355,141
24,33,2,4,6,7,24,43,9,4,379,184
24,34,4,3,9,4,-55,31,4,5,324,215
24,35,2,5,3,10,21,-45,5,0,345,170
24,36,3,3,8,5,-65,32,0,2,280,202
24,37,4,3,6,7,42,34,2,6,322,236
24,38,4,2,7,6,43,-76,5,0,365,160
24,39,2,4,5,8,23,44,8,4,388,204
24,40,3,3,7,6,-66,33,2,7,322,237
24,41,3,3,7,6,34,-67,6,0,356,170
24,42,3,3,7,6,-66,33,0,3,290,203
24,43,3,4,3,10,30,46,0,9,320,249
24,44,3,3,5,8,32,-65,2,4,352,184
24,45,2,4,6,7,24,43,6,7,376,227
24,46,2,5,5,8,23,-47,9,0,399,180
24,47,4,3,6,7,-58,34,1,4,341,214
24,48,3,4,8,5,35,41,6,5,376,255
24,49,4,2,6,7,42,-75,8,0,418,180
24,50,2,5,4,9,-78,54,0,4,340,234
24,51,4,3,6,7,42,34,2,8,382,268
24,52,3,4,5,8,32,-56,4,2,414,212
24,53,4,2,9,4,45,22,9,4,459,234
24,54,3,3,6,7,-67,34,2,8,392,268
24,55,3,3,4,9,31,-64,3,4,423,204
24,56,4,4,7,6,43,42,6,6,466,246
24,57,5,2,8,5,53,23,9,9,519,269
25,1,2,5,6,7,24,52,4,2,24,52
25,2,4,3,8,5,44,32,8,4,68,84
25,3,4,2,9,4,-55,22,3,6,13,106
25,4,5,2,8,5,53,23,6,9,66,129
25,5,2,6,2,11,20,-35,6,4,86,94
25,6,3,3,6,7,33,34,9,8,119,128
25,7,4,2,9,4,-55,-78,4,0,64,50
25,8,3,4,5,8,32,44,6,4,96,94
25,9,4,2,8,5,-56,23,0,7,40,117
25,10,5,2,9,4,54,22,4,9,94,139
25,11,4,4,5,8,41,-56,5,3,135,83
25,12,3,3,6,7,33,34,8,7,168,117
25,13,2,4,4,9,-78,-55,0,2,90,62
25,14,4,2,7,6,43,24,3,6,133,86
25,15,2,4,5,8,23,-56,6,0,156,30
25,16,3,3,8,5,-65,32,1,2,91,62
25,17,2,6,3,10,21,64,2,6,112,126
25,18,2,4,4,9,22,-55,4,1,134,71
25,19,2,5,5,8,23,53,7,4,157,124
25,20,4,2,10,3,-54,21,3,5,103,145
25,21,4,2,10,3,46,21,9,6,149,166
25,22,2,4,6,7,-76,43,3,9,73,209
25,23,3,4,5,8,32,-56,5,3,105,153
25,24,5,2,9,4,54,22,9,5,159,175
25,25,2,4,3,10,-79,-54,0,1,80,121
25,26,4,4,7,6,43,42,3,3,123,163
25,27,2,5,5,8,23,53,6,6,146,216
25,28,4,3,8,5,-56,32,0,8,90,248
25,29,3,3,6,7,33,-66,3,2,123,182
25,30,3,4,8,5,35,41,8,3,158,223
25,31,3,3,8,5,-65,32,3,5,93,255
25,32,2,4,4,9,22,-55,5,0,115,200
25,33,4,3,6,7,42,34,7,4,157,234
25,34,2,5,3,10,21,55,8,9,178,289
25,35,3,4,4,9,31,-55,9,4,209,234
25,36,3,3,7,6,-66,33,3,7,143,267
25,37,3,3,7,6,34,-67,7,0,177,200
25,38,2,5,6,7,-76,52,1,2,101,252
25,39,4,3,6,7,42,34,3,6,143,286
25,40,3,4,6,7,33,43,6,9,176,329
25,41,6,2,9,4,63,-78,9,1,239,251
25,42,3,3,7,6,-66,33,3,4,173,284
25,43,2,5,5,8,23,53,6,7,196,337
25,44,4,3,7,6,43,-67,9,0,239,270
25,45,3,3,8,5,-65,32,4,2,174,302
25,46,4,2,6,7,42,25,6,7,216,327
25,47,4,3,5,8,41,-65,7,2,257,262
25,48,2,4,6,7,-76,43,1,5,181,305
25,49,4,2,8,5,44,23,5,8,225,328
25,50,2,6,4,9,22,-37,7,1,247,291
25,51,2,5,5,8,-77,53,0,4,170,344
25,52,4,3,8,5,44,32,4,6,214,376
25,53,2,4,7,6,25,42,9,8,239,418
25,54,4,3,7,6,-57,-67,2,1,182,351
25,55,4,3,9,4,45,31,7,2,227,382
25,56,2,5,3,10,21,55,8,7,248,437
25,57,4,3,7,6,-57,-67,1,0,191,370
25,58,3,3,9,4,36,31,7,1,227,401
25,59,3,3,6,7,-67,34,0,5,160,435
25,60,2,6,3,10,21,64,1,9,181,499
25,61,3,3,5,8,32,-65,3,4,213,434
25,62,4,2,5,8,41,-74,4,0,254,360
25,63,4,2,9,4,45,22,9,2,299,382
25,64,4,3,7,6,-57,33,2,5,242,415
25,65,2,4,5,8,23,44,5,9,265,459
25,66,3,3,7,6,34,-67,9,2,299,392
25,67,3,3,5,8,-68,35,1,7,231,427
25,68,5,2,10,3,55,21,6,8,286,448
25,69,5,2,7,6,52,-76,8,2,338,372
25,70,4,3,6,7,-58,34,0,6,280,406
25,71,5,2,11,2,56,20,6,6,336,426
25,72,2,6,3,10,21,-36,7,0,357,390
25,73,3,3,5,8,32,35,9,5,389,425
25,74,5,2,6,7,-49,-75,0,0,340,350
25,75,3,4,4,9,31,45,1,5,371,395
25,76,4,2,9,4,45,22,6,7,416,417
25,77,4,3,7,6,43,-67,9,0,459,350
25,78,3,4,4,9,-69,45,0,5,390,395
25,79,3,4,8,5,35,41,5,6,425,436
25,80,2,4,7,6,-75,42,0,8,350,478
25,81,2,5,4,9,22,-46,2,2,372,432
25,82,2,5,4,9,22,54,4,6,394,486
25,83,4,3,9,4,45,31,9,7,439,517
26,1,2,4,6,7,24,43,4,3,24,43
26,2,2,4,5,8,23,44,7,7,47,87
26,3,5,2,10,3,-45,21,2,8,2,108
26,4,3,3,5,8,32,-65,4,3,34,43
26,5,5,3,9,4,54,31,8,4,88,74
26,6,3,4,7,6,-66,42,2,6,22,116
26,7,5,2,10,3,55,21,7,7,77,137
26,8,5,2,11,2,-44,20,3,7,33,157
26,9,5,2,9,4,54,22,7,9,87,179
26,10,3,5,6,7,-67,-48,0,1,20,131
26,11,4,3,7,6,43,33,3,4,63,164
26,12,2,4,6,7,24,43,7,7,87,207
26,13,2,4,5,8,-77,-56,0,1,10,151
26,14,2,4,5,8,23,44,3,5,33,195
26,15,4,2,8,5,44,23,7,8,77,218
26,16,5,2,10,3,-45,21,2,9,32,239
26,17,4,2,8,5,44,-77,6,2,76,162
26,18,3,3,9,4,-64,31,2,3,12,193
26,19,5,2,8,5,53,23,5,6,65,216
26,20,2,4,3,10,21,-54,6,2,86,162
26,21,3,3,5,8,32,35,8,7,118,197
26,22,3,3,5,8,-68,-65,0,2,50,132
26,23,4,2,7,6,43,24,3,6,93,156
26,24,5,2,10,3,55,21,8,7,148,177
26,25,5,2,6,7,51,-75,9,2,199,102
26,26,3,3,5,8,-68,35,1,7,131,137
26,27,5,3,7,6,52,-67,3,0,183,70
26,28,3,4,4,9,31,45,4,5,214,115
26,29,3,3,5,8,32,-65,6,0,246,50
26,30,3,4,6,7,33,43,9,3,279,93
26,31,2,5,3,10,-79,55,0,8,200,148
26,32,2,5,2,11,20,-44,0,4,220,104
26,33,3,4,7,6,34,42,4,6,254,146
26,34,2,5,5,8,23,53,7,9,277,199
26,35,3,4,4,9,31,-55,8,4,308,144
26,36,6,2,10,3,-36,21,2,5,272,165
26,37,4,3,6,7,42,34,4,9,314,199
26,38,2,5,7,6,25,-49,9,0,339,150
26,39,3,3,8,5,-65,32,4,2,274,182
26,40,3,3,10,3,-63,30,1,2,211,212
26,41,4,2,6,7,42,25,3,7,253,237
26,42,5,2,8,5,53,-77,6,0,306,160
26,43,2,5,4,9,22,54,8,4,328,214
26,44,4,3,10,3,-54,30,4,4,274,244
26,45,3,4,4,9,31,45,5,9,305,289
26,46,3,4,8,5,-65,-59,0,0,240,230
26,47,3,5,7,6,34,51,4,1,274,281
26,48,5,2,11,2,-44,20,0,1,230,301
26,49,2,5,2,11,20,56,0,7,250,357
26,50,3,4,4,9,31,-55,1,2,281,302
26,51,2,5,3,10,21,55,2,7,302,357
26,52,4,2,8,5,44,-77,6,0,346,280
26,53,4,2,6,7,42,25,8,5,388,305
26,54,3,4,6,7,-67,43,1,8,321,348
26,55,2,4,5,8,23,-56,4,2,344,292
26,56,5,3,9,4,54,31,8,3,398,323
26,57,3,3,8,5,-65,32,3,5,333,355
26,58,4,3,8,5,44,32,7,7,377,387
26,59,5,3,6,7,51,-66,8,1,428,321
26,60,6,2,11,2,-35,20,3,1,393,341
26,61,5,2,7,6,52,24,5,5,445,365
26,62,2,6,2,11,20,-35,5,0,465,330
26,63,2,6,4,9,22,63,7,3,487,393
26,64,4,2,9,4,-55,22,2,5,432,415
26,65,2,4,7,6,25,42,7,7,457,457
26,66,2,4,6,7,-76,-57,1,0,381,400
26,67,3,3,6,7,33,34,4,4,414,434
26,68,4,3,9,4,45,31,9,5,459,465
26,69,5,2,9,4,-46,22,3,7,413,487
26,70,3,3,8,5,35,32,8,9,448,519
27,1,3,4,6,7,33,43,3,3,33,43
27,2,4,3,5,8,41,35,4,8,74,78
27,3,3,4,6,7,33,-57,7,1,107,21
27,4,3,3,3,10,30,37,7,8,137,58
27,5,4,2,11,2,-53,20,4,8,84,78
27,6,3,3,8,5,35,-68,9,0,119,10
27,7,2,4,6,7,-76,43,3,3,43,53
27,8,3,4,7,6,34,42,7,5,77,95
27,9,3,4,6,7,-67,43,0,8,10,138
27,10,5,2,10,3,55,21,5,9,65,159
27,11,3,4,8,5,-65,-59,0,0,0,100
27,12,3,3,8,5,35,32,5,2,35,132
27,13,2,5,3,10,21,55,6,7,56,187
27,14,3,4,6,7,33,-57,9,0,89,130
27,15,3,3,6,7,-67,34,2,4,22,164
27,16,3,4,4,9,31,45,3,9,53,209
27,17,4,2,8,5,44,-77,7,2,97,132
27,18,3,3,5,8,32,35,9,7,129,167
27,19,4,3,9,4,-55,31,4,8,74,198
27,20,5,2,7,6,52,-76,6,2,126,122
27,21,4,3,9,4,-55,31,1,3,71,153
27,22,5,2,8,5,53,23,4,6,124,176
27,23,2,5,6,7,24,52,8,8,148,228
27,24,3,5,3,10,30,-45,8,3,178,183
27,25,3,4,4,9,31,45,9,8,209,228
27,26,5,2,11,2,-44,20,5,8,165,248
27,27,3,3,10,3,-63,30,2,8,102,278
27,28,4,3,5,8,41,-65,3,3,143,213
27,29,4,4,5,8,41,44,4,7,184,257
27,30,4,2,10,3,-54,21,0,8,130,278
27,31,4,3,7,6,43,-67,3,1,173,211
27,32,4,4,6,7,42,43,5,4,215,254
27,33,2,4,7,6,-75,42,0,6,140,296
27,34,5,2,8,5,53,23,3,9,193,319
27,35,5,2,9,4,54,-78,7,1,247,241
27,36,3,4,6,7,-67,43,0,4,180,284
27,37,4,3,5,8,41,35,1,9,221,319
27,38,2,4,5,8,23,-56,4,3,244,263
27,39,2,5,6,7,24,52,8,5,268,315
27,40,3,3,7,6,-66,33,2,8,202,348
27,41,2,6,3,10,21,-36,3,2,223,312
27,42,3,3,5,8,32,35,5,7,255,347
27,43,4,3,7,6,43,-67,8,0,298,280
27,44,2,4,6,7,-76,43,2,3,222,323
27,45,5,2,10,3,55,21,7,4,277,344
27,46,3,3,6,7,-67,34,0,8,210,378
27,47,2,4,5,8,23,-56,3,2,233,322
27,48,4,2,8,5,44,23,7,5,277,345
27,49,2,5,7,6,-75,51,2,6,202,396
27,50,3,3,6,7,33,-66,5,0,235,330
27,51,5,2,7,6,52,24,7,4,287,354
27,52,3,4,7,6,-66,42,1,6,221,396
27,53,3,3,7,6,34,33,5,9,255,429
27,54,2,5,4,9,22,-46,7,3,277,383
27,55,3,3,8,5,-65,32,2,5,212,415
27,56,3,4,5,8,32,44,4,9,244,459
27,57,2,5,3,10,21,-45,5,4,265,414
27,58,3,3,4,9,31,-64,6,0,296,350
27,59,5,2,9,4,-46,22,0,2,250,372
27,60,3,4,4,9,31,45,1,7,281,417
27,61,3,4,5,8,32,-56,3,1,313,361
27,62,4,2,9,4,45,22,8,3,358,383
27,63,3,3,8,5,-65,32,3,5,293,415
27,64,3,4,5,8,32,44,5,9,325,459
27,65,3,3,7,6,34,-67,9,2,359,392
27,66,3,3,7,6,-66,33,3,5,293,425
27,67,5,2,7,6,52,24,5,9,345,449
27,68,4,2,6,7,42,-75,7,4,387,374
27,69,3,3,5,8,32,35,9,9,419,409
27,70,4,3,9,4,-55,-69,4,0,364,340
27,71,2,5,2,11,20,56,4,6,384,396
27,72,5,2,8,5,53,23,7,9,437,419
27,73,4,2,7,6,-57,-76,0,3,380,343
27,74,2,5,3,10,21,55,1,8,401,398
27,75,5,3,8,5,53,-68,4,0,454,330
27,76,3,3,6,7,33,34,7,4,487,364
27,77,3,3,4,9,31,-64,8,0,518,300
28,1,4,3,9,4,45,31,5,1,45,31
28,2,2,5,5,8,23,53,8,4,68,84
28,3,6,2,10,3,-36,21,2,5,32,105
28,4,3,4,6,7,33,43,5,8,65,148
28,5,3,3,8,5,-65,-68,0,0,0,80
28,6,2,4,5,8,23,44,3,4,23,124
28,7,2,4,4,9,22,45,5,9,45,169
28,8,3,5,7,6,34,-49,9,0,79,120
28,9,3,3,6,7,-67,34,2,4,12,154
28,10,4,2,6,7,42,25,4,9,54,179
28,11,3,4,5,8,32,-56,6,3,86,123
28,12,2,6,2,11,20,65,6,8,106,188
28,13,2,4,5,8,23,-56,9,2,129,132
28,14,4,3,6,7,-58,34,1,6,71,166
28,15,4,3,6,7,42,-66,3,0,113,100
28,16,2,5,4,9,22,54,5,4,135,154
28,17,4,2,7,6,43,24,8,8,178,178
28,18,3,4,7,6,-66,-58,2,0,112,120
28,19,3,4,3,10,30,46,2,6,142,166
28,20,3,3,6,7,33,-66,5,0,175,100
28,21,5,2,8,5,53,23,8,3,228,123
28,22,3,4,4,9,31,45,9,8,259,168
28,23,2,4,6,7,-76,-57,3,1,183,111
28,24,3,3,7,6,34,33,7,4,217,144
28,25,3,4,7,6,-66,42,1,6,151,186
28,26,5,2,9,4,54,22,5,8,205,208
28,27,2,4,3,10,21,-54,6,4,226,154
28,28,3,4,6,7,33,43,9,7,259,197
28,29,4,3,9,4,-55,31,4,8,204,228
28,30,3,5,6,7,33,-48,7,0,237,180
28,31,3,4,5,8,32,44,9,4,269,224
28,32,5,3,6,7,-49,34,0,8,220,258
28,33,2,5,5,8,23,-47,3,1,243,211
28,34,4,3,6,7,42,34,5,5,285,245
28,35,3,3,5,8,32,-65,7,0,317,180
28,36,3,3,6,7,-67,34,0,4,250,214
28,37,3,4,6,7,33,43,3,7,283,257
28,38,4,2,10,3,46,21,9,8,329,278
28,39,3,3,5,8,-68,-65,1,3,261,213
28,40,2,4,6,7,24,43,5,6,285,256
28,41,3,3,5,8,32,-65,7,1,317,191
28,42,3,3,7,6,-66,33,1,4,251,224
28,43,3,3,5,8,32,35,3,9,283,259
28,44,2,4,3,10,21,-54,4,5,304,205
28,45,3,3,5,8,32,-65,6,0,336,140
28,46,3,3,8,5,-65,32,1,2,271,172
28,47,4,3,8,5,44,32,5,4,315,204
28,48,2,5,5,8,23,53,8,7,338,257
28,49,3,4,4,9,31,-55,9,2,369,202
28,50,3,3,6,7,-67,34,2,6,302,236
28,51,2,4,6,7,24,43,6,9,326,279
28,52,5,2,9,4,-46,-78,0,1,280,201
28,53,4,2,10,3,46,21,6,2,326,222
28,54,2,4,8,5,-74,41,2,3,252,263
28,55,3,4,5,8,32,44,4,7,284,307
28,56,5,2,10,3,55,21,9,8,339,328
28,57,3,4,5,8,-68,-56,1,2,271,272
28,58,4,3,8,5,44,32,5,4,315,304
28,59,3,3,5,8,32,35,7,9,347,339
28,60,5,2,9,4,-46,-78,1,1,301,261
28,61,3,4,6,7,33,43,4,4,334,304
28,62,2,6,5,8,23,62,7,6,357,366
28,63,3,4,6,7,-67,43,0,9,290,409
28,64,4,3,6,7,42,-66,2,3,332,343
28,65,3,4,5,8,32,44,4,7,364,387
28,66,4,4,4,9,40,-55,4,2,404,332
28,67,5,2,10,3,55,21,9,3,459,353
28,68,2,5,3,10,-79,55,0,8,380,408
28,69,4,3,7,6,43,-67,3,1,423,341
28,70,4,2,7,6,43,24,6,5,466,365
28,71,2,4,7,6,-75,42,1,7,391,407
28,72,3,3,6,7,33,-66,4,1,424,341
28,73,2,4,5,8,23,44,7,5,447,385
28,74,4,3,7,6,-57,33,0,8,390,418
28,75,2,6,3,10,21,-36,1,2,411,382
28,76,4,3,7,6,43,33,4,5,454,415
28,77,3,4,7,6,34,42,8,7,488,457
28,78,3,4,9,4,-64,40,4,7,424,497
28,79,3,4,5,8,32,-56,6,1,456,441
28,80,5,2,9,4,-46,22,0,3,410,463
28,81,5,2,9,4,54,22,4,5,464,485
28,82,3,3,7,6,34,33,8,8,498,518
29,1,4,2,9,4,45,22,5,2,45,22
29,2,2,5,3,10,21,55,6,7,66,77
29,3,4,3,5,8,41,-65,7,2,107,12
29,4,2,4,4,9,22,45,9,7,129,57
29,5,4,3,6,7,-58,-66,1,1,71,-9
29,6,4,3,8,5,44,32,5,3,115,23
29,7,6,2,10,3,64,21,9,4,179,44
29,8,3,4,6,7,-67,43,2,7,112,87
29,9,3,3,5,8,32,-65,4,2,144,22
29,10,4,3,6,7,42,34,6,6,186,56
29,11,2,5,3,10,21,-45,7,1,207,11
29,12,4,3,9,4,-55,31,2,2,152,42
29,13,4,3,6,7,42,34,4,6,194,76
29,14,4,3,8,5,44,32,8,8,238,108
29,15,4,3,7,6,-57,-67,1,1,181,41
29,16,3,3,7,6,34,33,5,4,215,74
29,17,2,4,7,6,-75,42,0,6,140,116
29,18,5,3,6,7,51,-66,1,0,191,50
29,19,2,4,5,8,23,44,4,4,214,94
29,20,3,3,5,8,32,35,6,9,246,129
29,21,2,4,4,9,22,-55,8,4,268,74
29,22,5,2,9,4,-46,22,2,6,222,96
29,23,3,3,8,5,35,32,7,8,257,128
29,24,4,2,10,3,-54,21,3,9,203,149
29,25,2,6,2,11,20,-35,3,4,223,114
29,26,4,3,7,6,43,33,6,7,266,147
29,27,2,4,5,8,23,-56,9,1,289,91
29,28,3,4,6,7,-67,43,2,4,222,134
29,29,3,5,4,9,31,54,3,8,253,188
29,30,4,3,8,5,44,-68,7,0,297,120
29,31,5,2,7,6,52,24,9,4,349,144
29,32,3,4,6,7,-67,43,2,7,282,187
29,33,3,4,4,9,31,-55,3,2,313,132
29,34,4,2,9,4,45,22,8,4,358,154
29,35,3,3,8,5,-65,32,3,6,293,186
29,36,4,3,8,5,44,32,7,8,337,218
29,37,5,2,11,2,-44,20,3,8,293,238
29,38,4,3,8,5,44,-68,7,0,337,170
29,39,4,3,9,4,-55,31,2,1,282,201
29,40,2,4,7,6,25,42,7,3,307,243
29,41,4,4,9,4,-55,40,2,3,252,283
29,42,3,3,5,8,32,35,4,8,284,318
29,43,4,3,8,5,44,-68,8,0,328,250
29,44,3,3,6,7,-67,34,1,4,261,284
29,45,4,2,7,6,43,24,4,8,304,308
29,46,4,2,9,4,45,-78,9,0,349,230
29,47,3,3,8,5,-65,32,4,2,284,262
29,48,2,4,7,6,25,42,9,4,309,304
29,49,3,3,6,7,-67,34,2,8,242,338
29,50,3,4,7,6,34,-58,6,0,276,280
29,51,2,5,5,8,23,53,9,3,299,333
29,52,4,3,8,5,-56,32,3,5,243,365
29,53,4,3,9,4,45,31,8,6,288,396
29,54,2,6,2,11,20,-35,8,1,308,361
29,55,3,5,4,9,31,54,9,5,339,415
29,56,2,4,8,5,-74,41,5,6,265,456
29,57,2,5,4,9,22,-46,7,0,287,410
29,58,3,4,6,7,-67,43,0,3,220,453
29,59,2,4,5,8,23,44,3,7,243,497
29,60,4,2,7,6,43,-76,6,1,286,421
29,61,4,3,7,6,43,33,9,4,329,454
29,62,2,5,6,7,-76,52,3,6,253,506
30,1,4,2,8,5,44,23,4,3,44,23
30,2,2,5,2,11,20,56,4,9,64,79
30,3,2,6,2,11,20,-35,4,4,84,44
30,4,4,2,9,4,45,22,9,6,129,66
30,5,4,3,8,5,-56,32,3,8,73,98
30,6,2,4,3,10,21,-54,4,4,94,44
30,7,2,5,4,9,22,54,6,8,116,98
30,8,3,4,5,8,32,-56,8,2,148,42
30,9,3,5,5,8,-68,53,0,5,80,95
30,10,2,5,8,5,26,50,6,5,106,145
30,11,4,4,7,6,43,42,9,7,149,187
30,12,2,4,6,7,-76,-57,3,0,73,130
30,13,4,2,7,6,43,24,6,4,116,154
30,14,5,2,12,1,-43,-20,3,4,73,134
30,15,4,3,9,4,45,31,8,5,118,165
30,16,3,3,5,8,-68,-65,0,0,50,100
30,17,5,2,8,5,53,23,3,3,103,123
30,18,2,5,4,9,22,54,5,7,125,177
30,19,4,2,7,6,43,-76,8,1,168,101
30,20,4,3,7,6,-57,33,1,4,111,134
30,21,3,4,4,9,31,45,2,9,142,179
30,22,3,4,5,8,32,-56,4,3,174,123
30,23,3,3,6,7,33,34,7,7,207,157
30,24,5,2,10,3,-45,21,2,8,162,178
30,25,5,2,9,4,54,-78,6,0,216,100
30,26,3,4,8,5,-65,41,1,1,151,141
30,27,5,3,7,6,52,33,3,4,203,174
30,28,3,3,7,6,34,33,7,7,237,207
30,29,4,3,7,6,-57,-67,0,0,180,140
30,30,4,2,8,5,44,23,4,3,224,163
30,31,3,4,6,7,33,43,7,6,257,206
30,32,4,3,7,6,-57,33,0,9,200,239
30,33,4,3,8,5,44,-68,4,1,244,171
30,34,2,5,2,11,20,56,4,7,264,227
30,35,3,4,4,9,31,-55,5,2,295,172
30,36,2,5,5,8,23,53,8,5,318,225
30,37,2,5,3,10,21,-45,9,0,339,180
30,38,5,2,9,4,-46,22,3,2,293,202
30,39,3,3,5,8,32,35,5,7,325,237
30,40,5,2,10,3,-45,21,0,8,280,258
30,41,4,3,9,4,45,31,5,9,325,289
30,42,2,5,4,9,22,-46,7,3,347,243
30,43,2,4,9,4,-73,40,4,3,274,283
30,44,3,4,6,7,33,43,7,6,307,326
30,45,3,3,7,6,-66,33,1,9,241,359
30,46,3,3,7,6,34,-67,5,2,275,292
30,47,2,5,5,8,23,53,8,5,298,345
30,48,4,2,9,4,-55,22,3,7,243,367
30,49,4,3,7,6,43,-67,6,0,286,300
30,50,3,3,9,4,-64,31,2,1,222,331
30,51,3,4,7,6,34,42,6,3,256,373
30,52,4,3,8,5,-56,32,0,5,200,405
30,53,4,2,9,4,45,22,5,7,245,427
30,54,5,2,9,4,54,22,9,9,299,449
30,55,4,2,10,3,-54,-79,5,0,245,370
30,56,2,4,6,7,24,43,9,3,269,413
30,57,2,4,7,6,-75,42,4,5,194,455
30,58,2,5,5,8,23,53,7,8,217,508
31,1,5,2,10,3,55,21,5,1,55,21
31,2,6,2,9,4,63,22,8,3,118,43
31,3,4,2,9,4,-55,22,3,5,63,65
31,4,3,3,8,5,35,32,8,7,98,97
31,5,4,2,8,5,-56,-77,2,0,42,20
31,6,3,3,9,4,36,31,8,1,78,51
31,7,3,3,5,8,-68,35,0,6,10,86
31,8,3,3,8,5,35,32,5,8,45,118
31,9,4,3,8,5,44,-68,9,0,89,50
31,10,3,4,5,8,-68,44,1,4,21,94
31,11,5,2,10,3,55,21,6,5,76,115
31,12,3,3,6,7,33,34,9,9,109,149
31,13,2,5,5,8,-77,-47,2,2,32,102
31,14,4,2,9,4,45,22,7,4,77,124
31,15,2,5,4,9,22,54,9,8,99,178
31,16,2,5,6,7,-76,-48,3,0,23,130
31,17,4,3,8,5,44,32,7,2,67,162
31,18,3,4,3,10,30,46,7,8,97,208
31,19,4,3,7,6,-57,-67,0,1,40,141
31,20,2,5,2,11,20,56,0,7,60,197
31,21,2,5,5,8,23,-47,3,0,83,150
31,22,2,5,4,9,22,54,5,4,105,204
31,23,3,4,7,6,34,42,9,6,139,246
31,24,2,5,6,7,-76,52,3,8,63,298
31,25,3,3,6,7,33,-66,6,2,96,232
31,26,2,5,4,9,22,54,8,6,118,286
31,27,4,3,6,7,-58,-66,0,0,60,220
31,28,2,5,4,9,22,54,2,4,82,274
31,29,3,4,6,7,33,43,5,7,115,317
31,30,3,4,5,8,32,-56,7,1,147,261
31,31,2,5,7,6,-75,51,2,2,72,312
31,32,4,2,5,8,41,26,3,8,113,338
31,33,3,4,5,8,32,-56,5,2,145,282
31,34,3,4,6,7,33,43,8,5,178,325
31,35,3,3,7,6,-66,33,2,8,112,358
31,36,4,2,7,6,43,-76,5,2,155,282
31,37,3,4,5,8,32,44,7,6,187,326
31,38,2,4,2,11,20,-53,7,3,207,273
31,39,3,4,6,7,-67,43,0,6,140,316
31,40,3,3,4,9,31,-64,1,2,171,252
31,41,4,2,7,6,43,24,4,6,214,276
31,42,2,5,4,9,22,-46,6,0,236,230
31,43,3,3,6,7,33,34,9,4,269,264
31,44,4,3,8,5,-56,32,3,6,213,296
31,45,6,2,8,5,62,23,5,9,275,319
31,46,3,3,9,4,-64,-69,1,0,211,250
31,47,5,2,8,5,53,23,4,3,264,273
31,48,4,3,6,7,42,34,6,7,306,307
31,49,3,4,8,5,-65,41,1,8,241,348
31,50,4,3,7,6,43,-67,4,1,284,281
31,51,3,3,9,4,-64,31,0,2,220,312
31,52,3,3,6,7,33,34,3,6,253,346
31,53,5,2,11,2,56,20,9,6,309,366
31,54,2,5,5,8,-77,53,2,9,232,419
31,55,2,4,7,6,25,-58,7,1,257,361
31,56,4,3,6,7,42,34,9,5,299,395
31,57,2,5,4,9,-78,54,1,9,221,449
31,58,4,3,7,6,43,-67,4,2,264,382
31,59,2,4,6,7,24,43,8,5,288,425
31,60,4,2,6,7,-58,-75,0,0,230,350
31,61,2,5,5,8,23,53,3,3,253,403
31,62,2,5,4,9,22,54,5,7,275,457
31,63,5,2,9,4,54,22,9,9,329,479
31,64,6,2,10,3,-36,-79,3,0,293,400
31,65,2,4,6,7,24,43,7,3,317,443
31,66,3,3,6,7,-67,34,0,7,250,477
31,67,4,3,5,8,41,-65,1,2,291,412
31,68,2,5,6,7,24,52,5,4,315,464
31,69,4,3,8,5,44,32,9,6,359,496
31,70,3,4,8,5,-65,41,4,7,294,537
32,1,2,4,2,11,20,47,0,7,20,47
32,2,2,4,4,9,22,-55,2,2,42,-8
32,3,5,2,8,5,53,23,5,5,95,15
32,4,2,5,2,11,20,-44,5,1,115,-29
32,5,5,2,9,4,54,22,9,3,169,-7
32,6,3,4,5,8,-68,44,1,7,101,37
32,7,3,4,9,4,36,40,7,7,137,77
32,8,3,4,7,6,-66,42,1,9,71,119
32,9,3,4,5,8,32,-56,3,3,103,63
32,10,4,3,6,7,42,34,5,7,145,97
32,11,4,2,9,4,-55,22,0,9,90,119
32,12,2,5,6,7,24,-48,4,1,114,71
32,13,4,2,9,4,45,22,9,3,159,93
32,14,4,2,10,3,-54,21,5,4,105,114
32,15,4,3,4,9,40,-64,5,0,145,50
32,16,4,3,9,4,-55,31,0,1,90,81
32,17,3,3,9,4,36,31,6,2,126,112
32,18,4,2,9,4,-55,22,1,4,71,134
32,19,3,3,4,9,31,-64,2,0,102,70
32,20,4,3,8,5,44,32,6,2,146,102
32,21,3,3,3,10,30,37,6,9,176,139
32,22,2,5,3,10,21,-45,7,4,197,94
32,23,3,4,8,5,-65,41,2,5,132,135
32,24,3,3,5,8,32,-65,4,0,164,70
32,25,2,4,6,7,24,43,8,3,188,113
32,26,2,5,6,7,-76,52,2,5,112,165
32,27,5,2,8,5,53,23,5,8,165,188
32,28,4,2,10,3,-54,21,1,9,111,209
32,29,4,2,4,9,40,-73,1,6,151,136
32,30,4,2,9,4,45,22,6,8,196,158
32,31,2,4,7,6,-75,-58,1,0,121,100
32,32,5,2,10,3,55,21,6,1,176,121
32,33,3,3,6,7,33,34,9,5,209,155
32,34,3,3,8,5,-65,32,4,7,144,187
32,35,2,5,7,6,25,51,9,8,169,238
32,36,2,5,3,10,-79,-45,0,3,90,193
32,37,3,4,3,10,30,46,0,9,120,239
32,38,3,4,6,7,33,-57,3,2,153,182
32,39,3,5,6,7,33,52,6,4,186,234
32,40,3,3,6,7,33,34,9,8,219,268
32,41,5,2,9,4,-46,-78,3,0,173,190
32,42,3,3,6,7,33,34,6,4,206,224
32,43,3,4,5,8,32,44,8,8,238,268
32,44,5,3,9,4,-46,31,2,9,192,299
32,45,3,3,9,4,36,-69,8,0,228,230
32,46,3,4,5,8,-68,44,0,4,160,274
32,47,2,4,4,9,22,45,2,9,182,319
32,48,2,4,5,8,23,-56,5,3,205,263
32,49,6,2,10,3,64,21,9,4,269,284
32,50,4,3,7,6,-57,33,2,7,212,317
32,51,4,2,9,4,45,22,7,9,257,339
32,52,5,2,9,4,-46,-78,1,1,211,261
32,53,4,3,6,7,42,34,3,5,253,295
32,54,3,3,6,7,33,34,6,9,286,329
32,55,3,4,4,9,31,-55,7,4,317,274
32,56,3,4,5,8,32,44,9,8,349,318
32,57,3,4,3,10,30,-54,9,4,379,264
32,58,3,3,6,7,-67,34,2,8,312,298
32,59,5,2,11,2,56,20,8,8,368,318
32,60,5,2,9,4,-46,-78,2,0,322,240
32,61,4,3,9,4,45,31,7,1,367,271
32,62,6,2,11,2,-35,20,2,1,332,291
32,63,5,2,7,6,52,24,4,5,384,315
32,64,2,4,6,7,24,43,8,8,408,358
32,65,4,3,6,7,-58,-66,0,2,350,292
32,66,5,2,11,2,56,20,6,2,406,312
32,67,5,2,8,5,53,23,9,5,459,335
32,68,2,4,4,9,-78,-55,1,0,381,280
32,69,3,4,4,9,31,45,2,5,412,325
32,70,2,4,7,6,25,42,7,7,437,367
32,71,2,4,7,6,-75,42,2,9,362,409
32,72,2,4,3,10,21,-54,3,5,383,355
32,73,5,2,7,6,52,24,5,9,435,379
32,74,5,2,11,2,-44,20,1,9,391,399
32,75,4,2,7,6,43,-76,4,3,434,323
32,76,2,5,5,8,23,53,7,6,457,376
32,77,3,3,5,8,32,-65,9,1,489,311
32,78,3,4,5,8,-68,44,1,5,421,355
32,79,5,2,8,5,53,23,4,8,474,378
32,80,4,3,9,4,45,31,9,9,519,409
33,1,4,2,5,8,41,26,1,6,41,26
33,2,4,2,8,5,44,23,5,9,85,49
33,3,3,4,8,5,-65,-59,0,0,20,-10
33,4,3,3,8,5,35,32,5,2,55,22
33,5,3,4,4,9,31,45,6,7,86,67
33,6,4,3,6,7,42,-66,8,1,128,1
33,7,5,2,9,4,-46,22,2,3,82,23
33,8,4,3,6,7,42,34,4,7,124,57
33,9,3,4,5,8,32,-56,6,1,156,1
33,10,4,2,8,5,-56,23,0,4,100,24
33,11,3,3,6,7,33,34,3,8,133,58
33,12,2,4,5,8,23,-56,6,2,156,2
33,13,2,5,6,7,-76,52,0,4,80,54
33,14,3,4,3,10,30,-54,0,0,110,0
33,15,4,2,9,4,45,22,5,2,155,22
33,16,3,3,6,7,33,34,8,6,188,56
33,17,2,6,5,8,-77,62,1,8,111,118
33,18,3,3,8,5,35,-68,6,0,146,50
33,19,3,3,6,7,33,34,9,4,179,84
33,20,3,4,5,8,-68,44,1,8,111,128
33,21,4,2,8,5,44,-77,5,1,155,51
33,22,2,4,3,10,21,46,6,7,176,97
33,23,4,2,8,5,-56,-77,0,0,120,20
33,24,3,3,6,7,33,34,3,4,153,54
33,25,2,4,6,7,24,43,7,7,177,97
33,26,4,3,6,7,42,-66,9,1,219,31
33,27,3,3,5,8,-68,35,1,6,151,66
33,28,2,5,5,8,23,53,4,9,174,119
33,29,4,3,10,3,-54,30,0,9,120,149
33,30,3,4,5,8,32,-56,2,3,152,93
33,31,4,2,9,4,45,22,7,5,197,115
33,32,3,4,5,8,32,44,9,9,229,159
33,33,2,4,4,9,-78,-55,1,4,151,104
33,34,3,3,7,6,34,33,5,7,185,137
33,35,3,3,6,7,33,-66,8,1,218,71
33,36,3,3,8,5,-65,32,3,3,153,103
33,37,4,3,8,5,44,32,7,5,197,135
33,38,4,3,8,5,-56,32,1,7,141,167
33,39,4,3,8,5,44,32,5,9,185,199
33,40,2,4,6,7,24,-57,9,2,209,142
33,41,2,5,5,8,-77,53,2,5,132,195
33,42,4,2,6,7,42,-75,4,0,174,120
33,43,3,3,6,7,33,34,7,4,207,154
33,44,3,3,6,7,-67,34,0,8,140,188
33,45,3,3,5,8,32,-65,2,3,172,123
33,46,3,3,4,9,31,36,3,9,203,159
33,47,4,2,9,4,45,-78,8,1,248,81
33,48,4,3,5,8,41,35,9,6,289,116
33,49,2,5,3,10,-79,-45,0,1,210,71
33,50,4,2,6,7,42,25,2,6,252,96
33,51,2,5,4,9,22,-46,4,0,274,50
33,52,5,2,10,3,55,21,9,1,329,71
33,53,2,4,6,7,-76,43,3,4,253,114
33,54,3,3,8,5,35,32,8,6,288,146
33,55,4,2,8,5,-56,23,2,9,232,169
33,56,3,3,7,6,34,-67,6,2,266,102
33,57,3,4,8,5,-65,41,1,3,201,143
33,58,3,3,7,6,34,33,5,6,235,176
33,59,6,2,9,4,63,22,8,8,298,198
33,60,3,3,9,4,-64,31,4,9,234,229
33,61,2,4,5,8,23,-56,7,3,257,173
33,62,4,3,7,6,-57,33,0,6,200,206
33,63,3,3,6,7,33,-66,3,0,233,140
33,64,2,4,7,6,25,42,8,2,258,182
33,65,4,3,7,6,-57,33,1,5,201,215
33,66,3,4,4,9,31,-55,2,0,232,160
33,67,2,4,6,7,24,43,6,3,256,203
33,68,4,2,8,5,-56,23,0,6,200,226
33,69,5,2,10,3,55,21,5,7,255,247
33,70,2,5,5,8,23,-47,8,0,278,200
33,71,2,5,3,10,21,55,9,5,299,255
33,72,5,2,9,4,-46,22,3,7,253,277
33,73,3,3,5,8,32,-65,5,2,285,212
33,74,3,4,7,6,34,42,9,4,319,254
33,75,2,5,6,7,-76,52,3,6,243,306
33,76,2,5,4,9,22,-46,5,0,265,260
33,77,3,3,5,8,32,35,7,5,297,295
33,78,5,2,7,6,52,24,9,9,349,319
33,79,2,4,6,7,-76,-57,3,2,273,262
33,80,2,5,5,8,23,53,6,5,296,315
33,81,5,2,9,4,-46,22,0,7,250,337
33,82,2,5,5,8,23,-47,3,0,273,290
33,83,3,4,6,7,33,43,6,3,306,333
33,84,2,4,5,8,23,44,9,7,329,377
33,85,3,3,7,6,-66,-67,3,0,263,310
33,86,3,3,10,3,-63,30,0,0,200,340
33,87,3,4,9,4,36,40,6,0,236,380
33,88,5,2,10,3,-45,21,1,1,191,401
33,89,3,4,8,5,35,41,6,2,226,442
33,90,4,2,10,3,-54,21,2,3,172,463
33,91,3,3,6,7,33,34,5,7,205,497
33,92,3,4,7,6,34,42,9,9,239,539
34,1,3,4,7,6,34,42,4,2,34,42
34,2,2,5,3,10,21,55,5,7,55,97
34,3,4,4,5,8,41,-56,6,1,96,41
34,4,3,3,6,7,33,34,9,5,129,75
34,5,3,4,9,4,-64,40,5,5,65,115
34,6,3,3,6,7,33,34,8,9,98,149
34,7,2,4,6,7,-76,-57,2,2,22,92
34,8,3,3,7,6,34,33,6,5,56,125
34,9,2,5,5,8,23,53,9,8,79,178
34,10,4,2,5,8,-59,-74,0,4,20,104
34,11,4,2,9,4,45,22,5,6,65,126
34,12,3,4,9,4,-64,40,1,6,1,166
34,13,4,2,6,7,42,-75,3,1,43,91
34,14,2,5,4,9,22,54,5,5,65,145
34,15,2,5,3,10,21,-45,6,0,86,100
34,16,2,4,5,8,23,44,9,4,109,144
34,17,4,3,7,6,-57,33,2,7,52,177
34,18,4,2,10,3,46,21,8,8,98,198
34,19,4,2,7,6,-57,-76,1,2,41,122
34,20,3,3,8,5,35,32,6,4,76,154
34,21,3,4,6,7,33,43,9,7,109,197
34,22,4,3,7,6,-57,-67,2,0,52,130
34,23,3,3,6,7,33,34,5,4,85,164
34,24,4,3,8,5,44,32,9,6,129,196
34,25,3,3,7,6,-66,33,3,9,63,229
34,26,2,4,3,10,21,-54,4,5,84,175
34,27,3,4,7,6,34,42,8,7,118,217
34,28,3,3,8,5,-65,32,3,9,53,249
34,29,5,2,8,5,53,-77,6,2,106,172
34,30,3,4,5,8,32,44,8,6,138,216
34,31,5,2,9,4,-46,22,2,8,92,238
34,32,4,2,8,5,44,-77,6,1,136,161
34,33,6,2,8,5,62,23,8,4,198,184
34,34,4,2,6,7,-58,25,0,9,140,209
34,35,4,3,6,7,42,-66,2,3,182,143
34,36,2,4,5,8,23,44,5,7,205,187
34,37,2,4,4,9,22,-55,7,2,227,132
34,38,5,2,10,3,-45,21,2,3,182,153
34,39,6,2,10,3,64,21,6,4,246,174
34,40,2,5,3,10,21,55,7,9,267,229
34,41,3,3,7,6,-66,-67,1,2,201,162
34,42,4,3,9,4,45,31,6,3,246,193
34,43,4,3,7,6,43,33,9,6,289,226
34,44,3,3,7,6,-66,33,3,9,223,259
34,45,5,2,10,3,55,-79,8,0,278,180
34,46,3,4,5,8,-68,44,0,4,210,224
34,47,4,3,7,6,43,33,3,7,253,257
34,48,4,3,7,6,43,-67,6,0,296,190
34,49,3,3,5,8,32,35,8,5,328,225
34,50,2,4,7,6,-75,42,3,7,253,267
34,51,2,4,5,8,23,-56,6,1,276,211
34,52,5,2,10,3,-45,21,1,2,231,232
34,53,4,2,8,5,44,23,5,5,275,255
34,54,2,4,6,7,24,43,9,8,299,298
34,55,3,3,8,5,-65,-68,4,0,234,230
34,56,3,3,5,8,32,35,6,5,266,265
34,57,5,2,9,4,-46,22,0,7,220,287
34,58,2,4,5,8,23,-56,3,1,243,231
34,59,3,3,9,4,36,31,9,2,279,262
34,60,5,2,6,7,-49,25,0,7,230,287
34,61,6,2,9,4,63,22,3,9,293,309
34,62,4,3,6,7,42,-66,5,3,335,243
34,63,3,4,7,6,34,42,9,5,369,285
34,64,3,3,6,7,-67,34,2,9,302,319
34,65,4,3,8,5,44,-68,6,1,346,251
34,66,5,2,10,3,-45,21,1,2,301,272
34,67,2,5,5,8,23,53,4,5,324,325
34,68,5,2,9,4,54,22,8,7,378,347
34,69,3,3,6,7,-67,-66,1,1,311,281
34,70,3,3,5,8,32,35,3,6,343,316
34,71,5,2,10,3,55,21,8,7,398,337
34,72,2,4,7,6,-75,42,3,9,323,379
34,73,4,4,5,8,41,-56,4,3,364,323
34,74,4,2,9,4,45,22,9,5,409,345
34,75,5,2,6,7,-49,-75,0,0,360,270
34,76,3,3,7,6,34,33,4,3,394,303
34,77,3,3,7,6,34,33,8,6,428,336
34,78,2,4,4,9,-78,-55,0,1,350,281
34,79,3,3,6,7,33,34,3,5,383,315
34,80,4,2,9,4,45,22,8,7,428,337
34,81,3,3,5,8,-68,-65,0,2,360,272
34,82,3,3,7,6,34,33,4,5,394,305
34,83,3,4,6,7,33,43,7,8,427,348
34,84,3,5,5,8,32,-47,9,1,459,301
34,85,3,4,6,7,-67,43,2,4,392,344
34,86,2,4,4,9,22,45,4,9,414,389
34,87,4,3,6,7,42,-66,6,3,456,323
34,88,4,2,8,5,-56,23,0,6,400,346
34,89,4,4,6,7,42,43,2,9,442,389
34,90,5,2,8,5,53,-77,5,2,495,312
34,91,3,3,7,6,34,33,9,5,529,345
35,1,5,2,10,3,55,21,5,1,55,21
35,2,5,2,9,4,54,22,9,3,109,43
35,3,2,5,6,7,-76,52,3,5,33,95
35,4,3,3,4,9,31,-64,4,1,64,31
35,5,4,2,9,4,45,22,9,3,109,53
35,6,4,3,5,8,-59,35,0,8,50,88
35,7,2,4,6,7,24,-57,4,1,74,31
35,8,3,3,7,6,34,33,8,4,108,64
35,9,5,2,9,4,-46,22,2,6,62,86
35,10,2,4,6,7,24,43,6,9,86,129
35,11,5,2,11,2,-44,20,2,9,42,149
35,12,3,4,7,6,34,-58,6,1,76,91
35,13,4,3,6,7,42,34,8,5,118,125
35,14,3,3,6,7,-67,34,1,9,51,159
35,15,3,4,4,9,31,-55,2,4,82,104
35,16,3,3,7,6,34,33,6,7,116,137
35,17,3,5,3,10,30,-45,6,2,146,92
35,18,3,4,7,6,-66,42,0,4,80,134
35,19,4,2,7,6,43,24,3,8,123,158
35,20,3,5,7,6,34,51,7,9,157,209
35,21,5,2,8,5,-47,-77,0,2,110,132
35,22,2,4,6,7,24,43,4,5,134,175
35,23,3,3,5,8,32,-65,6,0,166,110
35,24,5,2,10,3,-45,21,1,1,121,131
35,25,4,3,9,4,45,31,6,2,166,162
35,26,3,4,7,6,-66,42,0,4,100,204
35,27,2,4,5,8,23,44,3,8,123,248
35,28,5,2,9,4,54,-78,7,0,177,170
35,29,2,5,3,10,21,55,8,5,198,225
35,30,3,3,5,8,-68,-65,0,0,130,160
35,31,4,3,8,5,44,32,4,2,174,192
35,32,3,4,6,7,33,43,7,5,207,235
35,33,2,4,5,8,-77,44,0,9,130,279
35,34,3,3,6,7,33,-66,3,3,163,213
35,35,4,2,10,3,46,21,9,4,209,234
35,36,4,4,6,7,-58,43,1,7,151,277
35,37,3,4,5,8,32,-56,3,1,183,221
35,38,5,2,7,6,52,24,5,5,235,245
35,39,3,3,6,7,33,34,8,9,268,279
35,40,2,4,4,9,-78,-55,0,4,190,224
35,41,3,3,6,7,33,34,3,8,223,258
35,42,4,2,8,5,44,-77,7,1,267,181
35,43,4,3,7,6,-57,33,0,4,210,214
35,44,2,4,5,8,23,44,3,8,233,258
35,45,3,3,5,8,32,-65,5,3,265,193
35,46,4,3,8,5,44,32,9,5,309,225
35,47,4,3,4,9,40,-64,9,1,349,161
35,48,4,2,8,5,-56,23,3,4,293,184
35,49,3,3,9,4,36,31,9,5,329,215
35,50,3,4,6,7,-67,43,2,8,262,258
35,51,3,3,7,6,34,-67,6,1,296,191
35,52,4,3,9,4,-55,31,1,2,241,222
35,53,2,5,3,10,21,55,2,7,262,277
35,54,3,4,4,9,31,-55,3,2,293,222
35,55,4,2,9,4,45,22,8,4,338,244
35,56,4,3,7,6,-57,33,1,7,281,277
35,57,3,4,5,8,32,-56,3,1,313,221
35,58,4,2,8,5,44,23,7,4,357,244
35,59,3,3,5,8,32,35,9,9,389,279
35,60,3,4,5,8,-68,-56,1,3,321,223
35,61,6,2,9,4,63,22,4,5,384,245
35,62,3,3,5,8,32,-65,6,0,416,180
35,63,2,4,6,7,-76,43,0,3,340,223
35,64,5,2,8,5,53,23,3,6,393,246
35,65,3,4,5,8,32,-56,5,0,425,190
35,66,4,3,4,9,40,36,5,6,465,226
35,67,2,4,5,8,23,-56,8,0,488,170
35,68,4,3,8,5,-56,32,2,2,432,202
35,69,4,3,8,5,44,32,6,4,476,234
35,70,2,5,3,10,21,55,7,9,497,289
35,71,3,4,4,9,31,-55,8,4,528,234
36,1,2,4,5,8,23,44,3,4,23,44
36,2,2,6,3,10,21,64,4,8,44,108
36,3,4,2,6,7,42,-75,6,3,86,33
36,4,4,3,6,7,42,34,8,7,128,67
36,5,4,2,8,5,-56,-77,2,0,72,-10
36,6,5,2,8,5,53,23,5,3,125,13
36,7,4,2,10,3,-54,21,1,4,71,34
36,8,4,2,6,7,42,25,3,9,113,59
36,9,4,2,9,4,45,-78,8,1,158,-19
36,10,4,3,6,7,-58,34,0,5,100,15
36,11,4,3,9,4,45,31,5,6,145,46
36,12,3,3,8,5,-65,32,0,8,80,78
36,13,3,4,6,7,33,-57,3,1,113,21
36,14,2,4,6,7,24,43,7,4,137,64
36,15,4,3,7,6,-57,33,0,7,80,97
36,16,2,5,5,8,23,-47,3,0,103,50
36,17,2,4,2,11,20,47,3,7,123,97
36,18,4,2,5,8,41,-74,4,3,164,23
36,19,3,4,4,9,31,45,5,8,195,68
36,20,4,2,9,4,-55,-78,0,0,140,-10
36,21,3,3,5,8,32,35,2,5,172,25
36,22,4,2,9,4,45,22,7,7,217,47
36,23,2,5,2,11,20,-44,7,3,237,3
36,24,5,2,9,4,-46,22,1,5,191,25
36,25,5,2,10,3,55,21,6,6,246,46
36,26,5,2,9,4,-46,22,0,8,200,68
36,27,4,2,9,4,45,-78,5,0,245,-10
36,28,3,4,3,10,30,46,5,6,275,36
36,29,4,2,7,6,43,-76,8,0,318,-40
36,30,3,3,6,7,-67,34,1,4,251,-6
36,31,3,4,6,7,33,43,4,7,284,37
36,32,4,3,8,5,44,32,8,9,328,69
36,33,4,2,8,5,-56,-77,2,2,272,-8
36,34,2,5,3,10,21,55,3,7,293,47
36,35,3,4,5,8,32,-56,5,1,325,-9
36,36,2,4,8,5,-74,41,1,2,251,32
36,37,3,4,7,6,34,42,5,4,285,74
36,38,4,3,6,7,42,34,7,8,327,108
36,39,3,3,5,8,32,-65,9,3,359,43
36,40,4,2,9,4,-55,22,4,5,304,65
36,41,6,2,10,3,64,21,8,6,368,86
36,42,4,2,9,4,-55,22,3,8,313,108
36,43,2,4,4,9,22,-55,5,3,335,53
36,44,4,3,10,3,-54,30,1,3,281,83
36,45,3,4,3,10,30,46,1,9,311,129
36,46,5,2,11,2,56,20,7,9,367,149
36,47,3,3,8,5,-65,-68,2,1,302,81
36,48,3,4,5,8,32,44,4,5,334,125
36,49,5,3,8,5,53,32,7,7,387,157
36,50,5,2,9,4,-46,22,1,9,341,179
36,51,3,3,4,9,31,-64,2,5,372,115
36,52,5,2,8,5,53,23,5,8,425,138
36,53,3,3,8,5,-65,-68,0,0,360,70
36,54,4,2,7,6,43,24,3,4,403,94
36,55,4,2,7,6,43,24,6,8,446,118
36,56,3,4,7,6,-66,-58,0,0,380,60
36,57,3,3,6,7,33,34,3,4,413,94
36,58,3,3,7,6,34,33,7,7,447,127
36,59,3,4,6,7,-67,-57,0,0,380,70
36,60,4,2,7,6,43,24,3,4,423,94
36,61,3,4,6,7,33,43,6,7,456,137
36,62,3,4,6,7,33,-57,9,0,489,80
36,63,4,3,8,5,-56,32,3,2,433,112
36,64,4,3,6,7,42,34,5,6,475,146
36,65,4,3,9,4,-55,31,0,7,420,177
36,66,6,2,11,2,65,20,5,7,485,197
36,67,3,4,6,7,33,-57,8,0,518,140
37,1,5,3,8,5,53,32,3,2,53,32
37,2,5,2,7,6,52,24,5,6,105,56
37,3,5,2,9,4,54,22,9,8,159,78
37,4,5,2,9,4,-46,-78,3,0,113,0
37,5,2,4,7,6,25,42,8,2,138,42
37,6,5,2,11,2,-44,20,4,2,94,62
37,7,3,4,7,6,34,42,8,4,128,104
37,8,4,3,9,4,-55,31,3,5,73,135
37,9,5,2,9,4,54,22,7,7,127,157
37,10,4,2,10,3,-54,21,3,8,73,178
37,11,2,5,3,10,21,-45,4,3,94,133
37,12,3,3,5,8,32,35,6,8,126,168
37,13,4,2,6,7,42,-75,8,3,168,93
37,14,4,3,6,7,-58,34,0,7,110,127
37,15,3,4,6,7,33,-57,3,0,143,70
37,16,2,4,6,7,24,43,7,3,167,113
37,17,3,3,6,7,-67,34,0,7,100,147
37,18,3,3,8,5,35,32,5,9,135,179
37,19,4,2,7,6,43,-76,8,3,178,103
37,20,3,5,7,6,-66,51,2,4,112,154
37,21,2,5,5,8,23,53,5,7,135,207
37,22,4,2,6,7,42,-75,7,2,177,132
37,23,4,3,6,7,42,34,9,6,219,166
37,24,2,5,5,8,-77,53,2,9,142,219
37,25,5,2,9,4,54,-78,6,1,196,141
37,26,2,5,3,10,21,55,7,6,217,196
37,27,3,4,6,7,-67,43,0,9,150,239
37,28,2,6,2,11,20,-35,0,4,170,204
37,29,3,3,8,5,35,32,5,6,205,236
37,30,3,4,5,8,32,-56,7,0,237,180
37,31,5,2,9,4,-46,22,1,2,191,202
37,32,4,2,9,4,45,22,6,4,236,224
37,33,4,2,9,4,-55,22,1,6,181,246
37,34,3,3,7,6,34,33,5,9,215,279
37,35,3,3,8,5,-65,-68,0,1,150,211
37,36,2,4,3,10,21,46,1,7,171,257
37,37,3,3,5,8,32,-65,3,2,203,192
37,38,4,3,8,5,44,32,7,4,247,224
37,39,4,2,6,7,42,25,9,9,289,249
37,40,4,2,9,4,-55,-78,4,1,234,171
37,41,3,3,7,6,34,33,8,4,268,204
37,42,4,4,8,5,-56,41,2,5,212,245
37,43,3,3,10,3,37,30,9,5,249,275
37,44,4,3,7,6,-57,33,2,8,192,308
37,45,2,4,7,6,25,-58,7,0,217,250
37,46,2,4,6,7,-76,43,1,3,141,293
37,47,2,4,6,7,24,43,5,6,165,336
37,48,5,2,8,5,53,23,8,9,218,359
37,49,5,2,8,5,-47,-77,1,2,171,282
37,50,3,3,7,6,34,33,5,5,205,315
37,51,3,3,7,6,34,33,9,8,239,348
37,52,4,3,8,5,-56,-68,3,0,183,280
37,53,5,2,8,5,53,23,6,3,236,303
37,54,4,3,9,4,-55,31,1,4,181,334
37,55,3,3,7,6,34,33,5,7,215,367
37,56,2,6,2,11,20,-35,5,2,235,332
37,57,3,4,7,6,34,42,9,4,269,374
37,58,3,4,5,8,-68,44,1,8,201,418
37,59,4,3,9,4,45,31,6,9,246,449
37,60,4,2,8,5,-56,-77,0,2,190,372
37,61,5,2,11,2,56,20,6,2,246,392
37,62,4,3,7,6,43,33,9,5,289,425
37,63,4,2,9,4,-55,22,4,7,234,447
37,64,3,3,6,7,33,-66,7,1,267,381
37,65,5,2,11,2,-44,20,3,1,223,401
37,66,3,3,8,5,35,32,8,3,258,433
37,67,5,2,8,5,-47,23,1,6,211,456
37,68,4,3,8,5,44,32,5,8,255,488
37,69,3,3,8,5,-65,-68,0,0,190,420
37,70,4,2,5,8,41,26,1,6,231,446
37,71,5,2,8,5,53,23,4,9,284,469
37,72,2,4,3,10,21,-54,5,5,305,415
37,73,4,2,10,3,-54,21,1,6,251,436
37,74,3,3,9,4,36,31,7,7,287,467
37,75,3,3,7,6,-66,-67,1,0,221,400
37,76,4,2,7,6,43,24,4,4,264,424
37,77,4,3,8,5,44,32,8,6,308,456
37,78,4,2,7,6,-57,-76,1,0,251,380
37,79,4,3,8,5,44,32,5,2,295,412
37,80,3,4,5,8,32,44,7,6,327,456
37,81,3,3,5,8,32,-65,9,1,359,391
37,82,6,2,10,3,-36,21,3,2,323,412
37,83,3,3,8,5,35,32,8,4,358,444
37,84,4,2,7,6,-57,24,1,8,301,468
37,85,2,4,5,8,23,-56,4,2,324,412
37,86,2,4,5,8,23,44,7,6,347,456
37,87,3,3,5,8,32,-65,9,1,379,391
37,88,5,2,7,6,-48,24,1,5,331,415
37,89,2,6,3,10,21,64,2,9,352,479
37,90,2,4,7,6,25,-58,7,1,377,421
37,91,4,3,6,7,42,34,9,5,419,455
37,92,3,3,6,7,-67,34,2,9,352,489
37,93,2,4,6,7,24,-57,6,2,376,432
37,94,5,2,10,3,-45,21,1,3,331,453
37,95,4,2,9,4,45,22,6,5,376,475
37,96,3,3,9,4,-64,31,2,6,312,506
38,1,3,3,8,5,35,32,5,2,35,32
38,2,5,2,10,3,-45,21,0,3,-10,53
38,3,2,5,4,9,22,54,2,7,12,107
38,4,4,2,7,6,43,-76,5,1,55,31
38,5,3,4,4,9,31,45,6,6,86,76
38,6,5,2,8,5,53,23,9,9,139,99
38,7,2,5,4,9,-78,-46,1,3,61,53
38,8,2,4,4,9,22,45,3,8,83,98
38,9,2,4,3,10,21,-54,4,4,104,44
38,10,4,2,6,7,42,25,6,9,146,69
38,11,4,2,8,5,-56,-77,0,2,90,-8
38,12,3,4,9,4,36,40,6,2,126,32
38,13,3,4,4,9,31,45,7,7,157,77
38,14,4,3,6,7,42,-66,9,1,199,11
38,15,4,2,9,4,-55,22,4,3,144,33
38,16,2,5,6,7,24,52,8,5,168,85
38,17,4,2,5,8,41,-74,9,1,209,11
38,18,3,4,8,5,-65,41,4,2,144,52
38,19,2,5,6,7,24,52,8,4,168,104
38,20,3,3,8,5,-65,32,3,6,103,136
38,21,2,5,6,7,24,52,7,8,127,188
38,22,6,2,11,2,-35,20,2,8,92,208
38,23,4,4,5,8,41,-56,3,2,133,152
38,24,3,4,5,8,32,44,5,6,165,196
38,25,3,4,6,7,33,43,8,9,198,239
38,26,3,4,4,9,31,-55,9,4,229,184
38,27,3,3,5,8,-68,35,1,9,161,219
38,28,3,4,6,7,33,-57,4,2,194,162
38,29,3,3,7,6,34,33,8,5,228,195
38,30,4,2,10,3,-54,21,4,6,174,216
38,31,5,2,7,6,52,-76,6,0,226,140
38,32,4,3,9,4,-55,31,1,1,171,171
38,33,3,4,7,6,34,42,5,3,205,213
38,34,3,3,8,5,-65,32,0,5,140,245
38,35,4,3,7,6,43,33,3,8,183,278
38,36,4,3,10,3,46,30,9,8,229,308
38,37,2,5,4,9,-78,-46,1,2,151,262
38,38,3,4,7,6,34,42,5,4,185,304
38,39,3,3,8,5,-65,32,0,6,120,336
38,40,3,3,9,4,36,31,6,7,156,367
38,41,3,3,7,6,-66,-67,0,0,90,300
38,42,4,3,8,5,44,32,4,2,134,332
38,43,3,4,8,5,35,41,9,3,169,373
38,44,3,3,9,4,-64,31,5,4,105,404
38,45,5,2,7,6,52,24,7,8,157,428
38,46,4,3,7,6,-57,-67,0,1,100,361
38,47,3,3,7,6,34,33,4,4,134,394
38,48,3,3,6,7,33,34,7,8,167,428
38,49,3,3,6,7,-67,-66,0,2,100,362
38,50,2,5,3,10,21,55,1,7,121,417
38,51,2,5,4,9,22,-46,3,1,143,371
38,52,3,4,7,6,34,42,7,3,177,413
38,53,2,4,3,10,21,46,8,9,198,459
38,54,3,3,8,5,-65,-68,3,1,133,391
38,55,3,4,6,7,33,43,6,4,166,434
38,56,2,5,4,9,22,54,8,8,188,488
38,57,4,2,7,6,-57,-76,1,2,131,412
38,58,4,3,5,8,41,35,2,7,172,447
38,59,2,4,5,8,23,-56,5,1,195,391
38,60,6,2,10,3,64,21,9,2,259,412
38,61,2,5,2,11,20,56,9,8,279,468
38,62,2,5,3,10,-79,-45,0,3,200,423
38,63,4,3,7,6,43,33,3,6,243,456
38,64,3,4,8,5,35,41,8,7,278,497
38,65,4,2,9,4,-55,22,3,9,223,519
39,1,4,2,10,3,46,21,6,1,46,21
39,2,4,2,7,6,43,24,9,5,89,45
39,3,4,3,7,6,-57,33,2,8,32,78
39,4,3,4,7,6,34,-58,6,0,66,20
39,5,2,5,6,7,-76,52,0,2,-10,72
39,6,3,4,7,6,34,42,4,4,24,114
39,7,2,5,6,7,24,52,8,6,48,166
39,8,3,3,9,4,-64,31,4,7,-16,197
39,9,2,4,5,8,23,-56,7,1,7,141
39,10,3,3,4,9,31,36,8,7,38,177
39,11,3,4,5,8,-68,-56,0,1,-30,121
39,12,3,5,7,6,34,51,4,2,4,172
39,13,2,5,5,8,23,53,7,5,27,225
39,14,3,4,7,6,-66,42,1,7,-39,267
39,15,2,4,6,7,24,-57,5,0,-15,210
39,16,2,5,5,8,23,53,8,3,8,263
39,17,2,5,5,8,-77,53,1,6,-69,316
39,18,4,3,5,8,41,-65,2,1,-28,251
39,19,4,3,8,5,44,32,6,3,16,283
39,20,4,3,9,4,-55,31,1,4,-39,314
39,21,3,4,6,7,33,43,4,7,-6,357
39,22,2,4,6,7,24,-57,8,0,18,300
39,23,3,3,7,6,-66,33,2,3,-48,333
39,24,3,4,4,9,31,45,3,8,-17,378
39,25,3,3,8,5,35,-68,8,0,18,310
39,26,4,2,9,4,-55,22,3,2,-37,332
39,27,3,4,5,8,32,44,5,6,-5,376
39,28,2,6,2,11,20,-35,5,1,15,341
39,29,4,2,7,6,43,24,8,5,58,365
39,30,5,2,8,5,-47,23,1,8,11,388
39,31,3,3,6,7,33,-66,4,2,44,322
39,32,4,2,10,3,-54,21,0,3,-10,343
39,33,5,2,9,4,54,22,4,5,44,365
39,34,4,2,5,8,41,-74,5,1,85,291
39,35,5,2,9,4,54,22,9,3,139,313
39,36,3,3,9,4,-64,31,5,4,75,344
39,37,3,4,8,5,-65,41,0,5,10,385
39,38,3,3,7,6,34,33,4,8,44,418
39,39,4,3,8,5,44,-68,8,0,88,350
39,40,5,2,9,4,-46,22,2,2,42,372
39,41,4,3,8,5,44,32,6,4,86,404
39,42,6,2,10,3,-36,21,0,5,50,425
39,43,4,3,7,6,43,33,3,8,93,458
39,44,2,4,4,9,22,-55,5,3,115,403
39,45,4,3,7,6,43,33,8,6,158,436
39,46,3,4,3,10,30,-54,8,2,188,382
39,47,3,3,7,6,-66,33,2,5,122,415
39,48,3,3,6,7,33,34,5,9,155,449
39,49,4,3,6,7,42,-66,7,3,197,383
39,50,4,3,5,8,41,35,8,8,238,418
39,51,4,3,8,5,-56,-68,2,0,182,350
39,52,3,4,6,7,33,43,5,3,215,393
39,53,5,2,10,3,-45,21,0,4,170,414
39,54,4,3,7,6,43,33,3,7,213,447
39,55,3,4,6,7,33,-57,6,0,246,390
39,56,4,4,9,4,-55,40,1,0,191,430
39,57,4,3,8,5,44,32,5,2,235,462
39,58,3,3,8,5,-65,32,0,4,170,494
39,59,2,4,5,8,23,44,3,8,193,538
40,1,5,2,10,3,55,21,5,1,55,21
40,2,3,3,6,7,33,34,8,5,88,55
40,3,4,3,8,5,-56,32,2,7,32,87
40,4,4,3,6,7,42,-66,4,1,74,21
40,5,3,4,4,9,31,45,5,6,105,66
40,6,3,4,7,6,34,42,9,8,139,108
40,7,4,3,8,5,-56,-68,3,0,83,40
40,8,4,3,7,6,43,33,6,3,126,73
40,9,3,3,6,7,33,34,9,7,159,107
40,10,3,4,8,5,-65,41,4,8,94,148
40,11,3,4,6,7,33,-57,7,1,127,91
40,12,4,2,9,4,-55,22,2,3,72,113
40,13,4,3,6,7,42,34,4,7,114,147
40,14,4,3,6,7,42,-66,6,1,156,81
40,15,3,4,7,6,-66,42,0,3,90,123
40,16,2,5,5,8,23,53,3,6,113,176
40,17,2,5,3,10,21,-45,4,1,134,131
40,18,2,4,4,9,22,45,6,6,156,176
40,19,3,4,3,10,30,-54,6,2,186,122
40,20,3,3,5,8,32,35,8,7,218,157
40,21,4,3,7,6,-57,-67,1,0,161,90
40,22,3,4,5,8,32,44,3,4,193,134
40,23,2,4,5,8,23,44,6,8,216,178
40,24,4,3,8,5,-56,-68,0,0,160,110
40,25,3,3,5,8,32,35,2,5,192,145
40,26,2,4,5,8,23,44,5,9,215,189
40,27,2,4,4,9,22,-55,7,4,237,134
40,28,2,5,6,7,-76,52,1,6,161,186
40,29,3,4,7,6,34,42,5,8,195,228
40,30,4,2,9,4,-55,-78,0,0,140,150
40,31,3,4,8,5,35,41,5,1,175,191
40,32,3,3,5,8,32,35,7,6,207,226
40,33,3,3,6,7,-67,-66,0,0,140,160
40,34,6,2,10,3,64,21,4,1,204,181
40,35,3,4,6,7,33,43,7,4,237,224
40,36,4,2,10,3,-54,21,3,5,183,245
40,37,3,3,6,7,33,34,6,9,216,279
40,38,2,5,3,10,21,-45,7,4,237,234
40,39,4,2,7,6,-57,24,0,8,180,258
40,40,4,2,10,3,46,21,6,9,226,279
40,41,4,3,6,7,42,-66,8,3,268,213
40,42,5,3,7,6,-48,33,0,6,220,246
40,43,2,4,7,6,25,42,5,8,245,288
40,44,3,3,5,8,32,-65,7,3,277,223
40,45,4,2,9,4,-55,22,2,5,222,245
40,46,4,2,6,7,42,-75,4,0,264,170
40,47,5,3,6,7,51,34,5,4,315,204
40,48,2,5,5,8,23,53,8,7,338,257
40,49,4,3,8,5,-56,32,2,9,282,289
40,50,2,6,2,11,20,-35,2,4,302,254
40,51,3,4,7,6,34,42,6,6,336,296
40,52,3,5,6,7,33,52,9,8,369,348
40,53,4,2,9,4,-55,-78,4,0,314,270
40,54,5,3,8,5,53,32,7,2,367,302
40,55,4,2,10,3,-54,21,3,3,313,323
40,56,3,3,6,7,33,34,6,7,346,357
40,57,4,3,8,5,-56,32,0,9,290,389
40,58,3,4,8,5,35,-59,5,0,325,330
40,59,5,2,7,6,52,24,7,4,377,354
40,60,4,4,5,8,41,44,8,8,418,398
40,61,6,2,10,3,-36,21,2,9,382,419
40,62,3,3,5,8,32,-65,4,4,414,354
40,63,3,4,6,7,33,43,7,7,447,397
40,64,5,2,9,4,-46,22,1,9,401,419
40,65,3,4,7,6,34,-58,5,1,435,361
40,66,3,5,6,7,33,52,8,3,468,413
40,67,2,4,6,7,-76,43,2,6,392,456
40,68,2,4,3,10,21,-54,3,2,413,402
40,69,2,4,5,8,23,44,6,6,436,446
40,70,3,4,5,8,32,-56,8,0,468,390
40,71,3,3,7,6,-66,33,2,3,402,423
40,72,3,4,7,6,34,42,6,5,436,465
40,73,5,2,9,4,-46,22,0,7,390,487
40,74,2,4,7,6,25,42,5,9,415,529
41,1,4,2,7,6,43,24,3,4,43,24
41,2,2,5,5,8,23,53,6,7,66,77
41,3,3,3,8,5,-65,32,1,9,1,109
41,4,2,5,3,10,21,-45,2,4,22,64
41,5,3,3,6,7,33,34,5,8,55,98
41,6,2,4,7,6,-75,-58,0,0,-20,40
41,7,5,2,11,2,56,20,6,0,36,60
41,8,4,2,5,8,41,26,7,6,77,86
41,9,3,3,4,9,31,-64,8,2,108,22
41,10,3,3,8,5,-65,32,3,4,43,54
41,11,5,2,9,4,54,22,7,6,97,76
41,12,2,4,4,9,22,-55,9,1,119,21
41,13,3,4,6,7,-67,43,2,4,52,64
41,14,5,2,8,5,53,23,5,7,105,87
41,15,3,3,6,7,33,-66,8,1,138,21
41,16,4,4,9,4,-55,40,3,1,83,61
41,17,5,2,9,4,54,22,7,3,137,83
41,18,3,4,8,5,-65,41,2,4,72,124
41,19,3,4,7,6,34,42,6,6,106,166
41,20,2,4,7,6,-75,42,1,8,31,208
41,21,3,3,8,5,35,-68,6,0,66,140
41,22,3,3,7,6,-66,33,0,3,0,173
41,23,4,3,9,4,45,31,5,4,45,204
41,24,3,4,5,8,32,44,7,8,77,248
41,25,3,4,4,9,31,-55,8,3,108,193
41,26,2,5,4,9,-78,54,0,7,30,247
41,27,3,4,4,9,31,-55,1,2,61,192
41,28,5,2,6,7,51,25,2,7,112,217
41,29,3,4,7,6,34,42,6,9,146,259
41,30,3,3,5,8,32,-65,8,4,178,194
41,31,2,5,5,8,-77,53,1,7,101,247
41,32,4,3,6,7,42,-66,3,1,143,181
41,33,3,4,6,7,33,43,6,4,176,224
41,34,3,3,8,5,-65,32,1,6,111,256
41,35,2,4,7,6,25,42,6,8,136,298
41,36,2,4,9,4,-73,40,3,8,63,338
41,37,4,3,8,5,44,-68,7,0,107,270
41,38,3,4,6,7,-67,43,0,3,40,313
41,39,3,3,8,5,35,32,5,5,75,345
41,40,4,3,8,5,44,32,9,7,119,377
41,41,2,5,3,10,-79,-45,0,2,40,332
41,42,4,3,9,4,45,31,5,3,85,363
41,43,2,4,5,8,23,44,8,7,108,407
41,44,3,4,5,8,-68,-56,0,1,40,351
41,45,4,3,7,6,43,33,3,4,83,384
41,46,2,4,5,8,23,44,6,8,106,428
41,47,2,5,5,8,23,-47,9,1,129,381
41,48,3,4,5,8,-68,44,1,5,61,425
41,49,2,5,3,10,21,-45,2,0,82,380
41,50,4,3,6,7,42,34,4,4,124,414
41,51,3,3,4,9,31,-64,5,0,155,350
41,52,2,4,4,9,22,45,7,5,177,395
41,53,4,3,7,6,-57,33,0,8,120,428
41,54,5,2,6,7,51,-75,1,3,171,353
41,55,2,4,6,7,24,43,5,6,195,396
41,56,4,2,5,8,41,-74,6,2,236,322
41,57,2,4,7,6,-75,42,1,4,161,364
41,58,4,2,9,4,45,22,6,6,206,386
41,59,3,4,8,5,-65,41,1,7,141,427
41,60,4,3,7,6,43,-67,4,0,184,360
41,61,3,3,7,6,34,33,8,3,218,393
41,62,4,3,7,6,-57,33,1,6,161,426
41,63,5,2,9,4,54,22,5,8,215,448
41,64,4,2,8,5,44,-77,9,1,259,371
41,65,4,3,6,7,-58,34,1,5,201,405
41,66,4,2,8,5,44,23,5,8,245,428
41,67,3,4,5,8,32,-56,7,2,277,372
41,68,3,4,8,5,-65,41,2,3,212,413
41,69,2,4,8,5,26,41,8,4,238,454
41,70,4,3,8,5,-56,32,2,6,182,486
41,71,4,2,11,2,47,20,9,6,229,506
42,1,3,4,7,6,34,42,4,2,34,42
42,2,2,5,4,9,22,54,6,6,56,96
42,3,3,4,7,6,-66,42,0,8,-10,138
42,4,5,2,9,4,54,-78,4,0,44,60
42,5,3,4,9,4,-64,40,0,0,-20,100
42,6,3,4,7,6,34,42,4,2,14,142
42,7,3,4,3,10,30,46,4,8,44,188
42,8,2,5,3,10,21,-45,5,3,65,143
42,9,2,5,5,8,23,53,8,6,88,196
42,10,2,4,8,5,-74,41,4,7,14,237
42,11,4,3,7,6,43,-67,7,0,57,170
42,12,4,2,9,4,-55,22,2,2,2,192
42,13,2,5,3,10,21,55,3,7,23,247
42,14,3,4,6,7,33,-57,6,0,56,190
42,15,3,3,8,5,-65,32,1,2,-9,222
42,16,3,4,5,8,32,44,3,6,23,266
42,17,3,3,7,6,34,33,7,9,57,299
42,18,2,5,4,9,22,-46,9,3,79,253
42,19,3,5,3,10,30,55,9,8,109,308
42,20,3,4,4,9,-69,-55,0,3,40,253
42,21,4,2,10,3,46,21,6,4,86,274
42,22,3,5,5,8,32,53,8,7,118,327
42,23,3,3,7,6,-66,-67,2,0,52,260
42,24,3,4,7,6,34,42,6,2,86,302
42,25,3,4,5,8,32,44,8,6,118,346
42,26,2,5,6,7,-76,52,2,8,42,398
42,27,6,2,10,3,64,21,6,9,106,419
42,28,2,4,4,9,22,-55,8,4,128,364
42,29,3,3,8,5,-65,32,3,6,63,396
42,30,3,4,4,9,31,-55,4,1,94,341
42,31,3,3,7,6,34,33,8,4,128,374
42,32,3,3,6,7,-67,34,1,8,61,408
42,33,4,2,7,6,43,-76,4,2,104,332
42,34,4,2,10,3,-54,21,0,3,50,353
42,35,3,3,7,6,34,33,4,6,84,386
42,36,2,4,5,8,23,-56,7,0,107,330
42,37,5,2,10,3,-45,21,2,1,62,351
42,38,4,2,10,3,46,21,8,2,108,372
42,39,2,5,3,10,21,55,9,7,129,427
42,40,3,3,7,6,-66,-67,3,0,63,360
42,41,3,4,3,10,30,46,3,6,93,406
42,42,3,3,3,10,30,-63,3,3,123,343
42,43,4,3,7,6,43,33,6,6,166,376
42,44,4,3,9,4,-55,31,1,7,111,407
42,45,3,4,9,4,36,40,7,7,147,447
42,46,2,5,3,10,21,-45,8,2,168,402
42,47,5,2,10,3,-45,21,3,3,123,423
42,48,5,2,10,3,55,21,8,4,178,444
42,49,4,3,7,6,-57,33,1,7,121,477
42,50,6,2,9,4,63,22,4,9,184,499
42,51,5,2,11,2,-44,20,0,9,140,519
43,1,3,4,6,7,33,43,3,3,33,43
43,2,3,4,6,7,33,43,6,6,66,86
43,3,3,4,5,8,32,-56,8,0,98,30
43,4,4,3,8,5,-56,32,2,2,42,62
43,5,4,3,8,5,44,32,6,4,86,94
43,6,2,4,7,6,-75,42,1,6,11,136
43,7,2,4,5,8,23,-56,4,0,34,80
43,8,3,3,7,6,34,33,8,3,68,113
43,9,3,3,5,8,-68,35,0,8,0,148
43,10,4,3,7,6,43,-67,3,1,43,81
43,11,2,4,5,8,23,44,6,5,66,125
43,12,3,4,6,7,33,43,9,8,99,168
43,13,2,5,3,10,-79,-45,0,3,20,123
43,14,2,4,4,9,22,45,2,8,42,168
43,15,3,3,6,7,33,-66,5,2,75,102
43,16,2,4,6,7,24,43,9,5,99,145
43,17,3,4,4,9,-69,-55,0,0,30,90
43,18,3,3,5,8,32,35,2,5,62,125
43,19,4,2,9,4,45,22,7,7,107,147
43,20,2,5,3,10,21,-45,8,2,128,102
43,21,2,5,5,8,-77,53,1,5,51,155
43,22,3,3,4,9,31,-64,2,1,82,91
43,23,5,2,9,4,54,22,6,3,136,113
43,24,4,3,6,7,42,34,8,7,178,147
43,25,3,4,4,9,31,-55,9,2,209,92
43,26,4,3,8,5,-56,32,3,4,153,124
43,27,2,4,5,8,23,44,6,8,176,168
43,28,3,3,8,5,-65,-68,1,0,111,100
43,29,5,3,9,4,54,31,5,1,165,131
43,30,4,2,5,8,41,26,6,7,206,157
43,31,4,2,7,6,43,-76,9,1,249,81
43,32,6,2,8,5,-38,23,1,4,211,104
43,33,3,4,3,10,30,-54,1,0,241,50
43,34,3,3,6,7,33,34,4,4,274,84
43,35,4,3,9,4,45,31,9,5,319,115
43,36,2,4,6,7,-76,43,3,8,243,158
43,37,2,4,6,7,24,-57,7,1,267,101
43,38,3,3,5,8,32,35,9,6,299,136
43,39,4,3,6,7,-58,-66,1,0,241,70
43,40,3,3,8,5,35,32,6,2,276,102
43,41,5,3,9,4,-46,31,0,3,230,133
43,42,2,4,4,9,22,45,2,8,252,178
43,43,4,3,5,8,41,-65,3,3,293,113
43,44,2,5,7,6,25,51,8,4,318,164
43,45,5,2,7,6,-48,24,0,8,270,188
43,46,5,2,9,4,54,-78,4,0,324,110
43,47,3,3,8,5,35,32,9,2,359,142
43,48,5,2,8,5,-47,23,2,5,312,165
43,49,2,4,4,9,22,-55,4,0,334,110
43,50,5,2,7,6,52,24,6,4,386,134
43,51,3,4,4,9,31,45,7,9,417,179
43,52,5,2,9,4,-46,-78,1,1,371,101
43,53,4,3,6,7,42,34,3,5,413,135
43,54,2,4,8,5,26,41,9,6,439,176
43,55,2,5,3,10,-79,-45,0,1,360,131
43,56,2,5,3,10,21,55,1,6,381,186
43,57,4,2,11,2,47,20,8,6,428,206
43,58,4,3,6,7,-58,-66,0,0,370,140
43,59,4,3,4,9,40,36,0,6,410,176
43,60,4,3,9,4,45,31,5,7,455,207
43,61,5,2,7,6,52,-76,7,1,507,131
44,1,2,4,7,6,25,42,5,2,25,42
44,2,3,3,7,6,34,33,9,5,59,75
44,3,4,4,9,4,-55,40,4,5,4,115
44,4,3,3,6,7,33,34,7,9,37,149
44,5,3,3,3,10,30,-63,7,6,67,86
44,6,5,2,10,3,-45,21,2,7,22,107
44,7,3,4,3,10,30,-54,2,3,52,53
44,8,4,2,10,3,46,21,8,4,98,74
44,9,3,4,6,7,-67,43,1,7,31,117
44,10,3,3,4,9,31,-64,2,3,62,53
44,11,6,2,11,2,65,20,7,3,127,73
44,12,4,3,8,5,-56,32,1,5,71,105
44,13,2,6,3,10,21,64,2,9,92,169
44,14,4,3,5,8,41,-65,3,4,133,104
44,15,2,5,2,11,20,-44,3,0,153,60
44,16,3,4,5,8,32,44,5,4,185,104
44,17,4,3,8,5,44,32,9,6,229,136
44,18,5,2,8,5,-47,23,2,9,182,159
44,19,4,2,9,4,45,-78,7,1,227,81
44,20,4,3,7,6,-57,33,0,4,170,114
44,21,3,4,5,8,32,44,2,8,202,158
44,22,2,4,5,8,23,-56,5,2,225,102
44,23,4,2,8,5,44,23,9,5,269,125
44,24,4,3,7,6,-57,33,2,8,212,158
44,25,4,2,7,6,43,-76,5,2,255,82
44,26,3,3,8,5,-65,32,0,4,190,114
44,27,3,4,4,9,31,45,1,9,221,159
44,28,2,4,6,7,24,-57,5,2,245,102
44,29,4,3,7,6,43,33,8,5,288,135
44,30,5,2,9,4,-46,22,2,7,242,157
44,31,2,5,3,10,21,-45,3,2,263,112
44,32,3,3,7,6,34,33,7,5,297,145
44,33,3,3,4,9,31,-64,8,1,328,81
44,34,2,5,4,9,-78,54,0,5,250,135
44,35,2,4,4,9,22,-55,2,0,272,80
44,36,5,2,11,2,56,20,8,0,328,100
44,37,3,3,4,9,31,36,9,6,359,136
44,38,5,2,9,4,-46,22,3,8,313,158
44,39,3,4,3,10,30,-54,3,4,343,104
44,40,4,2,8,5,44,23,7,7,387,127
44,41,3,3,8,5,-65,32,2,9,322,159
44,42,3,3,6,7,33,-66,5,3,355,93
44,43,5,3,8,5,53,32,8,5,408,125
44,44,3,3,9,4,-64,31,4,6,344,156
44,45,4,2,8,5,44,23,8,9,388,179
44,46,2,4,4,9,-78,-55,0,4,310,124
44,47,3,3,7,6,34,33,4,7,344,157
44,48,4,3,9,4,45,31,9,8,389,188
44,49,3,3,7,6,-66,-67,3,1,323,121
44,50,3,3,7,6,34,33,7,4,357,154
44,51,2,4,5,8,-77,44,0,8,280,198
44,52,4,2,9,4,45,-78,5,0,325,120
44,53,3,4,8,5,-65,41,0,1,260,161
44,54,5,2,6,7,51,25,1,6,311,186
44,55,2,5,3,10,21,-45,2,1,332,141
44,56,2,4,4,9,22,45,4,6,354,186
44,57,3,3,9,4,-64,31,0,7,290,217
44,58,3,4,4,9,31,-55,1,2,321,162
44,59,2,5,7,6,25,51,6,3,346,213
44,60,2,5,6,7,-76,52,0,5,270,265
44,61,4,2,6,7,42,-75,2,0,312,190
44,62,3,3,6,7,33,34,5,4,345,224
44,63,2,4,3,10,21,-54,6,0,366,170
44,64,5,2,10,3,-45,21,1,1,321,191
44,65,4,3,6,7,42,34,3,5,363,225
44,66,6,2,10,3,64,21,7,6,427,246
44,67,4,3,10,3,-54,30,3,6,373,276
44,68,3,4,7,6,34,42,7,8,407,318
44,69,3,4,6,7,-67,-57,0,1,340,261
44,70,3,3,4,9,31,36,1,7,371,297
44,71,2,4,5,8,23,-56,4,1,394,241
44,72,3,4,5,8,32,44,6,5,426,285
44,73,5,2,8,5,53,23,9,8,479,308
44,74,3,3,9,4,-64,31,5,9,415,339
44,75,5,2,10,3,-45,-79,0,0,370,260
44,76,2,4,4,9,22,45,2,5,392,305
44,77,4,3,5,8,41,-65,3,0,433,240
44,78,3,4,4,9,31,45,4,5,464,285
44,79,4,3,7,6,43,33,7,8,507,318
45,1,3,3,6,7,33,34,3,4,33,34
45,2,3,3,5,8,32,35,5,9,65,69
45,3,3,4,6,7,33,-57,8,2,98,12
45,4,4,2,6,7,-58,25,0,7,40,37
45,5,2,4,7,6,25,42,5,9,65,79
45,6,3,4,6,7,33,-57,8,2,98,22
45,7,2,4,4,9,-78,45,0,7,20,67
45,8,3,3,8,5,35,32,5,9,55,99
45,9,2,5,3,10,21,-45,6,4,76,54
45,10,3,4,7,6,-66,42,0,6,10,96
45,11,3,3,8,5,35,32,5,8,45,128
45,12,3,4,7,6,34,-58,9,0,79,70
45,13,5,2,11,2,-44,20,5,0,35,90
45,14,5,2,6,7,51,25,6,5,86,115
45,15,2,4,5,8,23,44,9,9,109,159
45,16,4,4,5,8,-59,-56,0,3,50,103
45,17,4,2,10,3,46,21,6,4,96,124
45,18,3,3,8,5,-65,32,1,6,31,156
45,19,3,3,6,7,33,-66,4,0,64,90
45,20,5,2,8,5,53,23,7,3,117,113
45,21,3,3,6,7,-67,34,0,7,50,147
45,22,2,5,3,10,21,-45,1,2,71,102
45,23,3,3,7,6,34,33,5,5,105,135
45,24,3,3,4,9,31,-64,6,1,136,71
45,25,2,5,3,10,21,55,7,6,157,126
45,26,3,3,8,5,-65,32,2,8,92,158
45,27,4,3,7,6,43,-67,5,1,135,91
45,28,3,3,7,6,34,33,9,4,169,124
45,29,5,3,8,5,-47,32,2,6,122,156
45,30,3,4,7,6,34,42,6,8,156,198
45,31,4,3,6,7,42,-66,8,2,198,132
45,32,3,4,4,9,31,45,9,7,229,177
45,33,2,4,6,7,-76,-57,3,0,153,120
45,34,2,4,7,6,25,42,8,2,178,162
45,35,4,3,9,4,-55,31,3,3,123,193
45,36,4,3,9,4,45,31,8,4,168,224
45,37,4,2,10,3,-54,21,4,5,114,245
45,38,2,4,7,6,25,42,9,7,139,287
45,39,4,3,8,5,-56,32,3,9,83,319
45,40,4,3,6,7,42,-66,5,3,125,253
45,41,2,5,3,10,21,55,6,8,146,308
45,42,3,3,7,6,-66,-67,0,1,80,241
45,43,5,2,10,3,55,21,5,2,135,262
45,44,4,3,6,7,42,34,7,6,177,296
45,45,3,5,5,8,32,53,9,9,209,349
45,46,4,3,7,6,-57,-67,2,2,152,282
45,47,4,2,5,8,41,26,3,8,193,308
45,48,4,3,6,7,42,-66,5,2,235,242
45,49,3,4,6,7,33,43,8,5,268,285
45,50,2,5,3,10,21,-45,9,0,289,240
45,51,2,4,4,9,-78,45,1,5,211,285
45,52,5,2,10,3,55,21,6,6,266,306
45,53,3,4,6,7,33,43,9,9,299,349
45,54,2,4,7,6,-75,-58,4,1,224,291
45,55,4,3,6,7,42,34,6,5,266,325
45,56,2,4,3,10,21,-54,7,1,287,271
45,57,3,4,8,5,-65,41,2,2,222,312
45,58,4,2,8,5,44,23,6,5,266,335
45,59,3,4,3,10,30,-54,6,1,296,281
45,60,2,5,5,8,23,53,9,4,319,334
45,61,2,4,6,7,-76,43,3,7,243,377
45,62,2,4,5,8,23,-56,6,1,266,321
45,63,3,3,9,4,-64,31,2,2,202,352
45,64,4,3,8,5,44,32,6,4,246,384
45,65,3,3,6,7,33,34,9,8,279,418
45,66,5,2,11,2,-44,20,5,8,235,438
45,67,3,4,8,5,-65,41,0,9,170,479
45,68,6,2,9,4,63,-78,3,1,233,401
45,69,4,3,9,4,45,31,8,2,278,432
45,70,2,5,5,8,-77,53,1,5,201,485
45,71,3,4,6,7,33,43,4,8,234,528
46,1,3,4,5,8,32,44,2,4,32,44
46,2,4,3,9,4,45,31,7,5,77,75
46,3,4,2,8,5,-56,23,1,8,21,98
46,4,4,3,8,5,44,-68,5,0,65,30
46,5,4,3,6,7,42,34,7,4,107,64
46,6,4,3,7,6,-57,33,0,7,50,97
46,7,3,5,5,8,32,-47,2,0,82,50
46,8,4,3,9,4,45,31,7,1,127,81
46,9,5,2,10,3,-45,21,2,2,82,102
46,10,4,2,8,5,44,23,6,5,126,125
46,11,4,3,6,7,42,34,8,9,168,159
46,12,4,3,6,7,-58,-66,0,3,110,93
46,13,5,2,10,3,55,21,5,4,165,114
46,14,2,5,5,8,23,53,8,7,188,167
46,15,3,4,5,8,-68,-56,0,1,120,111
46,16,4,2,7,6,43,24,3,5,163,135
46,17,3,3,6,7,33,34,6,9,196,169
46,18,3,4,7,6,-66,-58,0,1,130,111
46,19,2,4,4,9,22,45,2,6,152,156
46,20,4,2,7,6,43,-76,5,0,195,80
46,21,3,3,8,5,-65,32,0,2,130,112
46,22,3,3,6,7,33,34,3,6,163,146
46,23,3,4,5,8,32,-56,5,0,195,90
46,24,6,2,10,3,64,21,9,1,259,111
46,25,3,3,7,6,-66,33,3,4,193,144
46,26,3,3,5,8,32,35,5,9,225,179
46,27,4,2,7,6,43,-76,8,3,268,103
46,28,3,3,6,7,-67,34,1,7,201,137
46,29,3,3,5,8,32,-65,3,2,233,72
46,30,3,4,4,9,31,45,4,7,264,117
46,31,2,5,3,10,21,-45,5,2,285,72
46,32,4,3,6,7,42,34,7,6,327,106
46,33,4,2,8,5,-56,23,1,9,271,129
46,34,3,3,5,8,32,-65,3,4,303,64
46,35,3,3,8,5,35,32,8,6,338,96
46,36,3,3,5,8,-68,-65,0,1,270,31
46,37,2,5,6,7,24,52,4,3,294,83
46,38,2,4,4,9,22,45,6,8,316,128
46,39,4,2,7,6,43,-76,9,2,359,52
46,40,3,5,4,9,-69,54,0,6,290,106
46,41,5,2,8,5,53,23,3,9,343,129
46,42,4,2,8,5,44,-77,7,2,387,52
46,43,2,4,4,9,22,45,9,7,409,97
46,44,5,2,7,6,-48,-76,1,1,361,21
46,45,4,3,6,7,42,34,3,5,403,55
46,46,2,4,3,10,21,-54,4,1,424,1
46,47,2,5,3,10,21,55,5,6,445,56
46,48,2,5,6,7,24,52,9,8,469,108
46,49,4,3,9,4,-55,31,4,9,414,139
46,50,3,4,5,8,32,-56,6,3,446,83
46,51,4,2,4,9,40,-73,6,0,486,10
46,52,4,2,7,6,43,24,9,4,529,34
47,1,3,3,5,8,32,35,2,5,32,35
47,2,3,3,4,9,31,-64,3,1,63,-29
47,3,3,4,9,4,36,40,9,1,99,11
47,4,3,3,6,7,-67,34,2,5,32,45
47,5,2,4,3,10,21,-54,3,1,53,-9
47,6,2,5,3,10,21,55,4,6,74,46
47,7,5,2,7,6,52,-76,6,0,126,-30
47,8,3,4,8,5,-65,41,1,1,61,11
47,9,5,2,10,3,55,21,6,2,116,32
47,10,5,2,10,3,-45,21,1,3,71,53
47,11,4,2,9,4,45,22,6,5,116,75
47,12,4,4,8,5,-56,41,0,6,60,116
47,13,3,3,6,7,33,-66,3,0,93,50
47,14,4,3,8,5,44,32,7,2,137,82
47,15,2,7,3,10,21,73,8,5,158,155
47,16,5,2,9,4,-46,22,2,7,112,177
47,17,2,5,6,7,24,52,6,9,136,229
47,18,4,2,11,2,-53,20,3,9,83,249
47,19,3,4,6,7,33,-57,6,2,116,192
47,20,3,3,7,6,-66,33,0,5,50,225
47,21,3,4,4,9,31,-55,1,0,81,170
47,22,2,4,5,8,23,44,4,4,104,214
47,23,2,4,5,8,23,44,7,8,127,258
47,24,4,2,7,6,-57,-76,0,2,70,182
47,25,3,4,4,9,31,45,1,7,101,227
47,26,5,3,8,5,53,32,4,9,154,259
47,27,3,3,7,6,34,-67,8,2,188,192
47,28,2,4,6,7,-76,43,2,5,112,235
47,29,2,5,3,10,21,-45,3,0,133,190
47,30,3,3,6,7,33,34,6,4,166,224
47,31,2,5,2,11,20,-44,6,0,186,180
47,32,4,4,7,6,43,42,9,2,229,222
47,33,3,3,8,5,-65,32,4,4,164,254
47,34,3,3,3,10,30,-63,4,1,194,191
47,35,3,3,7,6,34,33,8,4,228,224
47,36,2,4,6,7,-76,43,2,7,152,267
47,37,2,5,4,9,22,-46,4,1,174,221
47,38,4,2,8,5,44,23,8,4,218,244
47,39,3,3,6,7,-67,34,1,8,151,278
47,40,5,2,7,6,52,-76,3,2,203,202
47,41,2,5,4,9,22,54,5,6,225,256
47,42,4,2,7,6,43,-76,8,0,268,180
47,43,3,3,5,8,-68,35,0,5,200,215
47,44,4,2,10,3,46,21,6,6,246,236
47,45,3,3,8,5,-65,32,1,8,181,268
47,46,3,4,4,9,31,-55,2,3,212,213
47,47,5,2,7,6,52,24,4,7,264,237
47,48,3,3,9,4,-64,31,0,8,200,268
47,49,4,2,6,7,42,-75,2,3,242,193
47,50,4,2,7,6,43,24,5,7,285,217
47,51,6,2,10,3,64,21,9,8,349,238
47,52,4,3,6,7,-58,-66,1,2,291,172
47,53,4,2,10,3,46,21,7,3,337,193
47,54,5,2,9,4,-46,22,1,5,291,215
47,55,4,3,6,7,42,34,3,9,333,249
47,56,4,2,10,3,46,-79,9,0,379,170
47,57,4,3,5,8,-59,35,0,5,320,205
47,58,2,6,3,10,21,64,1,9,341,269
47,59,4,3,9,4,45,-69,6,0,386,200
47,60,3,3,6,7,33,34,9,4,419,234
47,61,3,3,7,6,-66,33,3,7,353,267
47,62,4,2,9,4,45,22,8,9,398,289
47,63,3,3,5,8,-68,-65,0,4,330,224
47,64,5,2,8,5,53,23,3,7,383,247
47,65,2,5,3,10,21,-45,4,2,404,202
47,66,3,3,7,6,34,33,8,5,438,235
47,67,2,5,3,10,21,-45,9,0,459,190
47,68,4,3,8,5,-56,32,3,2,403,222
47,69,6,2,10,3,64,21,7,3,467,243
47,70,2,4,6,7,-76,43,1,6,391,286
47,71,3,4,8,5,35,41,6,7,426,327
47,72,4,2,9,4,-55,22,1,9,371,349
47,73,5,2,10,3,55,-79,6,0,426,270
47,74,4,3,7,6,43,33,9,3,469,303
47,75,4,2,5,8,-59,26,0,9,410,329
47,76,2,5,3,10,21,-45,1,4,431,284
47,77,5,2,9,4,54,22,5,6,485,306
47,78,2,4,5,8,23,-56,8,0,508,250
48,1,4,2,7,6,43,24,3,4,43,24
48,2,4,2,9,4,45,22,8,6,88,46
48,3,2,5,8,5,-74,50,4,6,14,96
48,4,4,2,7,6,43,-76,7,0,57,20
48,5,3,3,7,6,-66,33,1,3,-9,53
48,6,2,4,4,9,22,45,3,8,13,98
48,7,4,2,8,5,44,-77,7,1,57,21
48,8,5,2,9,4,-46,22,1,3,11,43
48,9,4,3,7,6,43,33,4,6,54,76
48,10,2,4,4,9,22,-55,6,1,76,21
48,11,3,4,5,8,32,44,8,5,108,65
48,12,5,2,8,5,-47,23,1,8,61,88
48,13,4,2,10,3,46,21,7,9,107,109
48,14,3,4,5,8,32,-56,9,3,139,53
48,15,3,4,6,7,-67,43,2,6,72,96
48,16,4,4,6,7,42,43,4,9,114,139
48,17,2,4,5,8,23,-56,7,3,137,83
48,18,3,3,6,7,-67,34,0,7,70,117
48,19,2,4,4,9,22,-55,2,2,92,62
48,20,2,4,6,7,24,43,6,5,116,105
48,21,4,3,7,6,43,33,9,8,159,138
48,22,3,3,7,6,-66,-67,3,1,93,71
48,23,2,4,6,7,24,43,7,4,117,114
48,24,4,2,9,4,-55,22,2,6,62,136
48,25,2,4,2,11,20,-53,2,3,82,83
48,26,4,3,11,2,47,-30,9,3,129,53
48,27,3,4,5,8,-68,44,1,7,61,97
48,28,5,2,10,3,55,21,6,8,116,118
48,29,4,3,8,5,-56,-68,0,0,60,50
48,30,4,2,9,4,45,22,5,2,105,72
48,31,4,3,6,7,42,34,7,6,147,106
48,32,4,3,8,5,-56,32,1,8,91,138
48,33,2,4,3,10,21,-54,2,4,112,84
48,34,4,2,6,7,42,25,4,9,154,109
48,35,3,3,5,8,32,-65,6,4,186,44
48,36,5,2,9,4,-46,22,0,6,140,66
48,37,3,4,5,8,32,-56,2,0,172,10
48,38,3,4,5,8,32,44,4,4,204,54
48,39,3,5,4,9,31,54,5,8,235,108
48,40,4,3,8,5,44,-68,9,0,279,40
48,41,3,3,5,8,-68,35,1,5,211,75
48,42,2,6,4,9,22,63,3,8,233,138
48,43,3,4,4,9,31,-55,4,3,264,83
48,44,4,4,8,5,44,41,8,4,308,124
48,45,4,2,7,6,-57,24,1,8,251,148
48,46,3,3,6,7,33,-66,4,2,284,82
48,47,2,5,4,9,22,54,6,6,306,136
48,48,3,4,7,6,-66,42,0,8,240,178
48,49,2,4,4,9,22,-55,2,3,262,123
48,50,3,3,8,5,35,32,7,5,297,155
48,51,2,6,5,8,-77,62,0,7,220,217
48,52,2,5,5,8,23,-47,3,0,243,170
48,53,3,3,6,7,33,34,6,4,276,204
48,54,4,3,10,3,-54,30,2,4,222,234
48,55,3,4,6,7,33,43,5,7,255,277
48,56,5,2,6,7,51,-75,6,2,306,202
48,57,5,2,9,4,-46,22,0,4,260,224
48,58,3,4,5,8,32,44,2,8,292,268
48,59,3,4,4,9,31,-55,3,3,323,213
48,60,4,4,7,6,43,42,6,5,366,255
48,61,4,3,8,5,-56,32,0,7,310,287
48,62,3,3,8,5,35,32,5,9,345,319
48,63,3,3,7,6,34,-67,9,2,379,252
48,64,4,3,9,4,-55,31,4,3,324,283
48,65,2,5,4,9,22,54,6,7,346,337
48,66,2,5,6,7,-76,52,0,9,270,389
48,67,3,3,5,8,32,-65,2,4,302,324
48,68,3,3,8,5,35,32,7,6,337,356
48,69,2,4,8,5,-74,41,3,7,263,397
48,70,5,3,10,3,55,30,8,7,318,427
48,71,3,4,5,8,-68,-56,0,1,250,371
48,72,3,3,6,7,33,34,3,5,283,405
48,73,3,4,6,7,33,43,6,8,316,448
48,74,5,2,11,2,-44,20,2,8,272,468
48,75,3,3,6,7,33,-66,5,2,305,402
48,76,2,4,4,9,22,45,7,7,327,447
48,77,3,4,5,8,32,-56,9,1,359,391
48,78,3,3,7,6,-66,33,3,4,293,424
48,79,2,4,2,11,20,-53,3,1,313,371
48,80,4,3,6,7,42,34,5,5,355,405
48,81,3,4,7,6,34,42,9,7,389,447
48,82,3,4,5,8,-68,-56,1,1,321,391
48,83,3,4,4,9,31,45,2,6,352,436
48,84,3,3,5,8,32,-65,4,1,384,371
48,85,5,2,11,2,-44,20,0,1,340,391
48,86,4,3,8,5,44,32,4,3,384,423
48,87,3,3,5,8,32,35,6,8,416,458
48,88,4,3,9,4,-55,31,1,9,361,489
48,89,3,3,8,5,35,-68,6,1,396,421
48,90,4,2,8,5,-56,23,0,4,340,444
48,91,3,4,6,7,33,43,3,7,373,487
48,92,4,2,4,9,40,-73,3,4,413,414
48,93,3,4,6,7,33,43,6,7,446,457
48,94,2,5,4,9,22,-46,8,1,468,411
48,95,4,2,7,6,-57,24,1,5,411,435
48,96,3,4,5,8,32,44,3,9,443,479
48,97,2,4,7,6,25,-58,8,1,468,421
48,98,2,4,4,9,-78,45,0,6,390,466
48,99,2,4,7,6,25,42,5,8,415,508
49,1,2,5,3,10,21,55,1,5,21,55
49,2,3,4,4,9,31,-55,2,0,52,0
49,3,2,5,2,11,20,56,2,6,72,56
49,4,2,5,3,10,21,-45,3,1,93,11
49,5,2,6,3,10,21,64,4,5,114,75
49,6,2,4,6,7,24,43,8,8,138,118
49,7,3,3,9,4,-64,31,4,9,74,149
49,8,5,2,8,5,53,-77,7,2,127,72
49,9,4,3,9,4,-55,31,2,3,72,103
49,10,3,3,4,9,31,36,3,9,103,139
49,11,4,3,7,6,43,-67,6,2,146,72
49,12,5,2,7,6,52,24,8,6,198,96
49,13,4,3,7,6,-57,33,1,9,141,129
49,14,3,3,7,6,34,-67,5,2,175,62
49,15,5,2,10,3,-45,21,0,3,130,83
49,16,4,3,6,7,42,34,2,7,172,117
49,17,5,2,9,4,54,22,6,9,226,139
49,18,4,3,8,5,-56,-68,0,1,170,71
49,19,2,4,8,5,26,41,6,2,196,112
49,20,2,4,4,9,22,45,8,7,218,157
49,21,5,3,8,5,-47,32,1,9,171,189
49,22,2,4,6,7,24,-57,5,2,195,132
49,23,3,3,9,4,-64,31,1,3,131,163
49,24,3,3,7,6,34,33,5,6,165,196
49,25,2,4,6,7,24,43,9,9,189,239
49,26,3,3,9,4,-64,-69,5,0,125,170
49,27,5,2,6,7,51,25,6,5,176,195
49,28,4,2,11,2,-53,20,3,5,123,215
49,29,2,4,7,6,25,42,8,7,148,257
49,30,3,4,3,10,30,-54,8,3,178,203
49,31,3,3,6,7,-67,34,1,7,111,237
49,32,3,3,8,5,35,32,6,9,146,269
49,33,5,2,9,4,-46,-78,0,1,100,191
49,34,2,4,3,10,21,46,1,7,121,237
49,35,3,3,4,9,31,-64,2,3,152,173
49,36,3,4,3,10,30,46,2,9,182,219
49,37,3,4,5,8,32,-56,4,3,214,163
49,38,3,3,5,8,32,35,6,8,246,198
49,39,2,5,3,10,21,-45,7,3,267,153
49,40,3,4,5,8,32,44,9,7,299,197
49,41,3,4,5,8,-68,-56,1,1,231,141
49,42,3,5,4,9,31,54,2,5,262,195
49,43,4,2,8,5,44,23,6,8,306,218
49,44,2,6,4,9,22,-37,8,1,328,181
49,45,3,3,7,6,-66,33,2,4,262,214
49,46,2,5,7,6,25,51,7,5,287,265
49,47,3,3,7,6,-66,33,1,8,221,298
49,48,3,3,3,10,30,-63,1,5,251,235
49,49,4,3,7,6,43,33,4,8,294,268
49,50,4,3,8,5,44,-68,8,0,338,200
49,51,4,3,6,7,-58,34,0,4,280,234
49,52,2,5,6,7,24,52,4,6,304,286
49,53,4,3,6,7,42,-66,6,0,346,220
49,54,3,4,5,8,32,44,8,4,378,264
49,55,3,3,8,5,-65,32,3,6,313,296
49,56,5,2,7,6,52,-76,5,0,365,220
49,57,2,4,7,6,-75,42,0,2,290,262
49,58,5,2,8,5,53,23,3,5,343,285
49,59,3,3,6,7,33,34,6,9,376,319
49,60,3,3,4,9,31,-64,7,5,407,255
49,61,3,3,6,7,-67,34,0,9,340,289
49,62,3,3,8,5,35,-68,5,1,375,221
49,63,2,4,7,6,-75,42,0,3,300,263
49,64,3,3,4,9,31,36,1,9,331,299
49,65,2,4,5,8,23,-56,4,3,354,243
49,66,4,3,6,7,42,34,6,7,396,277
49,67,3,3,5,8,32,-65,8,2,428,212
49,68,4,2,8,5,-56,23,2,5,372,235
49,69,3,4,5,8,32,44,4,9,404,279
49,70,3,3,7,6,34,-67,8,2,438,212
49,71,3,3,8,5,-65,32,3,4,373,244
49,72,3,3,7,6,34,33,7,7,407,277
49,73,3,3,8,5,-65,32,2,9,342,309
49,74,4,2,9,4,45,-78,7,1,387,231
49,75,4,2,9,4,-55,22,2,3,332,253
49,76,3,4,6,7,33,43,5,6,365,296
49,77,3,3,4,9,31,-64,6,2,396,232
49,78,2,4,7,6,-75,42,1,4,321,274
49,79,6,2,9,4,63,22,4,6,384,296
49,80,3,4,5,8,32,-56,6,0,416,240
49,81,5,2,10,3,-45,21,1,1,371,261
49,82,2,5,4,9,22,54,3,5,393,315
49,83,4,2,9,4,45,22,8,7,438,337
49,84,2,4,6,7,-76,-57,2,0,362,280
49,85,3,4,8,5,35,41,7,1,397,321
49,86,5,2,9,4,-46,22,1,3,351,343
49,87,3,3,7,6,34,33,5,6,385,376
49,88,4,3,7,6,43,33,8,9,428,409
49,89,3,3,7,6,-66,-67,2,2,362,342
49,90,3,4,5,8,32,44,4,6,394,386
49,91,5,2,8,5,53,23,7,9,447,409
49,92,4,2,9,4,-55,-78,2,1,392,331
49,93,2,4,6,7,24,43,6,4,416,374
49,94,4,3,8,5,-56,32,0,6,360,406
49,95,2,5,6,7,24,52,4,8,384,458
49,96,2,5,4,9,22,-46,6,2,406,412
49,97,4,4,7,6,43,42,9,4,449,454
49,98,2,5,4,9,-78,54,1,8,371,508
50,1,4,3,5,8,41,35,1,5,41,35
50,2,5,2,9,4,54,22,5,7,95,57
50,3,3,3,5,8,32,-65,7,2,127,-8
50,4,3,3,7,6,-66,33,1,5,61,25
50,5,2,5,3,10,21,-45,2,0,82,-20
50,6,3,3,7,6,34,33,6,3,116,13
50,7,3,4,5,8,32,44,8,7,148,57
50,8,3,4,8,5,-65,41,3,8,83,98
50,9,4,3,8,5,44,-68,7,0,127,30
50,10,2,4,4,9,22,45,9,5,149,75
50,11,5,2,9,4,-46,22,3,7,103,97
50,12,4,4,7,6,43,42,6,9,146,139
50,13,3,3,6,7,33,-66,9,3,179,73
50,14,4,3,8,5,-56,32,3,5,123,105
50,15,3,3,5,8,32,-65,5,0,155,40
50,16,3,4,6,7,33,43,8,3,188,83
50,17,3,3,6,7,-67,34,1,7,121,117
50,18,3,3,6,7,33,-66,4,1,154,51
50,19,4,2,11,2,-53,20,1,1,101,71
50,20,2,4,6,7,24,43,5,4,125,114
50,21,3,4,7,6,34,42,9,6,159,156
50,22,6,2,7,6,-39,-76,0,0,120,80
50,23,3,4,6,7,33,43,3,3,153,123
50,24,4,2,5,8,41,26,4,9,194,149
50,25,2,5,3,10,21,-45,5,4,215,104
50,26,6,2,10,3,64,21,9,5,279,125
50,27,2,4,5,8,-77,44,2,9,202,169
50,28,3,4,5,8,32,-56,4,3,234,113
50,29,3,3,6,7,33,34,7,7,267,147
50,30,2,6,4,9,22,-37,9,0,289,110
50,31,4,2,8,5,-56,23,3,3,233,133
50,32,3,3,6,7,33,34,6,7,266,167
50,33,4,3,7,6,43,-67,9,0,309,100
50,34,2,5,4,9,-78,54,1,4,231,154
50,35,3,3,7,6,34,33,5,7,265,187
50,36,3,3,6,7,33,-66,8,1,298,121
50,37,4,3,7,6,-57,33,1,4,241,154
50,38,4,3,8,5,44,32,5,6,285,186
50,39,3,5,5,8,32,53,7,9,317,239
50,40,5,2,8,5,-47,-77,0,2,270,162
50,41,4,3,7,6,43,33,3,5,313,195
50,42,3,3,5,8,32,-65,5,0,345,130
50,43,2,5,4,9,22,54,7,4,367,184
50,44,2,5,5,8,-77,53,0,7,290,237
50,45,2,5,5,8,23,-47,3,0,313,190
50,46,2,5,4,9,22,54,5,4,335,244
50,47,5,2,7,6,52,24,7,8,387,268
50,48,4,3,6,7,42,-66,9,2,429,202
50,49,4,2,7,6,-57,24,2,6,372,226
50,50,4,3,8,5,44,32,6,8,416,258
50,51,5,2,10,3,-45,21,1,9,371,279
50,52,2,4,2,11,20,-53,1,6,391,226
50,53,4,2,6,7,42,-75,3,1,433,151
50,54,4,3,10,3,46,30,9,1,479,181
50,55,3,4,4,9,-69,45,0,6,410,226
50,56,3,4,4,9,31,-55,1,1,441,171
50,57,4,3,8,5,44,32,5,3,485,203
50,58,4,4,8,5,44,41,9,4,529,244
51,1,2,4,3,10,21,46,1,6,21,46
51,2,2,5,6,7,24,52,5,8,45,98
51,3,4,4,8,5,44,41,9,9,89,139
51,4,3,3,6,7,-67,-66,2,3,22,73
51,5,2,5,4,9,22,54,4,7,44,127
51,6,4,2,10,3,-54,21,0,8,-10,148
51,7,3,4,5,8,32,-56,2,2,22,92
51,8,2,5,3,10,21,55,3,7,43,147
51,9,4,3,7,6,43,-67,6,0,86,80
51,10,3,4,6,7,33,43,9,3,119,123
51,11,3,3,5,8,-68,35,1,8,51,158
51,12,2,5,6,7,24,-48,5,0,75,110
51,13,4,3,9,4,-55,31,0,1,20,141
51,14,4,3,5,8,41,35,1,6,61,176
51,15,4,2,5,8,41,-74,2,2,102,102
51,16,4,4,7,6,43,42,5,4,145,144
51,17,2,5,4,9,22,54,7,8,167,198
51,18,4,3,8,5,-56,-68,1,0,111,130
51,19,4,2,9,4,45,22,6,2,156,152
51,20,4,3,6,7,42,34,8,6,198,186
51,21,3,3,6,7,-67,-66,1,0,131,120
51,22,3,3,5,8,32,35,3,5,163,155
51,23,4,3,6,7,42,34,5,9,205,189
51,24,4,3,8,5,44,-68,9,1,249,121
51,25,4,3,9,4,-55,31,4,2,194,152
51,26,4,3,5,8,41,35,5,7,235,187
51,27,2,5,4,9,22,-46,7,1,257,141
51,28,3,4,7,6,-66,42,1,3,191,183
51,29,2,4,5,8,23,44,4,7,214,227
51,30,3,3,8,5,35,32,9,9,249,259
51,31,2,5,4,9,-78,-46,1,3,171,213
51,32,2,5,6,7,24,52,5,5,195,265
51,33,4,2,7,6,43,24,8,9,238,289
51,34,4,3,8,5,-56,-68,2,1,182,221
51,35,2,4,3,10,21,46,3,7,203,267
51,36,4,2,6,7,42,-75,5,2,245,192
51,37,3,3,5,8,32,35,7,7,277,227
51,38,2,4,3,10,21,-54,8,3,298,173
51,39,3,3,7,6,-66,33,2,6,232,206
51,40,2,5,3,10,21,-45,3,1,253,161
51,41,2,4,4,9,22,45,5,6,275,206
51,42,3,4,7,6,34,42,9,8,309,248
51,43,3,3,8,5,-65,-68,4,0,244,180
51,44,4,2,8,5,44,23,8,3,288,203
51,45,4,3,7,6,-57,33,1,6,231,236
51,46,3,3,6,7,33,-66,4,0,264,170
51,47,3,3,5,8,32,35,6,5,296,205
51,48,3,4,7,6,-66,42,0,7,230,247
51,49,6,2,9,4,63,22,3,9,293,269
51,50,5,2,9,4,54,-78,7,1,347,191
51,51,2,4,8,5,-74,41,3,2,273,232
51,52,5,2,8,5,53,23,6,5,326,255
51,53,2,4,4,9,22,-55,8,0,348,200
51,54,3,4,6,7,-67,43,1,3,281,243
51,55,3,4,3,10,30,46,1,9,311,289
51,56,4,2,6,7,42,-75,3,4,353,214
51,57,2,5,2,11,20,-44,3,0,373,170
51,58,4,2,8,5,44,23,7,3,417,193
51,59,4,2,8,5,-56,23,1,6,361,216
51,60,4,3,5,8,41,-65,2,1,402,151
51,61,3,3,8,5,35,32,7,3,437,183
51,62,3,3,7,6,-66,33,1,6,371,216
51,63,3,3,6,7,33,-66,4,0,404,150
51,64,4,2,9,4,45,22,9,2,449,172
51,65,3,3,7,6,-66,33,3,5,383,205
51,66,4,2,8,5,44,23,7,8,427,228
51,67,4,3,6,7,42,-66,9,2,469,162
51,68,3,4,5,8,-68,44,1,6,401,206
51,69,2,5,3,10,21,-45,2,1,422,161
51,70,3,4,8,5,35,41,7,2,457,202
51,71,5,2,9,4,-46,22,1,4,411,224
51,72,2,4,4,9,22,45,3,9,433,269
51,73,2,4,5,8,23,-56,6,3,456,213
51,74,2,5,3,10,21,55,7,8,477,268
51,75,3,4,3,10,30,-54,7,4,507,214
52,1,2,5,4,9,22,54,2,4,22,54
52,2,4,2,6,7,42,25,4,9,64,79
52,3,3,3,9,4,-64,-69,0,0,0,10
52,4,2,5,6,7,24,52,4,2,24,62
52,5,3,4,6,7,33,43,7,5,57,105
52,6,2,4,5,8,-77,44,0,9,-20,149
52,7,4,2,7,6,43,-76,3,3,23,73
52,8,3,3,9,4,36,31,9,4,59,104
52,9,2,4,8,5,-74,41,5,5,-15,145
52,10,4,2,9,4,-55,22,0,7,-70,167
52,11,4,2,10,3,46,21,6,8,-24,188
52,12,6,2,9,4,63,-78,9,0,39,110
52,13,4,2,9,4,-55,22,4,2,-16,132
52,14,3,3,7,6,34,33,8,5,18,165
52,15,4,2,8,5,-56,23,2,8,-38,188
52,16,3,3,6,7,33,-66,5,2,-5,122
52,17,5,2,8,5,53,23,8,5,48,145
52,18,6,2,11,2,-35,20,3,5,13,165
52,19,3,3,4,9,31,-64,4,1,44,101
52,20,3,4,8,5,35,41,9,2,79,142
52,21,3,3,8,5,-65,32,4,4,14,174
52,22,3,3,7,6,34,33,8,7,48,207
52,23,3,3,7,6,-66,-67,2,0,-18,140
52,24,3,4,3,10,30,46,2,6,12,186
52,25,4,2,9,4,45,22,7,8,57,208
52,26,2,6,3,10,21,-36,8,2,78,172
52,27,3,3,7,6,-66,33,2,5,12,205
52,28,3,4,6,7,33,43,5,8,45,248
52,29,5,2,9,4,54,-78,9,0,99,170
52,30,3,3,6,7,-67,34,2,4,32,204
52,31,4,3,9,4,45,31,7,5,77,235
52,32,3,3,9,4,-64,31,3,6,13,266
52,33,5,2,9,4,54,22,7,8,67,288
52,34,3,3,9,4,-64,31,3,9,3,319
52,35,4,2,6,7,42,-75,5,4,45,244
52,36,2,4,5,8,23,44,8,8,68,288
52,37,4,3,8,5,-56,-68,2,0,12,220
52,38,3,4,8,5,35,41,7,1,47,261
52,39,5,2,8,5,-47,23,0,4,0,284
52,40,4,4,5,8,41,44,1,8,41,328
52,41,2,4,6,7,24,-57,5,1,65,271
52,42,2,4,6,7,24,43,9,4,89,314
52,43,3,3,6,7,-67,34,2,8,22,348
52,44,3,3,7,6,34,-67,6,1,56,281
52,45,4,2,9,4,-55,22,1,3,1,303
52,46,3,4,7,6,34,42,5,5,35,345
52,47,3,4,6,7,33,43,8,8,68,388
52,48,3,3,7,6,-66,-67,2,1,2,321
52,49,3,4,5,8,32,44,4,5,34,365
52,50,2,4,3,10,21,-54,5,1,55,311
52,51,2,5,5,8,23,53,8,4,78,364
52,52,3,4,7,6,-66,42,2,6,12,406
52,53,3,4,5,8,32,-56,4,0,44,350
52,54,2,4,6,7,24,43,8,3,68,393
52,55,5,2,9,4,-46,22,2,5,22,415
52,56,4,3,5,8,41,-65,3,0,63,350
52,57,4,3,7,6,43,33,6,3,106,383
52,58,3,4,8,5,-65,41,1,4,41,424
52,59,4,3,9,4,45,31,6,5,86,455
52,60,4,4,7,6,43,42,9,7,129,497
52,61,6,2,10,3,-36,21,3,8,93,518
53,1,5,2,8,5,53,23,3,3,53,23
53,2,5,2,9,4,54,22,7,5,107,45
53,3,3,3,7,6,-66,33,1,8,41,78
53,4,3,4,6,7,33,-57,4,1,74,21
53,5,3,3,7,6,34,33,8,4,108,54
53,6,2,4,4,9,-78,45,0,9,30,99
53,7,3,3,9,4,36,-69,6,0,66,30
53,8,4,2,5,8,41,26,7,6,107,56
53,9,4,3,5,8,41,-65,8,1,148,-9
53,10,2,5,5,8,-77,53,1,4,71,44
53,11,3,4,8,5,35,41,6,5,106,85
53,12,3,3,7,6,-66,33,0,8,40,118
53,13,3,3,5,8,32,-65,2,3,72,53
53,14,3,4,6,7,33,43,5,6,105,96
53,15,2,4,6,7,24,43,9,9,129,139
53,16,4,3,8,5,-56,-68,3,1,73,71
53,17,2,4,7,6,25,42,8,3,98,113
53,18,5,2,11,2,-44,20,4,3,54,133
53,19,5,2,9,4,54,22,8,5,108,155
53,20,3,3,5,8,-68,-65,0,0,40,90
53,21,4,2,9,4,45,22,5,2,85,112
53,22,3,4,4,9,31,45,6,7,116,157
53,23,4,2,8,5,-56,-77,0,0,60,80
53,24,3,4,6,7,33,43,3,3,93,123
53,25,3,4,5,8,32,44,5,7,125,167
53,26,2,5,7,6,-75,51,0,8,50,218
53,27,4,3,7,6,43,-67,3,1,93,151
53,28,3,4,6,7,33,43,6,4,126,194
53,29,4,3,8,5,-56,32,0,6,70,226
53,30,3,3,6,7,33,-66,3,0,103,160
53,31,3,3,6,7,33,34,6,4,136,194
53,32,3,4,8,5,-65,41,1,5,71,235
53,33,2,6,3,10,21,64,2,9,92,299
53,34,5,2,9,4,54,-78,6,1,146,221
53,35,2,5,4,9,22,54,8,5,168,275
53,36,4,2,8,5,-56,23,2,8,112,298
53,37,4,2,6,7,42,-75,4,3,154,223
53,38,4,2,10,3,-54,21,0,4,100,244
53,39,3,3,8,5,35,32,5,6,135,276
53,40,4,3,8,5,44,32,9,8,179,308
53,41,3,5,4,9,-69,-46,0,2,110,262
53,42,2,5,4,9,22,54,2,6,132,316
53,43,5,2,9,4,54,22,6,8,186,338
53,44,3,4,8,5,-65,41,1,9,121,379
53,45,3,3,6,7,33,-66,4,3,154,313
53,46,5,2,9,4,54,22,8,5,208,335
53,47,5,2,11,2,-44,20,4,5,164,355
53,48,2,4,3,10,21,-54,5,1,185,301
53,49,3,3,7,6,34,33,9,4,219,334
53,50,3,4,6,7,-67,43,2,7,152,377
53,51,4,2,10,3,46,21,8,8,198,398
53,52,2,5,6,7,-76,-48,2,0,122,350
53,53,4,4,6,7,42,43,4,3,164,393
53,54,2,4,6,7,24,43,8,6,188,436
53,55,2,4,4,9,-78,-55,0,1,110,381
53,56,6,2,9,4,63,22,3,3,173,403
53,57,3,3,9,4,36,31,9,4,209,434
53,58,4,3,7,6,-57,33,2,7,152,467
53,59,5,2,7,6,52,-76,4,1,204,391
53,60,2,5,2,11,20,56,4,7,224,447
53,61,2,4,8,5,-74,41,0,8,150,488
53,62,2,5,4,9,22,-46,2,2,172,442
53,63,4,2,9,4,45,22,7,4,217,464
53,64,3,3,4,9,31,-64,8,0,248,400
53,65,4,3,9,4,-55,31,3,1,193,431
53,66,4,2,6,7,42,25,5,6,235,456
53,67,2,4,7,6,-75,42,0,8,160,498
53,68,3,3,6,7,33,-66,3,2,193,432
53,69,3,4,5,8,32,44,5,6,225,476
53,70,3,3,9,4,-64,31,1,7,161,507
54,1,5,2,10,3,55,21,5,1,55,21
54,2,4,2,11,2,-53,20,2,1,2,41
54,3,3,3,7,6,34,33,6,4,36,74
54,4,3,3,7,6,-66,33,0,7,-30,107
54,5,2,5,3,10,21,-45,1,2,-9,62
54,6,5,2,8,5,53,23,4,5,44,85
54,7,2,4,6,7,24,43,8,8,68,128
54,8,4,2,7,6,-57,-76,1,2,11,52
54,9,3,4,7,6,34,42,5,4,45,94
54,10,4,3,6,7,42,34,7,8,87,128
54,11,4,3,9,4,-55,31,2,9,32,159
54,12,3,3,7,6,34,-67,6,2,66,92
54,13,3,4,6,7,33,43,9,5,99,135
54,14,5,2,10,3,-45,21,4,6,54,156
54,15,3,3,7,6,34,33,8,9,88,189
54,16,3,4,6,7,-67,-57,1,2,21,132
54,17,3,3,5,8,32,35,3,7,53,167
54,18,2,4,7,6,25,42,8,9,78,209
54,19,5,2,7,6,-48,-76,0,3,30,133
54,20,2,5,3,10,21,55,1,8,51,188
54,21,3,4,6,7,33,-57,4,1,84,131
54,22,3,3,8,5,35,32,9,3,119,163
54,23,2,5,2,11,20,56,9,9,139,219
54,24,2,5,5,8,-77,-47,2,2,62,172
54,25,3,3,6,7,33,34,5,6,95,206
54,26,2,4,5,8,23,-56,8,0,118,150
54,27,4,3,7,6,-57,33,1,3,61,183
54,28,2,4,8,5,26,41,7,4,87,224
54,29,4,2,8,5,-56,23,1,7,31,247
54,30,3,4,6,7,33,-57,4,0,64,190
54,31,4,3,8,5,44,32,8,2,108,222
54,32,3,3,5,8,-68,35,0,7,40,257
54,33,2,4,2,11,20,-53,0,4,60,204
54,34,3,3,4,9,31,-64,1,0,91,140
54,35,3,3,7,6,34,33,5,3,125,173
54,36,4,3,7,6,43,33,8,6,168,206
54,37,4,3,7,6,-57,33,1,9,111,239
54,38,4,2,10,3,46,-79,7,0,157,160
54,39,6,2,10,3,-36,21,1,1,121,181
54,40,4,2,7,6,43,24,4,5,164,205
54,41,4,3,9,4,45,31,9,6,209,236
54,42,4,3,8,5,-56,32,3,8,153,268
54,43,4,3,9,4,45,31,8,9,198,299
54,44,4,2,10,3,-54,-79,4,0,144,220
54,45,4,2,9,4,45,22,9,2,189,242
54,46,2,5,3,10,-79,55,0,7,110,297
54,47,5,2,9,4,54,22,4,9,164,319
54,48,2,6,3,10,21,-36,5,3,185,283
54,49,4,3,5,8,41,35,6,8,226,318
54,50,2,5,3,10,21,-45,7,3,247,273
54,51,5,2,10,3,-45,21,2,4,202,294
54,52,2,5,8,5,26,50,8,4,228,344
54,53,2,4,5,8,-77,44,1,8,151,388
54,54,3,4,7,6,34,-58,5,0,185,330
54,55,3,4,4,9,31,45,6,5,216,375
54,56,4,3,8,5,-56,32,0,7,160,407
54,57,3,3,7,6,34,-67,4,0,194,340
54,58,3,4,5,8,32,44,6,4,226,384
54,59,2,6,2,11,20,65,6,9,246,449
54,60,3,4,5,8,32,-56,8,3,278,393
54,61,4,2,10,3,-54,21,4,4,224,414
54,62,4,3,8,5,44,32,8,6,268,446
54,63,4,2,5,8,41,-74,9,2,309,372
54,64,4,2,9,4,-55,22,4,4,254,394
54,65,3,4,7,6,34,42,8,6,288,436
54,66,3,3,10,3,-63,30,5,6,225,466
54,67,5,2,9,4,54,22,9,8,279,488
54,68,3,3,7,6,-66,-67,3,1,213,421
54,69,3,3,6,7,33,34,6,5,246,455
54,70,3,4,3,10,30,-54,6,1,276,401
54,71,3,4,5,8,32,44,8,5,308,445
54,72,3,3,4,9,31,-64,9,1,339,381
54,73,4,3,7,6,-57,33,2,4,282,414
54,74,3,3,6,7,33,34,5,8,315,448
54,75,3,3,8,5,-65,-68,0,0,250,380
54,76,3,3,6,7,33,34,3,4,283,414
54,77,4,3,6,7,42,34,5,8,325,448
54,78,4,3,5,8,41,-65,6,3,366,383
54,79,4,3,9,4,-55,31,1,4,311,414
54,80,5,2,10,3,55,21,6,5,366,435
54,81,3,3,5,8,32,-65,8,0,398,370
54,82,4,3,8,5,-56,32,2,2,342,402
54,83,3,4,4,9,31,45,3,7,373,447
54,84,4,3,8,5,44,32,7,9,417,479
54,85,2,4,4,9,22,-55,9,4,439,424
54,86,3,4,6,7,-67,43,2,7,372,467
54,87,3,3,9,4,36,31,8,8,408,498
54,88,2,6,4,9,-78,-37,0,1,330,461
54,89,3,3,4,9,31,36,1,7,361,497
54,90,5,2,7,6,52,-76,3,1,413,421
54,91,5,2,7,6,52,24,5,5,465,445
54,92,4,2,6,7,42,-75,7,0,507,370
55,1,4,3,8,5,44,32,4,2,44,32
55,2,3,4,4,9,31,45,5,7,75,77
55,3,5,2,9,4,54,22,9,9,129,99
55,4,2,5,5,8,-77,-47,2,2,52,52
55,5,4,3,8,5,44,32,6,4,96,84
55,6,4,2,7,6,43,24,9,8,139,108
55,7,2,4,6,7,-76,-57,3,1,63,51
55,8,4,3,8,5,44,32,7,3,107,83
55,9,3,3,7,6,-66,33,1,6,41,116
55,10,3,4,5,8,32,-56,3,0,73,60
55,11,3,4,4,9,31,45,4,5,104,105
55,12,2,5,4,9,22,54,6,9,126,159
55,13,4,2,10,3,-54,-79,2,0,72,80
55,14,2,4,2,11,20,47,2,7,92,127
55,15,4,3,8,5,44,32,6,9,136,159
55,16,2,4,6,7,-76,-57,0,2,60,102
55,17,3,5,3,10,30,55,0,7,90,157
55,18,3,3,6,7,33,-66,3,1,123,91
55,19,3,3,7,6,34,33,7,4,157,124
55,20,5,2,8,5,-47,23,0,7,110,147
55,21,3,3,7,6,34,-67,4,0,144,80
55,22,2,5,2,11,20,56,4,6,164,136
55,23,2,4,4,9,22,-55,6,1,186,81
55,24,3,3,6,7,33,34,9,5,219,115
55,25,3,4,3,10,30,-54,9,1,249,61
55,26,3,4,5,8,-68,44,1,5,181,105
55,27,4,2,8,5,44,23,5,8,225,128
55,28,3,4,4,9,31,-55,6,3,256,73
55,29,3,3,6,7,33,34,9,7,289,107
55,30,3,3,8,5,-65,32,4,9,224,139
55,31,2,4,4,9,22,-55,6,4,246,84
55,32,4,4,5,8,41,44,7,8,287,128
55,33,3,3,7,6,-66,-67,1,1,221,61
55,34,3,3,6,7,33,34,4,5,254,95
55,35,3,4,5,8,32,44,6,9,286,139
55,36,4,2,8,5,-56,-77,0,2,230,62
55,37,3,3,7,6,34,33,4,5,264,95
55,38,2,4,5,8,23,44,7,9,287,139
55,39,4,2,9,4,-55,-78,2,1,232,61
55,40,5,2,8,5,53,23,5,4,285,84
55,41,2,4,7,6,-75,42,0,6,210,126
55,42,4,3,6,7,42,-66,2,0,252,60
55,43,2,4,6,7,24,43,6,3,276,103
55,44,4,3,9,4,-55,31,1,4,221,134
55,45,3,4,6,7,33,43,4,7,254,177
55,46,6,2,8,5,62,-77,6,0,316,100
55,47,4,3,4,9,40,36,6,6,356,136
55,48,3,3,5,8,32,-65,8,1,388,71
55,49,3,3,8,5,-65,32,3,3,323,103
55,50,3,3,6,7,33,34,6,7,356,137
55,51,3,4,6,7,33,-57,9,0,389,80
55,52,5,2,6,7,-49,25,0,5,340,105
55,53,2,5,4,9,22,54,2,9,362,159
55,54,3,4,6,7,33,-57,5,2,395,102
55,55,3,3,6,7,33,34,8,6,428,136
55,56,4,2,10,3,-54,21,4,7,374,157
55,57,5,2,7,6,52,-76,6,1,426,81
55,58,2,5,3,10,21,55,7,6,447,136
55,59,4,3,6,7,42,-66,9,0,489,70
55,60,5,2,8,5,-47,23,2,3,442,93
55,61,3,4,6,7,33,43,5,6,475,136
55,62,3,3,7,6,34,33,9,9,509,169
56,1,4,3,10,3,46,30,6,0,46,30
56,2,2,4,5,8,23,44,9,4,69,74
56,3,4,2,7,6,-57,24,2,8,12,98
56,4,2,4,5,8,23,-56,5,2,35,42
56,5,3,3,3,10,30,37,5,9,65,79
56,6,2,5,3,10,21,-45,6,4,86,34
56,7,2,5,5,8,23,53,9,7,109,87
56,8,2,5,3,10,-79,-45,0,2,30,42
56,9,3,3,6,7,33,34,3,6,63,76
56,10,3,4,8,5,35,41,8,7,98,117
56,11,4,3,7,6,-57,-67,1,0,41,50
56,12,4,3,6,7,42,34,3,4,83,84
56,13,3,4,5,8,32,44,5,8,115,128
56,14,3,3,8,5,-65,-68,0,0,50,60
56,15,5,2,10,3,55,21,5,1,105,81
56,16,2,5,4,9,22,54,7,5,127,135
56,17,3,4,7,6,-66,42,1,7,61,177
56,18,3,3,7,6,34,-67,5,0,95,110
56,19,4,2,8,5,44,23,9,3,139,133
56,20,3,4,4,9,-69,45,0,8,70,178
56,21,4,2,9,4,45,-78,5,0,115,100
56,22,5,2,9,4,54,22,9,2,169,122
56,23,2,4,3,10,-79,46,0,8,90,168
56,24,3,3,4,9,31,-64,1,4,121,104
56,25,2,5,3,10,21,55,2,9,142,159
56,26,2,5,2,11,20,-44,2,5,162,115
56,27,2,4,8,5,26,41,8,6,188,156
56,28,2,5,7,6,-75,51,3,7,113,207
56,29,3,3,7,6,34,-67,7,0,147,140
56,30,2,4,6,7,-76,43,1,3,71,183
56,31,2,5,3,10,21,55,2,8,92,238
56,32,3,4,4,9,31,-55,3,3,123,183
56,33,2,5,5,8,23,53,6,6,146,236
56,34,5,2,10,3,-45,21,1,7,101,257
56,35,5,2,10,3,55,21,6,8,156,278
56,36,4,3,9,4,-55,31,1,9,101,309
56,37,4,2,6,7,42,-75,3,4,143,234
56,38,4,3,9,4,45,31,8,5,188,265
56,39,2,5,5,8,-77,53,1,8,111,318
56,40,4,3,7,6,43,-67,4,1,154,251
56,41,4,3,6,7,42,34,6,5,196,285
56,42,2,4,6,7,-76,43,0,8,120,328
56,43,4,2,11,2,47,20,7,8,167,348
56,44,3,3,6,7,-67,-66,0,2,100,282
56,45,2,4,5,8,23,44,3,6,123,326
56,46,4,3,9,4,45,31,8,7,168,357
56,47,4,2,7,6,-57,-76,1,1,111,281
56,48,2,5,3,10,21,55,2,6,132,336
56,49,4,3,8,5,44,32,6,8,176,368
56,50,3,4,5,8,32,-56,8,2,208,312
56,51,3,4,4,9,31,45,9,7,239,357
56,52,4,2,9,4,-55,22,4,9,184,379
56,53,3,3,10,3,-63,30,1,9,121,409
56,54,3,4,6,7,33,-57,4,2,154,352
56,55,5,2,11,2,-44,20,0,2,110,372
56,56,4,2,9,4,45,22,5,4,155,394
56,57,2,4,4,9,22,45,7,9,177,439
56,58,2,5,4,9,22,-46,9,3,199,393
56,59,3,4,5,8,-68,44,1,7,131,437
56,60,3,3,4,9,31,-64,2,3,162,373
56,61,5,2,9,4,54,22,6,5,216,395
56,62,3,3,7,6,-66,33,0,8,150,428
56,63,4,3,7,6,43,-67,3,1,193,361
56,64,4,2,8,5,44,23,7,4,237,384
56,65,4,2,8,5,-56,23,1,7,181,407
56,66,2,4,3,10,21,-54,2,3,202,353
56,67,4,4,5,8,41,44,3,7,243,397
56,68,3,3,7,6,34,-67,7,0,277,330
56,69,4,2,11,2,-53,20,4,0,224,350
56,70,4,3,10,3,-54,30,0,0,170,380
56,71,4,2,10,3,46,21,6,1,216,401
56,72,3,3,8,5,-65,32,1,3,151,433
56,73,3,4,5,8,32,44,3,7,183,477
56,74,2,5,5,8,23,-47,6,0,206,430
56,75,2,4,5,8,23,44,9,4,229,474
56,76,3,4,5,8,-68,44,1,8,161,518
57,1,3,3,4,9,31,36,1,6,31,36
57,2,3,4,5,8,32,-56,3,0,63,-20
57,3,2,4,8,5,26,41,9,1,89,21
57,4,2,4,5,8,-77,44,2,5,12,65
57,5,3,4,7,6,34,42,6,7,46,107
57,6,4,2,6,7,42,-75,8,2,88,32
57,7,2,5,5,8,-77,53,1,5,11,85
57,8,4,3,6,7,42,34,3,9,53,119
57,9,4,3,7,6,43,-67,6,2,96,52
57,10,3,4,8,5,-65,41,1,3,31,93
57,11,2,5,3,10,21,55,2,8,52,148
57,12,3,3,8,5,35,-68,7,0,87,80
57,13,2,4,6,7,-76,43,1,3,11,123
57,14,5,2,9,4,54,22,5,5,65,145
57,15,4,4,7,6,43,42,8,7,108,187
57,16,5,3,8,5,-47,32,1,9,61,219
57,17,3,3,8,5,35,-68,6,1,96,151
57,18,2,6,3,10,21,64,7,5,117,215
57,19,3,3,6,7,-67,34,0,9,50,249
57,20,3,3,8,5,35,-68,5,1,85,181
57,21,2,4,4,9,22,45,7,6,107,226
57,22,4,3,8,5,-56,32,1,8,51,258
57,23,2,4,8,5,26,41,7,9,77,299
57,24,3,4,7,6,-66,-58,1,1,11,241
57,25,3,3,7,6,34,33,5,4,45,274
57,26,3,4,8,5,-65,41,0,5,-20,315
57,27,4,3,8,5,44,32,4,7,24,347
57,28,2,4,4,9,22,-55,6,2,46,292
57,29,4,2,8,5,-56,23,0,5,-10,315
57,30,4,2,7,6,43,24,3,9,33,339
57,31,2,5,5,8,23,-47,6,2,56,292
57,32,5,2,10,3,-45,21,1,3,11,313
57,33,3,4,6,7,33,43,4,6,44,356
57,34,3,4,5,8,32,-56,6,0,76,300
57,35,5,2,7,6,52,24,8,4,128,324
57,36,3,4,5,8,-68,44,0,8,60,368
57,37,4,3,6,7,42,-66,2,2,102,302
57,38,3,3,6,7,33,34,5,6,135,336
57,39,3,3,4,9,31,-64,6,2,166,272
57,40,4,4,8,5,-56,41,0,3,110,313
57,41,3,4,4,9,31,45,1,8,141,358
57,42,3,4,6,7,33,-57,4,1,174,301
57,43,2,4,6,7,24,43,8,4,198,344
57,44,4,2,8,5,-56,23,2,7,142,367
57,45,3,3,8,5,35,32,7,9,177,399
57,46,2,5,4,9,22,-46,9,3,199,353
57,47,5,2,9,4,-46,22,3,5,153,375
57,48,4,4,6,7,42,43,5,8,195,418
57,49,3,3,5,8,32,-65,7,3,227,353
57,50,5,2,10,3,-45,21,2,4,182,374
57,51,3,3,6,7,33,34,5,8,215,408
57,52,2,4,6,7,24,-57,9,1,239,351
57,53,2,6,3,10,-79,64,0,5,160,415
57,54,4,3,5,8,41,-65,1,0,201,350
57,55,3,4,6,7,33,43,4,3,234,393
57,56,3,3,7,6,34,33,8,6,268,426
57,57,3,3,7,6,-66,33,2,9,202,459
57,58,2,5,4,9,22,-46,4,3,224,413
57,59,3,4,6,7,33,43,7,6,257,456
57,60,2,4,5,8,-77,-56,0,0,180,400
57,61,6,2,8,5,62,23,2,3,242,423
57,62,4,2,8,5,44,23,6,6,286,446
57,63,5,2,8,5,53,23,9,9,339,469
57,64,4,2,7,6,-57,-76,2,3,282,393
57,65,4,2,10,3,46,21,8,4,328,414
57,66,5,2,11,2,-44,20,4,4,284,434
57,67,3,3,6,7,33,34,7,8,317,468
57,68,5,2,10,3,-45,21,2,9,272,489
57,69,2,4,5,8,23,-56,5,3,295,433
57,70,2,5,5,8,23,53,8,6,318,486
57,71,5,2,10,3,-45,21,3,7,273,507
58,1,2,5,3,10,21,55,1,5,21,55
58,2,3,3,6,7,33,34,4,9,54,89
58,3,3,3,7,6,34,-67,8,2,88,22
58,4,5,2,9,4,-46,22,2,4,42,44
58,5,3,3,7,6,34,33,6,7,76,77
58,6,3,4,7,6,-66,42,0,9,10,119
58,7,3,4,7,6,34,-58,4,1,44,61
58,8,4,3,5,8,41,35,5,6,85,96
58,9,4,4,8,5,44,41,9,7,129,137
58,10,3,3,5,8,-68,-65,1,2,61,72
58,11,4,4,5,8,41,44,2,6,102,116
58,12,5,2,9,4,54,22,6,8,156,138
58,13,5,2,10,3,-45,21,1,9,111,159
58,14,2,5,6,7,24,-48,5,1,135,111
58,15,4,2,9,4,-55,22,0,3,80,133
58,16,4,3,9,4,45,31,5,4,125,164
58,17,4,2,9,4,-55,22,0,6,70,186
58,18,4,3,7,6,43,33,3,9,113,219
58,19,3,4,7,6,34,-58,7,1,147,161
58,20,4,3,9,4,-55,31,2,2,92,192
58,21,2,5,5,8,23,53,5,5,115,245
58,22,4,3,8,5,44,32,9,7,159,277
58,23,4,2,8,5,-56,-77,3,0,103,200
58,24,3,4,8,5,35,41,8,1,138,241
58,25,2,5,3,10,21,55,9,6,159,296
58,26,4,4,8,5,-56,41,3,7,103,337
58,27,2,4,7,6,25,42,8,9,128,379
58,28,4,3,8,5,-56,-68,2,1,72,311
58,29,3,3,7,6,34,33,6,4,106,344
58,30,2,5,4,9,22,54,8,8,128,398
58,31,5,2,7,6,-48,-76,0,2,80,322
58,32,2,6,3,10,21,64,1,6,101,386
58,33,4,3,7,6,43,33,4,9,144,419
58,34,2,4,3,10,21,-54,5,5,165,365
58,35,4,2,7,6,43,24,8,9,208,389
58,36,2,5,3,10,21,-45,9,4,229,344
58,37,2,5,6,7,-76,52,3,6,153,396
58,38,3,3,8,5,35,32,8,8,188,428
58,39,3,4,6,7,-67,-57,1,1,121,371
58,40,3,4,5,8,32,44,3,5,153,415
58,41,4,3,8,5,44,32,7,7,197,447
58,42,3,4,6,7,-67,-57,0,0,130,390
58,43,3,4,6,7,33,43,3,3,163,433
58,44,3,4,4,9,31,45,4,8,194,478
58,45,4,3,11,2,-53,-30,1,8,141,448
58,46,4,3,8,5,44,-68,5,0,185,380
58,47,3,3,6,7,33,34,8,4,218,414
58,48,3,4,6,7,-67,43,1,7,151,457
58,49,6,2,10,3,64,21,5,8,215,478
58,50,4,2,8,5,44,-77,9,1,259,401
58,51,4,3,8,5,-56,32,3,3,203,433
58,52,4,3,6,7,42,34,5,7,245,467
58,53,3,3,5,8,32,-65,7,2,277,402
58,54,3,4,4,9,31,45,8,7,308,447
58,55,4,3,9,4,-55,31,3,8,253,478
58,56,4,2,9,4,45,-78,8,0,298,400
58,57,5,2,9,4,-46,22,2,2,252,422
58,58,4,2,8,5,44,23,6,5,296,445
58,59,3,4,6,7,33,43,9,8,329,488
58,60,2,5,3,10,-79,-45,0,3,250,443
58,61,5,2,9,4,54,22,4,5,304,465
58,62,4,3,5,8,41,-65,5,0,345,400
58,63,3,4,6,7,33,43,8,3,378,443
58,64,3,4,5,8,-68,44,0,7,310,487
58,65,4,3,8,5,44,32,4,9,354,519
59,1,3,3,8,5,35,32,5,2,35,32
59,2,2,5,3,10,21,55,6,7,56,87
59,3,4,2,8,5,-56,-77,0,0,0,10
59,4,3,3,8,5,35,32,5,2,35,42
59,5,3,4,8,5,-65,41,0,3,-30,83
59,6,4,3,5,8,41,35,1,8,11,118
59,7,5,2,10,3,55,21,6,9,66,139
59,8,4,3,7,6,43,-67,9,2,109,72
59,9,2,5,4,9,-78,54,1,6,31,126
59,10,2,5,4,9,22,-46,3,0,53,80
59,11,2,6,3,10,21,64,4,4,74,144
59,12,4,3,7,6,43,33,7,7,117,177
59,13,3,3,7,6,-66,-67,1,0,51,110
59,14,4,3,10,3,46,30,7,0,97,140
59,15,3,3,5,8,32,35,9,5,129,175
59,16,4,3,6,7,-58,34,1,9,71,209
59,17,4,3,9,4,45,-69,6,0,116,140
59,18,3,3,7,6,-66,33,0,3,50,173
59,19,2,4,7,6,25,42,5,5,75,215
59,20,5,2,8,5,53,23,8,8,128,238
59,21,4,3,5,8,41,-65,9,3,169,173
59,22,3,3,7,6,-66,33,3,6,103,206
59,23,2,5,4,9,22,-46,5,0,125,160
59,24,2,5,3,10,21,55,6,5,146,215
59,25,2,5,7,6,-75,51,1,6,71,266
59,26,2,4,5,8,23,-56,4,0,94,210
59,27,2,4,5,8,23,44,7,4,117,254
59,28,2,4,5,8,-77,44,0,8,40,298
59,29,3,4,8,5,35,41,5,9,75,339
59,30,3,5,6,7,33,-48,8,1,108,291
59,31,3,4,5,8,-68,44,0,5,40,335
59,32,2,6,2,11,20,-35,0,0,60,300
59,33,4,2,8,5,44,23,4,3,104,323
59,34,2,4,8,5,-74,41,0,4,30,364
59,35,5,2,9,4,54,22,4,6,84,386
59,36,2,5,5,8,23,53,7,9,107,439
59,37,2,5,4,9,22,-46,9,3,129,393
59,38,4,3,7,6,-57,33,2,6,72,426
59,39,3,4,5,8,32,-56,4,0,104,370
59,40,4,3,7,6,43,33,7,3,147,403
59,41,2,4,5,8,-77,44,0,7,70,447
59,42,3,4,7,6,34,42,4,9,104,489
59,43,4,3,9,4,45,-69,9,0,149,420
59,44,3,3,8,5,-65,32,4,2,84,452
59,45,4,2,9,4,45,22,9,4,129,474
59,46,4,4,8,5,-56,41,3,5,73,515
60,1,3,3,8,5,35,32,5,2,35,32
60,2,3,3,7,6,34,33,9,5,69,65
60,3,4,2,8,5,-56,23,3,8,13,88
60,4,4,3,6,7,42,-66,5,2,55,22
60,5,3,4,6,7,33,43,8,5,88,65
60,6,2,5,6,7,-76,52,2,7,12,117
60,7,5,2,7,6,52,-76,4,1,64,41
60,8,4,2,7,6,43,24,7,5,107,65
60,9,3,4,3,10,30,-54,7,1,137,11
60,10,4,2,7,6,-57,24,0,5,80,35
60,11,3,3,8,5,35,32,5,7,115,67
60,12,3,3,4,9,31,-64,6,3,146,3
60,13,3,4,6,7,33,43,9,6,179,46
60,14,5,2,8,5,-47,23,2,9,132,69
60,15,3,4,8,5,35,-59,7,0,167,10
60,16,2,5,4,9,22,54,9,4,189,64
60,17,3,3,7,6,-66,33,3,7,123,97
60,18,3,3,8,5,35,32,8,9,158,129
60,19,3,4,6,7,-67,-57,1,2,91,72
60,20,2,4,6,7,24,43,5,5,115,115
60,21,3,4,7,6,34,42,9,7,149,157
60,22,3,4,6,7,-67,-57,2,0,82,100
60,23,4,2,8,5,44,23,6,3,126,123
60,24,2,4,6,7,-76,43,0,6,50,166
60,25,2,5,4,9,22,-46,2,0,72,120
60,26,3,3,6,7,33,34,5,4,105,154
60,27,3,4,4,9,31,45,6,9,136,199
60,28,2,4,4,9,22,-55,8,4,158,144
60,29,4,3,8,5,-56,32,2,6,102,176
60,30,3,4,5,8,32,-56,4,0,134,120
60,31,4,3,9,4,45,31,9,1,179,151
60,32,4,3,10,3,-54,30,5,1,125,181
60,33,4,3,6,7,42,34,7,5,167,215
60,34,3,3,8,5,-65,32,2,7,102,247
60,35,3,3,7,6,34,-67,6,0,136,180
60,36,2,4,5,8,23,44,9,4,159,224
60,37,4,2,9,4,-55,22,4,6,104,246
60,38,4,2,7,6,43,-76,7,0,147,170
60,39,3,4,6,7,-67,43,0,3,80,213
60,40,3,4,7,6,34,42,4,5,114,255
60,41,2,4,5,8,23,44,7,9,137,299
60,42,3,4,6,7,-67,-57,0,2,70,242
60,43,4,2,6,7,42,25,2,7,112,267
60,44,3,3,9,4,36,31,8,8,148,298
60,45,5,2,8,5,-47,-77,1,1,101,221
60,46,3,4,7,6,34,42,5,3,135,263
60,47,4,2,8,5,44,23,9,6,179,286
60,48,4,2,8,5,-56,23,3,9,123,309
60,49,3,3,5,8,32,-65,5,4,155,244
60,50,4,3,7,6,43,33,8,7,198,277
60,51,2,5,5,8,-77,-47,1,0,121,230
60,52,4,3,7,6,43,33,4,3,164,263
60,53,2,5,3,10,21,55,5,8,185,318
60,54,6,2,11,2,-35,20,0,8,150,338
60,55,3,4,5,8,32,-56,2,2,182,282
60,56,4,3,6,7,42,34,4,6,224,316
60,57,3,3,7,6,34,33,8,9,258,349
60,58,6,2,9,4,-37,-78,1,1,221,271
60,59,2,5,3,10,21,55,2,6,242,326
60,60,4,3,8,5,44,32,6,8,286,358
60,61,4,2,6,7,42,-75,8,3,328,283
60,62,4,3,5,8,41,35,9,8,369,318
60,63,3,4,4,9,-69,-55,0,3,300,263
60,64,2,5,5,8,23,53,3,6,323,316
60,65,3,5,5,8,32,53,5,9,355,369
60,66,4,3,7,6,43,-67,8,2,398,302
60,67,2,5,7,6,-75,51,3,3,323,353
60,68,4,3,7,6,43,33,6,6,366,386
60,69,4,3,7,6,43,33,9,9,409,419
60,70,2,4,6,7,-76,-57,3,2,333,362
60,71,3,3,5,8,32,35,5,7,365,397
60,72,3,4,3,10,30,-54,5,3,395,343
60,73,2,4,4,9,22,45,7,8,417,388
60,74,6,2,10,3,-36,21,1,9,381,409
60,75,3,3,5,8,32,-65,3,4,413,344
60,76,2,5,2,11,20,-44,3,0,433,300
60,77,2,4,6,7,24,43,7,3,457,343
60,78,4,3,6,7,42,34,9,7,499,377
60,79,4,3,7,6,-57,-67,2,0,442,310
60,80,2,5,3,10,21,55,3,5,463,365
60,81,4,3,6,7,42,34,5,9,505,399
61,1,3,3,8,5,35,32,5,2,35,32
61,2,2,4,7,6,-75,42,0,4,-40,74
61,3,3,4,7,6,34,42,4,6,-6,116
61,4,3,3,9,4,-64,31,0,7,-70,147
61,5,2,5,3,10,21,-45,1,2,-49,102
61,6,5,2,9,4,54,22,5,4,5,124
61,7,5,2,9,4,54,22,9,6,59,146
61,8,4,2,8,5,-56,23,3,9,3,169
61,9,3,3,4,9,31,-64,4,5,34,105
61,10,2,5,5,8,23,53,7,8,57,158
61,11,4,3,9,4,-55,31,2,9,2,189
61,12,4,3,6,7,42,-66,4,3,44,123
61,13,4,3,6,7,42,34,6,7,86,157
61,14,5,2,8,5,53,-77,9,0,139,80
61,15,4,3,6,7,-58,34,1,4,81,114
61,16,5,3,8,5,53,32,4,6,134,146
61,17,2,5,3,10,21,-45,5,1,155,101
61,18,4,3,8,5,44,32,9,3,199,133
61,19,3,4,4,9,-69,45,0,8,130,178
61,20,4,2,8,5,44,-77,4,1,174,101
61,21,3,3,6,7,33,34,7,5,207,135
61,22,3,3,9,4,-64,31,3,6,143,166
61,23,4,2,9,4,45,22,8,8,188,188
61,24,4,3,9,4,-55,31,3,9,133,219
61,25,3,3,7,6,34,-67,7,2,167,152
61,26,4,3,7,6,-57,33,0,5,110,185
61,27,2,4,3,10,21,-54,1,1,131,131
61,28,3,4,4,9,31,45,2,6,162,176
61,29,2,5,3,10,21,-45,3,1,183,131
61,30,4,3,10,3,46,30,9,1,229,161
61,31,3,4,4,9,-69,45,0,6,160,206
61,32,3,4,5,8,32,-56,2,0,192,150
61,33,2,4,7,6,25,42,7,2,217,192
61,34,5,2,9,4,-46,22,1,4,171,214
61,35,4,2,9,4,45,22,6,6,216,236
61,36,3,3,8,5,-65,32,1,8,151,268
61,37,2,5,4,9,22,-46,3,2,173,222
61,38,3,3,7,6,34,33,7,5,207,255
61,39,5,2,9,4,-46,22,1,7,161,277
61,40,3,4,4,9,31,-55,2,2,192,222
61,41,4,2,8,5,44,23,6,5,236,245
61,42,3,3,6,7,33,34,9,9,269,279
61,43,3,3,9,4,-64,-69,5,0,205,210
61,44,4,3,6,7,42,34,7,4,247,244
61,45,5,2,9,4,-46,22,1,6,201,266
61,46,6,2,10,3,64,21,5,7,265,287
61,47,3,4,6,7,33,-57,8,0,298,230
61,48,4,3,7,6,-57,33,1,3,241,263
61,49,3,3,4,9,31,36,2,9,272,299
61,50,5,2,9,4,54,-78,6,1,326,221
61,51,6,2,11,2,-35,20,1,1,291,241
61,52,3,3,4,9,31,36,2,7,322,277
61,53,3,4,6,7,33,-57,5,0,355,220
61,54,2,4,5,8,23,44,8,4,378,264
61,55,3,3,6,7,-67,34,1,8,311,298
61,56,4,2,8,5,44,-77,5,1,355,221
61,57,4,3,9,4,-55,31,0,2,300,252
61,58,2,5,5,8,23,53,3,5,323,305
61,59,4,3,7,6,43,33,6,8,366,338
61,60,4,3,8,5,-56,-68,0,0,310,270
61,61,6,2,11,2,65,20,5,0,375,290
61,62,2,4,4,9,22,45,7,5,397,335
61,63,3,3,6,7,-67,34,0,9,330,369
61,64,3,4,6,7,33,-57,3,2,363,312
61,65,5,2,6,7,51,25,4,7,414,337
61,66,4,2,6,7,42,-75,6,2,456,262
61,67,3,4,6,7,33,43,9,5,489,305
61,68,4,3,10,3,-54,30,5,5,435,335
61,69,4,2,9,4,-55,22,0,7,380,357
61,70,4,2,10,3,46,21,6,8,426,378
61,71,4,3,8,5,-56,-68,0,0,370,310
61,72,4,3,9,4,45,31,5,1,415,341
61,73,4,2,6,7,42,25,7,6,457,366
61,74,3,3,4,9,31,-64,8,2,488,302
61,75,4,2,7,6,-57,24,1,6,431,326
61,76,3,3,6,7,33,-66,4,0,464,260
61,77,4,3,10,3,-54,30,0,0,410,290
61,78,6,2,11,2,65,20,5,0,475,310
61,79,3,3,9,4,-64,31,1,1,411,341
61,80,5,2,11,2,56,20,7,1,467,361
61,81,4,4,6,7,42,43,9,4,509,404
62,1,4,3,7,6,43,33,3,3,43,33
62,2,3,3,6,7,33,34,6,7,76,67
62,3,3,4,5,8,32,-56,8,1,108,11
62,4,3,3,8,5,-65,32,3,3,43,43
62,5,4,2,8,5,44,23,7,6,87,66
62,6,4,3,7,6,-57,33,0,9,30,99
62,7,2,5,5,8,23,-47,3,2,53,52
62,8,3,3,9,4,36,31,9,3,89,83
62,9,2,4,6,7,-76,43,3,6,13,126
62,10,3,3,5,8,32,-65,5,1,45,61
62,11,4,3,8,5,44,32,9,3,89,93
62,12,3,3,6,7,-67,34,2,7,22,127
62,13,3,4,7,6,34,42,6,9,56,169
62,14,2,4,5,8,23,-56,9,3,79,113
62,15,3,4,4,9,-69,45,0,8,10,158
62,16,3,4,3,10,30,-54,0,4,40,104
62,17,2,4,4,9,22,45,2,9,62,149
62,18,3,4,6,7,33,-57,5,2,95,92
62,19,3,3,9,4,-64,31,1,3,31,123
62,20,4,3,9,4,45,31,6,4,76,154
62,21,2,4,6,7,-76,43,0,7,0,197
62,22,2,4,5,8,23,-56,3,1,23,141
62,23,4,2,9,4,45,22,8,3,68,163
62,24,4,3,8,5,-56,32,2,5,12,195
62,25,2,5,2,11,20,-44,2,1,32,151
62,26,3,4,6,7,33,43,5,4,65,194
62,27,4,3,7,6,43,33,8,7,108,227
62,28,4,3,9,4,-55,31,3,8,53,258
62,29,5,2,10,3,55,21,8,9,108,279
62,30,4,3,8,5,-56,-68,2,1,52,211
62,31,5,2,7,6,52,24,4,5,104,235
62,32,2,4,3,10,21,-54,5,1,125,181
62,33,5,2,8,5,53,23,8,4,178,204
62,34,4,3,9,4,-55,31,3,5,123,235
62,35,4,2,8,5,44,23,7,8,167,258
62,36,4,2,9,4,-55,-78,2,0,112,180
62,37,4,3,5,8,41,35,3,5,153,215
62,38,4,3,6,7,42,34,5,9,195,249
62,39,3,4,7,6,34,-58,9,1,229,191
62,40,4,3,8,5,-56,32,3,3,173,223
62,41,3,3,6,7,33,34,6,7,206,257
62,42,4,3,7,6,43,-67,9,0,249,190
62,43,4,3,7,6,-57,33,2,3,192,223
62,44,2,5,6,7,24,52,6,5,216,275
62,45,3,4,7,6,-66,42,0,7,150,317
62,46,3,3,7,6,34,-67,4,0,184,250
62,47,2,6,2,11,20,65,4,5,204,315
62,48,4,2,7,6,43,24,7,9,247,339
62,49,3,3,6,7,-67,-66,0,3,180,273
62,50,2,4,6,7,24,43,4,6,204,316
62,51,5,2,8,5,53,23,7,9,257,339
62,52,3,3,7,6,-66,-67,1,2,191,272
62,53,3,3,5,8,32,35,3,7,223,307
62,54,4,3,8,5,44,32,7,9,267,339
62,55,3,3,6,7,-67,-66,0,3,200,273
62,56,6,2,10,3,64,21,4,4,264,294
62,57,4,2,10,3,-54,21,0,5,210,315
62,58,4,4,6,7,42,43,2,8,252,358
62,59,3,4,5,8,32,-56,4,2,284,302
62,60,3,4,4,9,31,45,5,7,315,347
62,61,4,2,8,5,44,-77,9,0,359,270
62,62,2,4,8,5,-74,41,5,1,285,311
62,63,3,4,5,8,32,44,7,5,317,355
62,64,3,3,9,4,-64,31,3,6,253,386
62,65,3,3,8,5,35,32,8,8,288,418
62,66,3,3,8,5,-65,-68,3,0,223,350
62,67,2,5,2,11,20,56,3,6,243,406
62,68,5,3,9,4,54,31,7,7,297,437
62,69,4,3,7,6,-57,-67,0,0,240,370
62,70,3,4,6,7,33,43,3,3,273,413
62,71,3,3,8,5,35,32,8,5,308,445
62,72,4,2,6,7,-58,-75,0,0,250,370
62,73,3,3,7,6,34,33,4,3,284,403
62,74,3,3,3,10,30,-63,4,0,314,340
62,75,4,4,5,8,41,44,5,4,355,384
62,76,4,3,10,3,-54,30,1,4,301,414
62,77,3,3,7,6,34,33,5,7,335,447
62,78,3,3,9,4,-64,31,1,8,271,478
62,79,4,3,6,7,42,-66,3,2,313,412
62,80,3,3,7,6,34,33,7,5,347,445
62,81,4,3,6,7,42,34,9,9,389,479
62,82,3,4,5,8,-68,-56,1,3,321,423
62,83,3,3,10,3,37,30,8,3,358,453
62,84,3,3,6,7,-67,34,1,7,291,487
62,85,5,2,11,2,56,20,7,7,347,507
63,1,2,5,2,11,20,56,0,6,20,56
63,2,4,2,8,5,44,23,4,9,64,79
63,3,4,3,9,4,45,-69,9,0,109,10
63,4,4,2,8,5,-56,23,3,3,53,33
63,5,3,3,5,8,32,35,5,8,85,68
63,6,4,3,10,3,-54,30,1,8,31,98
63,7,5,2,8,5,53,-77,4,1,84,21
63,8,2,5,4,9,22,54,6,5,106,75
63,9,5,2,9,4,-46,22,0,7,60,97
63,10,4,3,10,3,46,30,6,7,106,127
63,11,4,2,6,7,42,-75,8,2,148,52
63,12,3,4,8,5,-65,41,3,3,83,93
63,13,3,3,4,9,31,36,4,9,114,129
63,14,5,2,10,3,55,-79,9,0,169,50
63,15,4,3,7,6,-57,33,2,3,112,83
63,16,6,2,11,2,65,20,7,3,177,103
63,17,6,2,10,3,-36,21,1,4,141,124
63,18,3,3,4,9,31,-64,2,0,172,60
63,19,5,2,9,4,54,22,6,2,226,82
63,20,3,3,10,3,-63,30,3,2,163,112
63,21,3,3,7,6,34,33,7,5,197,145
63,22,3,4,6,7,-67,43,0,8,130,188
63,23,2,4,6,7,24,-57,4,1,154,131
63,24,2,4,5,8,23,44,7,5,177,175
63,25,5,2,9,4,-46,22,1,7,131,197
63,26,2,4,5,8,23,-56,4,1,154,141
63,27,4,3,6,7,42,34,6,5,196,175
63,28,3,3,7,6,-66,33,0,8,130,208
63,29,3,4,5,8,32,-56,2,2,162,152
63,30,3,4,6,7,33,43,5,5,195,195
63,31,4,3,9,4,-55,31,0,6,140,226
63,32,3,4,5,8,32,-56,2,0,172,170
63,33,5,2,8,5,53,23,5,3,225,193
63,34,2,4,3,10,21,46,6,9,246,239
63,35,5,2,8,5,53,-77,9,2,299,162
63,36,3,3,8,5,-65,32,4,4,234,194
63,37,4,3,8,5,44,32,8,6,278,226
63,38,5,2,9,4,-46,22,2,8,232,248
63,39,3,5,6,7,33,-48,5,0,265,200
63,40,4,3,7,6,43,33,8,3,308,233
63,41,4,2,9,4,-55,22,3,5,253,255
63,42,3,5,7,6,34,51,7,6,287,306
63,43,2,5,8,5,-74,50,3,6,213,356
63,44,2,4,5,8,23,-56,6,0,236,300
63,45,4,3,7,6,43,33,9,3,279,333
63,46,2,5,4,9,-78,54,1,7,201,387
63,47,3,3,6,7,33,-66,4,1,234,321
63,48,4,2,7,6,43,24,7,5,277,345
63,49,3,4,7,6,-66,42,1,7,211,387
63,50,4,2,7,6,43,-76,4,1,254,311
63,51,3,3,7,6,34,33,8,4,288,344
63,52,4,2,10,3,-54,21,4,5,234,365
63,53,2,4,4,9,22,-55,6,0,256,310
63,54,4,3,8,5,-56,32,0,2,200,342
63,55,4,3,8,5,44,32,4,4,244,374
63,56,4,3,8,5,44,32,8,6,288,406
63,57,3,3,5,8,-68,-65,0,1,220,341
63,58,4,3,9,4,45,31,5,2,265,372
63,59,2,4,3,10,21,46,6,8,286,418
63,60,5,2,7,6,52,-76,8,2,338,342
63,61,3,4,7,6,-66,42,2,4,272,384
63,62,2,6,1,12,-20,-34,2,0,252,350
63,63,2,5,5,8,23,53,5,3,275,403
63,64,2,4,5,8,23,44,8,7,298,447
63,65,3,4,7,6,-66,42,2,9,232,489
63,66,3,5,3,10,30,-45,2,4,262,444
63,67,4,3,9,4,45,31,7,5,307,475
63,68,5,2,9,4,-46,22,1,7,261,497
63,69,2,5,3,10,21,-45,2,2,282,452
63,70,2,4,2,11,20,47,2,9,302,499
63,71,4,3,7,6,43,-67,5,2,345,432
63,72,3,4,7,6,34,42,9,4,379,474
63,73,5,2,9,4,-46,22,3,6,333,496
63,74,5,2,8,5,53,23,6,9,386,519
64,1,3,3,5,8,32,35,2,5,32,35
64,2,3,4,8,5,35,41,7,6,67,76
64,3,5,2,10,3,-45,21,2,7,22,97
64,4,3,4,4,9,31,-55,3,2,53,42
64,5,2,4,6,7,24,43,7,5,77,85
64,6,4,3,9,4,-55,31,2,6,22,116
64,7,4,3,7,6,43,33,5,9,65,149
64,8,6,2,9,4,63,-78,8,1,128,71
64,9,2,5,3,10,21,55,9,6,149,126
64,10,3,4,6,7,-67,43,2,9,82,169
64,11,3,4,6,7,33,-57,5,2,115,112
64,12,2,5,5,8,23,53,8,5,138,165
64,13,4,2,6,7,-58,-75,0,0,80,90
64,14,4,3,9,4,45,31,5,1,125,121
64,15,5,2,7,6,52,24,7,5,177,145
64,16,2,5,5,8,-77,53,0,8,100,198
64,17,3,5,6,7,33,-48,3,0,133,150
64,18,3,5,3,10,30,55,3,5,163,205
64,19,2,6,2,11,20,-35,3,0,183,170
64,20,4,2,8,5,44,23,7,3,227,193
64,21,3,3,7,6,-66,33,1,6,161,226
64,22,3,4,5,8,32,-56,3,0,193,170
64,23,2,4,4,9,22,45,5,5,215,215
64,24,2,5,3,10,21,-45,6,0,236,170
64,25,3,3,9,4,-64,31,2,1,172,201
64,26,4,3,6,7,42,34,4,5,214,235
64,27,3,4,7,6,34,42,8,7,248,277
64,28,4,3,6,7,-58,-66,0,1,190,211
64,29,4,3,8,5,44,32,4,3,234,243
64,30,2,4,6,7,24,43,8,6,258,286
64,31,4,3,8,5,-56,32,2,8,202,318
64,32,3,3,8,5,35,-68,7,0,237,250
64,33,5,2,9,4,-46,22,1,2,191,272
64,34,3,3,4,9,31,36,2,8,222,308
64,35,5,2,8,5,53,-77,5,1,275,231
64,36,2,4,3,10,21,46,6,7,296,277
64,37,3,3,7,6,-66,-67,0,0,230,210
64,38,3,5,6,7,33,52,3,2,263,262
64,39,3,3,7,6,34,33,7,5,297,295
64,40,2,5,3,10,21,-45,8,0,318,250
64,41,4,3,5,8,41,35,9,5,359,285
64,42,4,3,8,5,-56,32,3,7,303,317
64,43,4,3,8,5,44,32,7,9,347,349
64,44,3,3,7,6,-66,-67,1,2,281,282
64,45,3,3,6,7,33,34,4,6,314,316
64,46,4,4,9,4,45,40,9,6,359,356
64,47,2,5,4,9,-78,-46,1,0,281,310
64,48,3,3,5,8,32,35,3,5,313,345
64,49,4,2,8,5,44,23,7,8,357,368
64,50,3,4,6,7,-67,-57,0,1,290,311
64,51,2,4,8,5,26,41,6,2,316,352
64,52,2,5,4,9,22,54,8,6,338,406
64,53,4,3,9,4,-55,31,3,7,283,437
64,54,3,4,8,5,35,41,8,8,318,478
64,55,2,4,8,5,-74,41,4,9,244,519
65,1,3,4,5,8,32,44,2,4,32,44
65,2,4,3,7,6,43,33,5,7,75,77
65,3,4,2,8,5,44,-77,9,0,119,0
65,4,5,2,9,4,-46,22,3,2,73,22
65,5,2,5,7,6,25,51,8,3,98,73
65,6,3,4,5,8,-68,44,0,7,30,117
65,7,4,2,7,6,43,-76,3,1,73,41
65,8,3,3,6,7,33,34,6,5,106,75
65,9,4,3,8,5,-56,32,0,7,50,107
65,10,3,3,5,8,32,-65,2,2,82,42
65,11,4,3,9,4,45,31,7,3,127,73
65,12,4,2,9,4,-55,22,2,5,72,95
65,13,2,5,5,8,23,53,5,8,95,148
65,14,5,2,8,5,53,-77,8,1,148,71
65,15,3,4,7,6,-66,42,2,3,82,113
65,16,2,4,5,8,23,44,5,7,105,157
65,17,3,3,5,8,32,-65,7,2,137,92
65,18,3,3,3,10,30,37,7,9,167,129
65,19,2,5,5,8,-77,-47,0,2,90,82
65,20,4,2,9,4,45,22,5,4,135,104
65,21,4,3,9,4,-55,31,0,5,80,135
65,22,2,4,7,6,25,42,5,7,105,177
65,23,3,3,7,6,34,-67,9,0,139,110
65,24,2,5,4,9,-78,54,1,4,61,164
65,25,4,2,9,4,45,22,6,6,106,186
65,26,5,2,9,4,-46,22,0,8,60,208
65,27,4,2,7,6,43,-76,3,2,103,132
65,28,3,3,5,8,32,35,5,7,135,167
65,29,3,3,5,8,32,-65,7,2,167,102
65,30,4,2,10,3,-54,21,3,3,113,123
65,31,3,3,8,5,35,32,8,5,148,155
65,32,5,2,9,4,-46,22,2,7,102,177
65,33,3,3,6,7,33,-66,5,1,135,111
65,34,3,3,7,6,34,33,9,4,169,144
65,35,3,4,5,8,-68,44,1,8,101,188
65,36,3,3,6,7,33,-66,4,2,134,122
65,37,3,4,7,6,34,42,8,4,168,164
65,38,5,2,10,3,-45,21,3,5,123,185
65,39,2,5,4,9,22,54,5,9,145,239
65,40,5,2,10,3,-45,-79,0,0,100,160
65,41,2,4,6,7,24,43,4,3,124,203
65,42,3,3,8,5,35,32,9,5,159,235
65,43,5,3,8,5,-47,32,2,7,112,267
65,44,3,3,4,9,31,-64,3,3,143,203
65,45,3,3,7,6,34,33,7,6,177,236
65,46,5,2,8,5,-47,23,0,9,130,259
65,47,2,5,5,8,23,-47,3,2,153,212
65,48,4,2,10,3,46,21,9,3,199,233
65,49,4,2,10,3,-54,21,5,4,145,254
65,50,4,3,7,6,43,33,8,7,188,287
65,51,4,2,8,5,-56,-77,2,0,132,210
65,52,3,4,7,6,34,42,6,2,166,252
65,53,5,2,9,4,-46,22,0,4,120,274
65,54,2,5,4,9,22,54,2,8,142,328
65,55,2,4,3,10,21,-54,3,4,163,274
65,56,4,3,6,7,42,34,5,8,205,308
65,57,4,3,5,8,41,-65,6,3,246,243
65,58,3,4,5,8,32,44,8,7,278,287
65,59,4,2,8,5,-56,-77,2,0,222,210
65,60,3,3,9,4,36,31,8,1,258,241
65,61,4,3,8,5,-56,32,2,3,202,273
65,62,3,4,5,8,32,44,4,7,234,317
65,63,2,4,5,8,23,-56,7,1,257,261
65,64,4,3,7,6,-57,33,0,4,200,294
65,65,4,3,10,3,46,30,6,4,246,324
65,66,3,3,8,5,-65,32,1,6,181,356
65,67,3,3,6,7,33,-66,4,0,214,290
65,68,4,3,7,6,43,33,7,3,257,323
65,69,3,3,5,8,32,35,9,8,289,358
65,70,2,4,4,9,-78,-55,1,3,211,303
65,71,5,2,10,3,55,21,6,4,266,324
65,72,3,5,3,10,30,55,6,9,296,379
65,73,2,4,4,9,22,-55,8,4,318,324
65,74,3,3,5,8,-68,35,0,9,250,359
65,75,4,2,6,7,42,-75,2,4,292,284
65,76,3,3,6,7,33,34,5,8,325,318
65,77,4,2,8,5,44,-77,9,1,369,241
65,78,2,4,4,9,-78,45,1,6,291,286
65,79,4,2,8,5,44,23,5,9,335,309
65,80,2,5,3,10,21,-45,6,4,356,264
65,81,3,3,5,8,32,35,8,9,388,299
65,82,5,2,10,3,-45,-79,3,0,343,220
65,83,4,3,9,4,45,31,8,1,388,251
65,84,4,2,7,6,-57,24,1,5,331,275
65,85,5,2,6,7,51,-75,2,0,382,200
65,86,3,3,6,7,33,34,5,4,415,234
65,87,3,3,8,5,-65,32,0,6,350,266
65,88,4,2,6,7,42,-75,2,1,392,191
65,89,3,3,6,7,33,34,5,5,425,225
65,90,4,3,8,5,44,32,9,7,469,257
65,91,3,4,4,9,-69,-55,0,2,400,202
65,92,4,2,7,6,43,24,3,6,443,226
65,93,2,6,3,10,21,-36,4,0,464,190
65,94,3,4,4,9,31,45,5,5,495,235
65,95,4,2,10,3,-54,21,1,6,441,256
65,96,3,4,9,4,36,40,7,6,477,296
65,97,4,2,9,4,-55,22,2,8,422,318
65,98,2,4,7,6,25,-58,7,0,447,260
65,99,2,4,4,9,22,45,9,5,469,305
65,100,4,3,8,5,-56,32,3,7,413,337
65,101,2,4,7,6,25,42,8,9,438,379
65,102,6,2,8,5,-38,-77,0,2,400,302
65,103,2,5,3,10,21,55,1,7,421,357
65,104,3,3,6,7,33,-66,4,1,454,291
65,105,2,5,3,10,21,55,5,6,475,346
65,106,3,3,5,8,32,-65,7,1,507,281
66,1,3,3,5,8,32,35,2,5,32,35
66,2,3,4,5,8,32,44,4,9,64,79
66,3,3,3,6,7,33,-66,7,3,97,13
66,4,3,3,6,7,-67,34,0,7,30,47
66,5,3,4,6,7,33,-57,3,0,63,-10
66,6,3,3,7,6,34,33,7,3,97,23
66,7,4,3,7,6,-57,33,0,6,40,56
66,8,2,5,5,8,23,53,3,9,63,109
66,9,4,4,5,8,41,-56,4,3,104,53
66,10,4,3,7,6,43,33,7,6,147,86
66,11,4,3,5,8,41,-65,8,1,188,21
66,12,2,4,5,8,-77,44,1,5,111,65
66,13,5,2,10,3,55,21,6,6,166,86
66,14,2,5,4,9,22,-46,8,0,188,40
66,15,3,3,6,7,-67,34,1,4,121,74
66,16,2,6,4,9,22,63,3,7,143,137
66,17,3,3,6,7,33,-66,6,1,176,71
66,18,3,3,8,5,-65,32,1,3,111,103
66,19,2,4,7,6,25,42,6,5,136,145
66,20,3,3,9,4,-64,31,2,6,72,176
66,21,3,3,7,6,34,33,6,9,106,209
66,22,4,3,6,7,42,-66,8,3,148,143
66,23,2,6,3,10,21,64,9,7,169,207
66,24,3,4,7,6,-66,42,3,9,103,249
66,25,3,4,6,7,33,-57,6,2,136,192
66,26,3,3,7,6,-66,33,0,5,70,225
66,27,5,2,7,6,52,24,2,9,122,249
66,28,2,5,3,10,21,-45,3,4,143,204
66,29,4,2,6,7,42,25,5,9,185,229
66,30,4,3,8,5,44,-68,9,1,229,161
66,31,2,6,5,8,-77,62,2,3,152,223
66,32,3,3,9,4,36,31,8,4,188,254
66,33,4,4,6,7,-58,43,0,7,130,297
66,34,3,5,4,9,31,-46,1,1,161,251
66,35,4,2,9,4,45,22,6,3,206,273
66,36,3,3,7,6,-66,33,0,6,140,306
66,37,4,3,5,8,41,-65,1,1,181,241
66,38,3,3,10,3,37,30,8,1,218,271
66,39,3,4,7,6,-66,42,2,3,152,313
66,40,4,3,6,7,42,34,4,7,194,347
66,41,5,2,11,2,-44,20,0,7,150,367
66,42,5,2,9,4,54,22,4,9,204,389
66,43,4,2,9,4,45,-78,9,1,249,311
66,44,2,5,4,9,-78,54,1,5,171,365
66,45,3,3,5,8,32,-65,3,0,203,300
66,46,2,5,5,8,23,53,6,3,226,353
66,47,2,4,5,8,23,44,9,7,249,397
66,48,3,4,5,8,-68,-56,1,1,181,341
66,49,4,2,10,3,46,21,7,2,227,362
66,50,3,3,6,7,-67,34,0,6,160,396
66,51,4,3,8,5,44,32,4,8,204,428
66,52,4,3,6,7,42,-66,6,2,246,362
66,53,2,5,6,7,-76,52,0,4,170,414
66,54,5,2,8,5,53,23,3,7,223,437
66,55,3,3,5,8,32,-65,5,2,255,372
66,56,4,3,8,5,44,32,9,4,299,404
66,57,4,3,9,4,-55,31,4,5,244,435
66,58,4,3,9,4,45,31,9,6,289,466
66,59,3,3,5,8,-68,-65,1,1,221,401
66,60,4,3,8,5,44,32,5,3,265,433
66,61,3,3,7,6,34,33,9,6,299,466
66,62,2,4,7,6,-75,42,4,8,224,508
67,1,2,6,4,9,22,63,2,3,22,63
67,2,4,3,9,4,45,31,7,4,67,94
67,3,4,3,7,6,-57,33,0,7,10,127
67,4,3,4,5,8,32,-56,2,1,42,71
67,5,5,2,9,4,54,22,6,3,96,93
67,6,2,6,3,10,21,64,7,7,117,157
67,7,4,2,6,7,42,-75,9,2,159,82
67,8,3,5,4,9,-69,54,0,6,90,136
67,9,2,5,5,8,23,53,3,9,113,189
67,10,3,4,4,9,31,-55,4,4,144,134
67,11,3,3,6,7,33,34,7,8,177,168
67,12,4,3,7,6,-57,-67,0,1,120,101
67,13,2,4,5,8,23,44,3,5,143,145
67,14,3,3,8,5,35,32,8,7,178,177
67,15,2,5,3,10,21,-45,9,2,199,132
67,16,4,3,5,8,-59,35,0,7,140,167
67,17,3,3,8,5,35,32,5,9,175,199
67,18,5,2,7,6,52,-76,7,3,227,123
67,19,5,2,8,5,-47,23,0,6,180,146
67,20,4,2,9,4,45,22,5,8,225,168
67,21,4,3,9,4,-55,31,0,9,170,199
67,22,3,4,5,8,32,-56,2,3,202,143
67,23,2,6,3,10,21,64,3,7,223,207
67,24,2,6,3,10,21,-36,4,1,244,171
67,25,3,3,7,6,34,33,8,4,278,204
67,26,3,3,6,7,-67,34,1,8,211,238
67,27,4,2,8,5,44,-77,5,1,255,161
67,28,2,4,4,9,22,45,7,6,277,206
67,29,3,4,6,7,-67,43,0,9,210,249
67,30,4,3,7,6,43,-67,3,2,253,182
67,31,3,3,5,8,32,35,5,7,285,217
67,32,3,4,5,8,32,-56,7,1,317,161
67,33,4,3,5,8,41,35,8,6,358,196
67,34,4,3,7,6,-57,33,1,9,301,229
67,35,3,3,5,8,32,-65,3,4,333,164
67,36,3,3,6,7,33,34,6,8,366,198
67,37,2,6,3,10,21,-36,7,2,387,162
67,38,2,5,5,8,-77,53,0,5,310,215
67,39,5,3,9,4,54,31,4,6,364,246
67,40,4,3,5,8,41,-65,5,1,405,181
67,41,3,4,6,7,33,43,8,4,438,224
67,42,3,3,9,4,-64,31,4,5,374,255
67,43,4,3,8,5,44,32,8,7,418,287
67,44,4,3,5,8,41,-65,9,2,459,222
67,45,4,2,10,3,-54,21,5,3,405,243
67,46,2,4,5,8,23,44,8,7,428,287
67,47,3,3,6,7,-67,-66,1,1,361,221
67,48,3,4,5,8,32,44,3,5,393,265
67,49,5,2,11,2,56,20,9,5,449,285
67,50,2,5,3,10,-79,-45,0,0,370,240
67,51,3,4,5,8,32,44,2,4,402,284
67,52,3,3,6,7,33,34,5,8,435,318
67,53,4,3,9,4,-55,31,0,9,380,349
67,54,5,3,8,5,53,-68,3,1,433,281
67,55,2,5,3,10,21,55,4,6,454,336
67,56,5,2,8,5,53,23,7,9,507,359
68,1,4,3,8,5,44,32,4,2,44,32
68,2,4,3,7,6,43,33,7,5,87,65
68,3,3,4,5,8,32,44,9,9,119,109
68,4,4,2,9,4,-55,-78,4,1,64,31
68,5,4,3,8,5,44,32,8,3,108,63
68,6,3,4,5,8,-68,44,0,7,40,107
68,7,3,3,6,7,33,-66,3,1,73,41
68,8,2,4,5,8,23,44,6,5,96,85
68,9,3,4,6,7,33,43,9,8,129,128
68,10,3,3,8,5,-65,-68,4,0,64,60
68,11,4,2,11,2,-53,20,1,0,11,80
68,12,2,4,6,7,24,43,5,3,35,123
68,13,5,2,7,6,52,24,7,7,87,147
68,14,5,2,9,4,-46,22,1,9,41,169
68,15,3,3,6,7,33,-66,4,3,74,103
68,16,2,5,2,11,20,56,4,9,94,159
68,17,4,3,6,7,42,-66,6,3,136,93
68,18,3,4,4,9,31,45,7,8,167,138
68,19,4,4,7,6,-57,-58,0,0,110,80
68,20,4,3,7,6,43,33,3,3,153,113
68,21,4,3,6,7,42,34,5,7,195,147
68,22,2,4,4,9,22,-55,7,2,217,92
68,23,4,3,8,5,-56,32,1,4,161,124
68,24,4,3,7,6,43,33,4,7,204,157
68,25,3,4,6,7,33,-57,7,0,237,100
68,26,2,4,6,7,-76,43,1,3,161,143
68,27,3,3,6,7,33,34,4,7,194,177
68,28,3,3,6,7,33,-66,7,1,227,111
68,29,6,2,10,3,-36,21,1,2,191,132
68,30,4,3,8,5,44,32,5,4,235,164
68,31,2,4,5,8,23,44,8,8,258,208
68,32,4,2,8,5,-56,-77,2,1,202,131
68,33,4,2,10,3,46,21,8,2,248,152
68,34,5,2,8,5,-47,23,1,5,201,175
68,35,4,4,7,6,43,42,4,7,244,217
68,36,6,2,9,4,63,22,7,9,307,239
68,37,3,3,10,3,-63,30,4,9,244,269
68,38,3,4,6,7,33,-57,7,2,277,212
68,39,3,3,6,7,-67,34,0,6,210,246
68,40,3,3,9,4,36,31,6,7,246,277
68,41,3,3,6,7,33,-66,9,1,279,211
68,42,4,2,7,6,-57,24,2,5,222,235
68,43,5,2,9,4,54,22,6,7,276,257
68,44,2,4,3,10,21,-54,7,3,297,203
68,45,4,3,9,4,-55,31,2,4,242,234
68,46,5,2,9,4,54,22,6,6,296,256
68,47,5,2,9,4,-46,22,0,8,250,278
68,48,3,4,5,8,32,-56,2,2,282,222
68,49,5,2,7,6,52,24,4,6,334,246
68,50,4,2,9,4,45,22,9,8,379,268
68,51,5,2,10,3,-45,21,4,9,334,289
68,52,2,4,7,6,25,-58,9,1,359,231
68,53,2,5,2,11,20,56,9,7,379,287
68,54,3,3,8,5,-65,32,4,9,314,319
68,55,4,3,5,8,41,-65,5,4,355,254
68,56,4,2,11,2,-53,20,2,4,302,274
68,57,4,3,6,7,42,34,4,8,344,308
68,58,4,3,6,7,42,-66,6,2,386,242
68,59,2,4,5,8,23,44,9,6,409,286
68,60,3,4,5,8,-68,-56,1,0,341,230
68,61,5,2,10,3,55,21,6,1,396,251
68,62,4,3,4,9,40,36,6,7,436,287
68,63,3,4,5,8,32,-56,8,1,468,231
68,64,3,4,4,9,31,45,9,6,499,276
68,65,3,3,9,4,-64,31,5,7,435,307
68,66,3,3,7,6,34,-67,9,0,469,240
68,67,4,3,8,5,-56,32,3,2,413,272
68,68,3,4,7,6,34,42,7,4,447,314
68,69,4,2,5,8,41,-74,8,0,488,240
68,70,2,5,6,7,-76,52,2,2,412,292
68,71,4,3,7,6,43,33,5,5,455,325
68,72,4,3,6,7,42,34,7,9,497,359
68,73,3,4,3,10,30,-54,7,5,527,305
69,1,5,2,8,5,53,23,3,3,53,23
69,2,4,2,10,3,46,21,9,4,99,44
69,3,3,3,6,7,-67,34,2,8,32,78
69,4,3,4,5,8,32,-56,4,2,64,22
69,5,5,2,8,5,53,23,7,5,117,45
69,6,4,3,7,6,-57,33,0,8,60,78
69,7,4,2,7,6,43,-76,3,2,103,2
69,8,2,4,6,7,24,43,7,5,127,45
69,9,2,4,4,9,22,-55,9,0,149,-10
69,10,3,3,7,6,-66,33,3,3,83,23
69,11,3,4,7,6,34,42,7,5,117,65
69,12,5,2,10,3,-45,21,2,6,72,86
69,13,6,2,7,6,61,-76,3,0,133,10
69,14,3,4,5,8,32,44,5,4,165,54
69,15,2,4,7,6,-75,42,0,6,90,96
69,16,4,3,7,6,43,33,3,9,133,129
69,17,4,2,9,4,45,-78,8,1,178,51
69,18,4,3,8,5,-56,32,2,3,122,83
69,19,3,3,6,7,33,34,5,7,155,117
69,20,4,3,5,8,41,-65,6,2,196,52
69,21,3,3,5,8,32,35,8,7,228,87
69,22,5,2,9,4,-46,22,2,9,182,109
69,23,2,5,5,8,23,-47,5,2,205,62
69,24,4,3,9,4,-55,31,0,3,150,93
69,25,4,2,5,8,41,26,1,9,191,119
69,26,3,4,6,7,33,-57,4,2,224,62
69,27,3,4,6,7,33,43,7,5,257,105
69,28,4,3,6,7,42,34,9,9,299,139
69,29,3,4,4,9,-69,-55,0,4,230,84
69,30,3,3,10,3,37,30,7,4,267,114
69,31,2,5,6,7,-76,52,1,6,191,166
69,32,4,3,8,5,44,32,5,8,235,198
69,33,3,3,6,7,33,-66,8,2,268,132
69,34,3,3,7,6,-66,33,2,5,202,165
69,35,4,3,9,4,45,31,7,6,247,196
69,36,4,3,5,8,41,-65,8,1,288,131
69,37,3,3,6,7,-67,34,1,5,221,165
69,38,5,3,7,6,52,33,3,8,273,198
69,39,3,4,5,8,32,-56,5,2,305,142
69,40,4,3,7,6,43,33,8,5,348,175
69,41,3,4,8,5,-65,41,3,6,283,216
69,42,4,4,6,7,42,43,5,9,325,259
69,43,3,3,8,5,-65,-68,0,1,260,191
69,44,3,4,4,9,31,45,1,6,291,236
69,45,3,3,5,8,32,-65,3,1,323,171
69,46,4,3,8,5,44,32,7,3,367,203
69,47,4,3,9,4,-55,31,2,4,312,234
69,48,2,4,5,8,23,44,5,8,335,278
69,49,3,4,5,8,32,-56,7,2,367,222
69,50,2,7,2,11,20,74,7,6,387,296
69,51,3,3,7,6,-66,33,1,9,321,329
69,52,4,3,6,7,42,-66,3,3,363,263
69,53,4,3,7,6,43,33,6,6,406,296
69,54,5,2,11,2,-44,20,2,6,362,316
69,55,3,3,5,8,32,-65,4,1,394,251
69,56,2,5,3,10,21,55,5,6,415,306
69,57,4,3,6,7,42,-66,7,0,457,240
69,58,3,4,5,8,32,44,9,4,489,284
69,59,4,2,7,6,-57,24,2,8,432,308
69,60,2,5,3,10,21,-45,3,3,453,263
69,61,2,5,7,6,25,51,8,4,478,314
69,62,3,4,8,5,-65,41,3,5,413,355
69,63,5,2,9,4,54,22,7,7,467,377
69,64,2,5,5,8,-77,-47,0,0,390,330
69,65,4,3,8,5,44,32,4,2,434,362
69,66,4,2,10,3,-54,21,0,3,380,383
69,67,5,2,9,4,54,22,4,5,434,405
69,68,6,2,11,2,65,20,9,5,499,425
69,69,4,2,9,4,-55,22,4,7,444,447
69,70,4,3,6,7,42,-66,6,1,486,381
69,71,5,2,11,2,-44,20,2,1,442,401
69,72,2,5,4,9,22,54,4,5,464,455
69,73,4,3,9,4,45,31,9,6,509,486
70,1,3,4,9,4,36,40,6,0,36,40
70,2,3,3,7,6,-66,33,0,3,-30,73
70,3,3,4,5,8,32,44,2,7,2,117
70,4,4,3,8,5,44,32,6,9,46,149
70,5,2,4,4,9,22,-55,8,4,68,94
70,6,5,3,8,5,-47,32,1,6,21,126
70,7,2,4,4,9,22,-55,3,1,43,71
70,8,3,5,6,7,33,52,6,3,76,123
70,9,4,2,7,6,43,24,9,7,119,147
70,10,3,3,4,9,-69,-64,0,3,50,83
70,11,3,4,7,6,34,42,4,5,84,125
70,12,3,3,7,6,34,33,8,8,118,158
70,13,5,2,9,4,-46,-78,2,0,72,80
70,14,4,4,5,8,41,44,3,4,113,124
70,15,3,3,7,6,34,33,7,7,147,157
70,16,3,3,6,7,-67,-66,0,1,80,91
70,17,4,3,9,4,45,31,5,2,125,122
70,18,6,2,8,5,62,23,7,5,187,145
70,19,3,3,7,6,-66,33,1,8,121,178
70,20,3,4,6,7,33,-57,4,1,154,121
70,21,3,4,5,8,32,44,6,5,186,165
70,22,2,5,6,7,-76,52,0,7,110,217
70,23,3,4,6,7,33,-57,3,0,143,160
70,24,4,4,4,9,40,45,3,5,183,205
70,25,3,4,7,6,34,42,7,7,217,247
70,26,2,4,5,8,-77,-56,0,1,140,191
70,27,3,5,4,9,31,54,1,5,171,245
70,28,2,5,5,8,23,53,4,8,194,298
70,29,4,3,6,7,42,-66,6,2,236,232
70,30,2,5,3,10,21,55,7,7,257,287
70,31,4,3,9,4,-55,31,2,8,202,318
70,32,2,5,6,7,24,-48,6,0,226,270
70,33,2,5,3,10,21,55,7,5,247,325
70,34,4,2,10,3,-54,21,3,6,193,346
70,35,5,3,10,3,55,30,8,6,248,376
70,36,4,2,7,6,-57,-76,1,0,191,300
70,37,2,5,3,10,21,55,2,5,212,355
70,38,3,3,6,7,33,34,5,9,245,389
70,39,4,2,10,3,-54,-79,1,0,191,310
70,40,2,5,2,11,20,56,1,6,211,366
70,41,3,4,8,5,35,41,6,7,246,407
70,42,3,4,7,6,-66,42,0,9,180,449
70,43,5,2,8,5,53,-77,3,2,233,372
70,44,2,4,3,10,21,46,4,8,254,418
70,45,4,3,8,5,44,-68,8,0,298,350
70,46,5,2,8,5,-47,23,1,3,251,373
70,47,2,5,4,9,22,54,3,7,273,427
70,48,3,4,5,8,32,-56,5,1,305,371
70,49,4,3,6,7,42,34,7,5,347,405
70,50,3,4,4,9,31,-55,8,0,378,350
70,51,2,5,5,8,-77,53,1,3,301,403
70,52,3,3,7,6,34,33,5,6,335,436
70,53,3,3,7,6,34,33,9,9,369,469
70,54,4,2,8,5,-56,-77,3,2,313,392
70,55,5,2,9,4,54,22,7,4,367,414
70,56,3,3,8,5,-65,32,2,6,302,446
70,57,4,3,7,6,43,33,5,9,345,479
70,58,5,2,9,4,54,-78,9,1,399,401
70,59,2,5,5,8,-77,53,2,4,322,454
70,60,2,6,3,10,21,64,3,8,343,518
71,1,3,4,7,6,34,42,4,2,34,42
71,2,5,3,10,3,55,30,9,2,89,72
71,3,5,2,11,2,-44,20,5,2,45,92
71,4,2,5,3,10,21,55,6,7,66,147
71,5,3,4,7,6,-66,42,0,9,0,189
71,6,2,4,8,5,26,-59,6,0,26,130
71,7,4,3,8,5,-56,32,0,2,-30,162
71,8,4,3,7,6,43,33,3,5,13,195
71,9,5,2,8,5,53,23,6,8,66,218
71,10,4,3,8,5,-56,-68,0,0,10,150
71,11,3,4,5,8,32,44,2,4,42,194
71,12,4,3,6,7,42,34,4,8,84,228
71,13,4,4,5,8,41,-56,5,2,125,172
71,14,3,3,4,9,31,36,6,8,156,208
71,15,5,2,10,3,-45,21,1,9,111,229
71,16,4,3,6,7,42,-66,3,3,153,163
71,17,4,3,10,3,46,30,9,3,199,193
71,18,4,3,7,6,-57,33,2,6,142,226
71,19,5,2,10,3,55,21,7,7,197,247
71,20,3,3,8,5,-65,32,2,9,132,279
71,21,6,2,11,2,65,20,7,9,197,299
71,22,2,5,5,8,-77,-47,0,2,120,252
71,23,3,4,6,7,33,43,3,5,153,295
71,24,3,3,9,4,36,31,9,6,189,326
71,25,4,3,6,7,-58,-66,1,0,131,260
71,26,3,4,8,5,35,41,6,1,166,301
71,27,4,3,10,3,-54,30,2,1,112,331
71,28,3,4,7,6,34,42,6,3,146,373
71,29,3,4,5,8,32,44,8,7,178,417
71,30,4,3,6,7,-58,-66,0,1,120,351
71,31,3,3,7,6,34,33,4,4,154,384
71,32,3,3,4,9,31,-64,5,0,185,320
71,33,4,2,8,5,44,23,9,3,229,343
71,34,4,3,10,3,-54,30,5,3,175,373
71,35,3,4,7,6,34,42,9,5,209,415
71,36,3,4,7,6,-66,42,3,7,143,457
71,37,4,3,9,4,45,31,8,8,188,488
71,38,2,4,5,8,-77,-56,1,2,111,432
71,39,3,4,9,4,36,40,7,2,147,472
71,40,2,4,7,6,-75,42,2,4,72,514
72,1,2,4,4,9,22,45,2,5,22,45
72,2,2,5,4,9,22,54,4,9,44,99
72,3,3,3,7,6,34,-67,8,2,78,32
72,4,3,3,6,7,-67,34,1,6,11,66
72,5,4,2,11,2,47,20,8,6,58,86
72,6,3,3,4,9,31,-64,9,2,89,22
72,7,3,4,7,6,-66,42,3,4,23,64
72,8,3,4,9,4,36,40,9,4,59,104
72,9,5,2,9,4,-46,22,3,6,13,126
72,10,4,3,6,7,42,-66,5,0,55,60
72,11,2,5,4,9,22,54,7,4,77,114
72,12,5,2,10,3,-45,21,2,5,32,135
72,13,4,3,6,7,42,34,4,9,74,169
72,14,6,2,11,2,65,20,9,9,139,189
72,15,5,2,8,5,-47,-77,2,2,92,112
72,16,2,4,5,8,23,44,5,6,115,156
72,17,4,3,7,6,43,33,8,9,158,189
72,18,4,3,9,4,-55,-69,3,0,103,120
72,19,4,3,6,7,42,34,5,4,145,154
72,20,3,3,7,6,34,33,9,7,179,187
72,21,3,4,6,7,-67,-57,2,0,112,130
72,22,5,2,7,6,52,24,4,4,164,154
72,23,3,3,6,7,33,34,7,8,197,188
72,24,3,3,4,9,31,-64,8,4,228,124
72,25,4,3,7,6,-57,33,1,7,171,157
72,26,4,2,10,3,46,21,7,8,217,178
72,27,5,2,11,2,-44,20,3,8,173,198
72,28,2,4,6,7,24,-57,7,1,197,141
72,29,3,3,6,7,-67,34,0,5,130,175
72,30,2,5,5,8,23,53,3,8,153,228
72,31,4,3,7,6,43,-67,6,1,196,161
72,32,4,2,9,4,-55,22,1,3,141,183
72,33,3,3,7,6,34,33,5,6,175,216
72,34,3,4,7,6,34,42,9,8,209,258
72,35,4,4,6,7,-58,-57,1,1,151,201
72,36,3,4,6,7,33,43,4,4,184,244
72,37,2,4,4,9,22,45,6,9,206,289
72,38,3,5,3,10,30,-45,6,4,236,244
72,39,3,3,6,7,33,34,9,8,269,278
72,40,4,3,8,5,-56,-68,3,0,213,210
72,41,2,6,3,10,21,64,4,4,234,274
72,42,4,3,9,4,45,31,9,5,279,305
72,43,2,4,6,7,-76,43,3,8,203,348
72,44,5,2,10,3,55,21,8,9,258,369
72,45,2,5,3,10,21,-45,9,4,279,324
72,46,4,3,6,7,-58,34,1,8,221,358
72,47,4,2,9,4,45,-78,6,0,266,280
72,48,2,5,4,9,22,54,8,4,288,334
72,49,3,5,5,8,-68,53,0,7,220,387
72,50,3,4,6,7,33,-57,3,0,253,330
72,51,3,4,6,7,33,43,6,3,286,373
72,52,2,4,4,9,22,45,8,8,308,418
72,53,3,3,7,6,-66,-67,2,1,242,351
72,54,4,3,6,7,42,34,4,5,284,385
72,55,4,3,8,5,44,32,8,7,328,417
72,56,3,4,4,9,31,-55,9,2,359,362
72,57,4,2,8,5,-56,23,3,5,303,385
72,58,4,2,7,6,43,24,6,9,346,409
72,59,3,3,5,8,32,-65,8,4,378,344
72,60,3,4,4,9,31,45,9,9,409,389
72,61,4,2,7,6,-57,-76,2,3,352,313
72,62,2,5,4,9,22,54,4,7,374,367
72,63,5,2,10,3,55,21,9,8,429,388
72,64,3,4,4,9,-69,-55,0,3,360,333
72,65,2,5,3,10,21,55,1,8,381,388
72,66,3,3,7,6,34,-67,5,1,415,321
72,67,3,3,6,7,33,34,8,5,448,355
72,68,6,2,11,2,-35,20,3,5,413,375
72,69,3,4,5,8,32,44,5,9,445,419
72,70,4,3,7,6,43,-67,8,2,488,352
72,71,2,5,4,9,-78,54,0,6,410,406
72,72,2,4,6,7,24,43,4,9,434,449
72,73,3,3,7,6,34,-67,8,2,468,382
72,74,4,3,7,6,-57,33,1,5,411,415
72,75,2,5,7,6,25,51,6,6,436,466
72,76,4,3,8,5,-56,32,0,8,380,498
72,77,3,3,5,8,32,-65,2,3,412,433
72,78,6,2,11,2,65,20,7,3,477,453
72,79,4,4,6,7,42,43,9,6,519,496
73,1,3,4,9,4,36,40,6,0,36,40
73,2,5,2,9,4,-46,22,0,2,-10,62
73,3,3,3,8,5,35,32,5,4,25,94
73,4,3,3,7,6,34,33,9,7,59,127
73,5,3,4,7,6,-66,42,3,9,-7,169
73,6,2,4,5,8,23,-56,6,3,16,113
73,7,3,3,5,8,32,35,8,8,48,148
73,8,2,5,5,8,-77,-47,1,1,-29,101
73,9,3,3,7,6,34,33,5,4,5,134
73,10,4,2,7,6,43,24,8,8,48,158
73,11,4,3,6,7,-58,-66,0,2,-10,92
73,12,4,3,8,5,44,32,4,4,34,124
73,13,2,4,3,10,21,-54,5,0,55,70
73,14,4,2,7,6,43,24,8,4,98,94
73,15,5,2,10,3,-45,21,3,5,53,115
73,16,2,4,3,10,21,-54,4,1,74,61
73,17,4,3,6,7,42,34,6,5,116,95
73,18,2,6,3,10,21,64,7,9,137,159
73,19,3,4,8,5,-65,-59,2,0,72,100
73,20,4,2,7,6,43,24,5,4,115,124
73,21,4,3,9,4,-55,31,0,5,60,155
73,22,4,3,8,5,44,32,4,7,104,187
73,23,3,3,4,9,31,-64,5,3,135,123
73,24,4,2,8,5,44,23,9,6,179,146
73,25,4,3,8,5,-56,32,3,8,123,178
73,26,4,2,7,6,43,-76,6,2,166,102
73,27,4,2,10,3,-54,21,2,3,112,123
73,28,4,4,8,5,44,41,6,4,156,164
73,29,3,3,7,6,-66,33,0,7,90,197
73,30,2,4,7,6,25,42,5,9,115,239
73,31,5,3,7,6,52,-67,7,2,167,172
73,32,2,4,5,8,-77,44,0,6,90,216
73,33,3,5,3,10,30,-45,0,1,120,171
73,34,2,4,5,8,23,44,3,5,143,215
73,35,3,3,5,8,32,-65,5,0,175,150
73,36,4,2,8,5,44,23,9,3,219,173
73,37,3,4,6,7,-67,43,2,6,152,216
73,38,4,2,7,6,43,-76,5,0,195,140
73,39,6,2,11,2,-35,20,0,0,160,160
73,40,3,4,3,10,30,46,0,6,190,206
73,41,2,4,5,8,23,-56,3,0,213,150
73,42,4,2,6,7,42,25,5,5,255,175
73,43,3,3,7,6,34,33,9,8,289,208
73,44,2,5,3,10,-79,-45,0,3,210,163
73,45,2,4,4,9,22,45,2,8,232,208
73,46,4,2,8,5,44,-77,6,1,276,131
73,47,4,3,7,6,43,33,9,4,319,164
73,48,3,3,8,5,-65,32,4,6,254,196
73,49,3,3,8,5,35,32,9,8,289,228
73,50,4,3,8,5,-56,-68,3,0,233,160
73,51,4,2,7,6,43,24,6,4,276,184
73,52,2,5,3,10,21,55,7,9,297,239
73,53,3,4,4,9,31,-55,8,4,328,184
73,54,3,4,5,8,-68,44,0,8,260,228
73,55,3,4,4,9,31,-55,1,3,291,173
73,56,3,3,4,9,31,36,2,9,322,209
73,57,4,3,6,7,42,-66,4,3,364,143
73,58,2,5,3,10,21,55,5,8,385,198
73,59,4,3,7,6,43,-67,8,1,428,131
73,60,4,2,11,2,-53,20,5,1,375,151
73,61,4,3,7,6,43,33,8,4,418,184
73,62,3,3,4,9,31,-64,9,0,449,120
73,63,3,4,8,5,-65,41,4,1,384,161
73,64,2,4,5,8,23,44,7,5,407,205
73,65,3,4,4,9,31,-55,8,0,438,150
73,66,3,4,6,7,-67,43,1,3,371,193
73,67,2,5,5,8,23,53,4,6,394,246
73,68,4,3,7,6,43,33,7,9,437,279
73,69,3,3,7,6,-66,-67,1,2,371,212
73,70,3,4,4,9,31,45,2,7,402,257
73,71,3,4,7,6,34,42,6,9,436,299
73,72,6,2,9,4,63,-78,9,1,499,221
73,73,4,3,7,6,-57,33,2,4,442,254
73,74,4,3,7,6,43,33,5,7,485,287
73,75,3,4,6,7,33,-57,8,0,518,230
74,1,2,4,3,10,21,46,1,6,21,46
74,2,2,4,3,10,21,-54,2,2,42,-8
74,3,3,4,7,6,34,42,6,4,76,34
74,4,4,3,7,6,43,33,9,7,119,67
74,5,5,2,10,3,-45,21,4,8,74,88
74,6,4,2,10,3,-54,21,0,9,20,109
74,7,4,2,5,8,41,-74,1,5,61,35
74,8,4,3,7,6,43,33,4,8,104,68
74,9,4,3,8,5,44,-68,8,0,148,0
74,10,3,3,6,7,-67,34,1,4,81,34
74,11,4,3,6,7,42,34,3,8,123,68
74,12,3,3,5,8,32,-65,5,3,155,3
74,13,4,3,7,6,43,33,8,6,198,36
74,14,5,2,9,4,-46,22,2,8,152,58
74,15,2,5,5,8,23,-47,5,1,175,11
74,16,2,4,8,5,-74,41,1,2,101,52
74,17,2,4,2,11,20,47,1,9,121,99
74,18,3,5,6,7,33,-48,4,1,154,51
74,19,4,2,7,6,43,24,7,5,197,75
74,20,2,4,6,7,-76,43,1,8,121,118
74,21,3,4,7,6,34,-58,5,0,155,60
74,22,2,4,5,8,23,44,8,4,178,104
74,23,3,3,6,7,-67,34,1,8,111,138
74,24,3,3,4,9,31,-64,2,4,142,74
74,25,2,5,5,8,23,53,5,7,165,127
74,26,2,5,2,11,20,-44,5,3,185,83
74,27,4,2,8,5,44,23,9,6,229,106
74,28,3,3,5,8,-68,-65,1,1,161,41
74,29,2,4,5,8,23,44,4,5,184,85
74,30,3,3,6,7,33,34,7,9,217,119
74,31,4,3,8,5,-56,-68,1,1,161,51
74,32,4,3,5,8,41,35,2,6,202,86
74,33,4,2,9,4,45,22,7,8,247,108
74,34,5,3,8,5,-47,-68,0,0,200,40
74,35,4,3,6,7,42,34,2,4,242,74
74,36,3,3,5,8,32,35,4,9,274,109
74,37,3,4,7,6,34,-58,8,1,308,51
74,38,4,2,7,6,-57,24,1,5,251,75
74,39,3,3,6,7,33,34,4,9,284,109
74,40,3,4,5,8,32,-56,6,3,316,53
74,41,3,4,8,5,-65,41,1,4,251,94
74,42,3,3,5,8,32,35,3,9,283,129
74,43,2,4,5,8,23,-56,6,3,306,73
74,44,2,5,4,9,22,54,8,7,328,127
74,45,4,3,8,5,-56,32,2,9,272,159
74,46,3,3,6,7,33,-66,5,3,305,93
74,47,3,4,6,7,33,43,8,6,338,136
74,48,3,4,6,7,-67,43,1,9,271,179
74,49,4,2,7,6,43,-76,4,3,314,103
74,50,4,3,8,5,44,32,8,5,358,135
74,51,4,3,6,7,-58,34,0,9,300,169
74,52,5,2,8,5,53,-77,3,2,353,92
74,53,5,2,8,5,53,23,6,5,406,115
74,54,3,4,6,7,33,43,9,8,439,158
74,55,3,4,4,9,-69,-55,0,3,370,103
74,56,5,2,10,3,55,21,5,4,425,124
74,57,4,3,7,6,43,33,8,7,468,157
74,58,4,3,8,5,-56,32,2,9,412,189
74,59,4,3,7,6,43,-67,5,2,455,122
74,60,3,3,4,9,31,36,6,8,486,158
74,61,4,2,8,5,-56,-77,0,1,430,81
74,62,2,4,6,7,24,43,4,4,454,124
74,63,2,4,3,10,21,-54,5,0,475,70
74,64,4,3,5,8,41,35,6,5,516,105
75,1,3,3,6,7,33,34,3,4,33,34
75,2,6,2,11,2,65,20,8,4,98,54
75,3,4,3,10,3,-54,30,4,4,44,84
75,4,2,6,3,10,21,64,5,8,65,148
75,5,4,2,8,5,44,-77,9,1,109,71
75,6,2,5,3,10,-79,55,0,6,30,126
75,7,4,3,7,6,43,33,3,9,73,159
75,8,3,3,7,6,34,-67,7,2,107,92
75,9,4,3,9,4,-55,31,2,3,52,123
75,10,4,3,8,5,44,32,6,5,96,155
75,11,3,3,4,9,31,-64,7,1,127,91
75,12,4,3,7,6,-57,33,0,4,70,124
75,13,4,3,7,6,43,33,3,7,113,157
75,14,3,4,5,8,32,-56,5,1,145,101
75,15,3,3,6,7,33,34,8,5,178,135
75,16,4,3,8,5,-56,32,2,7,122,167
75,17,3,4,9,4,36,40,8,7,158,207
75,18,4,2,10,3,-54,21,4,8,104,228
75,19,3,4,6,7,33,-57,7,1,137,171
75,20,4,3,8,5,-56,32,1,3,81,203
75,21,5,2,9,4,54,22,5,5,135,225
75,22,2,5,5,8,23,53,8,8,158,278
75,23,3,3,7,6,-66,-67,2,1,92,211
75,24,3,4,4,9,31,45,3,6,123,256
75,25,3,4,6,7,33,43,6,9,156,299
75,26,2,4,6,7,-76,-57,0,2,80,242
75,27,4,3,7,6,43,33,3,5,123,275
75,28,2,4,3,10,21,-54,4,1,144,221
75,29,5,2,7,6,52,24,6,5,196,245
75,30,2,5,7,6,-75,51,1,6,121,296
75,31,4,3,7,6,43,33,4,9,164,329
75,32,2,5,3,10,21,-45,5,4,185,284
75,33,4,2,9,4,-55,22,0,6,130,306
75,34,4,4,8,5,44,41,4,7,174,347
75,35,5,2,9,4,54,22,8,9,228,369
75,36,3,3,6,7,-67,-66,1,3,161,303
75,37,3,3,4,9,31,36,2,9,192,339
75,38,3,3,4,9,31,-64,3,5,223,275
75,39,2,5,3,10,21,-45,4,0,244,230
75,40,4,3,7,6,43,33,7,3,287,263
75,41,2,5,4,9,22,54,9,7,309,317
75,42,2,4,4,9,-78,-55,1,2,231,262
75,43,4,3,7,6,43,33,4,5,274,295
75,44,4,4,6,7,42,43,6,8,316,338
75,45,2,4,6,7,-76,-57,0,1,240,281
75,46,2,5,5,8,23,53,3,4,263,334
75,47,5,2,10,3,55,21,8,5,318,355
75,48,4,3,7,6,-57,33,1,8,261,388
75,49,6,2,10,3,64,21,5,9,325,409
75,50,4,3,9,4,-55,-69,0,0,270,340
75,51,2,5,2,11,20,56,0,6,290,396
75,52,2,4,4,9,22,-55,2,1,312,341
75,53,3,4,6,7,33,43,5,4,345,384
75,54,4,3,9,4,-55,31,0,5,290,415
75,55,3,3,8,5,35,32,5,7,325,447
75,56,4,4,5,8,41,-56,6,1,366,391
75,57,4,3,8,5,-56,32,0,3,310,423
75,58,3,3,4,9,31,36,1,9,341,459
75,59,3,3,7,6,34,-67,5,2,375,392
75,60,4,3,7,6,43,33,8,5,418,425
75,61,4,3,9,4,-55,31,3,6,363,456
75,62,3,3,5,8,32,-65,5,1,395,391
75,63,2,5,3,10,21,55,6,6,416,446
75,64,3,3,9,4,-64,31,2,7,352,477
75,65,3,4,7,6,34,42,6,9,386,519
76,1,3,3,7,6,34,33,4,3,34,33
76,2,3,3,6,7,33,34,7,7,67,67
76,3,4,3,6,7,42,-66,9,1,109,1
76,4,4,3,9,4,-55,31,4,2,54,32
76,5,3,3,8,5,35,32,9,4,89,64
76,6,5,2,9,4,-46,22,3,6,43,86
76,7,3,3,7,6,34,33,7,9,77,119
76,8,3,5,3,10,30,-45,7,4,107,74
76,9,3,3,5,8,32,35,9,9,139,109
76,10,2,4,4,9,-78,-55,1,4,61,54
76,11,5,2,8,5,53,23,4,7,114,77
76,12,4,2,7,6,43,-76,7,1,157,1
76,13,4,3,7,6,-57,33,0,4,100,34
76,14,5,2,9,4,54,22,4,6,154,56
76,15,3,4,7,6,34,42,8,8,188,98
76,16,2,4,4,9,-78,-55,0,3,110,43
76,17,3,4,8,5,35,41,5,4,145,84
76,18,2,6,1,12,-20,-34,5,0,125,50
76,19,4,3,5,8,41,35,6,5,166,85
76,20,2,4,7,6,-75,42,1,7,91,127
76,21,3,3,5,8,32,-65,3,2,123,62
76,22,3,4,5,8,32,44,5,6,155,106
76,23,5,2,9,4,54,22,9,8,209,128
76,24,3,3,6,7,-67,-66,2,2,142,62
76,25,3,4,8,5,35,41,7,3,177,103
76,26,4,2,10,3,-54,21,3,4,123,124
76,27,2,5,4,9,22,54,5,8,145,178
76,28,5,2,11,2,-44,20,1,8,101,198
76,29,4,2,7,6,43,-76,4,2,144,122
76,30,4,2,5,8,41,26,5,8,185,148
76,31,3,3,8,5,-65,-68,0,0,120,80
76,32,4,3,5,8,41,35,1,5,161,115
76,33,2,5,5,8,23,53,4,8,184,168
76,34,4,3,9,4,45,31,9,9,229,199
76,35,2,5,5,8,-77,-47,2,2,152,152
76,36,3,4,5,8,32,44,4,6,184,196
76,37,5,2,8,5,53,23,7,9,237,219
76,38,2,4,8,5,-74,-59,3,0,163,160
76,39,3,3,6,7,33,34,6,4,196,194
76,40,2,5,3,10,21,55,7,9,217,249
76,41,2,4,6,7,-76,-57,1,2,141,192
76,42,2,4,5,8,23,44,4,6,164,236
76,43,3,3,6,7,33,-66,7,0,197,170
76,44,2,4,5,8,-77,44,0,4,120,214
76,45,4,3,7,6,43,33,3,7,163,247
76,46,4,3,5,8,41,-65,4,2,204,182
76,47,3,4,4,9,31,45,5,7,235,227
76,48,3,4,3,10,30,-54,5,3,265,173
76,49,2,4,6,7,24,43,9,6,289,216
76,50,5,2,11,2,-44,20,5,6,245,236
76,51,4,3,9,4,-55,31,0,7,190,267
76,52,5,2,9,4,54,22,4,9,244,289
76,53,4,2,9,4,45,-78,9,1,289,211
76,54,4,3,6,7,-58,34,1,5,231,245
76,55,4,3,7,6,43,33,4,8,274,278
76,56,2,5,4,9,22,-46,6,2,296,232
76,57,3,4,7,6,-66,42,0,4,230,274
76,58,6,2,10,3,64,21,4,5,294,295
76,59,5,2,6,7,51,-75,5,0,345,220
76,60,3,3,8,5,-65,32,0,2,280,252
76,61,4,3,6,7,42,34,2,6,322,286
76,62,5,2,10,3,55,21,7,7,377,307
76,63,2,6,3,10,21,-36,8,1,398,271
76,64,4,2,9,4,-55,22,3,3,343,293
76,65,5,2,8,5,53,23,6,6,396,316
76,66,4,3,6,7,42,-66,8,0,438,250
76,67,2,5,2,11,20,56,8,6,458,306
76,68,4,3,5,8,41,-65,9,1,499,241
76,69,4,3,8,5,-56,32,3,3,443,273
76,70,4,4,6,7,42,43,5,6,485,316
76,71,2,6,2,11,20,-35,5,1,505,281
77,1,3,3,6,7,33,34,3,4,33,34
77,2,3,5,5,8,32,53,5,7,65,87
77,3,3,4,4,9,31,-55,6,2,96,32
77,4,2,5,3,10,21,55,7,7,117,87
77,5,2,4,6,7,-76,-57,1,0,41,30
77,6,2,4,4,9,22,45,3,5,63,75
77,7,5,2,10,3,55,21,8,6,118,96
77,8,4,3,5,8,41,-65,9,1,159,31
77,9,2,4,6,7,-76,43,3,4,83,74
77,10,2,5,6,7,24,52,7,6,107,126
77,11,3,4,4,9,31,-55,8,1,138,71
77,12,3,3,3,10,30,37,8,8,168,108
77,13,5,3,7,6,-48,-67,0,1,120,41
77,14,4,3,9,4,45,31,5,2,165,72
77,15,3,3,8,5,-65,32,0,4,100,104
77,16,4,3,7,6,43,33,3,7,143,137
77,17,4,2,6,7,42,-75,5,2,185,62
77,18,4,2,10,3,-54,21,1,3,131,83
77,19,3,3,7,6,34,33,5,6,165,116
77,20,3,3,5,8,32,-65,7,1,197,51
77,21,3,3,8,5,-65,32,2,3,132,83
77,22,5,2,9,4,54,22,6,5,186,105
77,23,2,6,5,8,23,62,9,7,209,167
77,24,6,2,10,3,-36,21,3,8,173,188
77,25,4,3,7,6,43,-67,6,1,216,121
77,26,4,3,5,8,41,35,7,6,257,156
77,27,3,3,7,6,-66,33,1,9,191,189
77,28,4,3,9,4,45,-69,6,0,236,120
77,29,4,3,8,5,-56,32,0,2,180,152
77,30,4,2,9,4,45,22,5,4,225,174
77,31,3,3,7,6,34,33,9,7,259,207
77,32,3,3,6,7,-67,-66,2,1,192,141
77,33,3,5,3,10,30,55,2,6,222,196
77,34,2,4,5,8,23,-56,5,0,245,140
77,35,4,4,4,9,40,45,5,5,285,185
77,36,4,2,10,3,-54,21,1,6,231,206
77,37,4,3,7,6,43,33,4,9,274,239
77,38,4,2,10,3,-54,-79,0,0,220,160
77,39,5,2,10,3,55,21,5,1,275,181
77,40,2,4,5,8,23,44,8,5,298,225
77,41,4,2,7,6,-57,24,1,9,241,249
77,42,3,3,5,8,32,-65,3,4,273,184
77,43,5,2,9,4,54,22,7,6,327,206
77,44,3,4,4,9,31,-55,8,1,358,151
77,45,3,3,9,4,-64,31,4,2,294,182
77,46,5,2,10,3,55,21,9,3,349,203
77,47,3,3,4,9,-69,36,0,9,280,239
77,48,3,3,6,7,33,-66,3,3,313,173
77,49,2,4,5,8,23,44,6,7,336,217
77,50,2,5,7,6,-75,51,1,8,261,268
77,51,4,3,9,4,45,31,6,9,306,299
77,52,5,2,11,2,-44,20,2,9,262,319
77,53,2,4,4,9,22,-55,4,4,284,264
77,54,2,5,4,9,22,54,6,8,306,318
77,55,2,4,6,7,-76,-57,0,1,230,261
77,56,3,4,3,10,30,46,0,7,260,307
77,57,2,5,4,9,22,-46,2,1,282,261
77,58,4,3,9,4,45,31,7,2,327,292
77,59,4,2,9,4,-55,22,2,4,272,314
77,60,2,4,3,10,21,-54,3,0,293,260
77,61,3,3,5,8,32,35,5,5,325,295
77,62,4,3,6,7,42,34,7,9,367,329
77,63,2,5,5,8,-77,-47,0,2,290,282
77,64,4,3,8,5,44,32,4,4,334,314
77,65,2,4,6,7,24,43,8,7,358,357
77,66,5,2,9,4,-46,22,2,9,312,379
77,67,5,2,9,4,54,-78,6,1,366,301
77,68,3,3,6,7,33,34,9,5,399,335
77,69,2,4,6,7,-76,43,3,8,323,378
77,70,3,3,4,9,31,-64,4,4,354,314
77,71,4,3,7,6,43,33,7,7,397,347
77,72,3,3,8,5,-65,32,2,9,332,379
77,73,4,2,8,5,44,-77,6,2,376,302
77,74,3,3,6,7,33,34,9,6,409,336
77,75,2,4,5,8,-77,-56,2,0,332,280
77,76,4,3,7,6,43,33,5,3,375,313
77,77,3,4,7,6,34,42,9,5,409,355
77,78,2,5,7,6,-75,51,4,6,334,406
77,79,4,3,6,7,42,-66,6,0,376,340
77,80,2,5,4,9,22,54,8,4,398,394
77,81,3,4,7,6,-66,42,2,6,332,436
77,82,5,2,10,3,55,21,7,7,387,457
77,83,3,3,9,4,-64,31,3,8,323,488
77,84,4,2,9,4,45,-78,8,0,368,410
77,85,2,5,4,9,-78,54,0,4,290,464
77,86,3,3,6,7,33,34,3,8,323,498
77,87,3,3,5,8,32,-65,5,3,355,433
77,88,2,5,6,7,24,52,9,5,379,485
77,89,5,2,8,5,-47,23,2,8,332,508
78,1,2,5,5,8,23,53,3,3,23,53
78,2,4,2,5,8,41,26,4,9,64,79
78,3,2,4,7,6,25,-58,9,1,89,21
78,4,2,4,4,9,-78,45,1,6,11,66
78,5,2,5,5,8,23,53,4,9,34,119
78,6,3,4,4,9,31,-55,5,4,65,64
78,7,4,3,10,3,-54,30,1,4,11,94
78,8,3,3,6,7,33,34,4,8,44,128
78,9,3,3,7,6,34,-67,8,1,78,61
78,10,3,4,5,8,-68,44,0,5,10,105
78,11,3,3,8,5,35,32,5,7,45,137
78,12,2,4,4,9,22,-55,7,2,67,82
78,13,4,3,7,6,-57,33,0,5,10,115
78,14,2,5,4,9,22,54,2,9,32,169
78,15,5,2,10,3,55,-79,7,0,87,90
78,16,3,3,5,8,32,35,9,5,119,125
78,17,5,2,8,5,-47,23,2,8,72,148
78,18,3,4,6,7,33,-57,5,1,105,91
78,19,4,3,8,5,44,32,9,3,149,123
78,20,3,3,6,7,-67,34,2,7,82,157
78,21,3,3,5,8,32,-65,4,2,114,92
78,22,2,6,2,11,20,65,4,7,134,157
78,23,3,5,6,7,33,52,7,9,167,209
78,24,4,2,9,4,-55,-78,2,1,112,131
78,25,3,3,4,9,31,36,3,7,143,167
78,26,2,5,6,7,24,52,7,9,167,219
78,27,4,3,6,7,42,-66,9,3,209,153
78,28,3,3,6,7,-67,34,2,7,142,187
78,29,3,3,6,7,33,-66,5,1,175,121
78,30,3,4,6,7,33,43,8,4,208,164
78,31,5,2,9,4,-46,22,2,6,162,186
78,32,2,4,7,6,25,42,7,8,187,228
78,33,2,4,6,7,-76,-57,1,1,111,171
78,34,4,2,8,5,44,23,5,4,155,194
78,35,5,2,7,6,52,24,7,8,207,218
78,36,4,2,7,6,-57,-76,0,2,150,142
78,37,4,2,7,6,43,24,3,6,193,166
78,38,3,3,6,7,33,-66,6,0,226,100
78,39,3,3,8,5,-65,32,1,2,161,132
78,40,3,4,8,5,35,41,6,3,196,173
78,41,4,3,7,6,43,33,9,6,239,206
78,42,4,3,8,5,-56,32,3,8,183,238
78,43,4,3,8,5,44,-68,7,0,227,170
78,44,3,4,7,6,-66,42,1,2,161,212
78,45,5,2,10,3,55,21,6,3,216,233
78,46,3,3,9,4,-64,31,2,4,152,264
78,47,3,3,8,5,35,32,7,6,187,296
78,48,5,2,10,3,-45,21,2,7,142,317
78,49,5,2,8,5,53,-77,5,0,195,240
78,50,3,3,5,8,32,35,7,5,227,275
78,51,3,3,6,7,-67,34,0,9,160,309
78,52,3,4,6,7,33,-57,3,2,193,252
78,53,4,2,6,7,42,25,5,7,235,277
78,54,4,3,10,3,-54,30,1,7,181,307
78,55,4,3,10,3,46,30,7,7,227,337
78,56,4,3,7,6,-57,-67,0,0,170,270
78,57,4,3,8,5,44,32,4,2,214,302
78,58,3,4,4,9,31,45,5,7,245,347
78,59,3,3,7,6,34,-67,9,0,279,280
78,60,4,2,11,2,-53,20,6,0,226,300
78,61,4,2,9,4,-55,22,1,2,171,322
78,62,3,4,5,8,32,44,3,6,203,366
78,63,3,4,5,8,32,-56,5,0,235,310
78,64,4,3,9,4,-55,31,0,1,180,341
78,65,4,3,6,7,42,34,2,5,222,375
78,66,3,4,5,8,32,44,4,9,254,419
78,67,4,2,7,6,43,-76,7,3,297,343
78,68,4,3,8,5,-56,32,1,5,241,375
78,69,3,5,7,6,34,51,5,6,275,426
78,70,4,2,9,4,-55,22,0,8,220,448
78,71,6,2,7,6,61,-76,1,2,281,372
78,72,2,4,3,10,21,46,2,8,302,418
78,73,3,3,8,5,35,-68,7,0,337,350
78,74,3,3,9,4,-64,31,3,1,273,381
78,75,3,3,5,8,32,35,5,6,305,416
78,76,3,4,3,10,30,-54,5,2,335,362
78,77,2,4,4,9,22,45,7,7,357,407
78,78,3,3,8,5,-65,32,2,9,292,439
78,79,3,4,4,9,31,-55,3,4,323,384
78,80,2,5,3,10,21,55,4,9,344,439
78,81,2,6,3,10,21,-36,5,3,365,403
78,82,4,2,9,4,-55,22,0,5,310,425
78,83,4,2,10,3,46,21,6,6,356,446
78,84,2,4,6,7,-76,43,0,9,280,489
78,85,4,3,5,8,41,-65,1,4,321,424
78,86,3,3,7,6,34,33,5,7,355,457
78,87,4,2,11,2,-53,20,2,7,302,477
78,88,4,2,8,5,44,-77,6,0,346,400
78,89,3,4,5,8,32,44,8,4,378,444
78,90,2,4,6,7,-76,43,2,7,302,487
78,91,5,2,7,6,52,-76,4,1,354,411
78,92,4,3,8,5,44,32,8,3,398,443
78,93,4,3,6,7,-58,34,0,7,340,477
78,94,3,3,9,4,36,31,6,8,376,508
79,1,3,4,8,5,35,41,5,1,35,41
79,2,2,5,7,6,-75,51,0,2,-40,92
79,3,4,3,8,5,44,32,4,4,4,124
79,4,4,3,9,4,45,31,9,5,49,155
79,5,5,2,10,3,-45,21,4,6,4,176
79,6,6,2,10,3,64,21,8,7,68,197
79,7,2,5,4,9,-78,-46,0,1,-10,151
79,8,3,3,7,6,34,33,4,4,24,184
79,9,4,4,6,7,42,43,6,7,66,227
79,10,4,2,9,4,-55,22,1,9,11,249
79,11,5,2,10,3,55,-79,6,0,66,170
79,12,2,5,3,10,21,55,7,5,87,225
79,13,4,2,9,4,-55,22,2,7,32,247
79,14,2,6,2,11,20,-35,2,2,52,212
79,15,3,3,4,9,31,36,3,8,83,248
79,16,3,3,5,8,32,-65,5,3,115,183
79,17,2,4,5,8,23,44,8,7,138,227
79,18,3,4,5,8,-68,-56,0,1,70,171
79,19,2,5,3,10,21,55,1,6,91,226
79,20,5,2,9,4,54,22,5,8,145,248
79,21,4,2,7,6,43,-76,8,2,188,172
79,22,3,4,6,7,-67,43,1,5,121,215
79,23,4,3,8,5,44,32,5,7,165,247
79,24,5,2,9,4,54,22,9,9,219,269
79,25,4,2,6,7,-58,-75,1,4,161,194
79,26,6,2,11,2,65,20,6,4,226,214
79,27,4,3,9,4,-55,31,1,5,171,245
79,28,6,2,9,4,63,22,4,7,234,267
79,29,3,4,4,9,31,-55,5,2,265,212
79,30,3,3,5,8,32,35,7,7,297,247
79,31,3,4,8,5,-65,41,2,8,232,288
79,32,2,5,3,10,21,-45,3,3,253,243
79,33,2,5,6,7,24,52,7,5,277,295
79,34,4,2,7,6,-57,24,0,9,220,319
79,35,5,2,9,4,54,-78,4,1,274,241
79,36,4,2,6,7,42,25,6,6,316,266
79,37,4,4,7,6,43,42,9,8,359,308
79,38,3,3,7,6,-66,-67,3,1,293,241
79,39,4,3,7,6,43,33,6,4,336,274
79,40,5,3,10,3,-45,30,1,4,291,304
79,41,3,3,9,4,36,31,7,5,327,335
79,42,3,3,7,6,-66,33,1,8,261,368
79,43,3,3,4,9,31,-64,2,4,292,304
79,44,3,3,6,7,33,34,5,8,325,338
79,45,3,4,3,10,30,-54,5,4,355,284
79,46,4,3,6,7,42,34,7,8,397,318
79,47,3,4,5,8,32,-56,9,2,429,262
79,48,3,5,3,10,30,55,9,7,459,317
79,49,3,3,8,5,-65,32,4,9,394,349
79,50,5,3,9,4,54,-69,8,0,448,280
79,51,3,4,7,6,-66,42,2,2,382,322
79,52,2,4,5,8,23,44,5,6,405,366
79,53,6,2,11,2,-35,20,0,6,370,386
79,54,4,2,9,4,45,22,5,8,415,408
79,55,3,3,6,7,33,-66,8,2,448,342
79,56,5,2,7,6,-48,24,0,6,400,366
79,57,2,5,4,9,22,-46,2,0,422,320
79,58,3,4,4,9,31,45,3,5,453,365
79,59,2,5,2,11,20,-44,3,1,473,321
79,60,4,3,6,7,42,34,5,5,515,355
80,1,3,3,7,6,34,33,4,3,34,33
80,2,2,5,4,9,22,54,6,7,56,87
80,3,3,4,4,9,31,-55,7,2,87,32
80,4,2,4,7,6,-75,42,2,4,12,74
80,5,3,3,5,8,32,35,4,9,44,109
80,6,4,2,9,4,45,-78,9,1,89,31
80,7,4,3,7,6,-57,33,2,4,32,64
80,8,3,4,6,7,33,43,5,7,65,107
80,9,2,4,3,10,21,-54,6,3,86,53
80,10,3,4,6,7,33,43,9,6,119,96
80,11,3,4,4,9,-69,-55,0,1,50,41
80,12,5,2,9,4,54,22,4,3,104,63
80,13,5,2,10,3,55,21,9,4,159,84
80,14,3,4,4,9,-69,45,0,9,90,129
80,15,3,3,5,8,32,-65,2,4,122,64
80,16,3,3,7,6,34,33,6,7,156,97
80,17,4,3,5,8,41,-65,7,2,197,32
80,18,4,2,7,6,-57,24,0,6,140,56
80,19,3,3,8,5,35,32,5,8,175,88
80,20,2,4,4,9,22,-55,7,3,197,33
80,21,3,3,4,9,31,36,8,9,228,69
80,22,4,3,9,4,-55,-69,3,0,173,0
80,23,4,3,7,6,43,33,6,3,216,33
80,24,3,3,4,9,31,36,7,9,247,69
80,25,2,4,6,7,-76,-57,1,2,171,12
80,26,3,3,8,5,35,32,6,4,206,44
80,27,4,3,4,9,40,-64,6,0,246,-20
80,28,2,5,5,8,23,53,9,3,269,33
80,29,2,5,4,9,-78,54,1,7,191,87
80,30,4,4,6,7,42,-57,3,0,233,30
80,31,3,4,5,8,32,44,5,4,265,74
80,32,2,4,5,8,23,44,8,8,288,118
80,33,4,3,9,4,-55,31,3,9,233,149
80,34,3,3,4,9,31,-64,4,5,264,85
80,35,3,3,9,4,-64,31,0,6,200,116
80,36,5,2,10,3,55,21,5,7,255,137
80,37,3,4,7,6,34,42,9,9,289,179
80,38,2,4,5,8,-77,-56,2,3,212,123
80,39,5,2,7,6,52,24,4,7,264,147
80,40,3,5,5,8,32,-47,6,0,296,100
80,41,2,4,4,9,22,45,8,5,318,145
80,42,4,3,8,5,-56,32,2,7,262,177
80,43,4,2,9,4,45,22,7,9,307,199
80,44,4,2,7,6,-57,-76,0,3,250,123
80,45,2,5,5,8,23,53,3,6,273,176
80,46,4,2,9,4,45,22,8,8,318,198
80,47,2,5,4,9,-78,-46,0,2,240,152
80,48,4,3,8,5,44,32,4,4,284,184
80,49,3,3,8,5,35,32,9,6,319,216
80,50,4,2,6,7,-58,-75,1,1,261,141
80,51,4,3,8,5,44,32,5,3,305,173
80,52,3,4,6,7,33,43,8,6,338,216
80,53,3,4,6,7,-67,43,1,9,271,259
80,54,4,3,7,6,43,-67,4,2,314,192
80,55,3,3,8,5,35,32,9,4,349,224
80,56,4,2,8,5,-56,23,3,7,293,247
80,57,3,4,6,7,33,-57,6,0,326,190
80,58,4,2,7,6,43,24,9,4,369,214
80,59,2,4,6,7,-76,43,3,7,293,257
80,60,3,3,6,7,33,-66,6,1,326,191
80,61,2,4,8,5,-74,41,2,2,252,232
80,62,2,5,5,8,23,53,5,5,275,285
80,63,3,3,5,8,32,-65,7,0,307,220
80,64,5,2,8,5,-47,23,0,3,260,243
80,65,4,3,8,5,44,32,4,5,304,275
80,66,3,3,8,5,35,32,9,7,339,307
80,67,2,5,6,7,-76,52,3,9,263,359
80,68,2,5,2,11,20,-44,3,5,283,315
80,69,4,3,9,4,45,31,8,6,328,346
80,70,3,3,8,5,-65,32,3,8,263,378
80,71,3,4,7,6,34,-58,7,0,297,320
80,72,3,4,7,6,-66,42,1,2,231,362
80,73,3,3,7,6,34,33,5,5,265,395
80,74,3,5,4,9,31,54,6,9,296,449
80,75,4,3,6,7,42,-66,8,3,338,383
80,76,4,3,7,6,-57,33,1,6,281,416
80,77,3,3,9,4,36,31,7,7,317,447
80,78,4,2,10,3,-54,21,3,8,263,468
80,79,2,5,3,10,21,-45,4,3,284,423
80,80,4,3,7,6,43,33,7,6,327,456
80,81,3,4,5,8,32,-56,9,0,359,400
80,82,3,3,5,8,-68,35,1,5,291,435
80,83,2,4,3,10,21,-54,2,1,312,381
80,84,4,3,7,6,43,33,5,4,355,414
80,85,3,3,5,8,32,35,7,9,387,449
80,86,5,2,9,4,-46,-78,1,1,341,371
80,87,3,3,6,7,33,34,4,5,374,405
80,88,3,3,6,7,33,34,7,9,407,439
80,89,3,4,6,7,-67,-57,0,2,340,382
80,90,3,4,5,8,32,44,2,6,372,426
80,91,2,5,6,7,24,52,6,8,396,478
80,92,3,3,5,8,32,-65,8,3,428,413
80,93,4,3,5,8,41,35,9,8,469,448
80,94,2,4,6,7,-76,-57,3,1,393,391
80,95,4,3,8,5,44,32,7,3,437,423
80,96,2,5,7,6,-75,51,2,4,362,474
80,97,2,4,3,10,21,-54,3,0,383,420
80,98,3,3,8,5,35,32,8,2,418,452
80,99,3,4,8,5,-65,41,3,3,353,493
80,100,3,5,4,9,31,54,4,7,384,547
81,1,4,3,8,5,44,32,4,2,44,32
81,2,2,5,3,10,21,55,5,7,65,87
81,3,3,3,6,7,33,-66,8,1,98,21
81,4,2,4,8,5,-74,41,4,2,24,62
81,5,5,2,11,2,-44,20,0,2,-20,82
81,6,4,3,7,6,43,33,3,5,23,115
81,7,3,4,7,6,34,42,7,7,57,157
81,8,3,3,7,6,-66,-67,1,0,-9,90
81,9,2,4,2,11,20,47,1,7,11,137
81,10,3,3,7,6,34,-67,5,0,45,70
81,11,3,4,7,6,34,42,9,2,79,112
81,12,2,4,3,10,-79,46,0,8,0,158
81,13,5,2,9,4,54,-78,4,0,54,80
81,14,4,3,9,4,45,31,9,1,99,111
81,15,4,2,9,4,-55,22,4,3,44,133
81,16,2,4,4,9,22,45,6,8,66,178
81,17,4,3,6,7,42,-66,8,2,108,112
81,18,3,4,5,8,-68,44,0,6,40,156
81,19,5,2,7,6,52,-76,2,0,92,80
81,20,3,4,7,6,34,42,6,2,126,122
81,21,3,3,7,6,-66,33,0,5,60,155
81,22,4,3,7,6,43,33,3,8,103,188
81,23,3,4,3,10,30,-54,3,4,133,134
81,24,3,4,6,7,33,43,6,7,166,177
81,25,2,4,4,9,22,-55,8,2,188,122
81,26,4,2,10,3,-54,21,4,3,134,143
81,27,4,4,9,4,45,40,9,3,179,183
81,28,3,4,6,7,-67,43,2,6,112,226
81,29,4,3,6,7,42,-66,4,0,154,160
81,30,4,2,7,6,43,24,7,4,197,184
81,31,2,4,5,8,-77,44,0,8,120,228
81,32,4,3,5,8,41,-65,1,3,161,163
81,33,4,2,8,5,44,23,5,6,205,186
81,34,2,4,8,5,-74,41,1,7,131,227
81,35,5,2,9,4,54,22,5,9,185,249
81,36,5,3,9,4,54,-69,9,0,239,180
81,37,4,3,6,7,-58,34,1,4,181,214
81,38,3,3,5,8,32,35,3,9,213,249
81,39,4,3,10,3,46,30,9,9,259,279
81,40,6,2,9,4,-37,-78,2,1,222,201
81,41,3,3,8,5,35,32,7,3,257,233
81,42,3,3,8,5,-65,32,2,5,192,265
81,43,2,4,6,7,24,43,6,8,216,308
81,44,3,3,9,4,-64,31,2,9,152,339
81,45,2,5,6,7,24,-48,6,1,176,291
81,46,5,2,9,4,-46,22,0,3,130,313
81,47,4,2,7,6,43,24,3,7,173,337
81,48,2,6,3,10,21,-36,4,1,194,301
81,49,3,3,7,6,34,33,8,4,228,334
81,50,3,4,4,9,31,45,9,9,259,379
81,51,2,5,4,9,-78,-46,1,3,181,333
81,52,3,4,3,10,30,46,1,9,211,379
81,53,4,2,9,4,45,-78,6,1,256,301
81,54,4,3,8,5,-56,32,0,3,200,333
81,55,3,4,6,7,33,43,3,6,233,376
81,56,2,4,3,10,21,-54,4,2,254,322
81,57,3,4,6,7,33,43,7,5,287,365
81,58,3,3,7,6,-66,33,1,8,221,398
81,59,3,3,7,6,34,-67,5,1,255,331
81,60,2,5,6,7,24,52,9,3,279,383
81,61,4,3,7,6,-57,33,2,6,222,416
81,62,3,3,9,4,36,31,8,7,258,447
81,63,4,3,9,4,-55,31,3,8,203,478
81,64,4,2,9,4,45,-78,8,0,248,400
81,65,3,4,5,8,-68,44,0,4,180,444
81,66,4,2,9,4,45,22,5,6,225,466
81,67,2,4,7,6,-75,42,0,8,150,508
82,1,4,3,5,8,41,35,1,5,41,35
82,2,3,5,5,8,32,53,3,8,73,88
82,3,3,3,6,7,33,-66,6,2,106,22
82,4,2,4,4,9,22,45,8,7,128,67
82,5,3,4,7,6,-66,42,2,9,62,109
82,6,3,4,7,6,34,-58,6,1,96,51
82,7,4,4,5,8,41,44,7,5,137,95
82,8,4,3,8,5,-56,32,1,7,81,127
82,9,3,3,7,6,34,-67,5,0,115,60
82,10,3,3,7,6,34,33,9,3,149,93
82,11,5,2,7,6,-48,24,1,7,101,117
82,12,4,3,6,7,42,-66,3,1,143,51
82,13,4,2,8,5,44,23,7,4,187,74
82,14,3,3,5,8,32,35,9,9,219,109
82,15,3,3,7,6,-66,-67,3,2,153,42
82,16,3,4,4,9,31,45,4,7,184,87
82,17,3,3,4,9,31,-64,5,3,215,23
82,18,4,3,9,4,-55,31,0,4,160,54
82,19,3,3,8,5,35,32,5,6,195,86
82,20,3,3,5,8,32,-65,7,1,227,21
82,21,5,2,10,3,-45,21,2,2,182,42
82,22,3,3,9,4,36,31,8,3,218,73
82,23,5,2,7,6,-48,24,0,7,170,97
82,24,4,2,7,6,43,-76,3,1,213,21
82,25,3,4,4,9,31,45,4,6,244,66
82,26,4,3,6,7,42,-66,6,0,286,0
82,27,4,3,7,6,43,33,9,3,329,33
82,28,2,5,3,10,-79,55,0,8,250,88
82,29,4,3,7,6,43,-67,3,1,293,21
82,30,3,4,4,9,31,45,4,6,324,66
82,31,2,4,4,9,22,-55,6,1,346,11
82,32,4,3,7,6,43,33,9,4,389,44
82,33,2,5,3,10,-79,55,0,9,310,99
82,34,5,2,8,5,53,-77,3,2,363,22
82,35,3,3,8,5,35,32,8,4,398,54
82,36,4,3,8,5,-56,32,2,6,342,86
82,37,2,4,4,9,22,-55,4,1,364,31
82,38,2,4,5,8,23,44,7,5,387,75
82,39,2,5,4,9,22,54,9,9,409,129
82,40,4,3,9,4,-55,-69,4,0,354,60
82,41,3,3,4,9,31,36,5,6,385,96
82,42,3,4,6,7,33,43,8,9,418,139
82,43,3,4,5,8,-68,-56,0,3,350,83
82,44,3,3,8,5,35,32,5,5,385,115
82,45,3,3,9,4,-64,31,1,6,321,146
82,46,4,3,6,7,42,-66,3,0,363,80
82,47,2,4,4,9,22,45,5,5,385,125
82,48,3,4,5,8,32,44,7,9,417,169
82,49,3,3,6,7,-67,-66,0,3,350,103
82,50,3,3,7,6,34,33,4,6,384,136
82,51,6,2,10,3,64,21,8,7,448,157
82,52,2,4,5,8,-77,-56,1,1,371,101
82,53,4,3,9,4,45,31,6,2,416,132
82,54,2,4,5,8,23,44,9,6,439,176
82,55,3,4,7,6,-66,42,3,8,373,218
82,56,3,3,7,6,34,-67,7,1,407,151
82,57,4,2,8,5,-56,23,1,4,351,174
82,58,3,3,5,8,32,35,3,9,383,209
82,59,2,5,4,9,22,-46,5,3,405,163
82,60,3,4,4,9,31,45,6,8,436,208
82,61,3,4,6,7,33,-57,9,1,469,151
82,62,5,2,5,8,50,26,9,7,519,177
83,1,3,3,7,6,34,33,4,3,34,33
83,2,4,2,9,4,45,22,9,5,79,55
83,3,4,3,6,7,-58,34,1,9,21,89
83,4,4,2,7,6,43,-76,4,3,64,13
83,5,4,3,9,4,45,31,9,4,109,44
83,6,2,4,4,9,-78,45,1,9,31,89
83,7,4,3,6,7,42,-66,3,3,73,23
83,8,3,4,6,7,33,43,6,6,106,66
83,9,3,4,8,5,-65,41,1,7,41,107
83,10,4,2,8,5,44,-77,5,0,85,30
83,11,4,2,11,2,-53,20,2,0,32,50
83,12,3,3,6,7,33,34,5,4,65,84
83,13,5,2,8,5,53,23,8,7,118,107
83,14,2,5,6,7,-76,52,2,9,42,159
83,15,3,4,7,6,34,-58,6,1,76,101
83,16,4,3,7,6,43,33,9,4,119,134
83,17,4,2,7,6,-57,24,2,8,62,158
83,18,5,2,7,6,52,-76,4,2,114,82
83,19,3,3,7,6,34,33,8,5,148,115
83,20,3,4,7,6,-66,42,2,7,82,157
83,21,3,3,6,7,33,-66,5,1,115,91
83,22,3,3,7,6,34,33,9,4,149,124
83,23,3,4,5,8,-68,44,1,8,81,168
83,24,3,3,5,8,32,-65,3,3,113,103
83,25,2,4,8,5,26,41,9,4,139,144
83,26,4,2,8,5,-56,23,3,7,83,167
83,27,5,2,9,4,54,22,7,9,137,189
83,28,5,2,8,5,-47,-77,0,2,90,112
83,29,3,4,4,9,31,45,1,7,121,157
83,30,2,4,5,8,23,-56,4,1,144,101
83,31,5,2,9,4,54,22,8,3,198,123
83,32,5,2,8,5,-47,23,1,6,151,146
83,33,4,3,8,5,44,32,5,8,195,178
83,34,4,3,6,7,42,-66,7,2,237,112
83,35,4,3,8,5,-56,32,1,4,181,144
83,36,3,4,5,8,32,44,3,8,213,188
83,37,5,2,8,5,53,-77,6,1,266,111
83,38,4,3,7,6,43,33,9,4,309,144
83,39,4,2,10,3,-54,21,5,5,255,165
83,40,4,3,7,6,43,33,8,8,298,198
83,41,4,3,7,6,-57,-67,1,1,241,131
83,42,4,3,6,7,42,34,3,5,283,165
83,43,2,4,5,8,23,44,6,9,306,209
83,44,5,2,7,6,52,-76,8,3,358,133
83,45,5,2,9,4,-46,22,2,5,312,155
83,46,2,5,3,10,21,-45,3,0,333,110
83,47,2,4,6,7,24,43,7,3,357,153
83,48,2,5,3,10,21,55,8,8,378,208
83,49,4,3,7,6,-57,-67,1,1,321,141
83,50,4,3,6,7,42,34,3,5,363,175
83,51,3,4,8,5,35,41,8,6,398,216
83,52,2,5,2,11,20,-44,8,2,418,172
83,53,4,3,8,5,-56,32,2,4,362,204
83,54,5,2,11,2,56,20,8,4,418,224
83,55,2,4,6,7,-76,43,2,7,342,267
83,56,5,3,6,7,51,-66,3,1,393,201
83,57,3,3,8,5,35,32,8,3,428,233
83,58,5,2,11,2,-44,20,4,3,384,253
83,59,5,2,9,4,54,22,8,5,438,275
83,60,3,3,5,8,-68,-65,0,0,370,210
83,61,3,3,6,7,33,34,3,4,403,244
83,62,4,2,9,4,45,22,8,6,448,266
83,63,2,5,2,11,20,-44,8,2,468,222
83,64,4,3,9,4,-55,31,3,3,413,253
83,65,4,2,9,4,45,22,8,5,458,275
83,66,3,5,7,6,-66,51,2,6,392,326
83,67,4,2,7,6,43,-76,5,0,435,250
83,68,4,3,6,7,42,34,7,4,477,284
83,69,2,4,7,6,-75,42,2,6,402,326
83,70,3,4,4,9,31,-55,3,1,433,271
83,71,4,3,6,7,42,34,5,5,475,305
83,72,5,2,9,4,54,22,9,7,529,327
84,1,3,4,7,6,34,42,4,2,34,42
84,2,2,5,5,8,23,53,7,5,57,95
84,3,2,4,4,9,22,-55,9,0,79,40
84,4,4,2,8,5,-56,23,3,3,23,63
84,5,5,2,9,4,54,22,7,5,77,85
84,6,2,4,7,6,-75,42,2,7,2,127
84,7,2,5,4,9,22,-46,4,1,24,81
84,8,3,3,5,8,32,35,6,6,56,116
84,9,4,4,6,7,42,43,8,9,98,159
84,10,2,5,4,9,-78,-46,0,3,20,113
84,11,4,2,6,7,42,25,2,8,62,138
84,12,2,5,6,7,24,-48,6,0,86,90
84,13,4,2,6,7,42,25,8,5,128,115
84,14,5,2,8,5,-47,23,1,8,81,138
84,15,4,2,8,5,44,-77,5,1,125,61
84,16,3,3,8,5,-65,32,0,3,60,93
84,17,4,2,8,5,44,23,4,6,104,116
84,18,4,2,7,6,43,-76,7,0,147,40
84,19,4,3,8,5,-56,32,1,2,91,72
84,20,4,3,6,7,42,34,3,6,133,106
84,21,3,4,5,8,32,-56,5,0,165,50
84,22,4,3,9,4,-55,31,0,1,110,81
84,23,2,4,4,9,22,45,2,6,132,126
84,24,4,3,10,3,46,30,8,6,178,156
84,25,3,4,7,6,-66,42,2,8,112,198
84,26,3,4,4,9,31,-55,3,3,143,143
84,27,3,3,6,7,33,34,6,7,176,177
84,28,4,3,6,7,42,-66,8,1,218,111
84,29,4,2,10,3,-54,21,4,2,164,132
84,30,4,2,6,7,42,25,6,7,206,157
84,31,6,2,9,4,63,22,9,9,269,179
84,32,2,4,6,7,-76,-57,3,2,193,122
84,33,3,3,4,9,31,36,4,8,224,158
84,34,2,4,4,9,22,-55,6,3,246,103
84,35,2,5,3,10,21,55,7,8,267,158
84,36,2,4,4,9,22,-55,9,3,289,103
84,37,3,4,8,5,-65,41,4,4,224,144
84,38,2,4,3,10,21,-54,5,0,245,90
84,39,4,2,8,5,44,23,9,3,289,113
84,40,3,3,8,5,-65,32,4,5,224,145
84,41,3,3,6,7,33,34,7,9,257,179
84,42,4,2,9,4,-55,-78,2,1,202,101
84,43,4,4,6,7,42,43,4,4,244,144
84,44,2,4,5,8,23,44,7,8,267,188
84,45,4,3,6,7,42,-66,9,2,309,122
84,46,4,2,10,3,-54,21,5,3,255,143
84,47,2,4,4,9,22,45,7,8,277,188
84,48,4,3,5,8,41,-65,8,3,318,123
84,49,2,4,6,7,-76,43,2,6,242,166
84,50,5,2,10,3,55,21,7,7,297,187
84,51,3,4,6,7,-67,-57,0,0,230,130
84,52,2,4,3,10,21,46,1,6,251,176
84,53,2,5,7,6,25,51,6,7,276,227
84,54,5,2,8,5,53,-77,9,0,329,150
84,55,6,2,7,6,-39,24,0,4,290,174
84,56,3,3,7,6,34,33,4,7,324,207
84,57,3,4,7,6,34,42,8,9,358,249
84,58,4,3,6,7,-58,-66,0,3,300,183
84,59,4,3,6,7,42,34,2,7,342,217
84,60,3,4,5,8,32,-56,4,1,374,161
84,61,2,4,3,10,21,46,5,7,395,207
84,62,3,4,6,7,33,-57,8,0,428,150
84,63,2,4,3,10,21,46,9,6,449,196
84,64,5,2,8,5,-47,23,2,9,402,219
84,65,3,5,5,8,32,-47,4,2,434,172
84,66,4,2,10,3,-54,21,0,3,380,193
84,67,4,2,5,8,41,26,1,9,421,219
84,68,2,4,6,7,24,-57,5,2,445,162
84,69,3,4,4,9,31,45,6,7,476,207
84,70,3,5,4,9,31,-46,7,1,507,161
85,1,3,3,5,8,32,35,2,5,32,35
85,2,3,4,6,7,33,43,5,8,65,78
85,3,2,4,6,7,24,-57,9,1,89,21
85,4,4,2,8,5,-56,23,3,4,33,44
85,5,3,3,6,7,33,34,6,8,66,78
85,6,4,3,6,7,42,-66,8,2,108,12
85,7,3,3,8,5,-65,32,3,4,43,44
85,8,3,3,8,5,35,32,8,6,78,76
85,9,3,3,9,4,-64,31,4,7,14,107
85,10,2,6,4,9,22,-37,6,0,36,70
85,11,2,5,4,9,22,54,8,4,58,124
85,12,5,3,8,5,-47,32,1,6,11,156
85,13,3,3,6,7,33,-66,4,0,44,90
85,14,4,2,9,4,45,22,9,2,89,112
85,15,4,2,7,6,-57,24,2,6,32,136
85,16,2,4,6,7,24,43,6,9,56,179
85,17,3,4,5,8,32,-56,8,3,88,123
85,18,4,2,9,4,-55,22,3,5,33,145
85,19,4,4,7,6,43,42,6,7,76,187
85,20,4,3,8,5,-56,32,0,9,20,219
85,21,2,5,2,11,20,-44,0,5,40,175
85,22,5,2,11,2,56,20,6,5,96,195
85,23,3,3,6,7,33,34,9,9,129,229
85,24,3,4,5,8,-68,-56,1,3,61,173
85,25,3,3,6,7,33,34,4,7,94,207
85,26,2,6,3,10,21,-36,5,1,115,171
85,27,3,3,6,7,33,34,8,5,148,205
85,28,4,3,9,4,-55,31,3,6,93,236
85,29,4,2,7,6,43,-76,6,0,136,160
85,30,3,4,4,9,31,45,7,5,167,205
85,31,4,3,9,4,-55,31,2,6,112,236
85,32,5,2,9,4,54,22,6,8,166,258
85,33,3,3,6,7,33,-66,9,2,199,192
85,34,3,4,5,8,-68,44,1,6,131,236
85,35,2,4,5,8,23,-56,4,0,154,180
85,36,4,3,8,5,44,32,8,2,198,212
85,37,3,4,5,8,-68,44,0,6,130,256
85,38,3,3,5,8,32,-65,2,1,162,191
85,39,3,4,8,5,35,41,7,2,197,232
85,40,3,3,9,4,-64,31,3,3,133,263
85,41,4,3,8,5,44,32,7,5,177,295
85,42,5,2,7,6,52,24,9,9,229,319
85,43,3,3,6,7,-67,-66,2,3,162,253
85,44,2,4,3,10,21,46,3,9,183,299
85,45,4,3,4,9,40,-64,3,5,223,235
85,46,3,3,8,5,35,32,8,7,258,267
85,47,2,4,7,6,-75,42,3,9,183,309
85,48,4,3,9,4,45,-69,8,0,228,240
85,49,4,2,8,5,-56,23,2,3,172,263
85,50,5,2,8,5,53,23,5,6,225,286
85,51,2,5,4,9,22,-46,7,0,247,240
85,52,2,5,4,9,22,54,9,4,269,294
85,53,5,2,8,5,-47,23,2,7,222,317
85,54,4,3,6,7,42,-66,4,1,264,251
85,55,4,3,8,5,44,32,8,3,308,283
85,56,3,3,7,6,-66,33,2,6,242,316
85,57,4,2,10,3,46,21,8,7,288,337
85,58,5,3,10,3,-45,30,3,7,243,367
85,59,3,4,6,7,33,-57,6,0,276,310
85,60,3,3,5,8,32,35,8,5,308,345
85,61,3,5,4,9,31,54,9,9,339,399
85,62,5,2,10,3,-45,-79,4,0,294,320
85,63,3,3,7,6,34,33,8,3,328,353
85,64,5,2,9,4,-46,22,2,5,282,375
85,65,3,3,9,4,36,31,8,6,318,406
85,66,3,4,6,7,-67,43,1,9,251,449
85,67,4,3,7,6,43,-67,4,2,294,382
85,68,5,2,7,6,52,24,6,6,346,406
85,69,2,5,3,10,21,-45,7,1,367,361
85,70,3,3,5,8,32,35,9,6,399,396
85,71,3,4,5,8,-68,-56,1,0,331,340
85,72,3,3,4,9,31,36,2,6,362,376
85,73,2,4,4,9,22,-55,4,1,384,321
85,74,3,4,7,6,34,42,8,3,418,363
85,75,4,2,5,8,41,26,9,9,459,389
85,76,2,4,7,6,-75,-58,4,1,384,331
85,77,3,4,8,5,35,41,9,2,419,372
85,78,3,3,8,5,-65,32,4,4,354,404
85,79,4,3,7,6,43,33,7,7,397,437
85,80,3,3,7,6,-66,-67,1,0,331,370
85,81,2,4,5,8,23,44,4,4,354,414
85,82,4,2,10,3,-54,21,0,5,300,435
85,83,3,4,6,7,33,43,3,8,333,478
85,84,5,2,8,5,53,-77,6,1,386,401
85,85,5,3,7,6,52,33,8,4,438,434
85,86,3,4,4,9,31,45,9,9,469,479
85,87,5,2,10,3,-45,-79,4,0,424,400
85,88,4,3,7,6,43,33,7,3,467,433
85,89,3,4,5,8,32,44,9,7,499,477
85,90,3,3,4,9,-69,-64,0,3,430,413
85,91,2,5,3,10,21,55,1,8,451,468
85,92,4,3,7,6,43,-67,4,1,494,401
85,93,4,2,8,5,44,23,8,4,538,424
86,1,3,4,8,5,35,41,5,1,35,41
86,2,4,3,9,4,-55,31,0,2,-20,72
86,3,3,3,5,8,32,35,2,7,12,107
86,4,4,2,5,8,41,-74,3,3,53,33
86,5,3,3,7,6,34,33,7,6,87,66
86,6,4,3,6,7,42,-66,9,0,129,0
86,7,5,2,8,5,-47,23,2,3,82,23
86,8,3,3,7,6,34,33,6,6,116,56
86,9,4,2,10,3,-54,21,2,7,62,77
86,10,3,4,7,6,34,42,6,9,96,119
86,11,4,3,7,6,43,-67,9,2,139,52
86,12,4,3,6,7,-58,34,1,6,81,86
86,13,3,4,6,7,33,43,4,9,114,129
86,14,2,4,7,6,25,-58,9,1,139,71
86,15,2,4,6,7,-76,43,3,4,63,114
86,16,5,2,9,4,54,22,7,6,117,136
86,17,3,3,6,7,-67,-66,0,0,50,70
86,18,3,4,5,8,32,44,2,4,82,114
86,19,5,2,8,5,53,23,5,7,135,137
86,20,3,4,4,9,31,-55,6,2,166,82
86,21,3,3,6,7,33,34,9,6,199,116
86,22,3,4,3,10,30,-54,9,2,229,62
86,23,2,4,5,8,-77,44,2,6,152,106
86,24,4,2,7,6,43,-76,5,0,195,30
86,25,3,4,6,7,33,43,8,3,228,73
86,26,4,2,8,5,-56,23,2,6,172,96
86,27,3,3,8,5,35,32,7,8,207,128
86,28,6,2,9,4,-37,-78,0,0,170,50
86,29,4,2,9,4,45,22,5,2,215,72
86,30,4,3,10,3,-54,30,1,2,161,102
86,31,5,2,9,4,54,22,5,4,215,124
86,32,3,3,6,7,33,34,8,8,248,158
86,33,3,3,8,5,-65,-68,3,0,183,90
86,34,5,2,9,4,54,22,7,2,237,112
86,35,3,3,4,9,31,36,8,8,268,148
86,36,4,3,10,3,-54,30,4,8,214,178
86,37,4,2,9,4,45,-78,9,0,259,100
86,38,3,4,9,4,-64,40,5,0,195,140
86,39,4,2,8,5,44,23,9,3,239,163
86,40,4,2,7,6,-57,24,2,7,182,187
86,41,4,3,8,5,44,32,6,9,226,219
86,42,3,3,5,8,32,-65,8,4,258,154
86,43,2,4,6,7,-76,43,2,7,182,197
86,44,4,4,7,6,43,42,5,9,225,239
86,45,3,4,5,8,32,-56,7,3,257,183
86,46,3,3,8,5,-65,32,2,5,192,215
86,47,3,4,5,8,32,44,4,9,224,259
86,48,4,3,6,7,42,-66,6,3,266,193
86,49,3,3,8,5,-65,32,1,5,201,225
86,50,3,4,4,9,31,-55,2,0,232,170
86,51,5,2,9,4,54,22,6,2,286,192
86,52,4,3,6,7,42,34,8,6,328,226
86,53,3,3,8,5,-65,32,3,8,263,258
86,54,2,4,5,8,23,-56,6,2,286,202
86,55,5,2,9,4,-46,22,0,4,240,224
86,56,4,2,8,5,44,23,4,7,284,247
86,57,4,2,8,5,44,-77,8,0,328,170
86,58,4,2,7,6,-57,24,1,4,271,194
86,59,3,3,7,6,34,33,5,7,305,227
86,60,4,3,9,4,-55,31,0,8,250,258
86,61,5,3,8,5,53,-68,3,0,303,190
86,62,3,4,5,8,32,44,5,4,335,234
86,63,2,4,6,7,24,43,9,7,359,277
86,64,3,4,4,9,-69,-55,0,2,290,222
86,65,2,5,3,10,21,55,1,7,311,277
86,66,4,3,8,5,44,32,5,9,355,309
86,67,2,4,7,6,-75,-58,0,1,280,251
86,68,2,5,3,10,21,55,1,6,301,306
86,69,3,4,6,7,33,43,4,9,334,349
86,70,3,4,4,9,31,-55,5,4,365,294
86,71,5,2,7,6,52,24,7,8,417,318
86,72,4,3,9,4,-55,31,2,9,362,349
86,73,4,3,8,5,44,-68,6,1,406,281
86,74,2,4,4,9,22,45,8,6,428,326
86,75,4,2,8,5,-56,23,2,9,372,349
86,76,4,2,8,5,44,-77,6,2,416,272
86,77,5,2,7,6,52,24,8,6,468,296
86,78,4,3,7,6,-57,33,1,9,411,329
86,79,4,2,7,6,43,-76,4,3,454,253
86,80,4,2,7,6,43,24,7,7,497,277
86,81,3,3,4,9,31,-64,8,3,528,213
87,1,3,3,5,8,32,35,2,5,32,35
87,2,4,3,5,8,41,-65,3,0,73,-30
87,3,5,2,10,3,55,21,8,1,128,-9
87,4,3,3,6,7,-67,34,1,5,61,25
87,5,3,3,9,4,36,31,7,6,97,56
87,6,3,4,5,8,32,-56,9,0,129,0
87,7,4,3,10,3,-54,30,5,0,75,30
87,8,4,3,8,5,44,32,9,2,119,62
87,9,3,3,5,8,-68,35,1,7,51,97
87,10,4,3,8,5,44,32,5,9,95,129
87,11,4,2,9,4,-55,-78,0,1,40,51
87,12,3,4,6,7,33,43,3,4,73,94
87,13,4,2,8,5,44,23,7,7,117,117
87,14,2,4,7,6,-75,42,2,9,42,159
87,15,3,4,8,5,35,-59,7,0,77,100
87,16,4,3,6,7,42,34,9,4,119,134
87,17,4,3,10,3,-54,30,5,4,65,164
87,18,3,3,6,7,33,34,8,8,98,198
87,19,2,4,5,8,-77,-56,1,2,21,142
87,20,4,2,8,5,44,23,5,5,65,165
87,21,2,4,3,10,21,-54,6,1,86,111
87,22,3,4,6,7,33,43,9,4,119,154
87,23,5,2,6,7,-49,25,0,9,70,179
87,24,4,3,8,5,44,-68,4,1,114,111
87,25,5,2,8,5,53,23,7,4,167,134
87,26,2,6,4,9,22,63,9,7,189,197
87,27,4,3,9,4,-55,31,4,8,134,228
87,28,3,4,4,9,31,-55,5,3,165,173
87,29,4,3,9,4,-55,31,0,4,110,204
87,30,2,4,2,11,20,-53,0,1,130,151
87,31,2,4,4,9,22,45,2,6,152,196
87,32,4,2,8,5,44,23,6,9,196,219
87,33,2,4,4,9,22,-55,8,4,218,164
87,34,3,4,4,9,31,45,9,9,249,209
87,35,4,3,7,6,-57,-67,2,2,192,142
87,36,3,4,6,7,33,43,5,5,225,185
87,37,2,4,4,9,22,-55,7,0,247,130
87,38,2,4,7,6,-75,42,2,2,172,172
87,39,2,4,6,7,24,43,6,5,196,215
87,40,3,3,6,7,33,34,9,9,229,249
87,41,4,3,6,7,-58,-66,1,3,171,183
87,42,4,2,9,4,45,22,6,5,216,205
87,43,5,2,7,6,52,24,8,9,268,229
87,44,3,4,6,7,-67,-57,1,2,201,172
87,45,3,3,5,8,32,35,3,7,233,207
87,46,3,3,7,6,34,-67,7,0,267,140
87,47,4,2,8,5,-56,23,1,3,211,163
87,48,4,2,8,5,44,23,5,6,255,186
87,49,4,3,8,5,44,32,9,8,299,218
87,50,3,4,5,8,-68,-56,1,2,231,162
87,51,4,3,8,5,44,32,5,4,275,194
87,52,2,4,7,6,-75,42,0,6,200,236
87,53,3,4,6,7,33,43,3,9,233,279
87,54,3,3,4,9,31,-64,4,5,264,215
87,55,4,3,9,4,45,31,9,6,309,246
87,56,5,2,9,4,-46,22,3,8,263,268
87,57,5,2,8,5,53,-77,6,1,316,191
87,58,3,4,5,8,32,44,8,5,348,235
87,59,5,3,8,5,-47,32,1,7,301,267
87,60,3,3,7,6,34,-67,5,0,335,200
87,61,3,4,6,7,33,43,8,3,368,243
87,62,5,2,11,2,-44,20,4,3,324,263
87,63,3,3,5,8,32,35,6,8,356,298
87,64,2,4,6,7,-76,-57,0,1,280,241
87,65,3,3,7,6,34,33,4,4,314,274
87,66,3,3,8,5,35,32,9,6,349,306
87,67,4,3,8,5,-56,32,3,8,293,338
87,68,2,5,2,11,20,-44,3,4,313,294
87,69,4,3,5,8,41,35,4,9,354,329
87,70,3,4,7,6,34,-58,8,1,388,271
87,71,3,3,7,6,-66,33,2,4,322,304
87,72,4,3,9,4,45,31,7,5,367,335
87,73,3,3,4,9,31,-64,8,1,398,271
87,74,3,3,5,8,-68,35,0,6,330,306
87,75,3,3,7,6,34,33,4,9,364,339
87,76,3,3,6,7,33,-66,7,3,397,273
87,77,3,4,6,7,-67,43,0,6,330,316
87,78,3,4,8,5,35,41,5,7,365,357
87,79,2,4,3,10,21,-54,6,3,386,303
87,80,4,4,5,8,41,44,7,7,427,347
87,81,2,4,3,10,21,-54,8,3,448,293
87,82,4,2,7,6,-57,24,1,7,391,317
87,83,6,2,9,4,63,22,4,9,454,339
87,84,2,5,6,7,24,-48,8,1,478,291
87,85,3,4,4,9,31,45,9,6,509,336
88,1,4,4,6,7,42,43,2,3,42,43
88,2,4,2,7,6,43,24,5,7,85,67
88,3,5,2,6,7,51,-75,6,2,136,-8
88,4,3,4,5,8,32,44,8,6,168,36
88,5,4,3,10,3,-54,30,4,6,114,66
88,6,4,2,7,6,43,-76,7,0,157,-10
88,7,3,3,7,6,-66,33,1,3,91,23
88,8,3,4,5,8,32,44,3,7,123,67
88,9,3,4,5,8,32,-56,5,1,155,11
88,10,2,4,6,7,24,43,9,4,179,54
88,11,3,4,5,8,-68,44,1,8,111,98
88,12,2,5,4,9,22,-46,3,2,133,52
88,13,2,5,6,7,24,52,7,4,157,104
88,14,3,4,8,5,-65,41,2,5,92,145
88,15,3,3,6,7,33,34,5,9,125,179
88,16,3,3,5,8,32,-65,7,4,157,114
88,17,2,6,3,10,21,64,8,8,178,178
88,18,3,3,6,7,-67,-66,1,2,111,112
88,19,4,2,7,6,43,24,4,6,154,136
88,20,5,2,10,3,55,21,9,7,209,157
88,21,3,4,7,6,-66,42,3,9,143,199
88,22,5,2,11,2,56,20,9,9,199,219
88,23,4,2,7,6,-57,-76,2,3,142,143
88,24,5,2,6,7,51,25,3,8,193,168
88,25,3,3,8,5,35,-68,8,0,228,100
88,26,5,2,10,3,-45,21,3,1,183,121
88,27,3,4,4,9,31,45,4,6,214,166
88,28,2,4,5,8,23,-56,7,0,237,110
88,29,4,3,6,7,42,34,9,4,279,144
88,30,4,3,8,5,-56,32,3,6,223,176
88,31,3,3,5,8,32,-65,5,1,255,111
88,32,4,3,9,4,-55,31,0,2,200,142
88,33,3,3,4,9,31,36,1,8,231,178
88,34,2,5,5,8,23,-47,4,1,254,131
88,35,4,3,7,6,43,33,7,4,297,164
88,36,5,2,9,4,-46,22,1,6,251,186
88,37,2,5,3,10,21,-45,2,1,272,141
88,38,3,4,6,7,33,43,5,4,305,184
88,39,5,2,8,5,53,23,8,7,358,207
88,40,3,4,5,8,-68,-56,0,1,290,151
88,41,3,4,8,5,35,41,5,2,325,192
88,42,2,7,1,12,-20,75,5,7,305,267
88,43,5,2,11,2,-44,20,1,7,261,287
88,44,3,4,7,6,34,42,5,9,295,329
88,45,4,3,6,7,42,-66,7,3,337,263
88,46,3,3,5,8,32,35,9,8,369,298
88,47,6,2,11,2,-35,20,4,8,334,318
88,48,3,4,4,9,31,-55,5,3,365,263
88,49,3,3,5,8,32,35,7,8,397,298
88,50,4,4,4,9,40,-55,7,3,437,243
88,51,5,2,7,6,52,24,9,7,489,267
88,52,4,3,7,6,-57,-67,2,0,432,200
88,53,3,4,7,6,34,42,6,2,466,242
88,54,4,3,9,4,-55,31,1,3,411,273
88,55,4,3,6,7,42,34,3,7,453,307
88,56,3,4,8,5,35,41,8,8,488,348
88,57,4,2,10,3,-54,21,4,9,434,369
88,58,4,3,9,4,45,-69,9,0,479,300
88,59,3,3,6,7,-67,34,2,4,412,334
88,60,2,4,4,9,22,45,4,9,434,379
88,61,3,3,6,7,33,-66,7,3,467,313
88,62,5,2,9,4,-46,22,1,5,421,335
88,63,4,3,6,7,42,34,3,9,463,369
88,64,3,3,8,5,35,-68,8,1,498,301
88,65,4,3,7,6,-57,33,1,4,441,334
88,66,4,3,9,4,45,31,6,5,486,365
88,67,5,2,8,5,53,23,9,8,539,388
89,1,3,4,6,7,33,43,3,3,33,43
89,2,2,4,6,7,24,43,7,6,57,86
89,3,5,2,9,4,-46,22,1,8,11,108
89,4,2,5,4,9,22,-46,3,2,33,62
89,5,4,3,5,8,41,35,4,7,74,97
89,6,3,3,8,5,35,32,9,9,109,129
89,7,4,4,6,7,-58,-57,1,2,51,72
89,8,4,2,6,7,42,25,3,7,93,97
89,9,3,3,8,5,35,32,8,9,128,129
89,10,3,3,7,6,-66,-67,2,2,62,62
89,11,6,2,11,2,65,20,7,2,127,82
89,12,2,5,7,6,-75,51,2,3,52,133
89,13,4,2,9,4,45,22,7,5,97,155
89,14,4,2,8,5,-56,23,1,8,41,178
89,15,2,5,4,9,22,-46,3,2,63,132
89,16,4,2,7,6,43,24,6,6,106,156
89,17,4,2,7,6,43,-76,9,0,149,80
89,18,5,2,10,3,-45,21,4,1,104,101
89,19,2,5,6,7,24,52,8,3,128,153
89,20,2,4,4,9,-78,45,0,8,50,198
89,21,4,2,7,6,43,-76,3,2,93,122
89,22,3,4,6,7,33,43,6,5,126,165
89,23,4,4,5,8,41,44,7,9,167,209
89,24,4,3,6,7,42,-66,9,3,209,143
89,25,4,2,9,4,-55,22,4,5,154,165
89,26,4,3,6,7,42,34,6,9,196,199
89,27,2,4,3,10,21,-54,7,5,217,145
89,28,3,5,7,6,-66,51,1,6,151,196
89,29,2,4,3,10,21,-54,2,2,172,142
89,30,2,4,7,6,25,42,7,4,197,184
89,31,3,4,4,9,31,45,8,9,228,229
89,32,3,4,5,8,-68,-56,0,3,160,173
89,33,4,3,8,5,44,32,4,5,204,205
89,34,2,4,4,9,22,-55,6,0,226,150
89,35,4,3,8,5,-56,32,0,2,170,182
89,36,3,3,8,5,35,32,5,4,205,214
89,37,3,3,7,6,34,33,9,7,239,247
89,38,4,2,9,4,-55,22,4,9,184,269
89,39,4,2,9,4,45,-78,9,1,229,191
89,40,4,3,7,6,-57,33,2,4,172,224
89,41,3,3,7,6,34,33,6,7,206,257
89,42,2,4,3,10,21,-54,7,3,227,203
89,43,3,3,10,3,-63,30,4,3,164,233
89,44,4,2,11,2,-53,20,1,3,111,253
89,45,3,3,4,9,31,36,2,9,142,289
89,46,4,3,5,8,41,-65,3,4,183,224
89,47,4,3,5,8,41,35,4,9,224,259
89,48,5,2,8,5,53,-77,7,2,277,182
89,49,3,3,5,8,32,35,9,7,309,217
89,50,3,4,5,8,-68,-56,1,1,241,161
89,51,3,3,4,9,31,36,2,7,272,197
89,52,4,4,8,5,44,41,6,8,316,238
89,53,3,4,5,8,32,-56,8,2,348,182
89,54,4,3,6,7,-58,34,0,6,290,216
89,55,3,3,6,7,33,-66,3,0,323,150
89,56,4,2,6,7,42,25,5,5,365,175
89,57,3,4,5,8,32,44,7,9,397,219
89,58,6,2,10,3,-36,-79,1,0,361,140
89,59,4,2,6,7,42,25,3,5,403,165
89,60,2,4,4,9,22,-55,5,0,425,110
89,61,4,3,8,5,44,32,9,2,469,142
89,62,4,2,8,5,-56,23,3,5,413,165
89,63,2,5,2,11,20,-44,3,1,433,121
89,64,3,4,4,9,31,45,4,6,464,166
89,65,3,3,7,6,34,33,8,9,498,199
89,66,5,2,9,4,-46,-78,2,1,452,121
89,67,2,4,4,9,22,45,4,6,474,166
89,68,3,3,5,8,32,-65,6,1,506,101
90,1,4,2,6,7,42,25,2,5,42,25
90,2,2,6,3,10,21,64,3,9,63,89
90,3,2,5,5,8,23,-47,6,2,86,42
90,4,5,2,8,5,53,23,9,5,139,65
90,5,4,4,7,6,-57,42,2,7,82,107
90,6,4,3,8,5,44,32,6,9,126,139
90,7,4,2,5,8,41,-74,7,5,167,65
90,8,5,2,9,4,-46,22,1,7,121,87
90,9,3,3,8,5,35,32,6,9,156,119
90,10,2,4,5,8,23,-56,9,3,179,63
90,11,6,2,10,3,-36,21,3,4,143,84
90,12,2,5,4,9,22,54,5,8,165,138
90,13,5,3,10,3,-45,30,0,8,120,168
90,14,3,3,5,8,32,-65,2,3,152,103
90,15,4,3,9,4,45,31,7,4,197,134
90,16,4,4,5,8,41,44,8,8,238,178
90,17,3,3,6,7,-67,-66,1,2,171,112
90,18,2,5,2,11,20,56,1,8,191,168
90,19,3,3,6,7,33,-66,4,2,224,102
90,20,2,5,6,7,24,52,8,4,248,154
90,21,5,2,11,2,-44,20,4,4,204,174
90,22,5,2,8,5,53,23,7,7,257,197
90,23,3,4,6,7,-67,-57,0,0,190,140
90,24,3,4,8,5,35,41,5,1,225,181
90,25,4,4,6,7,42,43,7,4,267,224
90,26,2,6,2,11,20,65,7,9,287,289
90,27,3,3,8,5,-65,-68,2,1,222,221
90,28,3,4,5,8,32,44,4,5,254,265
90,29,4,3,6,7,42,34,6,9,296,299
90,30,2,4,7,6,-75,-58,1,1,221,241
90,31,5,2,9,4,54,22,5,3,275,263
90,32,3,4,5,8,32,44,7,7,307,307
90,33,3,3,6,7,-67,-66,0,1,240,241
90,34,3,4,8,5,35,41,5,2,275,282
90,35,6,2,6,7,60,25,5,7,335,307
90,36,4,3,9,4,-55,31,0,8,280,338
90,37,5,2,9,4,54,-78,4,0,334,260
90,38,3,4,9,4,-64,40,0,0,270,300
90,39,2,4,6,7,24,43,4,3,294,343
90,40,3,4,5,8,32,44,6,7,326,387
90,41,3,4,5,8,32,-56,8,1,358,331
90,42,3,3,9,4,-64,31,4,2,294,362
90,43,5,2,7,6,52,24,6,6,346,386
90,44,3,4,8,5,-65,41,1,7,281,427
90,45,2,4,4,9,22,-55,3,2,303,372
90,46,2,4,3,10,21,46,4,8,324,418
90,47,3,3,6,7,33,-66,7,2,357,352
90,48,2,4,3,10,21,46,8,8,378,398
90,49,4,3,6,7,-58,-66,0,2,320,332
90,50,5,2,9,4,54,22,4,4,374,354
90,51,2,6,2,11,20,65,4,9,394,419
90,52,2,4,5,8,23,-56,7,3,417,363
90,53,5,2,8,5,-47,23,0,6,370,386
90,54,4,3,7,6,43,33,3,9,413,419
90,55,4,4,6,7,42,-57,5,2,455,362
90,56,2,4,6,7,24,43,9,5,479,405
90,57,2,4,4,9,-78,-55,1,0,401,350
90,58,2,4,8,5,26,41,7,1,427,391
90,59,3,4,5,8,32,44,9,5,459,435
90,60,2,4,5,8,-77,44,2,9,382,479
90,61,3,4,6,7,33,-57,5,2,415,422
90,62,2,5,6,7,24,52,9,4,439,474
90,63,4,2,8,5,-56,23,3,7,383,497
90,64,4,3,9,4,45,31,8,8,428,528
91,1,3,4,5,8,32,44,2,4,32,44
91,2,2,4,5,8,23,44,5,8,55,88
91,3,2,5,3,10,21,-45,6,3,76,43
91,4,2,4,4,9,22,45,8,8,98,88
91,5,3,4,4,9,31,-55,9,3,129,33
91,6,2,4,6,7,-76,43,3,6,53,76
91,7,2,4,5,8,23,-56,6,0,76,20
91,8,3,3,8,5,-65,32,1,2,11,52
91,9,2,4,7,6,25,42,6,4,36,94
91,10,2,5,5,8,23,53,9,7,59,147
91,11,4,3,9,4,-55,31,4,8,4,178
91,12,3,3,4,9,31,-64,5,4,35,114
91,13,4,2,9,4,-55,22,0,6,-20,136
91,14,2,6,3,10,21,-36,1,0,1,100
91,15,4,2,10,3,46,21,7,1,47,121
91,16,3,3,7,6,-66,33,1,4,-19,154
91,17,3,4,8,5,35,41,6,5,16,195
91,18,4,3,6,7,42,34,8,9,58,229
91,19,3,4,8,5,-65,-59,3,0,-7,170
91,20,2,5,2,11,20,56,3,6,13,226
91,21,2,6,3,10,21,-36,4,0,34,190
91,22,2,4,4,9,22,45,6,5,56,235
91,23,5,2,8,5,53,23,9,8,109,258
91,24,4,3,4,9,40,-64,9,4,149,194
91,25,4,3,8,5,-56,32,3,6,93,226
91,26,2,4,3,10,21,-54,4,2,114,172
91,27,5,2,7,6,52,24,6,6,166,196
91,28,6,2,10,3,-36,21,0,7,130,217
91,29,4,3,4,9,40,-64,0,3,170,153
91,30,5,2,9,4,54,22,4,5,224,175
91,31,5,2,9,4,54,22,8,7,278,197
91,32,3,4,9,4,-64,40,4,7,214,237
91,33,2,4,5,8,23,-56,7,1,237,181
91,34,2,5,4,9,22,54,9,5,259,235
91,35,2,4,4,9,-78,-55,1,0,181,180
91,36,6,2,8,5,62,23,3,3,243,203
91,37,4,3,7,6,43,33,6,6,286,236
91,38,2,5,3,10,21,-45,7,1,307,191
91,39,4,2,8,5,-56,23,1,4,251,214
91,40,2,4,2,11,20,-53,1,1,271,161
91,41,4,2,5,8,41,26,2,7,312,187
91,42,3,3,5,8,32,-65,4,2,344,122
91,43,2,5,2,11,20,56,4,8,364,178
91,44,2,4,3,10,21,-54,5,4,385,124
91,45,3,4,7,6,34,42,9,6,419,166
91,46,5,2,8,5,-47,23,2,9,372,189
91,47,3,3,6,7,33,-66,5,3,405,123
91,48,3,4,7,6,34,42,9,5,439,165
91,49,4,3,9,4,-55,31,4,6,384,196
91,50,2,5,3,10,21,-45,5,1,405,151
91,51,3,3,10,3,-63,30,2,1,342,181
91,52,3,4,5,8,32,44,4,5,374,225
91,53,3,4,4,9,31,-55,5,0,405,170
91,54,3,3,6,7,33,34,8,4,438,204
91,55,4,2,8,5,-56,23,2,7,382,227
91,56,5,2,7,6,52,-76,4,1,434,151
91,57,4,3,6,7,42,34,6,5,476,185
91,58,3,4,8,5,-65,41,1,6,411,226
91,59,4,3,9,4,45,31,6,7,456,257
91,60,4,3,10,3,-54,30,2,7,402,287
91,61,2,4,5,8,23,-56,5,1,425,231
91,62,4,3,5,8,41,35,6,6,466,266
91,63,5,2,9,4,-46,22,0,8,420,288
91,64,4,2,9,4,45,-78,5,0,465,210
91,65,3,3,5,8,32,35,7,5,497,245
91,66,3,3,7,6,-66,33,1,8,431,278
91,67,5,2,7,6,52,-76,3,2,483,202
91,68,4,2,8,5,44,23,7,5,527,225
92,1,3,3,6,7,33,34,3,4,33,34
92,2,4,4,8,5,44,41,7,5,77,75
92,3,3,3,6,7,-67,34,0,9,10,109
92,4,5,2,11,2,56,20,6,9,66,129
92,5,5,2,10,3,-45,-79,1,0,21,50
92,6,3,4,5,8,32,44,3,4,53,94
92,7,3,3,6,7,33,34,6,8,86,128
92,8,2,4,7,6,-75,-58,1,0,11,70
92,9,3,4,3,10,30,46,1,6,41,116
92,10,2,5,3,10,21,-45,2,1,62,71
92,11,3,4,5,8,32,44,4,5,94,115
92,12,4,3,7,6,43,33,7,8,137,148
92,13,2,4,5,8,-77,-56,0,2,60,92
92,14,3,3,9,4,36,31,6,3,96,123
92,15,2,4,6,7,-76,43,0,6,20,166
92,16,2,5,7,6,25,51,5,7,45,217
92,17,3,4,7,6,34,42,9,9,79,259
92,18,2,5,2,11,20,-44,9,5,99,215
92,19,4,3,8,5,-56,32,3,7,43,247
92,20,2,4,5,8,23,-56,6,1,66,191
92,21,4,2,10,3,-54,21,2,2,12,212
92,22,3,3,7,6,34,33,6,5,46,245
92,23,4,2,6,7,42,-75,8,0,88,170
92,24,4,3,7,6,-57,33,1,3,31,203
92,25,3,3,6,7,33,34,4,7,64,237
92,26,3,3,7,6,34,-67,8,0,98,170
92,27,2,4,6,7,-76,43,2,3,22,213
92,28,4,2,8,5,44,23,6,6,66,236
92,29,3,3,4,9,31,-64,7,2,97,172
92,30,4,2,9,4,-55,22,2,4,42,194
92,31,4,3,9,4,45,31,7,5,87,225
92,32,4,2,9,4,-55,22,2,7,32,247
92,33,3,3,6,7,33,-66,5,1,65,181
92,34,3,3,8,5,-65,32,0,3,0,213
92,35,4,2,8,5,44,23,4,6,44,236
92,36,3,4,7,6,34,42,8,8,78,278
92,37,5,2,10,3,-45,21,3,9,33,299
92,38,3,4,6,7,33,-57,6,2,66,242
92,39,4,3,4,9,40,36,6,8,106,278
92,40,2,4,5,8,23,-56,9,2,129,222
92,41,3,4,5,8,-68,44,1,6,61,266
92,42,2,5,3,10,21,-45,2,1,82,221
92,43,4,3,7,6,43,33,5,4,125,254
92,44,3,4,4,9,31,45,6,9,156,299
92,45,3,3,8,5,-65,-68,1,1,91,231
92,46,3,4,6,7,33,43,4,4,124,274
92,47,5,2,8,5,53,23,7,7,177,297
92,48,3,4,7,6,-66,42,1,9,111,339
92,49,2,5,2,11,20,-44,1,5,131,295
92,50,2,5,3,10,21,-45,2,0,152,250
92,51,4,3,6,7,42,34,4,4,194,284
92,52,3,4,8,5,35,41,9,5,229,325
92,53,4,3,4,9,40,-64,9,1,269,261
92,54,4,2,9,4,-55,22,4,3,214,283
92,55,2,4,3,10,21,46,5,9,235,329
92,56,4,3,7,6,43,-67,8,2,278,262
92,57,3,3,5,8,-68,35,0,7,210,297
92,58,2,4,5,8,23,-56,3,1,233,241
92,59,3,3,7,6,34,33,7,4,267,274
92,60,4,2,8,5,-56,23,1,7,211,297
92,61,3,3,4,9,31,-64,2,3,242,233
92,62,3,3,6,7,33,34,5,7,275,267
92,63,3,4,5,8,32,-56,7,1,307,211
92,64,4,3,5,8,41,35,8,6,348,246
92,65,5,2,9,4,-46,22,2,8,302,268
92,66,4,3,8,5,44,-68,6,0,346,200
92,67,3,3,7,6,-66,33,0,3,280,233
92,68,3,4,5,8,32,44,2,7,312,277
92,69,3,3,5,8,32,-65,4,2,344,212
92,70,5,2,10,3,55,21,9,3,399,233
92,71,5,3,9,4,-46,31,3,4,353,264
92,72,2,4,2,11,20,-53,3,1,373,211
92,73,2,5,4,9,22,54,5,5,395,265
92,74,3,3,3,10,30,-63,5,2,425,202
92,75,3,3,7,6,34,33,9,5,459,235
92,76,5,2,8,5,-47,23,2,8,412,258
92,77,4,3,7,6,43,-67,5,1,455,191
92,78,3,4,5,8,32,44,7,5,487,235
92,79,2,4,7,6,-75,42,2,7,412,277
92,80,4,4,7,6,43,42,5,9,455,319
92,81,4,3,8,5,44,-68,9,1,499,251
92,82,4,2,10,3,-54,21,5,2,445,272
92,83,2,6,4,9,22,63,7,5,467,335
92,84,3,3,9,4,-64,31,3,6,403,366
92,85,2,5,6,7,24,52,7,8,427,418
92,86,3,3,7,6,-66,-67,1,1,361,351
92,87,3,5,3,10,30,55,1,6,391,406
92,88,2,4,5,8,23,-56,4,0,414,350
92,89,5,3,6,7,51,34,5,4,465,384
92,90,3,3,9,4,-64,31,1,5,401,415
92,91,2,4,6,7,24,43,5,8,425,458
92,92,5,2,8,5,53,-77,8,1,478,381
92,93,2,4,4,9,-78,45,0,6,400,426
92,94,6,2,8,5,62,23,2,9,462,449
92,95,3,3,5,8,32,-65,4,4,494,384
92,96,4,3,7,6,43,33,7,7,537,417
93,1,3,3,6,7,33,34,3,4,33,34
93,2,3,3,9,4,36,31,9,5,69,65
93,3,4,3,7,6,-57,33,2,8,12,98
93,4,2,4,5,8,23,-56,5,2,35,42
93,5,2,4,6,7,24,43,9,5,59,85
93,6,6,2,11,2,-35,20,4,5,24,105
93,7,2,5,4,9,22,54,6,9,46,159
93,8,4,3,6,7,42,-66,8,3,88,93
93,9,4,3,10,3,-54,30,4,3,34,123
93,10,3,3,4,9,31,36,5,9,65,159
93,11,3,3,5,8,32,-65,7,4,97,94
93,12,3,3,6,7,-67,34,0,8,30,128
93,13,2,4,5,8,23,-56,3,2,53,72
93,14,3,3,7,6,34,33,7,5,87,105
93,15,4,3,7,6,-57,33,0,8,30,138
93,16,3,4,8,5,35,41,5,9,65,179
93,17,2,4,3,10,21,-54,6,5,86,125
93,18,4,3,8,5,-56,32,0,7,30,157
93,19,3,4,7,6,34,42,4,9,64,199
93,20,4,3,9,4,45,-69,9,0,109,130
93,21,5,2,10,3,-45,21,4,1,64,151
93,22,5,2,11,2,-44,20,0,1,20,171
93,23,4,2,10,3,46,21,6,2,66,192
93,24,2,4,4,9,22,45,8,7,88,237
93,25,3,4,4,9,31,-55,9,2,119,182
93,26,5,3,7,6,-48,33,1,5,71,215
93,27,4,3,7,6,43,33,4,8,114,248
93,28,3,3,7,6,34,-67,8,1,148,181
93,29,4,2,9,4,-55,22,3,3,93,203
93,30,5,2,7,6,52,24,5,7,145,227
93,31,3,3,4,9,31,-64,6,3,176,163
93,32,5,3,8,5,53,32,9,5,229,195
93,33,2,4,3,10,-79,-54,0,1,150,141
93,34,4,3,8,5,44,32,4,3,194,173
93,35,3,3,4,9,31,36,5,9,225,209
93,36,5,2,11,2,-44,20,1,9,181,229
93,37,2,4,5,8,23,-56,4,3,204,173
93,38,4,3,5,8,41,35,5,8,245,208
93,39,3,3,7,6,34,-67,9,1,279,141
93,40,3,4,3,10,30,46,9,7,309,187
93,41,4,3,9,4,-55,31,4,8,254,218
93,42,3,3,6,7,33,-66,7,2,287,152
93,43,3,3,5,8,32,35,9,7,319,187
93,44,4,2,7,6,-57,-76,2,1,262,111
93,45,2,4,7,6,25,42,7,3,287,153
93,46,3,3,7,6,-66,33,1,6,221,186
93,47,2,4,7,6,25,42,6,8,246,228
93,48,3,4,8,5,-65,41,1,9,181,269
93,49,2,4,3,10,21,-54,2,5,202,215
93,50,3,3,8,5,35,32,7,7,237,247
93,51,4,3,10,3,-54,30,3,7,183,277
93,52,2,5,6,7,24,52,7,9,207,329
93,53,2,4,8,5,-74,-59,3,0,133,270
93,54,3,4,7,6,34,42,7,2,167,312
93,55,3,4,7,6,-66,42,1,4,101,354
93,56,2,4,3,10,21,-54,2,0,122,300
93,57,3,3,7,6,34,33,6,3,156,333
93,58,4,2,8,5,-56,23,0,6,100,356
93,59,4,3,7,6,43,33,3,9,143,389
93,60,3,4,6,7,33,-57,6,2,176,332
93,61,3,3,7,6,-66,33,0,5,110,365
93,62,3,3,6,7,33,34,3,9,143,399
93,63,3,4,6,7,33,-57,6,2,176,342
93,64,3,4,5,8,32,44,8,6,208,386
93,65,3,3,8,5,-65,32,3,8,143,418
93,66,4,2,9,4,45,-78,8,0,188,340
93,67,2,6,4,9,-78,63,0,3,110,403
93,68,4,3,8,5,44,32,4,5,154,435
93,69,2,5,4,9,22,54,6,9,176,489
93,70,4,3,5,8,41,-65,7,4,217,424
93,71,3,3,8,5,-65,32,2,6,152,456
93,72,3,4,6,7,33,43,5,9,185,499
93,73,2,5,5,8,23,-47,8,2,208,452
93,74,4,3,7,6,-57,33,1,5,151,485
93,75,5,2,8,5,53,23,4,8,204,508
94,1,4,2,7,6,43,24,3,4,43,24
94,2,2,4,5,8,23,44,6,8,66,68
94,3,5,2,8,5,53,-77,9,1,119,-9
94,4,3,4,7,6,-66,42,3,3,53,33
94,5,4,2,5,8,41,26,4,9,94,59
94,6,4,3,5,8,41,-65,5,4,135,-6
94,7,2,4,3,10,21,-54,6,0,156,-60
94,8,3,4,6,7,33,43,9,3,189,-17
94,9,4,3,6,7,-58,34,1,7,131,17
94,10,2,5,6,7,24,52,5,9,155,69
94,11,2,4,8,5,-74,-59,1,0,81,10
94,12,5,2,11,2,56,20,7,0,137,30
94,13,3,4,5,8,32,44,9,4,169,74
94,14,2,6,4,9,-78,63,1,7,91,137
94,15,3,3,9,4,36,31,7,8,127,168
94,16,3,4,6,7,-67,-57,0,1,60,111
94,17,3,4,6,7,33,43,3,4,93,154
94,18,3,4,6,7,33,43,6,7,126,197
94,19,4,3,6,7,42,-66,8,1,168,131
94,20,2,4,4,9,-78,45,0,6,90,176
94,21,2,4,6,7,24,43,4,9,114,219
94,22,2,4,6,7,24,-57,8,2,138,162
94,23,2,4,3,10,21,46,9,8,159,208
94,24,2,6,5,8,-77,-38,2,0,82,170
94,25,4,3,8,5,44,32,6,2,126,202
94,26,5,2,7,6,52,24,8,6,178,226
94,27,4,3,9,4,-55,31,3,7,123,257
94,28,3,4,3,10,30,-54,3,3,153,203
94,29,5,3,8,5,53,32,6,5,206,235
94,30,2,6,4,9,22,63,8,8,228,298
94,31,3,4,7,6,-66,-58,2,0,162,240
94,32,3,4,5,8,32,44,4,4,194,284
94,33,5,2,8,5,53,23,7,7,247,307
94,34,5,2,7,6,52,-76,9,1,299,231
94,35,4,3,6,7,-58,34,1,5,241,265
94,36,3,3,5,8,32,-65,3,0,273,200
94,37,2,4,6,7,24,43,7,3,297,243
94,38,3,3,7,6,-66,33,1,6,231,276
94,39,3,4,4,9,31,-55,2,1,262,221
94,40,4,4,6,7,42,43,4,4,304,264
94,41,2,5,3,10,21,55,5,9,325,319
94,42,2,5,5,8,23,-47,8,2,348,272
94,43,2,5,3,10,21,55,9,7,369,327
94,44,2,5,4,9,-78,-46,1,1,291,281
94,45,5,2,10,3,55,21,6,2,346,302
94,46,3,3,7,6,-66,33,0,5,280,335
94,47,5,3,7,6,52,33,2,8,332,368
94,48,4,3,6,7,42,-66,4,2,374,302
94,49,2,6,5,8,23,62,7,4,397,364
94,50,3,4,4,9,31,45,8,9,428,409
94,51,2,4,4,9,-78,-55,0,4,350,354
94,52,2,4,5,8,23,44,3,8,373,398
94,53,4,3,8,5,44,-68,7,0,417,330
94,54,3,3,6,7,-67,34,0,4,350,364
94,55,2,6,4,9,22,63,2,7,372,427
94,56,3,3,6,7,33,-66,5,1,405,361
94,57,3,3,7,6,34,33,9,4,439,394
94,58,3,4,6,7,-67,43,2,7,372,437
94,59,3,4,7,6,34,42,6,9,406,479
94,60,2,4,6,7,-76,-57,0,2,330,422
94,61,4,3,8,5,44,32,4,4,374,454
94,62,3,4,5,8,32,44,6,8,406,498
94,63,2,4,4,9,22,-55,8,3,428,443
94,64,4,3,7,6,-57,33,1,6,371,476
94,65,6,2,10,3,64,21,5,7,435,497
94,66,2,4,5,8,23,-56,8,1,458,441
94,67,4,2,6,7,-58,25,0,6,400,466
94,68,3,4,6,7,33,43,3,9,433,509
95,1,2,5,5,8,23,53,3,3,23,53
95,2,3,4,5,8,32,44,5,7,55,97
95,3,4,2,6,7,42,-75,7,2,97,22
95,4,4,3,9,4,-55,31,2,3,42,53
95,5,2,5,5,8,23,53,5,6,65,106
95,6,3,3,5,8,32,-65,7,1,97,41
95,7,2,6,3,10,21,64,8,5,118,105
95,8,4,3,7,6,-57,33,1,8,61,138
95,9,2,4,3,10,21,-54,2,4,82,84
95,10,4,2,9,4,45,22,7,6,127,106
95,11,4,3,8,5,-56,32,1,8,71,138
95,12,4,3,6,7,42,-66,3,2,113,72
95,13,4,3,7,6,43,33,6,5,156,105
95,14,4,2,5,8,41,-74,7,1,197,31
95,15,4,3,9,4,-55,31,2,2,142,62
95,16,5,2,11,2,56,20,8,2,198,82
95,17,3,4,6,7,-67,43,1,5,131,125
95,18,4,2,7,6,43,24,4,9,174,149
95,19,2,5,5,8,23,-47,7,2,197,102
95,20,2,5,5,8,-77,53,0,5,120,155
95,21,3,3,5,8,32,-65,2,0,152,90
95,22,5,3,8,5,53,32,5,2,205,122
95,23,3,4,7,6,34,42,9,4,239,164
95,24,2,5,7,6,-75,51,4,5,164,215
95,25,4,3,7,6,43,33,7,8,207,248
95,26,3,4,5,8,32,-56,9,2,239,192
95,27,3,3,6,7,-67,34,2,6,172,226
95,28,4,4,6,7,42,43,4,9,214,269
95,29,2,7,2,11,20,-26,4,3,234,243
95,30,3,3,6,7,33,34,7,7,267,277
95,31,2,5,5,8,-77,-47,0,0,190,230
95,32,4,3,9,4,45,31,5,1,235,261
95,33,3,3,8,5,-65,32,0,3,170,293
95,34,4,3,9,4,45,31,5,4,215,324
95,35,3,3,5,8,32,35,7,9,247,359
95,36,3,4,7,6,-66,-58,1,1,181,301
95,37,3,4,7,6,34,42,5,3,215,343
95,38,3,3,8,5,-65,32,0,5,150,375
95,39,5,2,9,4,54,22,4,7,204,397
95,40,4,2,5,8,41,-74,5,3,245,323
95,41,3,3,7,6,34,33,9,6,279,356
95,42,2,6,2,11,20,-35,9,1,299,321
95,43,5,2,9,4,-46,22,3,3,253,343
95,44,3,3,4,9,31,36,4,9,284,379
95,45,5,2,9,4,54,-78,8,1,338,301
95,46,3,3,7,6,-66,33,2,4,272,334
95,47,3,3,9,4,36,31,8,5,308,365
95,48,3,4,5,8,-68,44,0,9,240,409
95,49,3,3,5,8,32,-65,2,4,272,344
95,50,4,3,8,5,44,32,6,6,316,376
95,51,4,2,7,6,43,-76,9,0,359,300
95,52,4,3,8,5,-56,32,3,2,303,332
95,53,5,2,7,6,52,24,5,6,355,356
95,54,4,3,5,8,41,-65,6,1,396,291
95,55,3,3,7,6,-66,33,0,4,330,324
95,56,4,2,7,6,43,24,3,8,373,348
95,57,3,3,8,5,35,-68,8,0,408,280
95,58,2,4,7,6,-75,42,3,2,333,322
95,59,5,3,8,5,53,32,6,4,386,354
95,60,2,5,6,7,-76,52,0,6,310,406
95,61,4,3,7,6,43,33,3,9,353,439
95,62,3,3,6,7,33,-66,6,3,386,373
95,63,3,3,6,7,33,34,9,7,419,407
95,64,4,3,4,9,40,-64,9,3,459,343
95,65,5,2,8,5,-47,23,2,6,412,366
95,66,3,4,5,8,32,-56,4,0,444,310
95,67,4,2,8,5,44,23,8,3,488,333
95,68,3,3,5,8,-68,35,0,8,420,368
95,69,2,5,4,9,22,-46,2,2,442,322
95,70,3,4,6,7,33,43,5,5,475,365
95,71,4,3,5,8,41,-65,6,0,516,300
96,1,3,4,5,8,32,44,2,4,32,44
96,2,3,4,5,8,32,44,4,8,64,88
96,3,2,4,4,9,22,-55,6,3,86,33
96,4,2,6,2,11,20,65,6,8,106,98
96,5,2,4,5,8,23,-56,9,2,129,42
96,6,2,4,6,7,-76,43,3,5,53,85
96,7,3,4,6,7,33,43,6,8,86,128
96,8,3,3,8,5,-65,-68,1,0,21,60
96,9,3,3,8,5,35,32,6,2,56,92
96,10,2,5,3,10,21,55,7,7,77,147
96,11,4,2,10,3,-54,21,3,8,23,168
96,12,4,3,6,7,42,-66,5,2,65,102
96,13,2,4,7,6,-75,42,0,4,-10,144
96,14,3,3,7,6,34,33,4,7,24,177
96,15,2,4,2,11,20,-53,4,4,44,124
96,16,2,4,6,7,24,43,8,7,68,167
96,17,2,5,3,10,21,-45,9,2,89,122
96,18,3,4,8,5,-65,41,4,3,24,163
96,19,4,2,10,3,-54,21,0,4,-30,184
96,20,3,3,6,7,33,34,3,8,3,218
96,21,2,4,6,7,24,-57,7,1,27,161
96,22,3,4,8,5,-65,41,2,2,-38,202
96,23,5,2,8,5,53,23,5,5,15,225
96,24,3,4,7,6,34,42,9,7,49,267
96,25,4,3,7,6,-57,-67,2,0,-8,200
96,26,4,2,9,4,45,22,7,2,37,222
96,27,4,3,8,5,-56,32,1,4,-19,254
96,28,3,3,4,9,31,-64,2,0,12,190
96,29,2,5,4,9,22,54,4,4,34,244
96,30,2,4,3,10,21,-54,5,0,55,190
96,31,4,2,8,5,44,23,9,3,99,213
96,32,5,2,6,7,-49,25,0,8,50,238
96,33,3,4,4,9,31,-55,1,3,81,183
96,34,4,3,8,5,44,32,5,5,125,215
96,35,3,4,4,9,31,-55,6,0,156,160
96,36,2,4,7,6,-75,42,1,2,81,202
96,37,3,4,5,8,32,44,3,6,113,246
96,38,3,3,7,6,34,33,7,9,147,279
96,39,3,4,6,7,-67,-57,0,2,80,222
96,40,2,4,4,9,22,45,2,7,102,267
96,41,4,2,6,7,42,-75,4,2,144,192
96,42,3,3,9,4,-64,31,0,3,80,223
96,43,3,4,5,8,32,44,2,7,112,267
96,44,4,2,6,7,42,-75,4,2,154,192
96,45,4,4,6,7,42,43,6,5,196,235
96,46,4,3,9,4,-55,31,1,6,141,266
96,47,3,3,9,4,36,31,7,7,177,297
96,48,3,3,7,6,-66,-67,1,0,111,230
96,49,4,2,7,6,43,24,4,4,154,254
96,50,3,3,6,7,33,34,7,8,187,288
96,51,4,3,7,6,-57,-67,0,1,130,221
96,52,3,4,8,5,35,41,5,2,165,262
96,53,3,3,4,9,31,36,6,8,196,298
96,54,3,4,8,5,-65,41,1,9,131,339
96,55,4,3,8,5,44,-68,5,1,175,271
96,56,5,2,10,3,-45,21,0,2,130,292
96,57,2,4,5,8,23,44,3,6,153,336
96,58,2,5,4,9,22,-46,5,0,175,290
96,59,3,3,8,5,-65,32,0,2,110,322
96,60,4,3,6,7,42,34,2,6,152,356
96,61,4,2,8,5,44,23,6,9,196,379
96,62,4,3,5,8,41,-65,7,4,237,314
96,63,3,4,7,6,-66,42,1,6,171,356
96,64,3,3,3,10,30,-63,1,3,201,293
96,65,2,4,6,7,24,43,5,6,225,336
96,66,3,3,5,8,32,-65,7,1,257,271
96,67,2,5,4,9,22,54,9,5,279,325
96,68,4,3,8,5,-56,32,3,7,223,357
96,69,4,3,5,8,41,-65,4,2,264,292
96,70,4,4,7,6,43,42,7,4,307,334
96,71,3,3,7,6,-66,33,1,7,241,367
96,72,2,5,5,8,23,-47,4,0,264,320
96,73,3,4,6,7,33,43,7,3,297,363
96,74,5,2,10,3,-45,21,2,4,252,384
96,75,3,3,6,7,33,34,5,8,285,418
96,76,3,3,7,6,34,-67,9,1,319,351
96,77,2,4,6,7,-76,43,3,4,243,394
96,78,4,2,6,7,42,25,5,9,285,419
96,79,3,4,8,5,-65,-59,0,0,220,360
96,80,5,2,11,2,56,20,6,0,276,380
96,81,2,4,5,8,23,44,9,4,299,424
96,82,2,4,4,9,-78,45,1,9,221,469
96,83,2,6,3,10,21,-36,2,3,242,433
96,84,4,3,9,4,45,31,7,4,287,464
96,85,4,2,9,4,-55,22,2,6,232,486
96,86,4,2,7,6,43,-76,5,0,275,410
96,87,4,3,9,4,-55,31,0,1,220,441
96,88,2,4,4,9,22,45,2,6,242,486
96,89,3,3,8,5,35,32,7,8,277,518
97,1,4,3,8,5,44,32,4,2,44,32
97,2,2,4,6,7,24,43,8,5,68,75
97,3,3,4,4,9,31,-55,9,0,99,20
97,4,5,2,7,6,-48,24,1,4,51,44
97,5,3,3,5,8,32,35,3,9,83,79
97,6,5,2,7,6,52,-76,5,3,135,3
97,7,4,3,7,6,43,33,8,6,178,36
97,8,3,3,6,7,-67,-66,1,0,111,-30
97,9,4,3,7,6,43,33,4,3,154,3
97,10,3,3,5,8,32,35,6,8,186,38
97,11,4,3,5,8,41,-65,7,3,227,-27
97,12,3,4,6,7,-67,43,0,6,160,16
97,13,6,2,10,3,64,21,4,7,224,37
97,14,5,2,10,3,55,21,9,8,279,58
97,15,3,4,7,6,-66,-58,3,0,213,0
97,16,2,5,3,10,21,55,4,5,234,55
97,17,4,2,8,5,44,23,8,8,278,78
97,18,4,2,9,4,-55,-78,3,0,223,0
97,19,3,3,7,6,34,33,7,3,257,33
97,20,3,4,5,8,32,44,9,7,289,77
97,21,4,2,8,5,-56,-77,3,0,233,0
97,22,3,4,6,7,33,43,6,3,266,43
97,23,3,3,7,6,-66,33,0,6,200,76
97,24,3,3,6,7,33,-66,3,0,233,10
97,25,4,3,8,5,44,32,7,2,277,42
97,26,4,3,8,5,-56,32,1,4,221,74
97,27,3,4,8,5,35,41,6,5,256,115
97,28,4,3,7,6,43,33,9,8,299,148
97,29,3,3,7,6,-66,-67,3,1,233,81
97,30,2,5,2,11,20,56,3,7,253,137
97,31,5,2,8,5,53,-77,6,0,306,60
97,32,3,3,6,7,33,34,9,4,339,94
97,33,3,4,8,5,-65,41,4,5,274,135
97,34,3,5,4,9,31,54,5,9,305,189
97,35,4,2,8,5,44,-77,9,2,349,112
97,36,4,3,6,7,-58,34,1,6,291,146
97,37,3,4,7,6,34,42,5,8,325,188
97,38,3,4,7,6,34,-58,9,0,359,130
97,39,3,3,6,7,-67,34,2,4,292,164
97,40,2,6,2,11,20,65,2,9,312,229
97,41,4,2,9,4,45,-78,7,1,357,151
97,42,3,3,6,7,-67,34,0,5,290,185
97,43,4,3,8,5,44,32,4,7,334,217
97,44,2,4,4,9,22,-55,6,2,356,162
97,45,4,3,8,5,-56,32,0,4,300,194
97,46,5,2,10,3,55,21,5,5,355,215
97,47,3,4,8,5,-65,41,0,6,290,256
97,48,4,2,6,7,42,-75,2,1,332,181
97,49,4,3,8,5,44,32,6,3,376,213
97,50,5,2,8,5,53,23,9,6,429,236
97,51,4,3,7,6,-57,33,2,9,372,269
97,52,3,4,7,6,34,-58,6,1,406,211
97,53,2,5,3,10,21,55,7,6,427,266
97,54,4,3,9,4,-55,31,2,7,372,297
97,55,4,3,10,3,46,30,8,7,418,327
97,56,3,3,6,7,-67,-66,1,1,351,261
97,57,3,4,7,6,34,42,5,3,385,303
97,58,4,2,6,7,42,25,7,8,427,328
97,59,4,3,8,5,-56,-68,1,0,371,260
97,60,4,2,8,5,44,23,5,3,415,283
97,61,3,4,4,9,31,45,6,8,446,328
97,62,4,3,7,6,43,-67,9,1,489,261
97,63,2,5,5,8,-77,53,2,4,412,314
97,64,3,4,5,8,32,44,4,8,444,358
97,65,2,4,5,8,23,-56,7,2,467,302
97,66,2,5,4,9,22,54,9,6,489,356
97,67,2,4,3,10,-79,-54,0,2,410,302
97,68,4,2,9,4,45,22,5,4,455,324
97,69,3,3,8,5,-65,32,0,6,390,356
97,70,2,6,4,9,22,63,2,9,412,419
97,71,6,2,11,2,65,20,7,9,477,439
97,72,3,4,3,10,30,-54,7,5,507,385
98,1,2,4,6,7,24,43,4,3,24,43
98,2,3,4,8,5,35,41,9,4,59,84
98,3,3,4,6,7,-67,43,2,7,-8,127
98,4,4,3,8,5,44,32,6,9,36,159
98,5,3,3,8,5,-65,-68,1,1,-29,91
98,6,3,3,7,6,34,33,5,4,5,124
98,7,4,3,7,6,43,33,8,7,48,157
98,8,4,3,7,6,-57,-67,1,0,-9,90
98,9,3,4,6,7,33,43,4,3,24,133
98,10,3,4,5,8,32,44,6,7,56,177
98,11,4,4,5,8,41,-56,7,1,97,121
98,12,3,4,5,8,32,44,9,5,129,165
98,13,2,6,5,8,-77,62,2,7,52,227
98,14,2,5,3,10,21,-45,3,2,73,182
98,15,2,5,5,8,23,53,6,5,96,235
98,16,4,2,9,4,-55,22,1,7,41,257
98,17,5,2,9,4,54,22,5,9,95,279
98,18,4,3,9,4,-55,-69,0,0,40,210
98,19,4,3,8,5,44,32,4,2,84,242
98,20,4,2,7,6,43,24,7,6,127,266
98,21,3,3,6,7,-67,-66,0,0,60,200
98,22,4,3,9,4,45,31,5,1,105,231
98,23,3,3,6,7,33,34,8,5,138,265
98,24,2,5,5,8,-77,53,1,8,61,318
98,25,6,2,10,3,64,21,5,9,125,339
98,26,3,4,7,6,34,-58,9,1,159,281
98,27,3,4,5,8,-68,44,1,5,91,325
98,28,4,2,9,4,45,22,6,7,136,347
98,29,3,3,5,8,32,-65,8,2,168,282
98,30,3,3,5,8,-68,35,0,7,100,317
98,31,5,2,10,3,55,21,5,8,155,338
98,32,3,3,5,8,32,-65,7,3,187,273
98,33,4,3,7,6,-57,33,0,6,130,306
98,34,4,2,9,4,45,22,5,8,175,328
98,35,2,6,3,10,21,-36,6,2,196,292
98,36,4,3,6,7,42,34,8,6,238,326
98,37,3,4,4,9,31,-55,9,1,269,271
98,38,5,3,8,5,-47,32,2,3,222,303
98,39,3,4,6,7,33,43,5,6,255,346
98,40,4,2,9,4,-55,22,0,8,200,368
98,41,4,3,7,6,43,-67,3,1,243,301
98,42,3,3,7,6,34,33,7,4,277,334
98,43,3,3,5,8,32,35,9,9,309,369
98,44,2,4,4,9,-78,-55,1,4,231,314
98,45,3,4,8,5,35,41,6,5,266,355
98,46,2,5,6,7,-76,52,0,7,190,407
98,47,3,3,7,6,34,-67,4,0,224,340
98,48,3,4,5,8,32,44,6,4,256,384
98,49,3,3,8,5,-65,32,1,6,191,416
98,50,5,2,10,3,55,21,6,7,246,437
98,51,3,3,6,7,33,-66,9,1,279,371
98,52,3,4,6,7,-67,43,2,4,212,414
98,53,3,4,7,6,34,42,6,6,246,456
98,54,2,4,3,10,21,-54,7,2,267,402
98,55,4,2,7,6,-57,24,0,6,210,426
98,56,4,3,6,7,42,-66,2,0,252,360
98,57,2,4,6,7,24,43,6,3,276,403
98,58,3,3,8,5,-65,32,1,5,211,435
98,59,5,3,5,8,50,-65,1,0,261,370
98,60,2,4,6,7,24,43,5,3,285,413
98,61,4,3,6,7,42,34,7,7,327,447
98,62,3,4,6,7,-67,-57,0,0,260,390
98,63,4,3,6,7,42,34,2,4,302,424
98,64,4,3,7,6,43,33,5,7,345,457
98,65,4,3,9,4,-55,31,0,8,290,488
98,66,4,3,7,6,43,-67,3,1,333,421
98,67,4,3,7,6,43,33,6,4,376,454
98,68,3,3,8,5,-65,32,1,6,311,486
98,69,5,2,9,4,54,22,5,8,365,508
99,1,3,3,8,5,35,32,5,2,35,32
99,2,4,2,10,3,-54,21,1,3,-19,53
99,3,2,4,3,10,21,46,2,9,2,99
99,4,2,5,3,10,21,-45,3,4,23,54
99,5,3,4,8,5,35,41,8,5,58,95
99,6,4,3,5,8,41,-65,9,0,99,30
99,7,2,4,4,9,-78,45,1,5,21,75
99,8,4,3,9,4,45,31,6,6,66,106
99,9,2,5,4,9,22,-46,8,0,88,60
99,10,3,4,7,6,-66,42,2,2,22,102
99,11,3,3,10,3,37,30,9,2,59,132
99,12,2,5,4,9,-78,54,1,6,-19,186
99,13,4,3,7,6,43,33,4,9,24,219
99,14,3,4,5,8,32,-56,6,3,56,163
99,15,3,4,3,10,30,46,6,9,86,209
99,16,2,5,3,10,21,-45,7,4,107,164
99,17,3,4,5,8,32,44,9,8,139,208
99,18,3,3,7,6,-66,-67,3,1,73,141
99,19,2,4,4,9,22,45,5,6,95,186
99,20,4,3,7,6,43,33,8,9,138,219
99,21,3,3,7,6,-66,-67,2,2,72,152
99,22,3,3,7,6,34,33,6,5,106,185
99,23,4,3,10,3,-54,30,2,5,52,215
99,24,3,3,10,3,37,30,9,5,89,245
99,25,4,3,9,4,-55,31,4,6,34,276
99,26,3,4,6,7,33,43,7,9,67,319
99,27,2,5,2,11,20,-44,7,5,87,275
99,28,3,3,5,8,32,-65,9,0,119,210
99,29,3,4,7,6,-66,42,3,2,53,252
99,30,3,4,6,7,33,43,6,5,86,295
99,31,3,3,4,9,31,-64,7,1,117,231
99,32,3,5,6,7,-67,52,0,3,50,283
99,33,4,3,6,7,42,34,2,7,92,317
99,34,2,4,6,7,24,-57,6,0,116,260
99,35,4,2,9,4,-55,22,1,2,61,282
99,36,4,2,7,6,43,24,4,6,104,306
99,37,2,6,2,11,20,-35,4,1,124,271
99,38,5,2,6,7,51,25,5,6,175,296
99,39,2,4,3,10,21,-54,6,2,196,242
99,40,5,2,8,5,53,23,9,5,249,265
99,41,3,3,6,7,-67,34,2,9,182,299
99,42,4,2,8,5,44,-77,6,2,226,222
99,43,4,3,8,5,-56,32,0,4,170,254
99,44,2,5,2,11,20,-44,0,0,190,210
99,45,4,2,6,7,42,25,2,5,232,235
99,46,3,3,6,7,33,34,5,9,265,269
99,47,2,5,3,10,21,-45,6,4,286,224
99,48,5,2,11,2,-44,20,2,4,242,244
99,49,2,4,8,5,26,41,8,5,268,285
99,50,3,3,6,7,-67,34,1,9,201,319
99,51,4,3,7,6,43,-67,4,2,244,252
99,52,3,3,3,10,30,37,4,9,274,289
99,53,3,3,7,6,34,-67,8,2,308,222
99,54,2,4,4,9,-78,45,0,7,230,267
99,55,2,5,6,7,24,52,4,9,254,319
99,56,3,4,7,6,34,-58,8,1,288,261
99,57,4,2,9,4,-55,22,3,3,233,283
99,58,4,3,7,6,43,33,6,6,276,316
99,59,4,2,6,7,42,-75,8,1,318,241
99,60,2,5,6,7,-76,52,2,3,242,293
99,61,3,3,5,8,32,35,4,8,274,328
99,62,2,4,4,9,22,-55,6,3,296,273
99,63,3,4,4,9,31,45,7,8,327,318
99,64,4,3,9,4,-55,31,2,9,272,349
99,65,5,3,7,6,52,-67,4,2,324,282
99,66,3,4,5,8,32,44,6,6,356,326
99,67,4,3,6,7,42,-66,8,0,398,260
99,68,3,4,6,7,-67,43,1,3,331,303
99,69,2,4,3,10,21,46,2,9,352,349
99,70,3,4,4,9,31,-55,3,4,383,294
99,71,3,3,8,5,35,32,8,6,418,326
99,72,3,4,5,8,-68,-56,0,0,350,270
99,73,3,3,6,7,33,34,3,4,383,304
99,74,2,4,8,5,26,41,9,5,409,345
99,75,2,5,3,10,-79,-45,0,0,330,300
99,76,4,3,8,5,44,32,4,2,374,332
99,77,3,3,5,8,32,35,6,7,406,367
99,78,3,4,4,9,31,-55,7,2,437,312
99,79,2,5,3,10,21,55,8,7,458,367
99,80,4,2,7,6,-57,-76,1,1,401,291
99,81,4,3,9,4,45,31,6,2,446,322
99,82,3,4,6,7,33,43,9,5,479,365
99,83,4,2,7,6,-57,24,2,9,422,389
99,84,2,4,6,7,24,-57,6,2,446,332
99,85,2,4,5,8,23,44,9,6,469,376
99,86,4,2,10,3,-54,21,5,7,415,397
99,87,2,4,5,8,23,-56,8,1,438,341
99,88,3,4,3,10,30,46,8,7,468,387
99,89,4,3,8,5,-56,32,2,9,412,419
99,90,2,4,4,9,22,-55,4,4,434,364
99,91,6,2,10,3,64,21,8,5,498,385
99,92,2,5,4,9,-78,54,0,9,420,439
99,93,4,2,7,6,43,-76,3,3,463,363
99,94,4,3,8,5,44,32,7,5,507,395
100,1,5,2,9,4,54,22,4,2,54,22
100,2,3,3,4,9,31,36,5,8,85,58
100,3,4,4,5,8,41,-56,6,2,126,2
100,4,2,4,6,7,-76,43,0,5,50,45
100,5,2,5,5,8,23,53,3,8,73,98
100,6,2,4,4,9,22,-55,5,3,95,43
100,7,3,3,7,6,34,33,9,6,129,76
100,8,4,2,8,5,-56,23,3,9,73,99
100,9,2,5,3,10,21,-45,4,4,94,54
100,10,2,5,4,9,22,54,6,8,116,108
100,11,2,5,4,9,22,-46,8,2,138,62
100,12,4,2,8,5,-56,23,2,5,82,85
100,13,4,3,7,6,43,33,5,8,125,118
100,14,4,4,7,6,43,-58,8,0,168,60
100,15,3,3,8,5,-65,32,3,2,103,92
100,16,3,4,4,9,31,45,4,7,134,137
100,17,2,6,2,11,20,-35,4,2,154,102
100,18,4,3,7,6,43,33,7,5,197,135
100,19,4,2,6,7,42,-75,9,0,239,60
100,20,3,5,6,7,-67,52,2,2,172,112
100,21,2,4,2,11,20,47,2,9,192,159
100,22,4,3,8,5,44,-68,6,1,236,91
100,23,3,4,4,9,31,45,7,6,267,136
100,24,4,3,9,4,-55,31,2,7,212,167
100,25,3,4,6,7,33,-57,5,0,245,110
100,26,2,4,6,7,24,43,9,3,269,153
100,27,4,3,10,3,-54,30,5,3,215,183
100,28,2,4,5,8,23,44,8,7,238,227
100,29,4,2,7,6,-57,-76,1,1,181,151
100,30,4,2,7,6,43,24,4,5,224,175
100,31,4,2,10,3,-54,21,0,6,170,196
100,32,3,4,7,6,34,42,4,8,204,238
100,33,2,5,4,9,22,-46,6,2,226,192
100,34,2,4,5,8,23,44,9,6,249,236
100,35,3,4,7,6,-66,42,3,8,183,278
100,36,2,4,6,7,24,-57,7,1,207,221
100,37,4,2,10,3,-54,21,3,2,153,242
100,38,3,4,7,6,34,42,7,4,187,284
100,39,3,3,7,6,-66,33,1,7,121,317
100,40,3,4,6,7,33,-57,4,0,154,260
100,41,3,3,9,4,-64,31,0,1,90,291
100,42,3,4,5,8,32,44,2,5,122,335
100,43,4,3,8,5,44,32,6,7,166,367
100,44,2,4,6,7,-76,-57,0,0,90,310
100,45,4,2,9,4,45,22,5,2,135,332
100,46,5,2,11,2,-44,20,1,2,91,352
100,47,2,5,4,9,22,54,3,6,113,406
100,48,3,5,5,8,32,53,5,9,145,459
100,49,3,3,6,7,33,-66,8,3,178,393
100,50,2,4,5,8,-77,44,1,7,101,437
100,51,3,4,5,8,32,-56,3,1,133,381
100,52,4,3,7,6,43,33,6,4,176,414
100,53,3,4,4,9,31,45,7,9,207,459
100,54,2,5,4,9,22,-46,9,3,229,413
100,55,2,5,5,8,-77,53,2,6,152,466
100,56,2,4,5,8,23,-56,5,0,175,410
100,57,4,3,9,4,-55,31,0,1,120,441
100,58,2,5,5,8,23,53,3,4,143,494
100,59,3,3,9,4,36,31,9,5,179,525
101,1,2,4,6,7,24,43,4,3,24,43
101,2,3,4,8,5,35,41,9,4,59,84
101,3,4,3,7,6,-57,33,2,7,2,117
101,4,3,3,6,7,33,-66,5,1,35,51
101,5,5,2,8,5,53,23,8,4,88,74
101,6,3,4,6,7,-67,43,1,7,21,117
101,7,2,5,3,10,21,-45,2,2,42,72
101,8,2,5,6,7,24,52,6,4,66,124
101,9,3,3,6,7,33,34,9,8,99,158
101,10,2,5,4,9,-78,-46,1,2,21,112
101,11,4,2,10,3,46,21,7,3,67,133
101,12,2,5,2,11,20,56,7,9,87,189
101,13,3,4,5,8,32,-56,9,3,119,133
101,14,3,4,5,8,-68,44,1,7,51,177
101,15,3,3,7,6,34,-67,5,0,85,110
101,16,2,4,4,9,22,45,7,5,107,155
101,17,3,4,5,8,32,44,9,9,139,199
101,18,4,2,8,5,-56,-77,3,2,83,122
101,19,2,4,5,8,23,44,6,6,106,166
101,20,2,4,4,9,22,-55,8,1,128,111
101,21,3,4,4,9,31,45,9,6,159,156
101,22,4,2,7,6,-57,-76,2,0,102,80
101,23,6,2,10,3,64,21,6,1,166,101
101,24,3,3,7,6,-66,33,0,4,100,134
101,25,3,3,6,7,33,34,3,8,133,168
101,26,2,4,5,8,23,-56,6,2,156,112
101,27,4,2,6,7,42,25,8,7,198,137
101,28,3,3,5,8,-68,-65,0,2,130,72
101,29,3,4,6,7,33,43,3,5,163,115
101,30,4,3,9,4,45,31,8,6,208,146
101,31,2,5,4,9,-78,-46,0,0,130,100
101,32,3,4,8,5,35,41,5,1,165,141
101,33,3,4,5,8,32,44,7,5,197,185
101,34,3,4,8,5,-65,41,2,6,132,226
101,35,3,3,4,9,31,-64,3,2,163,162
101,36,2,4,6,7,24,43,7,5,187,205
101,37,4,3,8,5,-56,32,1,7,131,237
101,38,4,3,6,7,42,-66,3,1,173,171
101,39,2,5,4,9,22,54,5,5,195,225
101,40,3,3,6,7,33,34,8,9,228,259
101,41,3,3,8,5,-65,-68,3,1,163,191
101,42,4,2,10,3,46,21,9,2,209,212
101,43,3,4,6,7,-67,43,2,5,142,255
101,44,3,4,6,7,33,43,5,8,175,298
101,45,2,4,3,10,21,-54,6,4,196,244
101,46,4,2,9,4,-55,22,1,6,141,266
101,47,2,5,6,7,24,52,5,8,165,318
101,48,4,2,8,5,44,-77,9,1,209,241
101,49,3,3,5,8,-68,35,1,6,141,276
101,50,2,6,3,10,21,-36,2,0,162,240
101,51,5,2,8,5,53,23,5,3,215,263
101,52,4,2,9,4,-55,22,0,5,160,285
101,53,3,4,7,6,34,42,4,7,194,327
101,54,3,3,7,6,34,-67,8,0,228,260
101,55,3,4,6,7,-67,43,1,3,161,303
101,56,2,4,6,7,24,43,5,6,185,346
101,57,2,5,4,9,22,-46,7,0,207,300
101,58,3,4,4,9,31,45,8,5,238,345
101,59,5,2,8,5,-47,23,1,8,191,368
101,60,3,3,5,8,32,-65,3,3,223,303
101,61,3,3,5,8,32,35,5,8,255,338
101,62,4,2,9,4,-55,-78,0,0,200,260
101,63,3,3,8,5,35,32,5,2,235,292
101,64,4,3,5,8,41,35,6,7,276,327
101,65,4,3,10,3,-54,30,2,7,222,357
101,66,3,3,8,5,35,32,7,9,257,389
101,67,4,3,9,4,-55,-69,2,0,202,320
101,68,2,5,2,11,20,56,2,6,222,376
101,69,3,4,5,8,32,-56,4,0,254,320
101,70,4,3,7,6,43,33,7,3,297,353
101,71,3,3,5,8,32,35,9,8,329,388
101,72,4,2,7,6,-57,-76,2,2,272,312
101,73,4,2,7,6,43,24,5,6,315,336
101,74,2,4,4,9,22,-55,7,1,337,281
101,75,4,2,8,5,-56,23,1,4,281,304
101,76,3,4,4,9,31,45,2,9,312,349
101,77,3,3,4,9,31,-64,3,5,343,285
101,78,4,2,7,6,43,24,6,9,386,309
101,79,4,3,8,5,-56,-68,0,1,330,241
101,80,3,3,7,6,34,33,4,4,364,274
101,81,2,4,5,8,23,44,7,8,387,318
101,82,3,3,5,8,32,-65,9,3,419,253
101,83,5,2,7,6,-48,24,1,7,371,277
101,84,4,3,8,5,44,32,5,9,415,309
101,85,4,2,5,8,41,-74,6,5,456,235
101,86,2,4,4,9,22,-55,8,0,478,180
101,87,2,5,6,7,-76,52,2,2,402,232
101,88,2,4,6,7,24,43,6,5,426,275
101,89,4,3,7,6,43,33,9,8,469,308
101,90,2,5,3,10,-79,-45,0,3,390,263
101,91,2,5,4,9,22,54,2,7,412,317
101,92,4,3,9,4,45,31,7,8,457,348
101,93,3,3,5,8,32,-65,9,3,489,283
101,94,3,4,4,9,-69,45,0,8,420,328
101,95,3,3,7,6,34,-67,4,1,454,261
101,96,4,3,9,4,45,31,9,2,499,292
101,97,4,3,10,3,-54,30,5,2,445,322
101,98,6,2,8,5,62,23,7,5,507,345
102,1,3,3,7,6,34,33,4,3,34,33
102,2,3,4,4,9,31,45,5,8,65,78
102,3,4,2,6,7,42,-75,7,3,107,3
102,4,4,3,7,6,-57,33,0,6,50,36
102,5,3,4,4,9,31,-55,1,1,81,-19
102,6,2,4,7,6,25,42,6,3,106,23
102,7,5,2,7,6,52,24,8,7,158,47
102,8,6,2,9,4,-37,22,1,9,121,69
102,9,3,4,8,5,35,-59,6,0,156,10
102,10,2,4,5,8,23,44,9,4,179,54
102,11,2,5,4,9,-78,54,1,8,101,108
102,12,3,3,8,5,35,-68,6,0,136,40
102,13,3,3,6,7,33,34,9,4,169,74
102,14,3,3,5,8,-68,35,1,9,101,109
102,15,3,3,7,6,34,-67,5,2,135,42
102,16,3,3,10,3,-63,30,2,2,72,72
102,17,6,2,10,3,64,21,6,3,136,93
102,18,4,3,7,6,43,33,9,6,179,126
102,19,2,4,6,7,-76,43,3,9,103,169
102,20,3,3,8,5,35,-68,8,1,138,101
102,21,3,3,6,7,-67,34,1,5,71,135
102,22,4,3,10,3,46,30,7,5,117,165
102,23,6,2,10,3,-36,21,1,6,81,186
102,24,3,4,4,9,31,-55,2,1,112,131
102,25,2,5,4,9,22,54,4,5,134,185
102,26,3,3,8,5,35,32,9,7,169,217
102,27,4,2,8,5,-56,-77,3,0,113,140
102,28,2,5,4,9,22,54,5,4,135,194
102,29,4,2,8,5,44,23,9,7,179,217
102,30,4,3,7,6,-57,-67,2,0,122,150
102,31,3,3,5,8,32,35,4,5,154,185
102,32,2,5,3,10,21,-45,5,0,175,140
102,33,3,4,6,7,33,43,8,3,208,183
102,34,3,3,8,5,-65,32,3,5,143,215
102,35,6,2,11,2,65,20,8,5,208,235
102,36,3,5,6,7,-67,52,1,7,141,287
102,37,3,3,5,8,32,-65,3,2,173,222
102,38,5,2,7,6,52,24,5,6,225,246
102,39,2,4,4,9,22,-55,7,1,247,191
102,40,4,2,8,5,-56,23,1,4,191,214
102,41,3,4,7,6,34,42,5,6,225,256
102,42,2,4,7,6,-75,42,0,8,150,298
102,43,3,3,7,6,34,-67,4,1,184,231
102,44,2,4,4,9,22,45,6,6,206,276
102,45,4,2,8,5,-56,23,0,9,150,299
102,46,6,2,11,2,65,20,5,9,215,319
102,47,2,5,5,8,23,-47,8,2,238,272
102,48,3,4,5,8,-68,44,0,6,170,316
102,49,2,5,5,8,23,53,3,9,193,369
102,50,3,3,6,7,33,-66,6,3,226,303
102,51,4,3,8,5,-56,32,0,5,170,335
102,52,4,3,7,6,43,33,3,8,213,368
102,53,2,4,3,10,21,-54,4,4,234,314
102,54,3,3,9,4,-64,31,0,5,170,345
102,55,2,4,5,8,23,44,3,9,193,389
102,56,2,6,4,9,22,-37,5,2,215,352
102,57,5,2,9,4,54,22,9,4,269,374
102,58,3,3,8,5,-65,32,4,6,204,406
102,59,2,4,6,7,24,43,8,9,228,449
102,60,5,2,8,5,-47,-77,1,2,181,372
102,61,3,3,5,8,32,35,3,7,213,407
102,62,4,3,10,3,46,30,9,7,259,437
102,63,3,4,7,6,-66,42,3,9,193,479
102,64,3,3,9,4,36,-69,9,0,229,410
102,65,3,4,5,8,-68,44,1,4,161,454
102,66,4,2,9,4,45,22,6,6,206,476
102,67,3,3,5,8,32,-65,8,1,238,411
102,68,2,4,7,6,-75,42,3,3,163,453
102,69,5,2,9,4,54,22,7,5,217,475
102,70,4,2,7,6,-57,24,0,9,160,499
102,71,3,3,7,6,34,-67,4,2,194,432
102,72,4,3,8,5,44,32,8,4,238,464
102,73,3,3,9,4,-64,31,4,5,174,495
102,74,4,3,6,7,42,34,6,9,216,529
103,1,3,4,6,7,33,43,3,3,33,43
103,2,3,3,5,8,32,35,5,8,65,78
103,3,3,3,9,4,-64,31,1,9,1,109
103,4,4,3,5,8,41,-65,2,4,42,44
103,5,2,4,4,9,22,45,4,9,64,89
103,6,4,3,8,5,44,-68,8,1,108,21
103,7,4,3,6,7,-58,34,0,5,50,55
103,8,5,2,8,5,53,23,3,8,103,78
103,9,2,4,5,8,23,-56,6,2,126,22
103,10,3,4,3,10,30,46,6,8,156,68
103,11,2,4,9,4,-73,40,3,8,83,108
103,12,3,5,7,6,34,51,7,9,117,159
103,13,4,2,8,5,-56,-77,1,2,61,82
103,14,3,4,5,8,32,44,3,6,93,126
103,15,3,3,5,8,32,-65,5,1,125,61
103,16,2,5,3,10,21,55,6,6,146,116
103,17,3,3,8,5,-65,32,1,8,81,148
103,18,4,3,9,4,45,31,6,9,126,179
103,19,2,4,6,7,-76,-57,0,2,50,122
103,20,4,2,10,3,46,21,6,3,96,143
103,21,3,4,7,6,-66,42,0,5,30,185
103,22,4,2,9,4,45,22,5,7,75,207
103,23,3,3,7,6,34,-67,9,0,109,140
103,24,3,3,8,5,-65,32,4,2,44,172
103,25,4,3,4,9,40,36,4,8,84,208
103,26,2,4,3,10,21,-54,5,4,105,154
103,27,3,3,6,7,33,34,8,8,138,188
103,28,4,2,5,8,41,-74,9,4,179,114
103,29,4,4,5,8,-59,44,0,8,120,158
103,30,5,2,8,5,53,-77,3,1,173,81
103,31,2,4,8,5,26,41,9,2,199,122
103,32,4,2,9,4,-55,22,4,4,144,144
103,33,3,3,5,8,32,35,6,9,176,179
103,34,4,2,10,3,-54,-79,2,0,122,100
103,35,3,3,4,9,31,36,3,6,153,136
103,36,3,3,8,5,35,32,8,8,188,168
103,37,2,5,5,8,-77,-47,1,1,111,121
103,38,2,5,2,11,20,56,1,7,131,177
103,39,5,2,8,5,53,-77,4,0,184,100
103,40,4,3,8,5,44,32,8,2,228,132
103,41,3,4,6,7,-67,43,1,5,161,175
103,42,2,5,6,7,24,52,5,7,185,227
103,43,3,5,5,8,32,-47,7,0,217,180
103,44,4,3,6,7,42,34,9,4,259,214
103,45,4,2,11,2,-53,20,6,4,206,234
103,46,4,2,8,5,-56,23,0,7,150,257
103,47,3,4,6,7,33,-57,3,0,183,200
103,48,3,3,3,10,30,37,3,7,213,237
103,49,3,3,7,6,34,-67,7,0,247,170
103,50,4,3,6,7,42,34,9,4,289,204
103,51,5,2,7,6,-48,24,1,8,241,228
103,52,3,4,5,8,32,-56,3,2,273,172
103,53,4,2,9,4,45,22,8,4,318,194
103,54,3,3,9,4,-64,31,4,5,254,225
103,55,3,4,4,9,31,-55,5,0,285,170
103,56,3,3,8,5,-65,32,0,2,220,202
103,57,3,3,3,10,30,37,0,9,250,239
103,58,4,3,6,7,42,-66,2,3,292,173
103,59,3,3,8,5,35,32,7,5,327,205
103,60,3,4,6,7,-67,43,0,8,260,248
103,61,4,2,7,6,43,-76,3,2,303,172
103,62,3,3,6,7,33,34,6,6,336,206
103,63,3,4,7,6,-66,42,0,8,270,248
103,64,2,5,3,10,21,-45,1,3,291,203
103,65,4,2,6,7,42,25,3,8,333,228
103,66,5,2,9,4,54,-78,7,0,387,150
103,67,2,5,5,8,-77,53,0,3,310,203
103,68,3,3,7,6,34,33,4,6,344,236
103,69,5,2,10,3,55,21,9,7,399,257
103,70,2,5,3,10,-79,-45,0,2,320,212
103,71,5,2,8,5,53,23,3,5,373,235
103,72,3,4,8,5,35,41,8,6,408,276
103,73,5,2,7,6,-48,-76,0,0,360,200
103,74,3,3,7,6,34,33,4,3,394,233
103,75,4,3,8,5,44,32,8,5,438,265
103,76,4,2,10,3,-54,21,4,6,384,286
103,77,3,3,6,7,33,-66,7,0,417,220
103,78,3,4,7,6,-66,42,1,2,351,262
103,79,2,5,3,10,21,55,2,7,372,317
103,80,2,5,6,7,24,52,6,9,396,369
103,81,2,4,5,8,23,-56,9,3,419,313
103,82,5,2,7,6,-48,24,1,7,371,337
103,83,3,4,6,7,33,-57,4,0,404,280
103,84,4,2,10,3,-54,21,0,1,350,301
103,85,3,3,5,8,32,35,2,6,382,336
103,86,2,4,7,6,25,42,7,8,407,378
103,87,3,4,5,8,32,-56,9,2,439,322
103,88,3,4,8,5,-65,41,4,3,374,363
103,89,2,4,3,10,21,46,5,9,395,409
103,90,3,4,8,5,-65,-59,0,0,330,350
103,91,3,4,4,9,31,45,1,5,361,395
103,92,3,3,9,4,36,31,7,6,397,426
103,93,2,5,6,7,-76,52,1,8,321,478
103,94,4,3,8,5,44,-68,5,0,365,410
103,95,4,3,8,5,44,32,9,2,409,442
103,96,4,3,8,5,-56,32,3,4,353,474
103,97,5,2,9,4,54,22,7,6,407,496
103,98,3,3,4,9,31,-64,8,2,438,432
103,99,2,4,6,7,-76,43,2,5,362,475
103,100,6,2,9,4,63,22,5,7,425,497
103,101,5,2,10,3,-45,21,0,8,380,518
104,1,3,4,4,9,31,45,1,5,31,45
104,2,3,4,6,7,33,43,4,8,64,88
104,3,2,5,3,10,21,-45,5,3,85,43
104,4,5,2,7,6,52,24,7,7,137,67
104,5,3,4,6,7,-67,-57,0,0,70,10
104,6,2,5,2,11,20,56,0,6,90,66
104,7,3,3,9,4,36,31,6,7,126,97
104,8,2,4,4,9,22,-55,8,2,148,42
104,9,2,6,3,10,21,64,9,6,169,106
104,10,3,4,4,9,-69,-55,0,1,100,51
104,11,2,4,3,10,21,46,1,7,121,97
104,12,3,3,9,4,36,31,7,8,157,128
104,13,4,3,7,6,-57,-67,0,1,100,61
104,14,2,6,4,9,22,63,2,4,122,124
104,15,3,4,5,8,32,44,4,8,154,168
104,16,2,5,4,9,22,-46,6,2,176,122
104,17,3,5,5,8,32,53,8,5,208,175
104,18,2,6,2,11,20,-35,8,0,228,140
104,19,2,4,5,8,-77,44,1,4,151,184
104,20,4,4,8,5,44,41,5,5,195,225
104,21,2,4,6,7,24,43,9,8,219,268
104,22,3,4,7,6,-66,-58,3,0,153,210
104,23,5,2,9,4,54,22,7,2,207,232
104,24,2,5,6,7,-76,52,1,4,131,284
104,25,3,4,3,10,30,-54,1,0,161,230
104,26,4,2,7,6,43,24,4,4,204,254
104,27,4,2,7,6,43,24,7,8,247,278
104,28,4,2,5,8,41,-74,8,4,288,204
104,29,5,2,9,4,-46,22,2,6,242,226
104,30,2,5,5,8,23,53,5,9,265,279
104,31,4,3,5,8,41,-65,6,4,306,214
104,32,2,5,4,9,22,54,8,8,328,268
104,33,3,3,8,5,-65,-68,3,0,263,200
104,34,3,3,6,7,33,34,6,4,296,234
104,35,4,3,7,6,43,33,9,7,339,267
104,36,5,2,11,2,-44,20,5,7,295,287
104,37,4,2,9,4,-55,22,0,9,240,309
104,38,4,2,8,5,44,-77,4,2,284,232
104,39,3,3,6,7,33,34,7,6,317,266
104,40,2,6,3,10,21,-36,8,0,338,230
104,41,5,2,8,5,-47,23,1,3,291,253
104,42,5,2,10,3,55,21,6,4,346,274
104,43,2,6,3,10,21,64,7,8,367,338
104,44,5,2,11,2,-44,20,3,8,323,358
104,45,5,2,8,5,53,-77,6,1,376,281
104,46,4,2,9,4,-55,22,1,3,321,303
104,47,3,4,5,8,32,44,3,7,353,347
104,48,2,6,2,11,20,-35,3,2,373,312
104,49,2,4,4,9,22,45,5,7,395,357
104,50,5,2,9,4,54,22,9,9,449,379
104,51,5,2,9,4,-46,-78,3,1,403,301
104,52,4,2,7,6,43,24,6,5,446,325
104,53,3,3,8,5,-65,32,1,7,381,357
104,54,4,3,6,7,42,-66,3,1,423,291
104,55,4,3,5,8,41,35,4,6,464,326
104,56,3,3,5,8,32,-65,6,1,496,261
104,57,5,3,6,7,51,34,7,5,547,295
105,1,3,3,8,5,35,32,5,2,35,32
105,2,4,4,6,7,42,43,7,5,77,75
105,3,3,4,5,8,32,44,9,9,109,119
105,4,3,3,7,6,-66,-67,3,2,43,52
105,5,3,4,5,8,32,44,5,6,75,96
105,6,3,4,5,8,32,-56,7,0,107,40
105,7,2,5,4,9,22,54,9,4,129,94
105,8,3,3,3,10,30,-63,9,1,159,31
105,9,2,5,4,9,-78,54,1,5,81,85
105,10,5,2,8,5,53,23,4,8,134,108
105,11,4,2,5,8,41,-74,5,4,175,34
105,12,3,5,4,9,31,54,6,8,206,88
105,13,4,3,9,4,-55,31,1,9,151,119
105,14,4,2,9,4,45,-78,6,1,196,41
105,15,4,2,8,5,-56,23,0,4,140,64
105,16,4,2,7,6,43,24,3,8,183,88
105,17,3,3,9,4,36,31,9,9,219,119
105,18,3,3,5,8,-68,-65,1,4,151,54
105,19,2,5,7,6,25,51,6,5,176,105
105,20,5,2,7,6,52,24,8,9,228,129
105,21,3,3,8,5,-65,-68,3,1,163,61
105,22,4,3,8,5,44,32,7,3,207,93
105,23,5,2,10,3,-45,21,2,4,162,114
105,24,5,2,11,2,56,20,8,4,218,134
105,25,3,4,7,6,-66,42,2,6,152,176
105,26,3,3,6,7,33,-66,5,0,185,110
105,27,2,5,7,6,-75,51,0,1,110,161
105,28,5,2,7,6,52,24,2,5,162,185
105,29,3,3,6,7,33,34,5,9,195,219
105,30,4,3,9,4,-55,-69,0,0,140,150
105,31,3,4,6,7,33,43,3,3,173,193
105,32,4,3,7,6,43,33,6,6,216,226
105,33,3,3,6,7,33,-66,9,0,249,160
105,34,3,4,5,8,-68,44,1,4,181,204
105,35,4,2,8,5,44,23,5,7,225,227
105,36,5,2,8,5,53,-77,8,0,278,150
105,37,4,3,7,6,-57,33,1,3,221,183
105,38,2,4,6,7,24,43,5,6,245,226
105,39,3,4,7,6,34,42,9,8,279,268
105,40,4,3,9,4,-55,31,4,9,224,299
105,41,4,3,6,7,42,-66,6,3,266,233
105,42,5,2,8,5,53,23,9,6,319,256
105,43,3,3,6,7,-67,-66,2,0,252,190
105,44,3,3,5,8,32,35,4,5,284,225
105,45,3,3,6,7,33,34,7,9,317,259
105,46,2,5,4,9,22,-46,9,3,339,213
105,47,2,4,5,8,-77,44,2,7,262,257
105,48,3,4,5,8,32,-56,4,1,294,201
105,49,3,4,6,7,33,43,7,4,327,244
105,50,5,3,7,6,52,33,9,7,379,277
105,51,3,3,5,8,-68,-65,1,2,311,212
105,52,3,4,4,9,31,45,2,7,342,257
105,53,5,2,9,4,54,22,6,9,396,279
105,54,4,2,11,2,-53,20,3,9,343,299
105,55,5,2,10,3,55,-79,8,0,398,220
105,56,5,2,8,5,-47,23,1,3,351,243
105,57,2,5,6,7,24,52,5,5,375,295
105,58,4,2,9,4,-55,22,0,7,320,317
105,59,3,4,4,9,31,-55,1,2,351,262
105,60,4,2,10,3,46,21,7,3,397,283
105,61,5,3,10,3,-45,30,2,3,352,313
105,62,3,4,5,8,32,44,4,7,384,357
105,63,3,4,4,9,31,-55,5,2,415,302
105,64,4,2,6,7,42,25,7,7,457,327
105,65,4,3,9,4,-55,31,2,8,402,358
105,66,4,3,10,3,46,30,8,8,448,388
105,67,4,3,6,7,-58,-66,0,2,390,322
105,68,2,4,7,6,25,42,5,4,415,364
105,69,4,3,8,5,44,32,9,6,459,396
105,70,2,5,8,5,-74,50,5,6,385,446
105,71,2,5,4,9,22,-46,7,0,407,400
105,72,2,4,7,6,-75,42,2,2,332,442
105,73,3,3,8,5,35,32,7,4,367,474
105,74,3,3,8,5,-65,32,2,6,302,506
106,1,3,3,8,5,35,32,5,2,35,32
106,2,4,2,7,6,43,24,8,6,78,56
106,3,5,2,10,3,-45,21,3,7,33,77
106,4,3,4,5,8,32,-56,5,1,65,21
106,5,5,3,8,5,53,32,8,3,118,53
106,6,3,3,8,5,-65,32,3,5,53,85
106,7,2,4,5,8,23,44,6,9,76,129
106,8,3,5,4,9,31,-46,7,3,107,83
106,9,3,3,9,4,-64,31,3,4,43,114
106,10,3,4,5,8,32,44,5,8,75,158
106,11,4,2,5,8,41,-74,6,4,116,84
106,12,2,5,5,8,23,53,9,7,139,137
106,13,4,2,8,5,-56,-77,3,0,83,60
106,14,4,3,7,6,43,33,6,3,126,93
106,15,5,3,8,5,53,32,9,5,179,125
106,16,3,3,6,7,-67,34,2,9,112,159
106,17,4,2,10,3,46,-79,8,0,158,80
106,18,5,2,8,5,-47,23,1,3,111,103
106,19,2,4,3,10,21,46,2,9,132,149
106,20,2,4,4,9,22,-55,4,4,154,94
106,21,4,3,7,6,43,33,7,7,197,127
106,22,4,3,6,7,42,-66,9,1,239,61
106,23,2,4,6,7,-76,43,3,4,163,104
106,24,3,4,5,8,32,44,5,8,195,148
106,25,4,3,6,7,42,-66,7,2,237,82
106,26,2,4,4,9,22,45,9,7,259,127
106,27,2,6,5,8,-77,62,2,9,182,189
106,28,4,2,8,5,44,-77,6,2,226,112
106,29,3,3,10,3,-63,30,3,2,163,142
106,30,2,4,7,6,25,42,8,4,188,184
106,31,4,3,9,4,-55,31,3,5,133,215
106,32,3,4,5,8,32,44,5,9,165,259
106,33,3,3,7,6,34,-67,9,2,199,192
106,34,5,2,10,3,-45,21,4,3,154,213
106,35,4,2,9,4,45,22,9,5,199,235
106,36,3,3,9,4,-64,31,5,6,135,266
106,37,4,2,7,6,43,-76,8,0,178,190
106,38,3,4,4,9,31,45,9,5,209,235
106,39,6,2,11,2,-35,20,4,5,174,255
106,40,4,3,10,3,-54,30,0,5,120,285
106,41,3,3,8,5,35,32,5,7,155,317
106,42,5,3,6,7,51,-66,6,1,206,251
106,43,3,4,4,9,31,45,7,6,237,296
106,44,3,3,4,9,31,-64,8,2,268,232
106,45,3,3,6,7,-67,34,1,6,201,266
106,46,2,5,6,7,24,52,5,8,225,318
106,47,2,4,6,7,24,-57,9,1,249,261
106,48,3,4,7,6,-66,42,3,3,183,303
106,49,4,3,5,8,41,35,4,8,224,338
106,50,5,2,10,3,55,21,9,9,279,359
106,51,4,3,9,4,-55,-69,4,0,224,290
106,52,3,3,9,4,-64,31,0,1,160,321
106,53,3,3,6,7,33,34,3,5,193,355
106,54,3,3,9,4,36,31,9,6,229,386
106,55,2,4,5,8,-77,-56,2,0,152,330
106,56,3,3,9,4,36,31,8,1,188,361
106,57,4,3,8,5,-56,32,2,3,132,393
106,58,4,2,9,4,45,22,7,5,177,415
106,59,3,3,5,8,32,-65,9,0,209,350
106,60,4,3,10,3,-54,30,5,0,155,380
106,61,2,4,5,8,23,44,8,4,178,424
106,62,2,5,3,10,21,55,9,9,199,479
106,63,2,5,3,10,-79,-45,0,4,120,434
106,64,4,2,10,3,46,21,6,5,166,455
106,65,3,3,7,6,-66,33,0,8,100,488
106,66,3,3,6,7,33,-66,3,2,133,422
106,67,3,4,5,8,32,44,5,6,165,466
106,68,2,5,4,9,22,-46,7,0,187,420
106,69,3,3,8,5,-65,32,2,2,122,452
106,70,4,2,10,3,46,21,8,3,168,473
106,71,3,4,7,6,-66,42,2,5,102,515
107,1,4,3,8,5,44,32,4,2,44,32
107,2,2,5,5,8,23,53,7,5,67,85
107,3,2,5,6,7,-76,52,1,7,-9,137
107,4,2,4,5,8,23,-56,4,1,14,81
107,5,2,5,6,7,24,52,8,3,38,133
107,6,2,4,6,7,-76,43,2,6,-38,176
107,7,4,3,7,6,43,33,5,9,5,209
107,8,3,3,7,6,34,-67,9,2,39,142
107,9,2,6,4,9,-78,63,1,5,-39,205
107,10,3,4,5,8,32,44,3,9,-7,249
107,11,3,3,9,4,36,-69,9,0,29,180
107,12,3,3,7,6,-66,33,3,3,-37,213
107,13,3,4,8,5,35,41,8,4,-2,254
107,14,4,2,8,5,-56,23,2,7,-58,277
107,15,2,6,4,9,22,-37,4,0,-36,240
107,16,2,4,6,7,24,43,8,3,-12,283
107,17,4,2,8,5,-56,23,2,6,-68,306
107,18,3,4,4,9,31,-55,3,1,-37,251
107,19,4,3,7,6,43,33,6,4,6,284
107,20,3,3,5,8,32,35,8,9,38,319
107,21,3,5,6,7,-67,-48,1,1,-29,271
107,22,5,2,9,4,54,22,5,3,25,293
107,23,5,2,9,4,54,22,9,5,79,315
107,24,3,4,5,8,-68,44,1,9,11,359
107,25,4,3,9,4,45,-69,6,0,56,290
107,26,4,3,5,8,41,35,7,5,97,325
107,27,3,4,9,4,-64,40,3,5,33,365
107,28,3,4,5,8,32,44,5,9,65,409
107,29,3,4,7,6,34,-58,9,1,99,351
107,30,4,2,8,5,-56,23,3,4,43,374
107,31,3,3,8,5,35,32,8,6,78,406
107,32,5,2,8,5,-47,23,1,9,31,429
107,33,3,3,7,6,34,-67,5,2,65,362
107,34,2,4,8,5,-74,41,1,3,-9,403
107,35,3,3,9,4,36,31,7,4,27,434
107,36,5,2,9,4,-46,22,1,6,-19,456
107,37,4,3,9,4,45,31,6,7,26,487
107,38,6,2,10,3,-36,21,0,8,-10,508
108,1,4,3,6,7,42,34,2,4,42,34
108,2,4,4,5,8,41,44,3,8,83,78
108,3,4,3,8,5,44,-68,7,0,127,10
108,4,4,2,7,6,-57,24,0,4,70,34
108,5,3,3,6,7,33,34,3,8,103,68
108,6,3,3,5,8,32,-65,5,3,135,3
108,7,3,3,7,6,34,33,9,6,169,36
108,8,2,5,7,6,-75,51,4,7,94,87
108,9,4,3,7,6,43,-67,7,0,137,20
108,10,3,4,5,8,32,44,9,4,169,64
108,11,4,3,5,8,-59,35,0,9,110,99
108,12,2,4,4,9,22,-55,2,4,132,44
108,13,2,4,6,7,24,43,6,7,156,87
108,14,4,3,7,6,43,-67,9,0,199,20
108,15,5,2,8,5,-47,23,2,3,152,43
108,16,2,4,3,10,21,46,3,9,173,89
108,17,3,4,4,9,31,-55,4,4,204,34
108,18,4,3,7,6,43,33,7,7,247,67
108,19,5,2,9,4,-46,22,1,9,201,89
108,20,4,2,9,4,45,-78,6,1,246,11
108,21,3,4,4,9,31,45,7,6,277,56
108,22,3,3,5,8,32,-65,9,1,309,-9
108,23,3,4,6,7,-67,43,2,4,242,34
108,24,4,3,9,4,45,31,7,5,287,65
108,25,2,6,5,8,-77,62,0,7,210,127
108,26,3,4,4,9,31,-55,1,2,241,72
108,27,2,5,5,8,23,53,4,5,264,125
108,28,4,2,6,7,42,-75,6,0,306,50
108,29,4,3,8,5,-56,32,0,2,250,82
108,30,2,4,2,11,20,47,0,9,270,129
108,31,4,3,7,6,43,-67,3,2,313,62
108,32,2,5,4,9,22,54,5,6,335,116
108,33,5,3,7,6,52,33,7,9,387,149
108,34,3,3,7,6,-66,-67,1,2,321,82
108,35,2,5,4,9,22,54,3,6,343,136
108,36,3,3,6,7,33,-66,6,0,376,70
108,37,2,4,4,9,22,45,8,5,398,115
108,38,2,4,3,10,21,-54,9,1,419,61
108,39,3,4,5,8,-68,44,1,5,351,105
108,40,2,5,4,9,22,54,3,9,373,159
108,41,3,3,7,6,34,-67,7,2,407,92
108,42,2,4,5,8,-77,44,0,6,330,136
108,43,3,3,8,5,35,32,5,8,365,168
108,44,3,3,7,6,34,-67,9,1,399,101
108,45,2,4,6,7,-76,43,3,4,323,144
108,46,3,4,5,8,32,44,5,8,355,188
108,47,2,5,6,7,24,-48,9,0,379,140
108,48,2,4,7,6,-75,42,4,2,304,182
108,49,2,5,3,10,21,55,5,7,325,237
108,50,4,3,7,6,43,-67,8,0,368,170
108,51,5,2,9,4,-46,22,2,2,322,192
108,52,3,3,5,8,32,35,4,7,354,227
108,53,3,4,7,6,34,42,8,9,388,269
108,54,5,3,7,6,-48,-67,0,2,340,202
108,55,2,4,7,6,25,42,5,4,365,244
108,56,2,4,3,10,21,-54,6,0,386,190
108,57,2,6,3,10,21,64,7,4,407,254
108,58,4,3,5,8,41,35,8,9,448,289
108,59,3,4,6,7,-67,-57,1,2,381,232
108,60,3,4,7,6,34,42,5,4,415,274
108,61,4,3,6,7,42,34,7,8,457,308
108,62,4,2,8,5,-56,-77,1,1,401,231
108,63,2,5,3,10,21,55,2,6,422,286
108,64,5,2,8,5,53,23,5,9,475,309
108,65,3,4,8,5,-65,-59,0,0,410,250
108,66,4,3,10,3,46,30,6,0,456,280
108,67,5,2,7,6,52,24,8,4,508,304
109,1,4,3,6,7,42,34,2,4,42,34
109,2,2,5,4,9,22,54,4,8,64,88
109,3,3,3,6,7,33,-66,7,2,97,22
109,4,4,2,7,6,-57,24,0,6,40,46
109,5,4,3,9,4,45,31,5,7,85,77
109,6,2,5,4,9,22,-46,7,1,107,31
109,7,4,2,8,5,-56,23,1,4,51,54
109,8,3,4,7,6,34,42,5,6,85,96
109,9,4,2,8,5,44,23,9,9,129,119
109,10,4,3,4,9,40,-64,9,5,169,55
109,11,2,5,6,7,-76,52,3,7,93,107
109,12,2,4,5,8,23,-56,6,1,116,51
109,13,4,2,7,6,43,24,9,5,159,75
109,14,2,4,5,8,-77,44,2,9,82,119
109,15,3,3,7,6,34,-67,6,2,116,52
109,16,2,4,4,9,22,45,8,7,138,97
109,17,3,4,8,5,-65,41,3,8,73,138
109,18,3,4,6,7,33,-57,6,1,106,81
109,19,3,4,9,4,-64,40,2,1,42,121
109,20,4,3,8,5,44,32,6,3,86,153
109,21,5,3,8,5,53,32,9,5,139,185
109,22,4,2,9,4,-55,22,4,7,84,207
109,23,2,5,4,9,22,-46,6,1,106,161
109,24,3,3,9,4,-64,31,2,2,42,192
109,25,2,5,5,8,23,53,5,5,65,245
109,26,3,4,6,7,33,43,8,8,98,288
109,27,4,3,4,9,40,-64,8,4,138,224
109,28,6,2,11,2,-35,20,3,4,103,244
109,29,5,2,10,3,55,21,8,5,158,265
109,30,2,4,6,7,-76,43,2,8,82,308
109,31,2,4,7,6,25,-58,7,0,107,250
109,32,4,2,10,3,-54,21,3,1,53,271
109,33,4,2,6,7,42,25,5,6,95,296
109,34,3,4,7,6,34,42,9,8,129,338
109,35,5,2,10,3,-45,21,4,9,84,359
109,36,4,3,7,6,43,-67,7,2,127,292
109,37,3,3,5,8,32,35,9,7,159,327
109,38,4,3,9,4,-55,31,4,8,104,358
109,39,3,4,4,9,31,-55,5,3,135,303
109,40,6,2,10,3,64,21,9,4,199,324
109,41,5,2,9,4,-46,22,3,6,153,346
109,42,4,3,7,6,43,33,6,9,196,379
109,43,3,3,7,6,-66,-67,0,2,130,312
109,44,3,4,6,7,33,43,3,5,163,355
109,45,3,4,8,5,35,41,8,6,198,396
109,46,2,5,6,7,-76,52,2,8,122,448
109,47,2,4,5,8,23,-56,5,2,145,392
109,48,2,4,4,9,22,45,7,7,167,437
109,49,3,4,6,7,-67,-57,0,0,100,380
109,50,4,3,7,6,43,33,3,3,143,413
109,51,3,4,7,6,34,42,7,5,177,455
109,52,2,4,3,10,21,-54,8,1,198,401
109,53,4,3,8,5,-56,32,2,3,142,433
109,54,3,4,6,7,33,43,5,6,175,476
109,55,3,4,5,8,32,-56,7,0,207,420
109,56,3,4,6,7,-67,43,0,3,140,463
109,57,3,3,8,5,35,32,5,5,175,495
109,58,3,3,7,6,34,33,9,8,209,528
110,1,3,3,6,7,33,34,3,4,33,34
110,2,3,4,6,7,33,43,6,7,66,77
110,3,3,3,7,6,-66,-67,0,0,0,10
110,4,5,2,10,3,55,21,5,1,55,31
110,5,2,5,7,6,-75,51,0,2,-20,82
110,6,5,2,7,6,52,24,2,6,32,106
110,7,2,4,6,7,24,43,6,9,56,149
110,8,5,3,9,4,-46,-69,0,0,10,80
110,9,2,4,3,10,21,46,1,6,31,126
110,10,4,2,8,5,44,23,5,9,75,149
110,11,3,4,4,9,31,-55,6,4,106,94
110,12,4,3,8,5,-56,32,0,6,50,126
110,13,2,4,8,5,26,41,6,7,76,167
110,14,2,4,5,8,23,-56,9,1,99,111
110,15,4,3,8,5,-56,32,3,3,43,143
110,16,3,3,7,6,34,33,7,6,77,176
110,17,2,5,5,8,-77,53,0,9,0,229
110,18,2,5,5,8,23,-47,3,2,23,182
110,19,4,3,7,6,43,33,6,5,66,215
110,20,4,3,8,5,-56,32,0,7,10,247
110,21,5,3,6,7,51,-66,1,1,61,181
110,22,3,4,7,6,34,42,5,3,95,223
110,23,3,4,9,4,-64,40,1,3,31,263
110,24,3,4,5,8,32,44,3,7,63,307
110,25,5,2,9,4,54,22,7,9,117,329
110,26,4,3,7,6,-57,-67,0,2,60,262
110,27,2,5,5,8,23,53,3,5,83,315
110,28,3,3,8,5,35,32,8,7,118,347
110,29,4,3,7,6,-57,-67,1,0,61,280
110,30,3,3,9,4,36,31,7,1,97,311
110,31,4,3,5,8,41,35,8,6,138,346
110,32,3,3,6,7,-67,-66,1,0,71,280
110,33,3,3,7,6,34,33,5,3,105,313
110,34,4,3,9,4,-55,31,0,4,50,344
110,35,5,2,9,4,54,22,4,6,104,366
110,36,4,4,8,5,44,41,8,7,148,407
110,37,2,4,7,6,-75,42,3,9,73,449
110,38,3,3,7,6,34,-67,7,2,107,382
110,39,4,3,5,8,41,35,8,7,148,417
110,40,5,2,8,5,-47,-77,1,0,101,340
110,41,2,6,2,11,20,65,1,5,121,405
110,42,4,3,7,6,43,33,4,8,164,438
110,43,2,6,4,9,22,-37,6,1,186,401
110,44,3,3,8,5,-65,32,1,3,121,433
110,45,2,4,4,9,22,45,3,8,143,478
110,46,2,4,5,8,23,-56,6,2,166,422
110,47,3,3,7,6,-66,33,0,5,100,455
110,48,4,3,7,6,43,33,3,8,143,488
110,49,3,4,8,5,35,41,8,9,178,529
111,1,4,3,10,3,46,30,6,0,46,30
111,2,5,2,8,5,53,23,9,3,99,53
111,3,3,3,5,8,-68,35,1,8,31,88
111,4,4,2,7,6,43,-76,4,2,74,12
111,5,3,3,9,4,-64,31,0,3,10,43
111,6,5,2,9,4,54,22,4,5,64,65
111,7,4,2,8,5,44,23,8,8,108,88
111,8,4,2,9,4,-55,-78,3,0,53,10
111,9,5,2,7,6,52,24,5,4,105,34
111,10,2,4,6,7,24,43,9,7,129,77
111,11,4,2,8,5,-56,-77,3,0,73,0
111,12,2,4,6,7,24,43,7,3,97,43
111,13,4,3,6,7,42,34,9,7,139,77
111,14,2,5,3,10,-79,-45,0,2,60,32
111,15,3,4,7,6,34,42,4,4,94,74
111,16,4,3,8,5,44,32,8,6,138,106
111,17,2,4,3,10,21,-54,9,2,159,52
111,18,3,3,4,9,-69,36,0,8,90,88
111,19,4,2,7,6,43,-76,3,2,133,12
111,20,5,2,9,4,54,22,7,4,187,34
111,21,3,4,6,7,-67,43,0,7,120,77
111,22,2,5,2,11,20,-44,0,3,140,33
111,23,3,3,5,8,32,35,2,8,172,68
111,24,4,3,7,6,43,-67,5,1,215,1
111,25,5,2,8,5,53,23,8,4,268,24
111,26,3,3,7,6,-66,33,2,7,202,57
111,27,4,3,7,6,43,-67,5,0,245,-10
111,28,5,3,7,6,52,33,7,3,297,23
111,29,4,2,7,6,-57,24,0,7,240,47
111,30,4,3,5,8,41,-65,1,2,281,-18
111,31,2,4,6,7,24,43,5,5,305,25
111,32,4,3,5,8,41,-65,6,0,346,-40
111,33,3,3,6,7,33,34,9,4,379,-6
111,34,2,5,6,7,-76,52,3,6,303,46
111,35,3,4,4,9,31,-55,4,1,334,-9
111,36,2,5,3,10,21,55,5,6,355,46
111,37,4,3,5,8,41,-65,6,1,396,-19
111,38,3,3,9,4,-64,31,2,2,332,12
111,39,2,4,4,9,22,45,4,7,354,57
111,40,4,2,9,4,45,22,9,9,399,79
111,41,4,4,8,5,-56,-59,3,0,343,20
111,42,3,4,6,7,33,43,6,3,376,63
111,43,5,2,10,3,-45,21,1,4,331,84
111,44,3,4,7,6,34,42,5,6,365,126
111,45,3,3,6,7,33,-66,8,0,398,60
111,46,4,3,8,5,-56,32,2,2,342,92
111,47,3,4,6,7,33,43,5,5,375,135
111,48,3,4,4,9,31,-55,6,0,406,80
111,49,3,4,6,7,33,43,9,3,439,123
111,50,3,3,6,7,-67,34,2,7,372,157
111,51,4,3,7,6,43,-67,5,0,415,90
111,52,4,3,7,6,43,33,8,3,458,123
111,53,4,3,5,8,41,35,9,8,499,158
111,54,5,2,9,4,-46,-78,3,0,453,80
111,55,3,3,8,5,35,32,8,2,488,112
111,56,3,4,6,7,-67,43,1,5,421,155
111,57,3,4,5,8,32,44,3,9,453,199
111,58,4,3,8,5,44,-68,7,1,497,131
111,59,3,4,8,5,-65,41,2,2,432,172
111,60,3,3,5,8,32,35,4,7,464,207
111,61,4,3,6,7,42,-66,6,1,506,141
112,1,6,2,9,4,63,22,3,2,63,22
112,2,5,2,9,4,54,22,7,4,117,44
112,3,3,4,7,6,-66,42,1,6,51,86
112,4,4,3,8,5,44,32,5,8,95,118
112,5,5,2,8,5,53,-77,8,1,148,41
112,6,4,3,5,8,41,35,9,6,189,76
112,7,3,4,6,7,-67,43,2,9,122,119
112,8,4,2,7,6,43,-76,5,3,165,43
112,9,3,3,5,8,32,35,7,8,197,78
112,10,5,2,8,5,-47,-77,0,1,150,1
112,11,2,5,4,9,22,54,2,5,172,55
112,12,3,4,6,7,33,43,5,8,205,98
112,13,3,3,4,9,31,-64,6,4,236,34
112,14,5,2,9,4,-46,22,0,6,190,56
112,15,3,3,8,5,35,32,5,8,225,88
112,16,5,2,9,4,54,-78,9,0,279,10
112,17,4,2,9,4,-55,22,4,2,224,32
112,18,4,3,7,6,43,33,7,5,267,65
112,19,3,3,9,4,-64,31,3,6,203,96
112,20,3,4,5,8,32,-56,5,0,235,40
112,21,2,4,5,8,23,44,8,4,258,84
112,22,2,6,3,10,21,64,9,8,279,148
112,23,3,4,5,8,-68,-56,1,2,211,92
112,24,5,2,8,5,53,23,4,5,264,115
112,25,4,3,7,6,43,33,7,8,307,148
112,26,2,5,7,6,-75,51,2,9,232,199
112,27,3,4,4,9,31,-55,3,4,263,144
112,28,4,3,6,7,42,34,5,8,305,178
112,29,4,3,7,6,43,-67,8,1,348,111
112,30,2,5,4,9,-78,54,0,5,270,165
112,31,4,2,7,6,43,24,3,9,313,189
112,32,3,3,7,6,34,-67,7,2,347,122
112,33,5,2,7,6,52,24,9,6,399,146
112,34,4,2,9,4,-55,22,4,8,344,168
112,35,3,3,4,9,31,-64,5,4,375,104
112,36,4,2,10,3,-54,21,1,5,321,125
112,37,2,4,3,10,21,-54,2,1,342,71
112,38,3,4,5,8,32,44,4,5,374,115
112,39,3,4,5,8,32,44,6,9,406,159
112,40,3,3,4,9,31,-64,7,5,437,95
112,41,3,3,8,5,-65,32,2,7,372,127
112,42,2,4,5,8,23,-56,5,1,395,71
112,43,5,3,9,4,54,31,9,2,449,102
112,44,5,2,9,4,-46,22,3,4,403,124
112,45,3,4,8,5,35,41,8,5,438,165
112,46,4,3,8,5,-56,32,2,7,382,197
112,47,3,3,6,7,33,-66,5,1,415,131
112,48,2,5,4,9,22,54,7,5,437,185
112,49,4,2,7,6,-57,24,0,9,380,209
112,50,4,2,6,7,42,-75,2,4,422,134
112,51,5,2,8,5,53,23,5,7,475,157
112,52,5,2,8,5,53,-77,8,0,528,80
113,1,4,2,7,6,43,24,3,4,43,24
113,2,4,2,9,4,45,22,8,6,88,46
113,3,2,4,5,8,-77,-56,1,0,11,-10
113,4,2,5,4,9,22,54,3,4,33,44
113,5,3,4,5,8,32,44,5,8,65,88
113,6,4,2,7,6,43,-76,8,2,108,12
113,7,4,3,7,6,-57,33,1,5,51,45
113,8,3,3,4,9,31,-64,2,1,82,-19
113,9,2,5,5,8,23,53,5,4,105,34
113,10,2,5,5,8,23,53,8,7,128,87
113,11,2,5,3,10,21,-45,9,2,149,42
113,12,3,4,4,9,-69,45,0,7,80,87
113,13,3,4,5,8,32,-56,2,1,112,31
113,14,4,3,6,7,42,34,4,5,154,65
113,15,5,2,9,4,54,22,8,7,208,87
113,16,2,4,4,9,-78,-55,0,2,130,32
113,17,2,4,4,9,22,45,2,7,152,77
113,18,2,5,5,8,23,-47,5,0,175,30
113,19,3,3,5,8,32,35,7,5,207,65
113,20,3,3,5,8,32,-65,9,0,239,0
113,21,3,3,4,9,-69,36,0,6,170,36
113,22,3,4,8,5,35,41,5,7,205,77
113,23,3,4,7,6,34,42,9,9,239,119
113,24,4,2,6,7,-58,-75,1,4,181,44
113,25,3,3,6,7,33,34,4,8,214,78
113,26,4,2,10,3,-54,21,0,9,160,99
113,27,4,2,8,5,44,-77,4,2,204,22
113,28,5,2,9,4,54,22,8,4,258,44
113,29,2,5,3,10,21,55,9,9,279,99
113,30,2,4,5,8,-77,-56,2,3,202,43
113,31,3,3,8,5,35,32,7,5,237,75
113,32,4,2,7,6,-57,24,0,9,180,99
113,33,3,3,5,8,32,-65,2,4,212,34
113,34,2,5,3,10,21,55,3,9,233,89
113,35,5,2,9,4,54,-78,7,1,287,11
113,36,2,6,4,9,22,63,9,4,309,74
113,37,4,2,10,3,-54,21,5,5,255,95
113,38,4,3,6,7,42,34,7,9,297,129
113,39,3,3,7,6,-66,-67,1,2,231,62
113,40,5,2,9,4,54,22,5,4,285,84
113,41,3,4,7,6,34,42,9,6,319,126
113,42,2,5,3,10,-79,-45,0,1,240,81
113,43,5,2,10,3,55,21,5,2,295,102
113,44,2,4,6,7,24,43,9,5,319,145
113,45,4,2,9,4,-55,22,4,7,264,167
113,46,3,4,4,9,31,-55,5,2,295,112
113,47,3,3,8,5,-65,32,0,4,230,144
113,48,3,4,3,10,30,-54,0,0,260,90
113,49,2,6,5,8,23,62,3,2,283,152
113,50,3,4,5,8,32,44,5,6,315,196
113,51,3,4,6,7,33,43,8,9,348,239
113,52,4,2,10,3,-54,-79,4,0,294,160
113,53,4,2,7,6,43,24,7,4,337,184
113,54,3,3,5,8,32,35,9,9,369,219
113,55,3,4,6,7,-67,-57,2,2,302,162
113,56,3,3,4,9,31,36,3,8,333,198
113,57,3,4,8,5,35,41,8,9,368,239
113,58,3,3,9,4,-64,-69,4,0,304,170
113,59,4,3,8,5,44,32,8,2,348,202
113,60,3,3,7,6,-66,33,2,5,282,235
113,61,3,3,8,5,35,32,7,7,317,267
113,62,2,4,8,5,-74,41,3,8,243,308
113,63,5,2,8,5,53,-77,6,1,296,231
113,64,3,4,5,8,32,44,8,5,328,275
113,65,2,4,6,7,-76,43,2,8,252,318
113,66,3,3,6,7,33,-66,5,2,285,252
113,67,2,5,5,8,23,53,8,5,308,305
113,68,3,4,6,7,-67,43,1,8,241,348
113,69,3,3,8,5,35,-68,6,0,276,280
113,70,2,5,3,10,21,55,7,5,297,335
113,71,2,5,3,10,21,-45,8,0,318,290
113,72,4,2,7,6,-57,24,1,4,261,314
113,73,3,4,6,7,33,43,4,7,294,357
113,74,3,3,8,5,35,32,9,9,329,389
113,75,4,2,9,4,-55,-78,4,1,274,311
113,76,2,5,6,7,24,52,8,3,298,363
113,77,5,2,10,3,-45,21,3,4,253,384
113,78,4,3,7,6,43,33,6,7,296,417
113,79,3,4,5,8,32,-56,8,1,328,361
113,80,4,2,10,3,-54,21,4,2,274,382
113,81,3,4,3,10,30,46,4,8,304,428
113,82,4,3,10,3,-54,30,0,8,250,458
113,83,2,5,4,9,22,-46,2,2,272,412
113,84,6,2,9,4,63,22,5,4,335,434
113,85,4,2,7,6,43,24,8,8,378,458
113,86,2,5,4,9,-78,-46,0,2,300,412
113,87,2,4,5,8,23,44,3,6,323,456
113,88,3,4,4,9,31,-55,4,1,354,401
113,89,5,2,10,3,55,21,9,2,409,422
113,90,5,2,7,6,-48,24,1,6,361,446
113,91,3,3,7,6,34,33,5,9,395,479
113,92,3,3,7,6,34,-67,9,2,429,412
113,93,4,2,8,5,-56,23,3,5,373,435
113,94,3,4,6,7,33,43,6,8,406,478
113,95,2,5,6,7,-76,-48,0,0,330,430
113,96,4,3,5,8,41,35,1,5,371,465
113,97,4,2,6,7,42,-75,3,0,413,390
113,98,2,4,5,8,23,44,6,4,436,434
113,99,2,6,3,10,21,64,7,8,457,498
113,100,4,3,6,7,42,-66,9,2,499,432
113,101,2,5,4,9,-78,54,1,6,421,486
113,102,5,2,9,4,54,22,5,8,475,508
114,1,3,3,10,3,37,30,7,0,37,30
114,2,3,4,5,8,32,44,9,4,69,74
114,3,2,5,2,11,20,-44,9,0,89,30
114,4,3,3,7,6,-66,33,3,3,23,63
114,5,2,5,4,9,22,54,5,7,45,117
114,6,2,5,5,8,23,-47,8,0,68,70
114,7,2,4,4,9,-78,45,0,5,-10,115
114,8,3,3,7,6,34,33,4,8,24,148
114,9,3,4,5,8,32,-56,6,2,56,92
114,10,4,3,7,6,43,33,9,5,99,125
114,11,2,6,4,9,-78,63,1,8,21,188
114,12,5,2,10,3,55,21,6,9,76,209
114,13,4,3,7,6,43,-67,9,2,119,142
114,14,3,4,5,8,-68,44,1,6,51,186
114,15,2,4,4,9,22,-55,3,1,73,131
114,16,2,4,6,7,24,43,7,4,97,174
114,17,3,3,6,7,-67,34,0,8,30,208
114,18,3,3,4,9,31,-64,1,4,61,144
114,19,2,4,4,9,22,45,3,9,83,189
114,20,4,3,8,5,44,-68,7,1,127,121
114,21,3,3,6,7,-67,34,0,5,60,155
114,22,4,3,10,3,46,30,6,5,106,185
114,23,5,2,10,3,-45,21,1,6,61,206
114,24,3,3,6,7,33,-66,4,0,94,140
114,25,2,5,7,6,25,51,9,1,119,191
114,26,4,2,7,6,-57,24,2,5,62,215
114,27,3,4,8,5,35,41,7,6,97,256
114,28,4,2,8,5,-56,23,1,9,41,279
114,29,2,5,4,9,22,-46,3,3,63,233
114,30,3,3,8,5,35,32,8,5,98,265
114,31,4,2,6,7,-58,-75,0,0,40,190
114,32,4,3,8,5,44,32,4,2,84,222
114,33,4,3,8,5,44,32,8,4,128,254
114,34,3,3,8,5,-65,32,3,6,63,286
114,35,2,4,6,7,24,43,7,9,87,329
114,36,4,2,8,5,-56,-77,1,2,31,252
114,37,3,4,5,8,32,44,3,6,63,296
114,38,3,3,6,7,33,-66,6,0,96,230
114,39,3,3,10,3,-63,30,3,0,33,260
114,40,3,3,8,5,35,32,8,2,68,292
114,41,2,4,7,6,-75,42,3,4,-7,334
114,42,4,2,7,6,43,24,6,8,36,358
114,43,4,2,6,7,42,-75,8,3,78,283
114,44,4,4,6,7,-58,43,0,6,20,326
114,45,2,4,7,6,25,42,5,8,45,368
114,46,3,3,5,8,32,-65,7,3,77,303
114,47,2,6,2,11,20,65,7,8,97,368
114,48,4,2,10,3,-54,21,3,9,43,389
114,49,2,4,3,10,21,-54,4,5,64,335
114,50,2,4,6,7,24,43,8,8,88,378
114,51,3,4,4,9,31,-55,9,3,119,323
114,52,3,3,8,5,-65,32,4,5,54,355
114,53,3,3,6,7,33,34,7,9,87,389
114,54,5,2,7,6,52,-76,9,3,139,313
114,55,3,3,6,7,-67,34,2,7,72,347
114,56,3,4,4,9,31,-55,3,2,103,292
114,57,4,2,8,5,44,23,7,5,147,315
114,58,2,6,3,10,21,64,8,9,168,379
114,59,3,4,7,6,-66,-58,2,1,102,321
114,60,3,3,9,4,36,31,8,2,138,352
114,61,3,4,8,5,-65,41,3,3,73,393
114,62,3,4,4,9,31,45,4,8,104,438
114,63,2,5,4,9,22,-46,6,2,126,392
114,64,3,3,6,7,33,34,9,6,159,426
114,65,4,2,7,6,-57,-76,2,0,102,350
114,66,3,3,7,6,34,33,6,3,136,383
114,67,5,2,8,5,53,23,9,6,189,406
114,68,2,5,4,9,-78,-46,1,0,111,360
114,69,2,5,3,10,21,55,2,5,132,415
114,70,4,2,8,5,44,23,6,8,176,438
114,71,6,2,9,4,63,-78,9,0,239,360
114,72,3,3,7,6,-66,33,3,3,173,393
114,73,4,4,6,7,42,43,5,6,215,436
114,74,2,4,5,8,23,-56,8,0,238,380
114,75,4,3,6,7,-58,34,0,4,180,414
114,76,3,3,8,5,35,32,5,6,215,446
114,77,4,3,6,7,42,-66,7,0,257,380
114,78,4,3,8,5,-56,32,1,2,201,412
114,79,4,2,9,4,45,22,6,4,246,434
114,80,3,4,4,9,31,45,7,9,277,479
114,81,4,3,9,4,-55,-69,2,0,222,410
114,82,3,4,8,5,35,41,7,1,257,451
114,83,4,2,8,5,-56,23,1,4,201,474
114,84,2,4,6,7,24,43,5,7,225,517
115,1,4,3,7,6,43,33,3,3,43,33
115,2,3,4,4,9,31,45,4,8,74,78
115,3,3,3,9,4,-64,31,0,9,10,109
115,4,2,5,5,8,23,-47,3,2,33,62
115,5,3,5,8,5,35,50,8,2,68,112
115,6,3,3,5,8,-68,35,0,7,0,147
115,7,3,3,6,7,33,-66,3,1,33,81
115,8,4,2,7,6,43,24,6,5,76,105
115,9,2,5,3,10,21,-45,7,0,97,60
115,10,2,5,2,11,20,56,7,6,117,116
115,11,2,4,6,7,-76,43,1,9,41,159
115,12,3,3,7,6,34,-67,5,2,75,92
115,13,4,3,7,6,43,33,8,5,118,125
115,14,4,3,6,7,-58,34,0,9,60,159
115,15,3,5,6,7,33,-48,3,1,93,111
115,16,3,4,3,10,30,46,3,7,123,157
115,17,4,3,9,4,45,31,8,8,168,188
115,18,3,4,8,5,-65,41,3,9,103,229
115,19,3,3,10,3,-63,30,0,9,40,259
115,20,4,2,6,7,42,-75,2,4,82,184
115,21,3,4,5,8,32,44,4,8,114,228
115,22,3,4,6,7,33,-57,7,1,147,171
115,23,3,4,5,8,32,44,9,5,179,215
115,24,3,4,7,6,-66,42,3,7,113,257
115,25,2,6,3,10,21,-36,4,1,134,221
115,26,2,5,3,10,21,55,5,6,155,276
115,27,4,2,8,5,44,23,9,9,199,299
115,28,2,5,5,8,-77,-47,2,2,122,252
115,29,3,4,8,5,35,41,7,3,157,293
115,30,2,5,4,9,22,54,9,7,179,347
115,31,2,6,4,9,-78,-37,1,0,101,310
115,32,4,3,6,7,42,34,3,4,143,344
115,33,3,4,4,9,31,45,4,9,174,389
115,34,5,2,8,5,53,-77,7,2,227,312
115,35,3,4,4,9,31,45,8,7,258,357
115,36,2,5,5,8,-77,-47,1,0,181,310
115,37,2,4,6,7,24,43,5,3,205,353
115,38,4,3,5,8,41,35,6,8,246,388
115,39,2,4,4,9,22,-55,8,3,268,333
115,40,4,3,9,4,-55,31,3,4,213,364
115,41,3,3,4,9,31,-64,4,0,244,300
115,42,4,3,9,4,45,31,9,1,289,331
115,43,4,3,6,7,-58,34,1,5,231,365
115,44,4,2,5,8,41,-74,2,1,272,291
115,45,2,4,4,9,22,45,4,6,294,336
115,46,4,2,9,4,45,22,9,8,339,358
115,47,3,4,7,6,-66,-58,3,0,273,300
115,48,3,4,5,8,32,44,5,4,305,344
115,49,3,3,8,5,-65,32,0,6,240,376
115,50,4,3,9,4,45,31,5,7,285,407
115,51,2,4,6,7,24,-57,9,0,309,350
115,52,3,3,5,8,-68,35,1,5,241,385
115,53,4,2,8,5,44,23,5,8,285,408
115,54,3,4,5,8,32,-56,7,2,317,352
115,55,3,4,6,7,-67,43,0,5,250,395
115,56,3,3,7,6,34,33,4,8,284,428
115,57,3,5,7,6,34,51,8,9,318,479
115,58,3,4,8,5,-65,-59,3,0,253,420
115,59,4,2,9,4,45,22,8,2,298,442
115,60,4,3,9,4,-55,31,3,3,243,473
115,61,4,3,9,4,45,31,8,4,288,504
116,1,2,5,2,11,20,56,0,6,20,56
116,2,5,2,10,3,55,21,5,7,75,77
116,3,4,3,6,7,42,-66,7,1,117,11
116,4,3,3,5,8,32,35,9,6,149,46
116,5,4,3,6,7,-58,-66,1,0,91,-20
116,6,3,4,4,9,31,45,2,5,122,25
116,7,2,4,4,9,22,-55,4,0,144,-30
116,8,5,2,7,6,52,24,6,4,196,-6
116,9,2,4,6,7,-76,43,0,7,120,37
116,10,3,3,8,5,35,32,5,9,155,69
116,11,4,2,7,6,43,-76,8,3,198,-7
116,12,3,4,4,9,31,45,9,8,229,38
116,13,4,3,8,5,-56,-68,3,0,173,-30
116,14,3,3,5,8,32,35,5,5,205,5
116,15,3,3,5,8,32,-65,7,0,237,-60
116,16,4,3,6,7,42,34,9,4,279,-26
116,17,3,4,6,7,-67,43,2,7,212,17
116,18,3,3,8,5,35,32,7,9,247,49
116,19,2,4,7,6,-75,-58,2,1,172,-9
116,20,2,5,5,8,23,53,5,4,195,44
116,21,4,4,6,7,42,43,7,7,237,87
116,22,2,4,7,6,-75,42,2,9,162,129
116,23,5,2,9,4,54,-78,6,1,216,51
116,24,2,4,6,7,-76,43,0,4,140,94
116,25,4,2,8,5,44,23,4,7,184,117
116,26,4,3,10,3,-54,30,0,7,130,147
116,27,2,4,8,5,26,41,6,8,156,188
116,28,3,3,8,5,-65,-68,1,0,91,120
116,29,3,4,8,5,35,41,6,1,126,161
116,30,4,2,8,5,-56,23,0,4,70,184
116,31,3,3,3,10,30,-63,0,1,100,121
116,32,4,3,8,5,44,32,4,3,144,153
116,33,3,4,7,6,34,42,8,5,178,195
116,34,2,6,4,9,-78,63,0,8,100,258
116,35,2,5,4,9,22,-46,2,2,122,212
116,36,4,2,9,4,45,22,7,4,167,234
116,37,3,4,8,5,-65,41,2,5,102,275
116,38,3,3,6,7,33,34,5,9,135,309
116,39,4,3,7,6,43,-67,8,2,178,242
116,40,4,4,7,6,-57,42,1,4,121,284
116,41,4,3,8,5,44,32,5,6,165,316
116,42,2,6,3,10,21,-36,6,0,186,280
116,43,3,4,6,7,33,43,9,3,219,323
116,44,4,2,8,5,-56,23,3,6,163,346
116,45,3,3,7,6,34,33,7,9,197,379
116,46,2,5,5,8,-77,-47,0,2,120,332
116,47,3,3,4,9,31,36,1,8,151,368
116,48,4,3,10,3,46,30,7,8,197,398
116,49,4,4,7,6,-57,-58,0,0,140,340
116,50,2,4,4,9,22,45,2,5,162,385
116,51,3,3,6,7,33,34,5,9,195,419
116,52,4,2,8,5,44,-77,9,2,239,342
116,53,3,3,8,5,-65,32,4,4,174,374
116,54,4,2,10,3,-54,21,0,5,120,395
116,55,4,2,7,6,43,24,3,9,163,419
116,56,4,3,7,6,43,-67,6,2,206,352
116,57,5,2,10,3,-45,21,1,3,161,373
116,58,2,4,6,7,24,43,5,6,185,416
116,59,5,2,10,3,-45,21,0,7,140,437
116,60,4,3,8,5,44,32,4,9,184,469
116,61,2,4,3,10,21,-54,5,5,205,415
116,62,4,3,9,4,-55,31,0,6,150,446
116,63,2,4,7,6,25,42,5,8,175,488
116,64,3,3,9,4,-64,31,1,9,111,519
117,1,2,4,6,7,24,43,4,3,24,43
117,2,2,5,5,8,23,53,7,6,47,96
117,3,4,2,7,6,-57,-76,0,0,-10,20
117,4,5,2,8,5,53,23,3,3,43,43
117,5,5,2,8,5,53,23,6,6,96,66
117,6,3,4,5,8,32,-56,8,0,128,10
117,7,2,5,4,9,-78,54,0,4,50,64
117,8,4,3,9,4,45,31,5,5,95,95
117,9,4,3,7,6,43,33,8,8,138,128
117,10,4,3,5,8,41,-65,9,3,179,63
117,11,2,5,4,9,-78,54,1,7,101,117
117,12,4,3,7,6,43,-67,4,0,144,50
117,13,4,2,5,8,41,26,5,6,185,76
117,14,3,4,6,7,33,43,8,9,218,119
117,15,5,2,9,4,-46,-78,2,1,172,41
117,16,2,4,6,7,24,43,6,4,196,84
117,17,2,4,3,10,21,-54,7,0,217,30
117,18,2,5,5,8,-77,53,0,3,140,83
117,19,3,4,6,7,33,43,3,6,173,126
117,20,5,3,10,3,55,30,8,6,228,156
117,21,4,2,8,5,-56,23,2,9,172,179
117,22,4,2,10,3,46,-79,8,0,218,100
117,23,3,4,7,6,-66,42,2,2,152,142
117,24,3,3,7,6,34,33,6,5,186,175
117,25,4,2,8,5,-56,23,0,8,130,198
117,26,4,2,8,5,44,-77,4,1,174,121
117,27,2,5,5,8,23,53,7,4,197,174
117,28,3,3,7,6,-66,33,1,7,131,207
117,29,3,4,4,9,31,-55,2,2,162,152
117,30,2,4,2,11,20,47,2,9,182,199
117,31,4,3,8,5,44,-68,6,1,226,131
117,32,4,2,10,3,-54,21,2,2,172,152
117,33,3,4,5,8,32,44,4,6,204,196
117,34,3,4,5,8,32,-56,6,0,236,140
117,35,4,3,9,4,-55,31,1,1,181,171
117,36,3,3,7,6,34,33,5,4,215,204
117,37,5,2,9,4,54,22,9,6,269,226
117,38,2,5,6,7,-76,52,3,8,193,278
117,39,5,2,10,3,55,21,8,9,248,299
117,40,2,5,3,10,21,-45,9,4,269,254
117,41,3,3,5,8,-68,35,1,9,201,289
117,42,5,2,9,4,54,-78,5,1,255,211
117,43,3,3,7,6,34,33,9,4,289,244
117,44,4,4,5,8,-59,44,0,8,230,288
117,45,3,4,7,6,34,-58,4,0,264,230
117,46,4,2,9,4,45,22,9,2,309,252
117,47,2,4,6,7,-76,43,3,5,233,295
117,48,2,5,4,9,22,54,5,9,255,349
117,49,3,3,7,6,34,-67,9,2,289,282
117,50,2,5,5,8,-77,53,2,5,212,335
117,51,4,3,9,4,45,31,7,6,257,366
117,52,4,2,8,5,-56,23,1,9,201,389
117,53,5,2,11,2,56,20,7,9,257,409
117,54,4,4,5,8,41,-56,8,3,298,353
117,55,5,2,10,3,-45,21,3,4,253,374
117,56,2,6,4,9,22,63,5,7,275,437
117,57,2,4,4,9,22,-55,7,2,297,382
117,58,3,3,6,7,-67,34,0,6,230,416
117,59,2,5,3,10,21,-45,1,1,251,371
117,60,3,4,5,8,32,44,3,5,283,415
117,61,3,3,7,6,34,33,7,8,317,448
117,62,3,3,5,8,32,-65,9,3,349,383
117,63,2,5,4,9,-78,54,1,7,271,437
117,64,5,2,9,4,54,22,5,9,325,459
117,65,4,3,6,7,42,-66,7,3,367,393
117,66,3,4,4,9,31,45,8,8,398,438
117,67,3,3,5,8,-68,-65,0,3,330,373
117,68,3,4,4,9,31,45,1,8,361,418
117,69,3,4,6,7,33,-57,4,1,394,361
117,70,2,5,4,9,22,54,6,5,416,415
117,71,3,4,8,5,-65,41,1,6,351,456
117,72,2,4,3,10,21,-54,2,2,372,402
117,73,6,2,11,2,65,20,7,2,437,422
117,74,2,4,5,8,-77,44,0,6,360,466
117,75,3,4,7,6,34,42,4,8,394,508
118,1,4,3,7,6,43,33,3,3,43,33
118,2,4,2,10,3,46,21,9,4,89,54
118,3,6,2,10,3,-36,21,3,5,53,75
118,4,2,4,3,10,21,-54,4,1,74,21
118,5,3,4,3,10,30,46,4,7,104,67
118,6,3,4,5,8,32,-56,6,1,136,11
118,7,4,2,6,7,42,25,8,6,178,36
118,8,4,3,6,7,-58,-66,0,0,120,-30
118,9,4,3,6,7,42,34,2,4,162,4
118,10,5,2,9,4,54,22,6,6,216,26
118,11,2,6,2,11,20,-35,6,1,236,-9
118,12,3,3,7,6,-66,33,0,4,170,24
118,13,2,4,5,8,23,44,3,8,193,68
118,14,3,4,6,7,33,-57,6,1,226,11
118,15,3,4,5,8,32,44,8,5,258,55
118,16,5,3,8,5,-47,32,1,7,211,87
118,17,4,3,6,7,42,-66,3,1,253,21
118,18,3,3,9,4,36,31,9,2,289,52
118,19,2,5,2,11,20,56,9,8,309,108
118,20,3,3,5,8,-68,-65,1,3,241,43
118,21,4,3,5,8,41,35,2,8,282,78
118,22,3,3,8,5,35,-68,7,0,317,10
118,23,4,2,9,4,-55,22,2,2,262,32
118,24,3,3,4,9,31,36,3,8,293,68
118,25,2,4,6,7,24,-57,7,1,317,11
118,26,2,5,5,8,-77,53,0,4,240,64
118,27,3,4,8,5,35,41,5,5,275,105
118,28,4,2,9,4,-55,22,0,7,220,127
118,29,2,4,6,7,24,-57,4,0,244,70
118,30,2,5,3,10,21,55,5,5,265,125
118,31,3,3,4,9,31,-64,6,1,296,61
118,32,5,2,8,5,53,23,9,4,349,84
118,33,3,3,6,7,-67,34,2,8,282,118
118,34,6,2,9,4,63,-78,5,0,345,40
118,35,2,5,2,11,20,56,5,6,365,96
118,36,3,4,4,9,31,-55,6,1,396,41
118,37,3,3,5,8,32,35,8,6,428,76
118,38,5,2,6,7,51,-75,9,1,479,1
118,39,4,3,7,6,-57,33,2,4,422,34
118,40,5,2,8,5,53,23,5,7,475,57
118,41,6,2,11,2,-35,20,0,7,440,77
118,42,4,3,7,6,43,-67,3,0,483,10
118,43,3,3,6,7,33,34,6,4,516,44
119,1,3,3,9,4,36,31,6,1,36,31
119,2,4,2,7,6,43,24,9,5,79,55
119,3,3,3,6,7,-67,34,2,9,12,89
119,4,4,3,7,6,43,-67,5,2,55,22
119,5,4,2,10,3,-54,21,1,3,1,43
119,6,4,3,6,7,42,34,3,7,43,77
119,7,3,3,8,5,35,32,8,9,78,109
119,8,4,3,8,5,-56,-68,2,1,22,41
119,9,3,3,8,5,35,32,7,3,57,73
119,10,3,4,6,7,-67,43,0,6,-10,116
119,11,5,2,9,4,54,22,4,8,44,138
119,12,3,3,6,7,33,-66,7,2,77,72
119,13,4,3,9,4,-55,31,2,3,22,103
119,14,2,4,3,10,21,46,3,9,43,149
119,15,5,2,10,3,55,-79,8,0,98,70
119,16,3,3,8,5,-65,32,3,2,33,102
119,17,5,2,7,6,52,24,5,6,85,126
119,18,6,2,10,3,64,21,9,7,149,147
119,19,6,2,9,4,-37,22,2,9,112,169
119,20,3,4,6,7,33,-57,5,2,145,112
119,21,2,4,4,9,22,45,7,7,167,157
119,22,2,4,5,8,-77,-56,0,1,90,101
119,23,3,3,8,5,35,32,5,3,125,133
119,24,3,4,9,4,-64,40,1,3,61,173
119,25,3,4,5,8,32,44,3,7,93,217
119,26,6,2,10,3,64,21,7,8,157,238
119,27,2,4,4,9,22,-55,9,3,179,183
119,28,2,6,2,11,20,65,9,8,199,248
119,29,3,4,5,8,-68,-56,1,2,131,192
119,30,3,4,7,6,34,42,5,4,165,234
119,31,5,2,9,4,54,22,9,6,219,256
119,32,3,4,4,9,-69,-55,0,1,150,201
119,33,3,3,5,8,32,35,2,6,182,236
119,34,3,3,4,9,31,-64,3,2,213,172
119,35,3,3,7,6,34,33,7,5,247,205
119,36,5,2,9,4,-46,22,1,7,201,227
119,37,2,5,4,9,22,-46,3,1,223,181
119,38,2,4,5,8,23,44,6,5,246,225
119,39,5,2,9,4,-46,22,0,7,200,247
119,40,3,3,7,6,34,-67,4,0,234,180
119,41,3,3,6,7,33,34,7,4,267,214
119,42,4,3,7,6,-57,33,0,7,210,247
119,43,5,2,10,3,55,21,5,8,265,268
119,44,3,4,6,7,33,-57,8,1,298,211
119,45,3,4,5,8,-68,44,0,5,230,255
119,46,3,4,5,8,32,44,2,9,262,299
119,47,4,3,5,8,41,-65,3,4,303,234
119,48,2,5,3,10,21,55,4,9,324,289
119,49,3,4,6,7,33,-57,7,2,357,232
119,50,2,4,4,9,22,45,9,7,379,277
119,51,2,4,4,9,-78,-55,1,2,301,222
119,52,4,4,7,6,43,42,4,4,344,264
119,53,4,2,9,4,45,22,9,6,389,286
119,54,4,2,8,5,-56,23,3,9,333,309
119,55,3,3,4,9,31,-64,4,5,364,245
119,56,2,4,6,7,24,43,8,8,388,288
119,57,4,2,6,7,-58,-75,0,3,330,213
119,58,4,3,9,4,45,31,5,4,375,244
119,59,2,4,6,7,24,43,9,7,399,287
119,60,5,2,9,4,-46,22,3,9,353,309
119,61,5,2,9,4,54,-78,7,1,407,231
119,62,2,5,3,10,21,55,8,6,428,286
119,63,4,3,5,8,41,-65,9,1,469,221
119,64,4,3,9,4,-55,31,4,2,414,252
119,65,4,2,8,5,44,23,8,5,458,275
119,66,5,2,11,2,-44,20,4,5,414,295
119,67,4,3,6,7,42,34,6,9,456,329
119,68,4,3,6,7,42,-66,8,3,498,263
119,69,4,2,10,3,-54,21,4,4,444,284
119,70,5,2,6,7,51,25,5,9,495,309
119,71,3,3,7,6,34,-67,9,2,529,242
120,1,2,5,3,10,21,55,1,5,21,55
120,2,2,5,4,9,22,54,3,9,43,109
120,3,5,3,7,6,52,-67,5,2,95,42
120,4,3,4,7,6,34,42,9,4,129,84
120,5,3,3,5,8,-68,35,1,9,61,119
120,6,4,3,9,4,45,-69,6,0,106,50
120,7,3,4,5,8,32,44,8,4,138,94
120,8,6,2,10,3,-36,21,2,5,102,115
120,9,3,3,8,5,35,32,7,7,137,147
120,10,2,4,5,8,-77,-56,0,1,60,91
120,11,4,4,7,6,43,42,3,3,103,133
120,12,2,4,5,8,23,44,6,7,126,177
120,13,4,3,5,8,41,-65,7,2,167,112
120,14,4,3,9,4,-55,31,2,3,112,143
120,15,3,4,6,7,33,43,5,6,145,186
120,16,4,3,7,6,43,33,8,9,188,219
120,17,2,5,4,9,-78,-46,0,3,110,173
120,18,4,3,7,6,43,33,3,6,153,206
120,19,3,3,6,7,33,-66,6,0,186,140
120,20,3,4,3,10,30,46,6,6,216,186
120,21,3,3,6,7,33,-66,9,0,249,120
120,22,3,4,9,4,-64,40,5,0,185,160
120,23,3,4,6,7,33,43,8,3,218,203
120,24,3,4,5,8,-68,44,0,7,150,247
120,25,3,3,8,5,35,32,5,9,185,279
120,26,5,2,9,4,54,-78,9,1,239,201
120,27,5,2,10,3,-45,21,4,2,194,222
120,28,4,2,9,4,45,22,9,4,239,244
120,29,3,3,8,5,-65,32,4,6,174,276
120,30,3,4,5,8,32,-56,6,0,206,220
120,31,2,4,7,6,-75,42,1,2,131,262
120,32,2,4,4,9,22,45,3,7,153,307
120,33,3,4,7,6,34,42,7,9,187,349
120,34,2,4,7,6,-75,-58,2,1,112,291
120,35,4,3,8,5,44,32,6,3,156,323
120,36,4,3,9,4,-55,31,1,4,101,354
120,37,4,3,7,6,43,33,4,7,144,387
120,38,4,3,10,3,-54,30,0,7,90,417
120,39,2,5,4,9,22,-46,2,1,112,371
120,40,2,4,7,6,25,42,7,3,137,413
120,41,2,4,5,8,-77,44,0,7,60,457
120,42,2,4,5,8,23,-56,3,1,83,401
120,43,3,3,7,6,34,33,7,4,117,434
120,44,3,4,6,7,-67,43,0,7,50,477
120,45,3,4,7,6,34,42,4,9,84,519
121,1,2,5,4,9,22,54,2,4,22,54
121,2,4,2,9,4,45,22,7,6,67,76
121,3,3,3,9,4,-64,31,3,7,3,107
121,4,4,3,10,3,46,30,9,7,49,137
121,5,5,2,10,3,-45,21,4,8,4,158
121,6,3,4,6,7,33,-57,7,1,37,101
121,7,3,4,3,10,30,46,7,7,67,147
121,8,3,3,6,7,-67,-66,0,1,0,81
121,9,2,4,7,6,25,42,5,3,25,123
121,10,5,2,11,2,-44,20,1,3,-19,143
121,11,4,3,8,5,44,32,5,5,25,175
121,12,3,3,9,4,-64,31,1,6,-39,206
121,13,2,5,5,8,23,53,4,9,-16,259
121,14,3,3,4,9,31,-64,5,5,15,195
121,15,4,3,9,4,-55,31,0,6,-40,226
121,16,4,2,11,2,47,20,7,6,7,246
121,17,2,5,5,8,-77,53,0,9,-70,299
121,18,3,4,7,6,34,-58,4,1,-36,241
121,19,3,3,6,7,33,34,7,5,-3,275
121,20,3,4,5,8,32,44,9,9,29,319
121,21,4,2,9,4,-55,-78,4,1,-26,241
121,22,4,2,8,5,44,23,8,4,18,264
121,23,2,4,5,8,-77,44,1,8,-59,308
121,24,3,3,5,8,32,-65,3,3,-27,243
121,25,2,4,7,6,25,42,8,5,-2,285
121,26,4,3,8,5,-56,32,2,7,-58,317
121,27,2,5,3,10,21,-45,3,2,-37,272
121,28,2,4,7,6,25,42,8,4,-12,314
121,29,3,4,5,8,-68,44,0,8,-80,358
121,30,3,3,6,7,33,-66,3,2,-47,292
121,31,2,4,7,6,25,42,8,4,-22,334
121,32,4,2,6,7,-58,25,0,9,-80,359
121,33,4,2,9,4,45,-78,5,1,-35,281
121,34,3,4,6,7,33,43,8,4,-2,324
121,35,2,5,3,10,21,55,9,9,19,379
121,36,2,5,6,7,-76,-48,3,1,-57,331
121,37,3,3,5,8,32,35,5,6,-25,366
121,38,2,5,6,7,24,52,9,8,-1,418
121,39,3,3,6,7,-67,-66,2,2,-68,352
121,40,2,5,6,7,24,52,6,4,-44,404
121,41,3,3,8,5,-65,32,1,6,-109,436
121,42,4,2,9,4,45,22,6,8,-64,458
121,43,5,2,9,4,-46,-78,0,0,-110,380
121,44,2,4,4,9,22,45,2,5,-88,425
121,45,3,4,5,8,32,44,4,9,-56,469
121,46,2,4,5,8,23,-56,7,3,-33,413
121,47,3,3,9,4,-64,31,3,4,-97,444
121,48,3,3,4,9,31,-64,4,0,-66,380
121,49,3,3,7,6,34,33,8,3,-32,413
121,50,5,2,6,7,51,25,9,8,19,438
121,51,3,3,7,6,-66,-67,3,1,-47,371
121,52,4,3,9,4,45,31,8,2,-2,402
121,53,3,3,5,8,-68,35,0,7,-70,437
121,54,2,5,7,6,25,51,5,8,-45,488
121,55,2,4,4,9,22,-55,7,3,-23,433
121,56,4,3,9,4,-55,31,2,4,-78,464
121,57,3,4,6,7,33,43,5,7,-45,507
122,1,5,2,7,6,52,24,2,4,52,24
122,2,3,3,9,4,36,31,8,5,88,55
122,3,3,4,8,5,-65,41,3,6,23,96
122,4,2,5,3,10,21,-45,4,1,44,51
122,5,3,3,6,7,33,34,7,5,77,85
122,6,4,3,7,6,-57,33,0,8,20,118
122,7,2,4,5,8,23,-56,3,2,43,62
122,8,3,4,5,8,32,44,5,6,75,106
122,9,5,2,10,3,-45,21,0,7,30,127
122,10,4,3,8,5,44,32,4,9,74,159
122,11,4,4,6,7,42,-57,6,2,116,102
122,12,4,3,7,6,43,33,9,5,159,135
122,13,4,3,7,6,-57,33,2,8,102,168
122,14,2,4,7,6,25,-58,7,0,127,110
122,15,2,4,7,6,-75,42,2,2,52,152
122,16,4,3,9,4,45,31,7,3,97,183
122,17,4,4,5,8,41,44,8,7,138,227
122,18,4,2,8,5,-56,-77,2,0,82,150
122,19,3,3,6,7,33,34,5,4,115,184
122,20,3,5,6,7,33,52,8,6,148,236
122,21,5,2,7,6,-48,-76,0,0,100,160
122,22,6,2,9,4,63,22,3,2,163,182
122,23,5,2,7,6,52,24,5,6,215,206
122,24,4,2,6,7,42,-75,7,1,257,131
122,25,3,4,5,8,32,44,9,5,289,175
122,26,4,2,9,4,-55,22,4,7,234,197
122,27,5,2,8,5,53,-77,7,0,287,120
122,28,3,3,7,6,-66,33,1,3,221,153
122,29,3,3,6,7,33,34,4,7,254,187
122,30,5,2,11,2,-44,20,0,7,210,207
122,31,3,3,5,8,32,-65,2,2,242,142
122,32,4,2,8,5,44,23,6,5,286,165
122,33,4,3,7,6,43,33,9,8,329,198
122,34,6,2,9,4,-37,-78,2,0,292,120
122,35,3,3,6,7,33,34,5,4,325,154
122,36,4,3,8,5,44,32,9,6,369,186
122,37,2,4,6,7,-76,43,3,9,293,229
122,38,4,3,8,5,44,-68,7,1,337,161
122,39,4,3,7,6,-57,33,0,4,280,194
122,40,3,3,7,6,34,33,4,7,314,227
122,41,5,2,9,4,54,22,8,9,368,249
122,42,3,3,6,7,-67,-66,1,3,301,183
122,43,2,4,5,8,23,44,4,7,324,227
122,44,3,3,5,8,32,-65,6,2,356,162
122,45,2,5,4,9,22,54,8,6,378,216
122,46,4,3,8,5,-56,32,2,8,322,248
122,47,4,3,9,4,45,31,7,9,367,279
122,48,3,3,7,6,-66,-67,1,2,301,212
122,49,3,4,6,7,33,43,4,5,334,255
122,50,2,4,5,8,23,44,7,9,357,299
122,51,3,4,5,8,32,-56,9,3,389,243
122,52,3,3,6,7,-67,34,2,7,322,277
122,53,4,2,10,3,46,21,8,8,368,298
122,54,4,3,7,6,-57,-67,1,1,311,231
122,55,3,3,5,8,32,35,3,6,343,266
122,56,2,5,6,7,24,52,7,8,367,318
122,57,4,3,4,9,40,-64,7,4,407,254
122,58,4,2,7,6,-57,24,0,8,350,278
122,59,3,4,3,10,30,-54,0,4,380,224
122,60,3,4,6,7,33,43,3,7,413,267
122,61,4,3,8,5,44,32,7,9,457,299
122,62,3,4,5,8,32,-56,9,3,489,243
122,63,5,2,10,3,-45,21,4,4,444,264
122,64,2,4,6,7,24,43,8,7,468,307
122,65,5,2,10,3,-45,21,3,8,423,328
122,66,2,5,4,9,22,-46,5,2,445,282
122,67,3,4,5,8,32,44,7,6,477,326
122,68,3,3,7,6,-66,33,1,9,411,359
122,69,2,4,4,9,22,-55,3,4,433,304
122,70,3,3,4,9,31,-64,4,0,464,240
122,71,3,3,7,6,34,33,8,3,498,273
122,72,4,3,6,7,-58,34,0,7,440,307
122,73,4,2,8,5,44,-77,4,0,484,230
122,74,4,3,9,4,45,31,9,1,529,261
123,1,2,4,6,7,24,43,4,3,24,43
123,2,3,3,4,9,31,36,5,9,55,79
123,3,5,2,11,2,-44,20,1,9,11,99
123,4,4,2,9,4,45,-78,6,1,56,21
123,5,5,2,9,4,-46,22,0,3,10,43
123,6,3,4,4,9,31,45,1,8,41,88
123,7,5,2,9,4,54,-78,5,0,95,10
123,8,2,4,6,7,24,43,9,3,119,53
123,9,2,4,5,8,-77,44,2,7,42,97
123,10,3,3,6,7,33,-66,5,1,75,31
123,11,4,3,9,4,-55,31,0,2,20,62
123,12,4,2,6,7,42,25,2,7,62,87
123,13,4,3,8,5,44,32,6,9,106,119
123,14,3,4,8,5,-65,-59,1,0,41,60
123,15,4,3,6,7,42,34,3,4,83,94
123,16,3,3,5,8,32,35,5,9,115,129
123,17,3,4,4,9,31,-55,6,4,146,74
123,18,4,2,10,3,-54,21,2,5,92,95
123,19,2,4,7,6,25,42,7,7,117,137
123,20,5,2,9,4,-46,22,1,9,71,159
123,21,3,4,4,9,31,-55,2,4,102,104
123,22,5,2,9,4,54,22,6,6,156,126
123,23,4,2,6,7,42,-75,8,1,198,51
123,24,4,3,5,8,41,35,9,6,239,86
123,25,2,4,3,10,-79,-54,0,2,160,32
123,26,2,5,3,10,21,55,1,7,181,87
123,27,4,2,10,3,46,21,7,8,227,108
123,28,4,2,7,6,-57,-76,0,2,170,32
123,29,4,2,9,4,45,22,5,4,215,54
123,30,4,3,9,4,-55,31,0,5,160,85
123,31,3,4,7,6,34,42,4,7,194,127
123,32,2,5,4,9,22,-46,6,1,216,81
123,33,4,3,7,6,43,33,9,4,259,114
123,34,4,3,9,4,-55,31,4,5,204,145
123,35,3,4,6,7,33,43,7,8,237,188
123,36,4,3,6,7,42,-66,9,2,279,122
123,37,2,4,6,7,-76,43,3,5,203,165
123,38,3,3,6,7,33,34,6,9,236,199
123,39,4,3,10,3,-54,30,2,9,182,229
123,40,2,4,7,6,25,-58,7,1,207,171
123,41,3,4,5,8,32,44,9,5,239,215
123,42,3,4,7,6,-66,42,3,7,173,257
123,43,3,4,5,8,32,-56,5,1,205,201
123,44,3,3,7,6,34,33,9,4,239,234
123,45,5,2,11,2,-44,20,5,4,195,254
123,46,3,3,6,7,33,34,8,8,228,288
123,47,3,3,7,6,-66,-67,2,1,162,221
123,48,2,5,3,10,21,55,3,6,183,276
123,49,3,3,7,6,34,33,7,9,217,309
123,50,3,3,7,6,-66,-67,1,2,151,242
123,51,3,3,5,8,32,35,3,7,183,277
123,52,3,4,3,10,30,-54,3,3,213,223
123,53,3,3,10,3,-63,30,0,3,150,253
123,54,3,4,9,4,36,40,6,3,186,293
123,55,2,4,5,8,23,44,9,7,209,337
123,56,4,4,8,5,-56,41,3,8,153,378
123,57,3,3,6,7,33,-66,6,2,186,312
123,58,3,4,7,6,-66,42,0,4,120,354
123,59,5,2,8,5,53,23,3,7,173,377
123,60,3,4,5,8,32,-56,5,1,205,321
123,61,3,4,4,9,31,45,6,6,236,366
123,62,3,3,4,9,31,-64,7,2,267,302
123,63,3,3,5,8,32,35,9,7,299,337
123,64,3,4,4,9,-69,-55,0,2,230,282
123,65,2,4,6,7,24,43,4,5,254,325
123,66,3,4,4,9,31,-55,5,0,285,270
123,67,3,3,6,7,33,34,8,4,318,304
123,68,3,4,7,6,-66,42,2,6,252,346
123,69,2,5,5,8,23,53,5,9,275,399
123,70,3,5,5,8,32,-47,7,2,307,352
123,71,4,2,9,4,-55,22,2,4,252,374
123,72,5,2,8,5,53,23,5,7,305,397
123,73,4,4,5,8,41,-56,6,1,346,341
123,74,2,5,4,9,22,54,8,5,368,395
123,75,4,3,5,8,41,-65,9,0,409,330
123,76,3,4,4,9,-69,45,0,5,340,375
123,77,2,4,7,6,25,42,5,7,365,417
123,78,2,5,3,10,21,-45,6,2,386,372
123,79,2,4,6,7,-76,43,0,5,310,415
123,80,4,2,6,7,42,-75,2,0,352,340
123,81,2,4,6,7,24,43,6,3,376,383
123,82,4,3,7,6,43,33,9,6,419,416
123,83,3,3,8,5,-65,32,4,8,354,448
123,84,3,3,7,6,34,-67,8,1,388,381
123,85,6,2,9,4,-37,22,1,3,351,403
123,86,2,4,4,9,22,45,3,8,373,448
123,87,3,3,6,7,33,-66,6,2,406,382
123,88,4,3,8,5,-56,32,0,4,350,414
123,89,3,4,7,6,34,42,4,6,384,456
123,90,4,3,5,8,41,-65,5,1,425,391
123,91,4,2,8,5,44,23,9,4,469,414
123,92,3,4,4,9,-69,45,0,9,400,459
123,93,4,3,7,6,43,-67,3,2,443,392
123,94,3,3,6,7,33,34,6,6,476,426
123,95,2,4,5,8,23,-56,9,0,499,370
123,96,3,4,4,9,-69,45,0,5,430,415
123,97,4,3,8,5,44,32,4,7,474,447
123,98,2,6,4,9,22,-37,6,0,496,410
123,99,2,4,6,7,-76,43,0,3,420,453
123,100,4,3,6,7,42,34,2,7,462,487
123,101,2,5,2,11,20,-44,2,3,482,443
123,102,2,4,6,7,24,43,6,6,506,486
124,1,4,3,8,5,44,32,4,2,44,32
124,2,2,4,3,10,21,46,5,8,65,78
124,3,3,3,4,9,31,-64,6,4,96,14
124,4,4,2,8,5,-56,23,0,7,40,37
124,5,2,5,3,10,21,-45,1,2,61,-8
124,6,4,3,6,7,42,34,3,6,103,26
124,7,2,4,4,9,22,-55,5,1,125,-29
124,8,3,4,5,8,32,44,7,5,157,15
124,9,4,3,8,5,-56,32,1,7,101,47
124,10,2,4,5,8,23,-56,4,1,124,-9
124,11,5,2,10,3,55,21,9,2,179,12
124,12,4,3,7,6,-57,33,2,5,122,45
124,13,5,2,9,4,54,22,6,7,176,67
124,14,3,4,6,7,33,-57,9,0,209,10
124,15,4,3,6,7,-58,34,1,4,151,44
124,16,5,2,10,3,55,21,6,5,206,65
124,17,3,3,8,5,-65,32,1,7,141,97
124,18,4,3,10,3,46,30,7,7,187,127
124,19,4,3,8,5,-56,32,1,9,131,159
124,20,5,2,8,5,53,-77,4,2,184,82
124,21,2,4,4,9,22,45,6,7,206,127
124,22,4,4,6,7,42,-57,8,0,248,70
124,23,3,3,7,6,-66,33,2,3,182,103
124,24,2,6,4,9,22,63,4,6,204,166
124,25,3,4,4,9,31,-55,5,1,235,111
124,26,3,3,4,9,31,36,6,7,266,147
124,27,5,2,9,4,-46,22,0,9,220,169
124,28,2,4,5,8,23,-56,3,3,243,113
124,29,2,4,5,8,23,44,6,7,266,157
124,30,2,6,5,8,23,62,9,9,289,219
124,31,4,3,7,6,-57,-67,2,2,232,152
124,32,3,3,8,5,35,32,7,4,267,184
124,33,4,3,5,8,41,35,8,9,308,219
124,34,3,3,6,7,-67,-66,1,3,241,153
124,35,4,2,8,5,44,23,5,6,285,176
124,36,4,2,8,5,44,23,9,9,329,199
124,37,3,4,3,10,30,-54,9,5,359,145
124,38,4,3,6,7,-58,34,1,9,301,179
124,39,3,3,6,7,33,-66,4,3,334,113
124,40,4,4,7,6,43,42,7,5,377,155
124,41,4,3,8,5,-56,32,1,7,321,187
124,42,3,3,5,8,32,-65,3,2,353,122
124,43,2,6,3,10,21,64,4,6,374,186
124,44,2,5,4,9,22,-46,6,0,396,140
124,45,5,2,9,4,-46,22,0,2,350,162
124,46,4,3,5,8,41,35,1,7,391,197
124,47,4,2,9,4,45,22,6,9,436,219
124,48,4,3,4,9,40,-64,6,5,476,155
124,49,5,3,8,5,53,32,9,7,529,187
125,1,5,2,8,5,53,23,3,3,53,23
125,2,4,3,8,5,44,32,7,5,97,55
125,3,3,3,5,8,32,-65,9,0,129,-10
125,4,4,3,6,7,-58,34,1,4,71,24
125,5,2,6,3,10,21,64,2,8,92,88
125,6,2,5,5,8,23,-47,5,1,115,41
125,7,3,3,6,7,33,34,8,5,148,75
125,8,2,4,6,7,-76,43,2,8,72,118
125,9,3,3,6,7,33,-66,5,2,105,52
125,10,3,4,6,7,33,43,8,5,138,95
125,11,4,3,8,5,-56,32,2,7,82,127
125,12,4,2,6,7,42,-75,4,2,124,52
125,13,3,3,7,6,34,33,8,5,158,85
125,14,3,4,6,7,-67,43,1,8,91,128
125,15,4,4,9,4,45,40,6,8,136,168
125,16,3,3,8,5,-65,-68,1,0,71,100
125,17,4,2,9,4,45,22,6,2,116,122
125,18,4,4,4,9,40,45,6,7,156,167
125,19,4,3,7,6,43,-67,9,0,199,100
125,20,2,5,5,8,-77,53,2,3,122,153
125,21,3,3,6,7,33,34,5,7,155,187
125,22,4,3,7,6,43,-67,8,0,198,120
125,23,4,2,8,5,-56,23,2,3,142,143
125,24,2,6,3,10,21,64,3,7,163,207
125,25,5,2,10,3,55,21,8,8,218,228
125,26,5,3,6,7,51,-66,9,2,269,162
125,27,3,3,8,5,-65,32,4,4,204,194
125,28,2,4,9,4,-73,40,1,4,131,234
125,29,3,4,5,8,32,44,3,8,163,278
125,30,2,4,6,7,24,-57,7,1,187,221
125,31,2,4,7,6,-75,42,2,3,112,263
125,32,3,4,4,9,31,45,3,8,143,308
125,33,5,2,8,5,53,-77,6,1,196,231
125,34,3,4,5,8,32,44,8,5,228,275
125,35,3,3,9,4,-64,31,4,6,164,306
125,36,4,3,5,8,41,-65,5,1,205,241
125,37,3,3,6,7,33,34,8,5,238,275
125,38,3,3,6,7,-67,34,1,9,171,309
125,39,4,3,8,5,44,-68,5,1,215,241
125,40,3,3,8,5,-65,32,0,3,150,273
125,41,3,4,6,7,33,43,3,6,183,316
125,42,3,4,5,8,32,-56,5,0,215,260
125,43,2,4,7,6,-75,42,0,2,140,302
125,44,4,2,8,5,44,23,4,5,184,325
125,45,3,3,5,8,32,-65,6,0,216,260
125,46,3,4,7,6,-66,42,0,2,150,302
125,47,4,2,9,4,45,22,5,4,195,324
125,48,4,3,9,4,-55,31,0,5,140,355
125,49,3,4,7,6,34,42,4,7,174,397
125,50,3,3,9,4,-64,31,0,8,110,428
125,51,2,4,7,6,25,-58,5,0,135,370
125,52,4,2,9,4,-55,22,0,2,80,392
125,53,3,3,6,7,33,34,3,6,113,426
125,54,5,2,8,5,53,23,6,9,166,449
125,55,3,3,4,9,31,-64,7,5,197,385
125,56,2,4,6,7,-76,43,1,8,121,428
125,57,4,3,9,4,45,31,6,9,166,459
125,58,3,4,5,8,32,-56,8,3,198,403
125,59,3,3,5,8,-68,35,0,8,130,438
125,60,4,2,8,5,44,-77,4,1,174,361
125,61,3,3,6,7,33,34,7,5,207,395
125,62,4,3,6,7,42,34,9,9,249,429
125,63,2,5,8,5,-74,50,5,9,175,479
125,64,3,4,5,8,32,-56,7,3,207,423
125,65,2,4,5,8,-77,44,0,7,130,467
125,66,3,4,4,9,31,-55,1,2,161,412
125,67,4,2,9,4,45,22,6,4,206,434
125,68,3,4,7,6,-66,42,0,6,140,476
125,69,3,4,5,8,32,-56,2,0,172,420
125,70,2,4,5,8,23,44,5,4,195,464
125,71,2,5,5,8,23,53,8,7,218,517
126,1,4,3,10,3,46,30,6,0,46,30
126,2,3,3,7,6,-66,33,0,3,-20,63
126,3,4,3,8,5,44,32,4,5,24,95
126,4,5,2,11,2,-44,20,0,5,-20,115
126,5,3,3,5,8,32,-65,2,0,12,50
126,6,2,4,7,6,25,42,7,2,37,92
126,7,3,3,7,6,-66,33,1,5,-29,125
126,8,3,3,8,5,35,32,6,7,6,157
126,9,3,3,5,8,32,-65,8,2,38,92
126,10,2,5,3,10,21,55,9,7,59,147
126,11,2,4,5,8,-77,-56,2,1,-18,91
126,12,2,5,5,8,23,53,5,4,5,144
126,13,3,3,5,8,32,35,7,9,37,179
126,14,3,4,4,9,31,-55,8,4,68,124
126,15,3,4,6,7,-67,43,1,7,1,167
126,16,4,2,7,6,43,-76,4,1,44,91
126,17,4,3,6,7,42,34,6,5,86,125
126,18,4,2,9,4,-55,22,1,7,31,147
126,19,5,2,10,3,55,21,6,8,86,168
126,20,3,5,5,8,32,-47,8,1,118,121
126,21,2,5,4,9,-78,54,0,5,40,175
126,22,2,5,7,6,25,51,5,6,65,226
126,23,3,3,7,6,34,33,9,9,99,259
126,24,4,3,10,3,-54,30,5,9,45,289
126,25,2,5,4,9,22,-46,7,3,67,243
126,26,3,3,8,5,-65,32,2,5,2,275
126,27,4,3,9,4,45,31,7,6,47,306
126,28,4,2,9,4,-55,22,2,8,-8,328
126,29,5,2,10,3,55,21,7,9,47,349
126,30,3,4,8,5,-65,-59,2,0,-18,290
126,31,4,3,6,7,42,34,4,4,24,324
126,32,5,3,8,5,53,32,7,6,77,356
126,33,3,4,7,6,-66,42,1,8,11,398
126,34,4,3,8,5,44,-68,5,0,55,330
126,35,4,2,5,8,41,26,6,6,96,356
126,36,5,2,10,3,-45,21,1,7,51,377
126,37,5,2,10,3,55,21,6,8,106,398
126,38,3,3,5,8,32,-65,8,3,138,333
126,39,3,4,7,6,-66,42,2,5,72,375
126,40,5,2,11,2,56,20,8,5,128,395
126,41,3,4,6,7,-67,43,1,8,61,438
126,42,4,3,7,6,43,-67,4,1,104,371
126,43,3,4,4,9,31,45,5,6,135,416
126,44,3,3,5,8,32,-65,7,1,167,351
126,45,3,4,7,6,-66,42,1,3,101,393
126,46,4,2,10,3,46,21,7,4,147,414
126,47,2,5,6,7,-76,52,1,6,71,466
126,48,3,4,7,6,34,42,5,8,105,508
127,1,3,3,8,5,35,32,5,2,35,32
127,2,2,4,4,9,22,45,7,7,57,77
127,3,4,2,10,3,-54,21,3,8,3,98
127,4,3,3,6,7,33,-66,6,2,36,32
127,5,3,4,5,8,32,44,8,6,68,76
127,6,3,3,5,8,-68,-65,0,1,0,11
127,7,3,4,6,7,33,43,3,4,33,54
127,8,3,3,8,5,35,32,8,6,68,86
127,9,4,3,9,4,-55,31,3,7,13,117
127,10,3,4,4,9,31,-55,4,2,44,62
127,11,4,2,4,9,40,27,4,9,84,89
127,12,2,5,4,9,22,-46,6,3,106,43
127,13,2,5,3,10,21,55,7,8,127,98
127,14,3,4,6,7,-67,-57,0,1,60,41
127,15,4,2,8,5,44,23,4,4,104,64
127,16,3,3,7,6,34,33,8,7,138,97
127,17,3,4,7,6,-66,42,2,9,72,139
127,18,2,4,7,6,25,-58,7,1,97,81
127,19,3,4,7,6,-66,42,1,3,31,123
127,20,2,5,6,7,24,52,5,5,55,175
127,21,3,3,7,6,34,33,9,8,89,208
127,22,5,2,9,4,-46,-78,3,0,43,130
127,23,2,4,6,7,24,43,7,3,67,173
127,24,4,2,5,8,41,26,8,9,108,199
127,25,3,3,6,7,-67,-66,1,3,41,133
127,26,3,4,6,7,33,43,4,6,74,176
127,27,2,4,7,6,25,42,9,8,99,218
127,28,3,3,8,5,-65,-68,4,0,34,150
127,29,4,3,8,5,44,32,8,2,78,182
127,30,2,5,4,9,-78,54,0,6,0,236
127,31,3,3,6,7,33,-66,3,0,33,170
127,32,3,4,2,11,-30,47,3,7,3,217
127,33,3,3,4,9,31,-64,4,3,34,153
127,34,4,3,7,6,43,33,7,6,77,186
127,35,2,4,4,9,22,-55,9,1,99,131
127,36,5,2,6,7,-49,25,0,6,50,156
127,37,3,4,8,5,35,41,5,7,85,197
127,38,3,3,6,7,33,-66,8,1,118,131
127,39,2,4,5,8,-77,44,1,5,41,175
127,40,3,4,6,7,33,43,4,8,74,218
127,41,3,3,7,6,34,-67,8,1,108,151
127,42,2,4,4,9,-78,45,0,6,30,196
127,43,4,3,7,6,43,33,3,9,73,229
127,44,4,3,5,8,41,-65,4,4,114,164
127,45,3,3,5,8,32,35,6,9,146,199
127,46,2,5,4,9,22,-46,8,3,168,153
127,47,4,3,6,7,-58,34,0,7,110,187
127,48,3,3,3,10,30,-63,0,4,140,124
127,49,4,3,8,5,44,32,4,6,184,156
127,50,3,3,6,7,33,-66,7,0,217,90
127,51,3,3,5,8,32,35,9,5,249,125
127,52,4,2,9,4,-55,22,4,7,194,147
127,53,3,4,6,7,33,-57,7,0,227,90
127,54,4,2,6,7,42,25,9,5,269,115
127,55,2,4,6,7,-76,43,3,8,193,158
127,56,2,5,4,9,22,-46,5,2,215,112
127,57,2,5,5,8,23,53,8,5,238,165
127,58,3,4,7,6,-66,42,2,7,172,207
127,59,4,2,8,5,44,-77,6,0,216,130
127,60,3,3,8,5,-65,32,1,2,151,162
127,61,4,3,9,4,45,31,6,3,196,193
127,62,3,3,6,7,33,34,9,7,229,227
127,63,4,2,7,6,-57,-76,2,1,172,151
127,64,3,3,6,7,33,34,5,5,205,185
127,65,3,4,4,9,31,-55,6,0,236,130
127,66,5,2,7,6,52,24,8,4,288,154
127,67,3,4,5,8,-68,44,0,8,220,198
127,68,3,3,5,8,32,-65,2,3,252,133
127,69,5,2,11,2,56,20,8,3,308,153
127,70,5,2,7,6,-48,24,0,7,260,177
127,71,4,3,8,5,44,32,4,9,304,209
127,72,3,3,5,8,32,-65,6,4,336,144
127,73,5,2,9,4,-46,22,0,6,290,166
127,74,4,3,6,7,42,-66,2,0,332,100
127,75,3,5,5,8,32,53,4,3,364,153
127,76,3,4,8,5,35,41,9,4,399,194
127,77,3,3,6,7,-67,34,2,8,332,228
127,78,4,3,10,3,46,30,8,8,378,258
127,79,4,3,9,4,-55,31,3,9,323,289
127,80,4,3,8,5,44,-68,7,1,367,221
127,81,2,4,5,8,-77,44,0,5,290,265
127,82,4,3,9,4,45,31,5,6,335,296
127,83,2,4,4,9,22,-55,7,1,357,241
127,84,3,3,6,7,-67,34,0,5,290,275
127,85,2,5,5,8,23,53,3,8,313,328
127,86,3,4,3,10,30,-54,3,4,343,274
127,87,2,4,6,7,24,43,7,7,367,317
127,88,5,2,10,3,-45,21,2,8,322,338
127,89,5,2,10,3,55,21,7,9,377,359
127,90,2,4,6,7,-76,-57,1,2,301,302
127,91,4,2,6,7,42,25,3,7,343,327
127,92,3,3,6,7,33,-66,6,1,376,261
127,93,3,4,5,8,32,44,8,5,408,305
127,94,4,2,8,5,-56,23,2,8,352,328
127,95,3,3,4,9,31,-64,3,4,383,264
127,96,5,2,7,6,52,24,5,8,435,288
127,97,3,5,4,9,31,-46,6,2,466,242
127,98,2,5,5,8,23,53,9,5,489,295
127,99,5,2,8,5,-47,23,2,8,442,318
127,100,2,4,4,9,22,-55,4,3,464,263
127,101,2,4,7,6,25,42,9,5,489,305
127,102,3,3,4,9,-69,-64,0,1,420,241
127,103,3,4,8,5,35,41,5,2,455,282
127,104,4,2,9,4,-55,22,0,4,400,304
127,105,3,4,7,6,34,42,4,6,434,346
127,106,2,4,4,9,22,-55,6,1,456,291
127,107,2,5,4,9,22,54,8,5,478,345
127,108,3,4,6,7,-67,43,1,8,411,388
127,109,5,2,10,3,55,21,6,9,466,409
127,110,3,4,5,8,32,-56,8,3,498,353
127,111,5,2,10,3,-45,21,3,4,453,374
127,112,3,4,3,10,30,-54,3,0,483,320
127,113,3,4,4,9,31,45,4,5,514,365
128,1,4,3,8,5,44,32,4,2,44,32
128,2,2,5,5,8,23,53,7,5,67,85
128,3,4,2,9,4,-55,22,2,7,12,107
128,4,3,4,7,6,34,42,6,9,46,149
128,5,4,2,6,7,42,-75,8,4,88,74
128,6,3,4,8,5,-65,41,3,5,23,115
128,7,4,3,8,5,44,32,7,7,67,147
128,8,3,3,7,6,-66,-67,1,0,1,80
128,9,4,2,5,8,41,26,2,6,42,106
128,10,3,3,4,9,31,-64,3,2,73,42
128,11,3,3,6,7,33,34,6,6,106,76
128,12,5,2,7,6,52,-76,8,0,158,0
128,13,3,3,4,9,31,36,9,6,189,36
128,14,2,4,2,11,20,-53,9,3,209,-17
128,15,3,3,7,6,-66,33,3,6,143,16
128,16,4,3,8,5,44,32,7,8,187,48
128,17,3,4,6,7,-67,-57,0,1,120,-9
128,18,3,5,4,9,31,54,1,5,151,45
128,19,3,4,4,9,31,-55,2,0,182,-10
128,20,2,5,3,10,21,55,3,5,203,45
128,21,3,4,4,9,31,-55,4,0,234,-10
128,22,3,4,8,5,35,41,9,1,269,31
128,23,3,3,4,9,-69,36,0,7,200,67
128,24,2,4,5,8,23,-56,3,1,223,11
128,25,3,4,6,7,33,43,6,4,256,54
128,26,3,4,7,6,-66,42,0,6,190,96
128,27,5,2,9,4,54,22,4,8,244,118
128,28,4,3,5,8,41,-65,5,3,285,53
128,29,3,3,4,9,31,36,6,9,316,89
128,30,4,2,7,6,43,-76,9,3,359,13
128,31,2,4,5,8,-77,44,2,7,282,57
128,32,5,2,8,5,53,-77,5,0,335,-20
128,33,2,5,5,8,23,53,8,3,358,33
128,34,4,2,9,4,-55,22,3,5,303,55
128,35,2,5,2,11,20,-44,3,1,323,11
128,36,3,3,7,6,34,33,7,4,357,44
128,37,2,5,4,9,22,54,9,8,379,98
128,38,3,4,5,8,-68,-56,1,2,311,42
128,39,3,4,8,5,35,41,6,3,346,83
128,40,3,4,4,9,31,45,7,8,377,128
128,41,2,4,5,8,-77,-56,0,2,300,72
128,42,3,3,6,7,33,34,3,6,333,106
128,43,4,2,8,5,44,23,7,9,377,129
128,44,4,3,9,4,-55,-69,2,0,322,60
128,45,6,2,11,2,65,20,7,0,387,80
128,46,4,4,8,5,-56,41,1,1,331,121
128,47,4,2,8,5,44,23,5,4,375,144
128,48,3,4,8,5,-65,41,0,5,310,185
128,49,4,3,7,6,43,33,3,8,353,218
128,50,2,4,5,8,23,-56,6,2,376,162
128,51,5,2,11,2,-44,20,2,2,332,182
128,52,4,3,8,5,44,32,6,4,376,214
128,53,3,3,6,7,33,34,9,8,409,248
128,54,2,4,7,6,-75,-58,4,0,334,190
128,55,3,4,5,8,32,44,6,4,366,234
128,56,3,4,4,9,31,45,7,9,397,279
128,57,3,3,7,6,-66,-67,1,2,331,212
128,58,2,4,6,7,24,43,5,5,355,255
128,59,5,2,9,4,54,22,9,7,409,277
128,60,4,3,10,3,-54,30,5,7,355,307
128,61,3,3,6,7,33,-66,8,1,388,241
128,62,4,4,6,7,-58,43,0,4,330,284
128,63,4,3,9,4,45,31,5,5,375,315
128,64,2,5,2,11,20,-44,5,1,395,271
128,65,3,4,5,8,32,44,7,5,427,315
128,66,2,5,4,9,22,54,9,9,449,369
128,67,5,2,8,5,-47,-77,2,2,402,292
128,68,3,4,6,7,33,43,5,5,435,335
128,69,4,3,9,4,-55,31,0,6,380,366
128,70,3,3,5,8,32,-65,2,1,412,301
128,71,3,4,4,9,31,45,3,6,443,346
128,72,3,3,10,3,-63,30,0,6,380,376
128,73,5,2,9,4,54,22,4,8,434,398
128,74,4,2,10,3,-54,21,0,9,380,419
128,75,2,4,6,7,24,-57,4,2,404,362
128,76,2,4,3,10,21,46,5,8,425,408
128,77,3,3,6,7,33,-66,8,2,458,342
128,78,4,3,7,6,-57,33,1,5,401,375
128,79,2,4,5,8,23,44,4,9,424,419
128,80,3,3,8,5,35,-68,9,1,459,351
128,81,4,3,9,4,-55,31,4,2,404,382
128,82,4,3,4,9,40,36,4,8,444,418
128,83,3,4,5,8,32,-56,6,2,476,362
128,84,4,3,6,7,42,34,8,6,518,396
129,1,5,2,8,5,53,23,3,3,53,23
129,2,3,4,5,8,32,44,5,7,85,67
129,3,5,2,10,3,-45,21,0,8,40,88
129,4,2,4,2,11,20,-53,0,5,60,35
129,5,4,2,7,6,43,24,3,9,103,59
129,6,3,5,4,9,31,-46,4,3,134,13
129,7,3,3,6,7,33,34,7,7,167,47
129,8,3,4,5,8,32,-56,9,1,199,-9
129,9,3,4,6,7,-67,43,2,4,132,34
129,10,4,2,10,3,46,21,8,5,178,55
129,11,4,3,8,5,-56,32,2,7,122,87
129,12,2,4,2,11,20,-53,2,4,142,34
129,13,3,3,5,8,32,35,4,9,174,69
129,14,5,2,8,5,53,-77,7,2,227,-8
129,15,3,4,7,6,-66,42,1,4,161,34
129,16,5,2,10,3,55,21,6,5,216,55
129,17,3,3,7,6,-66,33,0,8,150,88
129,18,3,4,8,5,35,41,5,9,185,129
129,19,3,3,5,8,32,-65,7,4,217,64
129,20,3,4,7,6,-66,42,1,6,151,106
129,21,5,2,9,4,54,22,5,8,205,128
129,22,3,3,9,4,-64,31,1,9,141,159
129,23,3,3,7,6,34,-67,5,2,175,92
129,24,4,3,7,6,43,33,8,5,218,125
129,25,2,5,5,8,-77,53,1,8,141,178
129,26,2,4,4,9,22,-55,3,3,163,123
129,27,4,3,9,4,45,31,8,4,208,154
129,28,5,2,10,3,-45,21,3,5,163,175
129,29,2,4,5,8,23,44,6,9,186,219
129,30,3,4,6,7,33,-57,9,2,219,162
129,31,4,2,9,4,-55,22,4,4,164,184
129,32,2,5,5,8,23,53,7,7,187,237
129,33,2,4,6,7,-76,-57,1,0,111,180
129,34,3,3,8,5,35,32,6,2,146,212
129,35,5,2,8,5,53,23,9,5,199,235
129,36,4,2,8,5,-56,23,3,8,143,258
129,37,4,3,7,6,43,-67,6,1,186,191
129,38,4,3,8,5,-56,32,0,3,130,223
129,39,3,4,4,9,31,45,1,8,161,268
129,40,4,3,8,5,44,-68,5,0,205,200
129,41,5,2,11,2,-44,20,1,0,161,220
129,42,3,3,6,7,33,34,4,4,194,254
129,43,3,3,7,6,34,33,8,7,228,287
129,44,4,4,6,7,-58,-57,0,0,170,230
129,45,5,2,9,4,54,22,4,2,224,252
129,46,3,3,5,8,32,35,6,7,256,287
129,47,4,2,9,4,-55,22,1,9,201,309
129,48,2,4,7,6,25,-58,6,1,226,251
129,49,3,4,6,7,33,43,9,4,259,294
129,50,2,5,3,10,-79,55,0,9,180,349
129,51,5,2,9,4,54,-78,4,1,234,271
129,52,3,4,4,9,31,45,5,6,265,316
129,53,3,3,8,5,-65,32,0,8,200,348
129,54,2,4,5,8,23,-56,3,2,223,292
129,55,3,4,4,9,31,45,4,7,254,337
129,56,3,4,6,7,33,-57,7,0,287,280
129,57,3,3,4,9,31,36,8,6,318,316
129,58,3,3,7,6,-66,33,2,9,252,349
129,59,4,2,8,5,44,-77,6,2,296,272
129,60,3,3,6,7,33,34,9,6,329,306
129,61,5,2,9,4,-46,22,3,8,283,328
129,62,3,3,6,7,33,-66,6,2,316,262
129,63,3,3,4,9,31,36,7,8,347,298
129,64,3,4,5,8,32,-56,9,2,379,242
129,65,3,4,4,9,-69,45,0,7,310,287
129,66,6,2,9,4,63,22,3,9,373,309
129,67,4,2,10,3,46,-79,9,0,419,230
129,68,2,4,4,9,-78,45,1,5,341,275
129,69,3,4,6,7,33,43,4,8,374,318
129,70,4,2,8,5,44,-77,8,1,418,241
129,71,3,3,6,7,-67,34,1,5,351,275
129,72,5,2,7,6,52,24,3,9,403,299
129,73,4,3,9,4,45,-69,8,0,448,230
129,74,3,3,6,7,-67,34,1,4,381,264
129,75,4,3,7,6,43,33,4,7,424,297
129,76,4,2,10,3,-54,21,0,8,370,318
129,77,4,3,8,5,44,-68,4,0,414,250
129,78,4,2,8,5,44,23,8,3,458,273
129,79,2,4,4,9,-78,45,0,8,380,318
129,80,3,3,7,6,34,-67,4,1,414,251
129,81,2,4,8,5,-74,41,0,2,340,292
129,82,4,3,8,5,44,32,4,4,384,324
129,83,3,5,4,9,31,54,5,8,415,378
129,84,3,3,8,5,-65,-68,0,0,350,310
129,85,4,3,7,6,43,33,3,3,393,343
129,86,2,5,4,9,22,54,5,7,415,397
129,87,3,3,9,4,-64,31,1,8,351,428
129,88,3,4,4,9,31,-55,2,3,382,373
129,89,2,4,7,6,25,42,7,5,407,415
129,90,2,5,6,7,-76,52,1,7,331,467
129,91,4,2,8,5,44,-77,5,0,375,390
129,92,4,2,7,6,43,24,8,4,418,414
129,93,4,2,9,4,-55,22,3,6,363,436
129,94,5,3,8,5,53,32,6,8,416,468
129,95,5,2,6,7,51,-75,7,3,467,393
129,96,3,3,5,8,32,35,9,8,499,428
129,97,4,3,7,6,-57,-67,2,1,442,361
129,98,3,3,6,7,33,34,5,5,475,395
129,99,4,3,9,4,-55,31,0,6,420,426
129,100,2,4,5,8,23,-56,3,0,443,370
129,101,2,5,4,9,22,54,5,4,465,424
129,102,3,3,9,4,-64,31,1,5,401,455
129,103,4,2,7,6,43,24,4,9,444,479
129,104,2,5,4,9,22,-46,6,3,466,433
129,105,5,2,9,4,-46,22,0,5,420,455
129,106,3,5,8,5,35,50,5,5,455,505
130,1,4,3,8,5,44,32,4,2,44,32
130,2,3,3,8,5,35,32,9,4,79,64
130,3,2,5,5,8,-77,53,2,7,2,117
130,4,4,2,9,4,45,22,7,9,47,139
130,5,4,4,6,7,42,-57,9,2,89,82
130,6,3,4,7,6,-66,42,3,4,23,124
130,7,2,4,4,9,22,45,5,9,45,169
130,8,3,4,7,6,34,-58,9,1,79,111
130,9,3,3,7,6,-66,33,3,4,13,144
130,10,3,4,4,9,31,45,4,9,44,189
130,11,4,2,9,4,45,-78,9,1,89,111
130,12,3,3,8,5,-65,32,4,3,24,143
130,13,2,5,2,11,20,56,4,9,44,199
130,14,4,4,4,9,40,-55,4,4,84,144
130,15,3,3,8,5,35,32,9,6,119,176
130,16,4,2,9,4,-55,22,4,8,64,198
130,17,4,2,8,5,44,-77,8,1,108,121
130,18,4,2,10,3,-54,21,4,2,54,142
130,19,2,6,4,9,22,63,6,5,76,205
130,20,4,2,8,5,-56,23,0,8,20,228
130,21,2,6,5,8,23,-38,3,0,43,190
130,22,3,5,4,9,31,54,4,4,74,244
130,23,2,5,5,8,23,53,7,7,97,297
130,24,5,2,10,3,-45,21,2,8,52,318
130,25,3,3,6,7,33,-66,5,2,85,252
130,26,4,2,10,3,-54,21,1,3,31,273
130,27,4,3,9,4,45,31,6,4,76,304
130,28,2,4,8,5,-74,41,2,5,2,345
130,29,4,3,7,6,43,33,5,8,45,378
130,30,3,4,5,8,32,-56,7,2,77,322
130,31,3,5,3,10,30,55,7,7,107,377
130,32,4,3,6,7,42,-66,9,1,149,311
130,33,2,5,5,8,-77,53,2,4,72,364
130,34,5,2,8,5,53,23,5,7,125,387
130,35,4,2,10,3,-54,21,1,8,71,408
130,36,3,3,7,6,34,-67,5,1,105,341
130,37,2,5,3,10,21,55,6,6,126,396
130,38,3,3,10,3,-63,30,3,6,63,426
130,39,2,5,2,11,20,-44,3,2,83,382
130,40,4,3,6,7,42,34,5,6,125,416
130,41,2,4,2,11,20,-53,5,3,145,363
130,42,5,2,10,3,-45,21,0,4,100,384
130,43,4,2,9,4,45,22,5,6,145,406
130,44,2,4,6,7,24,43,9,9,169,449
130,45,3,4,8,5,-65,-59,4,0,104,390
130,46,3,3,7,6,34,33,8,3,138,423
130,47,4,3,8,5,-56,32,2,5,82,455
130,48,3,3,8,5,35,32,7,7,117,487
130,49,4,2,7,6,-57,-76,0,1,60,411
130,50,4,3,8,5,44,32,4,3,104,443
130,51,3,3,9,4,-64,31,0,4,40,474
130,52,5,2,11,2,56,20,6,4,96,494
130,53,2,5,3,10,21,55,7,9,117,549
131,1,3,4,9,4,36,40,6,0,36,40
131,2,3,3,6,7,33,34,9,4,69,74
131,3,2,5,3,10,-79,55,0,9,-10,129
131,4,2,4,4,9,22,-55,2,4,12,74
131,5,3,3,6,7,33,34,5,8,45,108
131,6,2,4,4,9,22,-55,7,3,67,53
131,7,3,3,5,8,32,35,9,8,99,88
131,8,3,4,6,7,-67,-57,2,1,32,31
131,9,4,3,10,3,46,30,8,1,78,61
131,10,2,5,4,9,-78,54,0,5,0,115
131,11,2,4,7,6,25,42,5,7,25,157
131,12,3,4,5,8,32,-56,7,1,57,101
131,13,2,5,5,8,-77,53,0,4,-20,154
131,14,4,3,10,3,46,30,6,4,26,184
131,15,3,4,4,9,31,45,7,9,57,229
131,16,4,2,7,6,-57,-76,0,3,0,153
131,17,3,3,4,9,31,36,1,9,31,189
131,18,4,3,7,6,43,-67,4,2,74,122
131,19,3,3,7,6,34,33,8,5,108,155
131,20,5,2,9,4,-46,22,2,7,62,177
131,21,2,4,5,8,23,-56,5,1,85,121
131,22,5,2,8,5,53,23,8,4,138,144
131,23,2,5,4,9,-78,54,0,8,60,198
131,24,3,4,4,9,31,-55,1,3,91,143
131,25,5,2,7,6,52,24,3,7,143,167
131,26,6,2,10,3,64,21,7,8,207,188
131,27,3,3,7,6,-66,-67,1,1,141,121
131,28,4,2,9,4,45,22,6,3,186,143
131,29,4,3,10,3,-54,30,2,3,132,173
131,30,4,2,9,4,45,22,7,5,177,195
131,31,3,3,7,6,-66,33,1,8,111,228
131,32,2,4,3,10,21,-54,2,4,132,174
131,33,2,4,4,9,22,45,4,9,154,219
131,34,5,2,8,5,53,-77,7,2,207,142
131,35,3,3,7,6,-66,33,1,5,141,175
131,36,4,3,7,6,43,33,4,8,184,208
131,37,3,3,6,7,33,-66,7,2,217,142
131,38,4,2,8,5,-56,23,1,5,161,165
131,39,5,2,11,2,56,20,7,5,217,185
131,40,4,2,11,2,-53,20,4,5,164,205
131,41,2,6,2,11,20,-35,4,0,184,170
131,42,4,2,10,3,-54,21,0,1,130,191
131,43,3,5,6,7,33,52,3,3,163,243
131,44,4,3,9,4,45,31,8,4,208,274
131,45,4,3,7,6,-57,33,1,7,151,307
131,46,3,3,8,5,35,32,6,9,186,339
131,47,4,3,9,4,-55,-69,1,0,131,270
131,48,5,2,10,3,55,21,6,1,186,291
131,49,3,3,7,6,-66,33,0,4,120,324
131,50,5,2,9,4,54,22,4,6,174,346
131,51,4,3,6,7,42,-66,6,0,216,280
131,52,4,2,7,6,43,24,9,4,259,304
131,53,2,4,3,10,-79,-54,0,0,180,250
131,54,4,3,8,5,44,32,4,2,224,282
131,55,5,3,6,7,51,34,5,6,275,316
131,56,3,4,5,8,32,-56,7,0,307,260
131,57,5,3,7,6,52,33,9,3,359,293
131,58,5,2,8,5,-47,23,2,6,312,316
131,59,4,3,9,4,45,31,7,7,357,347
131,60,4,3,8,5,-56,32,1,9,301,379
131,61,2,4,5,8,23,-56,4,3,324,323
131,62,2,4,5,8,23,44,7,7,347,367
131,63,2,4,4,9,22,-55,9,2,369,312
131,64,3,3,9,4,-64,31,5,3,305,343
131,65,3,4,5,8,32,44,7,7,337,387
131,66,3,4,4,9,31,-55,8,2,368,332
131,67,4,3,8,5,-56,32,2,4,312,364
131,68,3,4,9,4,36,40,8,4,348,404
131,69,3,3,7,6,-66,33,2,7,282,437
131,70,5,2,8,5,53,-77,5,0,335,360
131,71,2,5,1,12,-20,57,5,7,315,417
131,72,3,4,4,9,31,-55,6,2,346,362
131,73,2,4,8,5,-74,41,2,3,272,403
131,74,4,3,8,5,44,32,6,5,316,435
131,75,4,3,7,6,43,33,9,8,359,468
131,76,3,5,4,9,-69,-46,0,2,290,422
131,77,2,5,2,11,20,56,0,8,310,478
131,78,3,3,6,7,33,-66,3,2,343,412
131,79,5,2,9,4,54,22,7,4,397,434
131,80,4,2,9,4,-55,22,2,6,342,456
131,81,3,3,6,7,33,-66,5,0,375,390
131,82,3,3,7,6,34,33,9,3,409,423
131,83,4,2,9,4,-55,22,4,5,354,445
131,84,3,3,8,5,35,32,9,7,389,477
131,85,3,4,4,9,-69,-55,0,2,320,422
131,86,4,3,9,4,45,31,5,3,365,453
131,87,3,3,5,8,32,35,7,8,397,488
131,88,4,3,9,4,-55,31,2,9,342,519
132,1,4,2,7,6,43,24,3,4,43,24
132,2,4,3,8,5,44,32,7,6,87,56
132,3,4,2,6,7,42,-75,9,1,129,-19
132,4,4,2,8,5,-56,23,3,4,73,4
132,5,3,4,7,6,34,42,7,6,107,46
132,6,3,3,7,6,-66,33,1,9,41,79
132,7,3,3,8,5,35,-68,6,1,76,11
132,8,4,2,8,5,-56,23,0,4,20,34
132,9,3,5,3,10,30,55,0,9,50,89
132,10,3,3,9,4,36,-69,6,0,86,20
132,11,3,3,9,4,-64,31,2,1,22,51
132,12,2,5,3,10,21,55,3,6,43,106
132,13,2,4,3,10,21,-54,4,2,64,52
132,14,5,2,8,5,53,23,7,5,117,75
132,15,2,4,6,7,-76,43,1,8,41,118
132,16,3,3,5,8,32,-65,3,3,73,53
132,17,3,4,4,9,31,45,4,8,104,98
132,18,5,2,10,3,55,21,9,9,159,119
132,19,3,3,5,8,-68,-65,1,4,91,54
132,20,3,3,7,6,34,33,5,7,125,87
132,21,3,3,7,6,34,-67,9,0,159,20
132,22,3,3,7,6,-66,33,3,3,93,53
132,23,3,3,6,7,33,34,6,7,126,87
132,24,2,5,3,10,21,-45,7,2,147,42
132,25,5,3,10,3,-45,30,2,2,102,72
132,26,3,4,6,7,33,43,5,5,135,115
132,27,4,3,8,5,44,32,9,7,179,147
132,28,2,4,6,7,-76,-57,3,0,103,90
132,29,3,3,9,4,36,31,9,1,139,121
132,30,4,3,8,5,-56,32,3,3,83,153
132,31,3,3,8,5,35,32,8,5,118,185
132,32,2,5,4,9,-78,54,0,9,40,239
132,33,4,2,7,6,43,-76,3,3,83,163
132,34,4,2,7,6,43,24,6,7,126,187
132,35,3,3,7,6,-66,-67,0,0,60,120
132,36,4,3,6,7,42,34,2,4,102,154
132,37,3,4,5,8,32,44,4,8,134,198
132,38,3,4,6,7,33,-57,7,1,167,141
132,39,4,3,10,3,-54,30,3,1,113,171
132,40,3,5,6,7,33,52,6,3,146,223
132,41,4,4,8,5,-56,41,0,4,90,264
132,42,5,2,11,2,56,20,6,4,146,284
132,43,3,3,9,4,-64,31,2,5,82,315
132,44,4,3,8,5,44,32,6,7,126,347
132,45,2,5,5,8,23,-47,9,0,149,300
132,46,3,5,3,10,30,55,9,5,179,355
132,47,2,4,5,8,-77,44,2,9,102,399
132,48,3,3,4,9,31,-64,3,5,133,335
132,49,6,2,9,4,63,22,6,7,196,357
132,50,3,3,7,6,-66,-67,0,0,130,290
132,51,4,3,7,6,43,33,3,3,173,323
132,52,2,4,3,10,21,46,4,9,194,369
132,53,3,3,6,7,33,-66,7,3,227,303
132,54,4,3,6,7,42,34,9,7,269,337
132,55,2,6,3,10,-79,-36,0,1,190,301
132,56,3,4,9,4,36,40,6,1,226,341
132,57,3,3,8,5,-65,32,1,3,161,373
132,58,2,5,4,9,22,54,3,7,183,427
132,59,4,2,8,5,44,-77,7,0,227,350
132,60,4,3,7,6,-57,33,0,3,170,383
132,61,2,5,4,9,22,54,2,7,192,437
132,62,5,2,10,3,55,21,7,8,247,458
132,63,3,3,5,8,32,-65,9,3,279,393
132,64,3,3,6,7,-67,34,2,7,212,427
132,65,2,4,4,9,22,-55,4,2,234,372
132,66,4,3,6,7,42,34,6,6,276,406
132,67,4,3,6,7,42,-66,8,0,318,340
132,68,4,2,8,5,-56,23,2,3,262,363
132,69,3,4,4,9,31,45,3,8,293,408
132,70,4,2,9,4,45,-78,8,0,338,330
132,71,4,2,8,5,-56,23,2,3,282,353
132,72,3,3,9,4,36,31,8,4,318,384
132,73,3,4,4,9,31,45,9,9,349,429
132,74,3,3,7,6,-66,-67,3,2,283,362
132,75,4,3,5,8,41,35,4,7,324,397
132,76,4,3,6,7,42,-66,6,1,366,331
132,77,3,3,7,6,-66,33,0,4,300,364
132,78,4,3,8,5,44,32,4,6,344,396
132,79,4,2,9,4,45,22,9,8,389,418
132,80,4,3,9,4,-55,31,4,9,334,449
132,81,3,3,7,6,34,-67,8,2,368,382
132,82,6,2,10,3,-36,21,2,3,332,403
132,83,5,2,9,4,54,22,6,5,386,425
132,84,3,3,5,8,32,-65,8,0,418,360
132,85,3,3,3,10,30,37,8,7,448,397
132,86,4,3,5,8,41,-65,9,2,489,332
132,87,5,2,9,4,-46,22,3,4,443,354
132,88,3,4,7,6,34,42,7,6,477,396
132,89,2,4,4,9,22,-55,9,1,499,341
132,90,5,2,10,3,-45,21,4,2,454,362
132,91,4,3,5,8,41,35,5,7,495,397
132,92,3,3,7,6,34,-67,9,0,529,330
133,1,5,2,10,3,55,21,5,1,55,21
133,2,4,3,6,7,42,34,7,5,97,55
133,3,4,3,6,7,42,34,9,9,139,89
133,4,4,2,8,5,-56,-77,3,2,83,12
133,5,4,2,10,3,46,21,9,3,129,33
133,6,3,3,4,9,-69,36,0,9,60,69
133,7,2,4,7,6,25,-58,5,1,85,11
133,8,5,2,9,4,54,22,9,3,139,33
133,9,4,3,9,4,-55,31,4,4,84,64
133,10,6,2,11,2,65,20,9,4,149,84
133,11,5,2,10,3,-45,21,4,5,104,105
133,12,3,4,7,6,34,42,8,7,138,147
133,13,3,3,7,6,-66,-67,2,0,72,80
133,14,4,3,9,4,45,31,7,1,117,111
133,15,3,4,8,5,-65,41,2,2,52,152
133,16,3,4,5,8,32,44,4,6,84,196
133,17,2,4,4,9,22,-55,6,1,106,141
133,18,4,3,9,4,-55,31,1,2,51,172
133,19,4,4,7,6,43,42,4,4,94,214
133,20,3,4,5,8,32,44,6,8,126,258
133,21,4,2,8,5,-56,-77,0,1,70,181
133,22,3,4,5,8,32,44,2,5,102,225
133,23,3,3,6,7,33,34,5,9,135,259
133,24,2,5,6,7,24,-48,9,1,159,211
133,25,5,2,9,4,-46,22,3,3,113,233
133,26,4,4,4,9,40,45,3,8,153,278
133,27,3,3,7,6,34,-67,7,1,187,211
133,28,5,2,8,5,-47,23,0,4,140,234
133,29,2,5,5,8,23,53,3,7,163,287
133,30,5,2,8,5,53,-77,6,0,216,210
133,31,4,3,9,4,-55,31,1,1,161,241
133,32,3,4,5,8,32,44,3,5,193,285
133,33,3,4,8,5,35,41,8,6,228,326
133,34,4,2,9,4,-55,22,3,8,173,348
133,35,4,3,8,5,44,-68,7,0,217,280
133,36,2,4,5,8,-77,44,0,4,140,324
133,37,2,4,4,9,22,45,2,9,162,369
133,38,5,2,9,4,54,-78,6,1,216,291
133,39,3,3,6,7,33,34,9,5,249,325
133,40,4,2,10,3,-54,21,5,6,195,346
133,41,3,4,5,8,32,-56,7,0,227,290
133,42,2,5,7,6,-75,51,2,1,152,341
133,43,4,2,6,7,42,25,4,6,194,366
133,44,2,5,5,8,23,53,7,9,217,419
133,45,6,2,8,5,62,-77,9,2,279,342
133,46,3,3,6,7,-67,34,2,6,212,376
133,47,5,3,7,6,52,33,4,9,264,409
133,48,2,5,5,8,23,-47,7,2,287,362
133,49,3,3,7,6,-66,33,1,5,221,395
133,50,3,4,6,7,33,43,4,8,254,438
133,51,6,2,11,2,65,20,9,8,319,458
133,52,2,5,5,8,-77,-47,2,1,242,411
133,53,5,2,7,6,52,24,4,5,294,435
133,54,3,3,3,10,30,-63,4,2,324,372
133,55,3,4,5,8,32,44,6,6,356,416
133,56,4,2,9,4,-55,22,1,8,301,438
133,57,2,4,8,5,26,41,7,9,327,479
133,58,4,2,7,6,-57,-76,0,3,270,403
133,59,4,2,6,7,42,25,2,8,312,428
133,60,3,3,8,5,35,-68,7,0,347,360
133,61,4,3,6,7,42,34,9,4,389,394
133,62,2,4,3,10,-79,-54,0,0,310,340
133,63,5,2,5,8,50,26,0,6,360,366
133,64,3,4,8,5,35,41,5,7,395,407
133,65,2,5,3,10,21,-45,6,2,416,362
133,66,2,4,5,8,23,44,9,6,439,406
133,67,2,4,5,8,-77,-56,2,0,362,350
133,68,4,3,6,7,42,34,4,4,404,384
133,69,4,3,8,5,44,32,8,6,448,416
133,70,2,5,4,9,-78,-46,0,0,370,370
133,71,3,4,4,9,31,45,1,5,401,415
133,72,3,4,7,6,34,42,5,7,435,457
133,73,2,4,5,8,23,-56,8,1,458,401
133,74,2,5,3,10,21,55,9,6,479,456
133,75,3,4,4,9,-69,-55,0,1,410,401
133,76,3,3,6,7,33,34,3,5,443,435
133,77,3,3,7,6,34,33,7,8,477,468
133,78,4,3,9,4,-55,31,2,9,422,499
133,79,4,2,8,5,44,-77,6,2,466,422
133,80,5,2,9,4,-46,22,0,4,420,444
133,81,4,3,7,6,43,33,3,7,463,477
133,82,3,4,6,7,33,-57,6,0,496,420
133,83,4,3,10,3,-54,30,2,0,442,450
133,84,3,3,7,6,34,33,6,3,476,483
133,85,3,3,7,6,-66,33,0,6,410,516
134,1,3,4,7,6,34,42,4,2,34,42
134,2,2,5,3,10,21,55,5,7,55,97
134,3,3,4,4,9,31,-55,6,2,86,42
134,4,2,4,5,8,23,44,9,6,109,86
134,5,3,4,7,6,-66,42,3,8,43,128
134,6,4,2,9,4,45,-78,8,0,88,50
134,7,4,4,9,4,-55,40,3,0,33,90
134,8,3,4,6,7,33,43,6,3,66,133
134,9,2,4,7,6,-75,42,1,5,-9,175
134,10,2,5,3,10,21,-45,2,0,12,130
134,11,2,5,4,9,22,54,4,4,34,184
134,12,4,2,7,6,43,24,7,8,77,208
134,13,5,2,10,3,-45,21,2,9,32,229
134,14,3,4,7,6,34,-58,6,1,66,171
134,15,2,5,5,8,23,53,9,4,89,224
134,16,3,4,5,8,-68,44,1,8,21,268
134,17,2,5,5,8,23,-47,4,1,44,221
134,18,2,5,3,10,21,55,5,6,65,276
134,19,3,4,5,8,32,-56,7,0,97,220
134,20,3,4,5,8,32,44,9,4,129,264
134,21,5,2,8,5,-47,23,2,7,82,287
134,22,4,3,6,7,42,-66,4,1,124,221
134,23,2,4,3,10,21,46,5,7,145,267
134,24,4,3,5,8,41,-65,6,2,186,202
134,25,3,4,6,7,33,43,9,5,219,245
134,26,3,3,7,6,-66,33,3,8,153,278
134,27,3,4,6,7,33,-57,6,1,186,221
134,28,3,3,6,7,33,34,9,5,219,255
134,29,3,4,5,8,-68,44,1,9,151,299
134,30,2,4,5,8,23,-56,4,3,174,243
134,31,4,2,5,8,41,26,5,9,215,269
134,32,4,2,8,5,44,-77,9,2,259,192
134,33,3,3,4,9,-69,36,0,8,190,228
134,34,3,3,6,7,33,-66,3,2,223,162
134,35,3,3,7,6,34,33,7,5,257,195
134,36,5,2,10,3,-45,21,2,6,212,216
134,37,3,3,7,6,34,33,6,9,246,249
134,38,3,4,8,5,-65,-59,1,0,181,190
134,39,4,3,7,6,43,33,4,3,224,223
134,40,4,2,9,4,45,22,9,5,269,245
134,41,3,4,6,7,-67,43,2,8,202,288
134,42,5,2,6,7,51,-75,3,3,253,213
134,43,2,4,4,9,22,45,5,8,275,258
134,44,5,2,10,3,-45,21,0,9,230,279
134,45,4,3,8,5,44,-68,4,1,274,211
134,46,3,3,7,6,34,33,8,4,308,244
134,47,3,3,7,6,-66,33,2,7,242,277
134,48,3,3,6,7,33,-66,5,1,275,211
134,49,6,2,10,3,64,21,9,2,339,232
134,50,2,4,3,10,-79,46,0,8,260,278
134,51,4,2,7,6,43,-76,3,2,303,202
134,52,2,4,7,6,25,42,8,4,328,244
134,53,4,3,7,6,-57,33,1,7,271,277
134,54,3,3,5,8,32,-65,3,2,303,212
134,55,2,5,4,9,22,54,5,6,325,266
134,56,4,3,8,5,44,32,9,8,369,298
134,57,3,4,4,9,-69,-55,0,3,300,243
134,58,3,4,6,7,33,43,3,6,333,286
134,59,5,2,11,2,56,20,9,6,389,306
134,60,3,3,7,6,-66,33,3,9,323,339
134,61,3,3,6,7,33,-66,6,3,356,273
134,62,3,3,6,7,33,34,9,7,389,307
134,63,3,3,7,6,-66,-67,3,0,323,240
134,64,2,5,4,9,22,54,5,4,345,294
134,65,4,2,7,6,43,24,8,8,388,318
134,66,3,4,7,6,-66,-58,2,0,322,260
134,67,3,3,8,5,35,32,7,2,357,292
134,68,3,3,7,6,-66,33,1,5,291,325
134,69,3,4,6,7,33,43,4,8,324,368
134,70,4,2,9,4,45,-78,9,0,369,290
134,71,4,2,8,5,-56,23,3,3,313,313
134,72,4,3,7,6,43,33,6,6,356,346
134,73,3,4,7,6,-66,42,0,8,290,388
134,74,4,2,8,5,44,-77,4,1,334,311
134,75,5,2,8,5,53,23,7,4,387,334
134,76,3,4,6,7,-67,43,0,7,320,377
134,77,3,3,7,6,34,-67,4,0,354,310
134,78,4,3,7,6,43,33,7,3,397,343
134,79,4,3,7,6,-57,33,0,6,340,376
134,80,3,4,7,6,34,42,4,8,374,418
134,81,5,3,10,3,55,30,9,8,429,448
134,82,4,2,4,9,40,-73,9,5,469,375
134,83,4,4,6,7,-58,43,1,8,411,418
134,84,3,3,6,7,33,-66,4,2,444,352
134,85,3,3,5,8,32,35,6,7,476,387
134,86,2,4,5,8,23,-56,9,1,499,331
134,87,2,6,3,10,-79,64,0,5,420,395
134,88,4,2,8,5,44,23,4,8,464,418
134,89,2,5,4,9,22,-46,6,2,486,372
134,90,2,4,8,5,-74,41,2,3,412,413
134,91,3,4,7,6,34,42,6,5,446,455
134,92,3,4,5,8,32,44,8,9,478,499
134,93,2,4,3,10,21,-54,9,5,499,445
134,94,3,3,9,4,-64,31,5,6,435,476
134,95,4,2,6,7,42,-75,7,1,477,401
134,96,4,3,7,6,-57,33,0,4,420,434
134,97,3,4,4,9,31,45,1,9,451,479
134,98,4,3,9,4,45,-69,6,0,496,410
134,99,4,3,7,6,43,33,9,3,539,443
135,1,2,4,7,6,25,42,5,2,25,42
135,2,2,4,6,7,24,43,9,5,49,85
135,3,3,3,8,5,-65,32,4,7,-16,117
135,4,4,2,9,4,45,22,9,9,29,139
135,5,2,4,5,8,-77,-56,2,3,-48,83
135,6,3,3,6,7,33,34,5,7,-15,117
135,7,4,3,8,5,44,32,9,9,29,149
135,8,4,3,8,5,-56,-68,3,1,-27,81
135,9,3,4,5,8,32,44,5,5,5,125
135,10,4,2,10,3,-54,21,1,6,-49,146
135,11,4,3,10,3,46,30,7,6,-3,176
135,12,4,3,6,7,42,-66,9,0,39,110
135,13,3,4,7,6,-66,42,3,2,-27,152
135,14,3,3,4,9,31,36,4,8,4,188
135,15,5,2,9,4,54,-78,8,0,58,110
135,16,3,3,8,5,-65,32,3,2,-7,142
135,17,2,4,4,9,22,45,5,7,15,187
135,18,3,4,3,10,30,-54,5,3,45,133
135,19,4,3,8,5,44,32,9,5,89,165
135,20,4,3,7,6,-57,33,2,8,32,198
135,21,3,4,3,10,30,-54,2,4,62,144
135,22,3,4,8,5,35,41,7,5,97,185
135,23,4,2,7,6,-57,24,0,9,40,209
135,24,4,2,7,6,43,-76,3,3,83,133
135,25,3,4,5,8,32,44,5,7,115,177
135,26,4,3,8,5,44,32,9,9,159,209
135,27,5,2,9,4,-46,-78,3,1,113,131
135,28,2,5,5,8,23,53,6,4,136,184
135,29,3,4,4,9,31,45,7,9,167,229
135,30,3,4,7,6,-66,-58,1,1,101,171
135,31,3,3,8,5,35,32,6,3,136,203
135,32,3,3,6,7,33,34,9,7,169,237
135,33,3,4,8,5,-65,41,4,8,104,278
135,34,3,5,5,8,32,-47,6,1,136,231
135,35,4,3,6,7,42,34,8,5,178,265
135,36,3,4,5,8,-68,44,0,9,110,309
135,37,2,4,5,8,23,-56,3,3,133,253
135,38,3,5,4,9,31,54,4,7,164,307
135,39,5,3,10,3,55,30,9,7,219,337
135,40,3,3,5,8,-68,-65,1,2,151,272
135,41,3,3,8,5,35,32,6,4,186,304
135,42,2,5,2,11,20,-44,6,0,206,260
135,43,4,3,8,5,-56,32,0,2,150,292
135,44,4,3,7,6,43,33,3,5,193,325
135,45,3,4,6,7,33,43,6,8,226,368
135,46,4,3,5,8,41,-65,7,3,267,303
135,47,3,3,5,8,32,35,9,8,299,338
135,48,3,3,9,4,-64,31,5,9,235,369
135,49,2,4,4,9,22,-55,7,4,257,314
135,50,3,3,8,5,-65,32,2,6,192,346
135,51,2,4,6,7,24,43,6,9,216,389
135,52,3,4,6,7,33,-57,9,2,249,332
135,53,4,2,8,5,-56,23,3,5,193,355
135,54,2,4,7,6,25,42,8,7,218,397
135,55,3,3,9,4,-64,31,4,8,154,428
135,56,4,3,6,7,42,-66,6,2,196,362
135,57,3,3,5,8,32,35,8,7,228,397
135,58,2,5,4,9,-78,-46,0,1,150,351
135,59,2,5,5,8,23,53,3,4,173,404
135,60,3,3,7,6,34,33,7,7,207,437
135,61,5,2,7,6,52,-76,9,1,259,361
135,62,2,5,7,6,-75,51,4,2,184,412
135,63,3,3,4,9,31,36,5,8,215,448
135,64,3,3,5,8,32,-65,7,3,247,383
135,65,3,4,7,6,-66,42,1,5,181,425
135,66,4,3,5,8,41,-65,2,0,222,360
135,67,3,4,6,7,33,43,5,3,255,403
135,68,5,2,7,6,52,24,7,7,307,427
135,69,3,3,9,4,-64,31,3,8,243,458
135,70,4,3,6,7,42,-66,5,2,285,392
135,71,4,3,5,8,41,35,6,7,326,427
135,72,2,4,6,7,-76,-57,0,0,250,370
135,73,4,2,6,7,42,25,2,5,292,395
135,74,3,3,5,8,32,-65,4,0,324,330
135,75,4,3,8,5,44,32,8,2,368,362
135,76,5,2,10,3,-45,21,3,3,323,383
135,77,3,3,4,9,31,36,4,9,354,419
135,78,3,4,4,9,31,-55,5,4,385,364
135,79,3,4,6,7,33,43,8,7,418,407
135,80,3,4,4,9,31,-55,9,2,449,352
135,81,2,4,4,9,-78,45,1,7,371,397
135,82,2,4,6,7,24,-57,5,0,395,340
135,83,3,4,6,7,33,43,8,3,428,383
135,84,2,4,4,9,-78,45,0,8,350,428
135,85,4,3,9,4,45,31,5,9,395,459
135,86,2,5,5,8,23,-47,8,2,418,412
135,87,4,3,8,5,-56,32,2,4,362,444
135,88,4,2,7,6,43,24,5,8,405,468
135,89,2,4,5,8,23,-56,8,2,428,412
135,90,5,3,8,5,-47,32,1,4,381,444
135,91,4,3,8,5,44,32,5,6,425,476
135,92,3,3,7,6,34,33,9,9,459,509
136,1,4,3,8,5,44,32,4,2,44,32
136,2,4,2,7,6,43,24,7,6,87,56
136,3,5,2,10,3,-45,21,2,7,42,77
136,4,5,2,8,5,53,-77,5,0,95,0
136,5,3,3,6,7,33,34,8,4,128,34
136,6,3,3,9,4,-64,31,4,5,64,65
136,7,4,4,5,8,41,44,5,9,105,109
136,8,4,3,9,4,-55,-69,0,0,50,40
136,9,2,4,4,9,22,45,2,5,72,85
136,10,4,3,5,8,41,-65,3,0,113,20
136,11,4,3,8,5,44,32,7,2,157,52
136,12,3,4,6,7,-67,43,0,5,90,95
136,13,4,2,9,4,45,22,5,7,135,117
136,14,3,4,6,7,33,-57,8,0,168,60
136,15,3,4,6,7,-67,43,1,3,101,103
136,16,4,3,7,6,43,33,4,6,144,136
136,17,4,2,7,6,43,-76,7,0,187,60
136,18,3,3,7,6,-66,33,1,3,121,93
136,19,4,3,9,4,45,31,6,4,166,124
136,20,2,5,3,10,21,55,7,9,187,179
136,21,4,2,7,6,-57,-76,0,3,130,103
136,22,3,3,6,7,33,34,3,7,163,137
136,23,2,5,5,8,23,-47,6,0,186,90
136,24,3,4,5,8,32,44,8,4,218,134
136,25,2,4,5,8,-77,44,1,8,141,178
136,26,3,4,6,7,33,-57,4,1,174,121
136,27,2,5,4,9,22,54,6,5,196,175
136,28,6,2,9,4,63,22,9,7,259,197
136,29,2,4,3,10,-79,-54,0,3,180,143
136,30,3,3,6,7,33,34,3,7,213,177
136,31,3,4,5,8,32,-56,5,1,245,121
136,32,2,4,3,10,21,46,6,7,266,167
136,33,2,4,6,7,-76,-57,0,0,190,110
136,34,4,3,6,7,42,34,2,4,232,144
136,35,4,3,7,6,43,33,5,7,275,177
136,36,3,3,8,5,-65,32,0,9,210,209
136,37,5,2,10,3,55,-79,5,0,265,130
136,38,4,3,8,5,44,32,9,2,309,162
136,39,3,4,7,6,-66,42,3,4,243,204
136,40,4,3,7,6,43,33,6,7,286,237
136,41,4,3,7,6,43,-67,9,0,329,170
136,42,4,2,6,7,-58,25,1,5,271,195
136,43,4,3,8,5,44,32,5,7,315,227
136,44,4,2,10,3,-54,21,1,8,261,248
136,45,4,2,10,3,46,21,7,9,307,269
136,46,4,2,8,5,-56,-77,1,2,251,192
136,47,2,4,6,7,24,43,5,5,275,235
136,48,4,2,9,4,-55,22,0,7,220,257
136,49,4,3,7,6,43,-67,3,0,263,190
136,50,2,4,5,8,23,44,6,4,286,234
136,51,4,2,8,5,-56,23,0,7,230,257
136,52,4,3,4,9,40,-64,0,3,270,193
136,53,2,5,5,8,23,53,3,6,293,246
136,54,5,2,8,5,53,23,6,9,346,269
136,55,3,4,3,10,30,-54,6,5,376,215
136,56,5,3,9,4,-46,31,0,6,330,246
136,57,4,3,7,6,43,33,3,9,373,279
136,58,4,2,6,7,42,-75,5,4,415,204
136,59,4,4,8,5,44,41,9,5,459,245
136,60,4,3,5,8,-59,-65,0,0,400,180
136,61,2,4,4,9,22,45,2,5,422,225
136,62,4,2,7,6,43,24,5,9,465,249
136,63,3,4,7,6,34,-58,9,1,499,191
136,64,4,3,7,6,-57,33,2,4,442,224
136,65,2,5,2,11,20,-44,2,0,462,180
136,66,4,3,8,5,44,32,6,2,506,212
137,1,3,3,5,8,32,35,2,5,32,35
137,2,4,2,7,6,43,24,5,9,75,59
137,3,6,2,8,5,62,-77,7,2,137,-18
137,4,4,2,9,4,-55,22,2,4,82,4
137,5,2,4,6,7,24,43,6,7,106,47
137,6,3,4,6,7,33,-57,9,0,139,-10
137,7,3,3,8,5,-65,32,4,2,74,22
137,8,4,3,9,4,45,31,9,3,119,53
137,9,2,4,4,9,-78,45,1,8,41,98
137,10,2,4,3,10,21,-54,2,4,62,44
137,11,3,3,5,8,32,35,4,9,94,79
137,12,2,5,3,10,21,-45,5,4,115,34
137,13,5,2,9,4,54,22,9,6,169,56
137,14,5,2,8,5,-47,23,2,9,122,79
137,15,4,2,7,6,43,-76,5,3,165,3
137,16,3,4,6,7,33,43,8,6,198,46
137,17,4,3,7,6,-57,33,1,9,141,79
137,18,3,3,7,6,34,-67,5,2,175,12
137,19,3,3,6,7,33,34,8,6,208,46
137,20,4,3,6,7,-58,-66,0,0,150,-20
137,21,3,4,6,7,33,43,3,3,183,23
137,22,3,3,7,6,34,33,7,6,217,56
137,23,4,2,7,6,-57,-76,0,0,160,-20
137,24,4,2,5,8,41,26,1,6,201,6
137,25,3,5,3,10,30,-45,1,1,231,-39
137,26,2,5,3,10,21,55,2,6,252,16
137,27,4,3,9,4,45,31,7,7,297,47
137,28,2,6,3,10,21,-36,8,1,318,11
137,29,4,3,6,7,-58,34,0,5,260,45
137,30,4,2,11,2,47,20,7,5,307,65
137,31,3,4,7,6,-66,42,1,7,241,107
137,32,5,2,9,4,54,22,5,9,295,129
137,33,3,4,4,9,31,-55,6,4,326,74
137,34,3,3,6,7,33,34,9,8,359,108
137,35,3,4,5,8,-68,-56,1,2,291,52
137,36,3,3,6,7,33,34,4,6,324,86
137,37,4,3,6,7,42,-66,6,0,366,20
137,38,2,5,6,7,-76,52,0,2,290,72
137,39,3,3,5,8,32,35,2,7,322,107
137,40,3,3,6,7,33,-66,5,1,355,41
137,41,2,6,3,10,21,64,6,5,376,105
137,42,3,4,4,9,31,-55,7,0,407,50
137,43,4,3,8,5,-56,32,1,2,351,82
137,44,3,4,8,5,35,41,6,3,386,123
137,45,5,2,6,7,51,25,7,8,437,148
137,46,3,3,6,7,-67,-66,0,2,370,82
137,47,4,2,11,2,47,20,7,2,417,102
137,48,2,4,7,6,-75,42,2,4,342,144
137,49,2,4,5,8,23,44,5,8,365,188
137,50,2,4,3,10,21,-54,6,4,386,134
137,51,3,3,5,8,32,35,8,9,418,169
137,52,2,5,4,9,-78,-46,0,3,340,123
137,53,4,2,9,4,45,22,5,5,385,145
137,54,5,2,9,4,54,22,9,7,439,167
137,55,5,2,8,5,-47,-77,2,0,392,90
137,56,2,4,4,9,22,45,4,5,414,135
137,57,4,2,6,7,42,-75,6,0,456,60
137,58,2,5,3,10,21,55,7,5,477,115
137,59,2,5,4,9,22,54,9,9,499,169
137,60,4,3,8,5,-56,-68,3,1,443,101
137,61,4,3,9,4,45,31,8,2,488,132
137,62,2,5,6,7,-76,52,2,4,412,184
137,63,4,3,9,4,45,31,7,5,457,215
137,64,2,4,3,10,21,-54,8,1,478,161
137,65,4,2,7,6,-57,24,1,5,421,185
137,66,3,3,7,6,34,33,5,8,455,218
137,67,3,3,6,7,33,-66,8,2,488,152
137,68,3,3,5,8,-68,35,0,7,420,187
137,69,4,3,10,3,46,30,6,7,466,217
137,70,3,4,5,8,32,-56,8,1,498,161
137,71,2,4,7,6,-75,42,3,3,423,203
137,72,2,4,5,8,23,44,6,7,446,247
137,73,3,3,5,8,32,-65,8,2,478,182
137,74,3,4,7,6,-66,42,2,4,412,224
137,75,5,2,10,3,55,21,7,5,467,245
137,76,5,2,9,4,-46,22,1,7,421,267
137,77,3,4,6,7,33,-57,4,0,454,210
137,78,4,2,8,5,44,23,8,3,498,233
137,79,2,5,4,9,-78,54,0,7,420,287
137,80,3,4,6,7,33,-57,3,0,453,230
137,81,3,4,7,6,34,42,7,2,487,272
137,82,4,3,4,9,40,36,7,8,527,308
138,1,4,3,7,6,43,33,3,3,43,33
138,2,4,3,10,3,46,30,9,3,89,63
138,3,2,5,4,9,-78,54,1,7,11,117
138,4,4,2,4,9,40,-73,1,4,51,44
138,5,2,4,4,9,22,45,3,9,73,89
138,6,4,3,8,5,44,-68,7,1,117,21
138,7,2,4,5,8,-77,44,0,5,40,65
138,8,5,3,8,5,53,32,3,7,93,97
138,9,2,6,3,10,21,-36,4,1,114,61
138,10,3,3,7,6,34,33,8,4,148,94
138,11,2,6,2,11,20,65,8,9,168,159
138,12,2,5,6,7,-76,-48,2,1,92,111
138,13,4,3,9,4,45,31,7,2,137,142
138,14,3,5,7,6,-66,51,1,3,71,193
138,15,5,2,10,3,55,21,6,4,126,214
138,16,3,4,4,9,31,45,7,9,157,259
138,17,3,3,3,10,30,-63,7,6,187,196
138,18,2,6,4,9,22,63,9,9,209,259
138,19,4,2,8,5,-56,-77,3,2,153,182
138,20,3,3,4,9,31,36,4,8,184,218
138,21,4,4,7,6,43,-58,7,0,227,160
138,22,5,2,11,2,-44,20,3,0,183,180
138,23,3,3,5,8,32,35,5,5,215,215
138,24,3,4,5,8,32,44,7,9,247,259
138,25,4,3,8,5,-56,-68,1,1,191,191
138,26,4,2,9,4,45,22,6,3,236,213
138,27,2,5,4,9,22,54,8,7,258,267
138,28,3,3,5,8,-68,-65,0,2,190,202
138,29,3,3,4,9,31,36,1,8,221,238
138,30,3,4,8,5,35,41,6,9,256,279
138,31,4,2,7,6,43,-76,9,3,299,203
138,32,4,3,9,4,-55,31,4,4,244,234
138,33,2,4,8,5,-74,41,0,5,170,275
138,34,4,3,9,4,45,31,5,6,215,306
138,35,3,3,9,4,-64,31,1,7,151,337
138,36,3,3,7,6,34,-67,5,0,185,270
138,37,3,4,5,8,32,44,7,4,217,314
138,38,2,5,5,8,-77,53,0,7,140,367
138,39,4,2,7,6,43,-76,3,1,183,291
138,40,2,5,4,9,22,54,5,5,205,345
138,41,4,2,10,3,-54,21,1,6,151,366
138,42,3,3,6,7,33,-66,4,0,184,300
138,43,3,4,5,8,32,44,6,4,216,344
138,44,3,4,8,5,-65,41,1,5,151,385
138,45,3,3,9,4,36,31,7,6,187,416
138,46,3,4,8,5,-65,41,2,7,122,457
138,47,2,4,5,8,23,-56,5,1,145,401
138,48,3,3,7,6,34,33,9,4,179,434
138,49,2,5,5,8,-77,53,2,7,102,487
138,50,3,3,7,6,34,-67,6,0,136,420
138,51,4,2,8,5,-56,23,0,3,80,443
138,52,3,4,9,4,36,40,6,3,116,483
138,53,2,5,7,6,-75,51,1,4,41,534
139,1,3,3,8,5,35,32,5,2,35,32
139,2,3,3,8,5,-65,32,0,4,-30,64
139,3,3,4,7,6,34,42,4,6,4,106
139,4,4,3,8,5,44,32,8,8,48,138
139,5,5,2,10,3,-45,21,3,9,3,159
139,6,2,4,6,7,24,-57,7,2,27,102
139,7,3,4,6,7,-67,43,0,5,-40,145
139,8,2,4,5,8,23,44,3,9,-17,189
139,9,4,2,7,6,43,-76,6,3,26,113
139,10,4,2,7,6,43,24,9,7,69,137
139,11,3,4,5,8,-68,-56,1,1,1,81
139,12,3,3,5,8,32,35,3,6,33,116
139,13,3,4,6,7,33,43,6,9,66,159
139,14,3,5,6,7,33,-48,9,1,99,111
139,15,5,2,9,4,-46,22,3,3,53,133
139,16,4,3,6,7,42,34,5,7,95,167
139,17,2,4,7,6,-75,42,0,9,20,209
139,18,3,3,8,5,35,-68,5,1,55,141
139,19,3,4,4,9,31,45,6,6,86,186
139,20,3,4,6,7,33,43,9,9,119,229
139,21,3,3,8,5,-65,-68,4,1,54,161
139,22,3,4,7,6,34,42,8,3,88,203
139,23,5,2,11,2,-44,20,4,3,44,223
139,24,3,4,7,6,34,42,8,5,78,265
139,25,2,5,6,7,-76,52,2,7,2,317
139,26,4,2,8,5,44,-77,6,0,46,240
139,27,2,5,6,7,-76,52,0,2,-30,292
139,28,2,4,6,7,24,43,4,5,-6,335
139,29,2,4,6,7,24,43,8,8,18,378
139,30,6,2,9,4,-37,-78,1,0,-19,300
139,31,3,4,7,6,34,42,5,2,15,342
139,32,4,2,8,5,44,23,9,5,59,365
139,33,2,4,5,8,-77,44,2,9,-18,409
139,34,3,3,7,6,34,-67,6,2,16,342
139,35,2,5,4,9,22,54,8,6,38,396
139,36,3,4,4,9,31,-55,9,1,69,341
139,37,5,2,10,3,-45,21,4,2,24,362
139,38,5,2,11,2,-44,20,0,2,-20,382
139,39,2,5,5,8,23,53,3,5,3,435
139,40,3,3,5,8,32,-65,5,0,35,370
139,41,3,3,7,6,34,33,9,3,69,403
139,42,4,3,6,7,-58,34,1,7,11,437
139,43,3,3,7,6,34,-67,5,0,45,370
139,44,4,2,4,9,40,27,5,7,85,397
139,45,3,3,8,5,-65,32,0,9,20,429
139,46,3,3,6,7,33,-66,3,3,53,363
139,47,2,4,7,6,25,42,8,5,78,405
139,48,4,2,9,4,-55,22,3,7,23,427
139,49,3,3,7,6,34,-67,7,0,57,360
139,50,4,2,8,5,-56,23,1,3,1,383
139,51,4,3,6,7,42,34,3,7,43,417
139,52,3,3,6,7,33,-66,6,1,76,351
139,53,2,4,7,6,-75,42,1,3,1,393
139,54,4,3,8,5,44,32,5,5,45,425
139,55,5,2,6,7,51,-75,6,0,96,350
139,56,4,2,7,6,43,24,9,4,139,374
139,57,2,5,4,9,-78,54,1,8,61,428
139,58,4,3,8,5,44,-68,5,0,105,360
139,59,5,2,10,3,-45,21,0,1,60,381
139,60,4,3,6,7,42,34,2,5,102,415
139,61,3,4,5,8,32,44,4,9,134,459
139,62,4,3,7,6,43,-67,7,2,177,392
139,63,3,4,7,6,-66,42,1,4,111,434
139,64,5,3,7,6,52,33,3,7,163,467
139,65,4,3,9,4,45,31,8,8,208,498
139,66,4,3,9,4,-55,31,3,9,153,529
140,1,3,4,4,9,31,45,1,5,31,45
140,2,3,4,6,7,33,43,4,8,64,88
140,3,4,3,7,6,43,-67,7,1,107,21
140,4,3,3,7,6,-66,33,1,4,41,54
140,5,3,4,7,6,34,42,5,6,75,96
140,6,2,4,7,6,-75,42,0,8,0,138
140,7,3,3,6,7,33,-66,3,2,33,72
140,8,4,4,8,5,44,41,7,3,77,113
140,9,5,2,10,3,-45,21,2,4,32,134
140,10,3,3,6,7,33,34,5,8,65,168
140,11,2,5,4,9,22,-46,7,2,87,122
140,12,3,3,7,6,-66,33,1,5,21,155
140,13,3,4,5,8,32,44,3,9,53,199
140,14,3,4,6,7,33,-57,6,2,86,142
140,15,3,4,6,7,33,43,9,5,119,185
140,16,3,3,6,7,-67,34,2,9,52,219
140,17,4,3,8,5,44,-68,6,1,96,151
140,18,3,4,5,8,32,44,8,5,128,195
140,19,3,3,7,6,-66,33,2,8,62,228
140,20,4,3,4,9,40,-64,2,4,102,164
140,21,4,3,4,9,40,-64,2,0,142,100
140,22,4,2,6,7,42,25,4,5,184,125
140,23,2,4,6,7,24,43,8,8,208,168
140,24,4,3,9,4,-55,31,3,9,153,199
140,25,2,6,4,9,22,-37,5,2,175,162
140,26,3,4,6,7,33,43,8,5,208,205
140,27,4,4,6,7,-58,43,0,8,150,248
140,28,4,3,7,6,43,-67,3,1,193,181
140,29,2,4,7,6,25,42,8,3,218,223
140,30,3,3,9,4,-64,31,4,4,154,254
140,31,4,3,8,5,44,32,8,6,198,286
140,32,3,3,5,8,-68,-65,0,1,130,221
140,33,4,2,11,2,47,20,7,1,177,241
140,34,4,3,6,7,42,34,9,5,219,275
140,35,4,3,5,8,-59,-65,0,0,160,210
140,36,2,5,4,9,22,54,2,4,182,264
140,37,2,5,4,9,22,54,4,8,204,318
140,38,3,3,8,5,35,-68,9,0,239,250
140,39,4,2,5,8,-59,26,0,6,180,276
140,40,3,3,5,8,32,-65,2,1,212,211
140,41,4,4,6,7,42,43,4,4,254,254
140,42,3,4,5,8,32,44,6,8,286,298
140,43,2,4,5,8,23,-56,9,2,309,242
140,44,4,3,8,5,-56,32,3,4,253,274
140,45,3,4,6,7,33,43,6,7,286,317
140,46,3,4,5,8,32,-56,8,1,318,261
140,47,3,4,6,7,-67,43,1,4,251,304
140,48,3,4,8,5,35,41,6,5,286,345
140,49,3,4,5,8,32,44,8,9,318,389
140,50,3,4,8,5,-65,-59,3,0,253,330
140,51,4,3,6,7,42,34,5,4,295,364
140,52,3,3,4,9,31,-64,6,0,326,300
140,53,3,4,5,8,32,44,8,4,358,344
140,54,5,2,10,3,-45,21,3,5,313,365
140,55,3,3,7,6,34,33,7,8,347,398
140,56,4,3,6,7,42,-66,9,2,389,332
140,57,3,3,6,7,-67,34,2,6,322,366
140,58,4,3,6,7,42,-66,4,0,364,300
140,59,4,2,8,5,44,23,8,3,408,323
140,60,4,2,7,6,-57,24,1,7,351,347
140,61,2,4,4,9,22,-55,3,2,373,292
140,62,3,4,5,8,32,44,5,6,405,336
140,63,3,4,4,9,31,-55,6,1,436,281
140,64,4,3,8,5,-56,32,0,3,380,313
140,65,4,3,8,5,44,32,4,5,424,345
140,66,4,3,8,5,44,32,8,7,468,377
140,67,3,3,9,4,-64,31,4,8,404,408
140,68,4,3,7,6,43,-67,7,1,447,341
140,69,2,5,5,8,-77,53,0,4,370,394
140,70,3,3,7,6,34,33,4,7,404,427
140,71,5,2,9,4,54,22,8,9,458,449
140,72,4,3,7,6,-57,-67,1,2,401,382
140,73,5,2,7,6,52,24,3,6,453,406
140,74,5,2,10,3,55,21,8,7,508,427
141,1,2,5,5,8,23,53,3,3,23,53
141,2,5,2,7,6,52,24,5,7,75,77
141,3,3,3,7,6,34,-67,9,0,109,10
141,4,3,3,6,7,-67,34,2,4,42,44
141,5,2,4,5,8,23,44,5,8,65,88
141,6,3,4,5,8,32,-56,7,2,97,32
141,7,4,3,8,5,-56,32,1,4,41,64
141,8,4,2,7,6,43,24,4,8,84,88
141,9,3,4,8,5,35,41,9,9,119,129
141,10,4,3,7,6,-57,-67,2,2,62,62
141,11,3,4,4,9,31,45,3,7,93,107
141,12,4,2,7,6,43,-76,6,1,136,31
141,13,2,4,5,8,23,44,9,5,159,75
141,14,2,4,6,7,-76,43,3,8,83,118
141,15,2,4,6,7,24,-57,7,1,107,61
141,16,5,2,9,4,-46,22,1,3,61,83
141,17,3,3,9,4,36,31,7,4,97,114
141,18,2,4,4,9,22,45,9,9,119,159
141,19,2,5,4,9,-78,-46,1,3,41,113
141,20,3,4,4,9,31,45,2,8,72,158
141,21,3,3,6,7,33,-66,5,2,105,92
141,22,4,3,7,6,43,33,8,5,148,125
141,23,4,2,8,5,-56,23,2,8,92,148
141,24,3,3,4,9,31,-64,3,4,123,84
141,25,4,4,8,5,44,41,7,5,167,125
141,26,3,4,8,5,-65,41,2,6,102,166
141,27,4,3,7,6,43,33,5,9,145,199
141,28,4,3,8,5,44,-68,9,1,189,131
141,29,3,3,8,5,-65,32,4,3,124,163
141,30,3,3,4,9,31,36,5,9,155,199
141,31,2,5,3,10,21,-45,6,4,176,154
141,32,3,4,8,5,-65,41,1,5,111,195
141,33,3,4,7,6,34,42,5,7,145,237
141,34,4,2,7,6,43,-76,8,1,188,161
141,35,3,4,8,5,-65,41,3,2,123,202
141,36,3,3,3,10,30,37,3,9,153,239
141,37,2,4,4,9,22,-55,5,4,175,184
141,38,3,3,5,8,32,35,7,9,207,219
141,39,4,3,7,6,-57,-67,0,2,150,152
141,40,3,3,7,6,34,33,4,5,184,185
141,41,3,4,7,6,34,42,8,7,218,227
141,42,3,4,3,10,30,-54,8,3,248,173
141,43,3,3,6,7,-67,34,1,7,181,207
141,44,3,3,6,7,33,-66,4,1,214,141
141,45,5,2,8,5,53,23,7,4,267,164
141,46,5,2,10,3,-45,21,2,5,222,185
141,47,3,4,7,6,34,42,6,7,256,227
141,48,2,4,3,10,21,-54,7,3,277,173
141,49,4,3,7,6,-57,33,0,6,220,206
141,50,4,2,8,5,44,23,4,9,264,229
141,51,4,3,5,8,41,-65,5,4,305,164
141,52,4,3,5,8,41,35,6,9,346,199
141,53,3,3,7,6,-66,-67,0,2,280,132
141,54,3,4,6,7,33,43,3,5,313,175
141,55,4,3,10,3,46,30,9,5,359,205
141,56,3,3,7,6,-66,33,3,8,293,238
141,57,3,4,7,6,34,-58,7,0,327,180
141,58,2,5,4,9,22,54,9,4,349,234
141,59,2,5,5,8,-77,53,2,7,272,287
141,60,2,5,4,9,22,-46,4,1,294,241
141,61,2,5,3,10,21,55,5,6,315,296
141,62,3,3,8,5,-65,32,0,8,250,328
141,63,3,3,4,9,31,-64,1,4,281,264
141,64,3,3,6,7,33,34,4,8,314,298
141,65,4,2,8,5,44,-77,8,1,358,221
141,66,3,3,5,8,-68,35,0,6,290,256
141,67,3,4,6,7,33,43,3,9,323,299
141,68,3,4,6,7,33,-57,6,2,356,242
141,69,3,3,6,7,33,34,9,6,389,276
141,70,2,5,4,9,-78,-46,1,0,311,230
141,71,2,4,6,7,24,43,5,3,335,273
141,72,3,4,7,6,34,42,9,5,369,315
141,73,5,2,10,3,-45,21,4,6,324,336
141,74,3,3,9,4,-64,31,0,7,260,367
141,75,4,2,7,6,43,-76,3,1,303,291
141,76,3,3,5,8,32,35,5,6,335,326
141,77,3,3,7,6,34,33,9,9,369,359
141,78,2,4,4,9,-78,-55,1,4,291,304
141,79,4,2,7,6,43,24,4,8,334,328
141,80,2,4,5,8,23,-56,7,2,357,272
141,81,2,5,4,9,22,54,9,6,379,326
141,82,6,2,9,4,-37,22,2,8,342,348
141,83,4,2,9,4,45,-78,7,0,387,270
141,84,5,2,7,6,52,24,9,4,439,294
141,85,3,4,4,9,-69,45,0,9,370,339
141,86,4,3,6,7,42,-66,2,3,412,273
141,87,5,2,10,3,55,21,7,4,467,294
141,88,3,3,6,7,-67,34,0,8,400,328
141,89,2,4,4,9,22,-55,2,3,422,273
141,90,4,2,11,2,47,20,9,3,469,293
141,91,3,4,5,8,-68,44,1,7,401,337
141,92,2,4,2,11,20,-53,1,4,421,284
141,93,4,2,8,5,44,23,5,7,465,307
141,94,4,3,8,5,44,32,9,9,509,339
142,1,4,2,10,3,46,21,6,1,46,21
142,2,4,2,7,6,43,24,9,5,89,45
142,3,4,2,9,4,-55,22,4,7,34,67
142,4,3,4,3,10,30,-54,4,3,64,13
142,5,4,2,7,6,43,24,7,7,107,37
142,6,5,2,10,3,-45,21,2,8,62,58
142,7,4,2,6,7,42,-75,4,3,104,-17
142,8,2,5,7,6,25,51,9,4,129,34
142,9,3,3,7,6,-66,33,3,7,63,67
142,10,2,4,3,10,21,-54,4,3,84,13
142,11,5,2,7,6,52,24,6,7,136,37
142,12,3,3,7,6,-66,-67,0,0,70,-30
142,13,3,3,8,5,35,32,5,2,105,2
142,14,5,2,9,4,54,22,9,4,159,24
142,15,3,3,7,6,-66,33,3,7,93,57
142,16,6,2,10,3,64,21,7,8,157,78
142,17,4,2,6,7,42,-75,9,3,199,3
142,18,4,3,7,6,-57,33,2,6,142,36
142,19,4,2,8,5,44,23,6,9,186,59
142,20,2,4,4,9,22,-55,8,4,208,4
142,21,4,3,6,7,-58,34,0,8,150,38
142,22,4,3,7,6,43,-67,3,1,193,-29
142,23,3,5,5,8,32,53,5,4,225,24
142,24,3,3,6,7,33,34,8,8,258,58
142,25,2,4,4,9,-78,-55,0,3,180,3
142,26,4,2,5,8,41,26,1,9,221,29
142,27,4,3,5,8,41,-65,2,4,262,-36
142,28,3,3,8,5,35,32,7,6,297,-4
142,29,3,3,7,6,-66,33,1,9,231,29
142,30,3,4,7,6,34,-58,5,1,265,-29
142,31,3,3,8,5,-65,32,0,3,200,3
142,32,4,3,9,4,45,31,5,4,245,34
142,33,3,4,5,8,32,44,7,8,277,78
142,34,3,4,5,8,32,-56,9,2,309,22
142,35,3,4,5,8,-68,44,1,6,241,66
142,36,5,2,7,6,52,-76,3,0,293,-10
142,37,4,2,7,6,43,24,6,4,336,14
142,38,3,3,7,6,-66,33,0,7,270,47
142,39,4,4,7,6,43,42,3,9,313,89
142,40,2,5,5,8,23,-47,6,2,336,42
142,41,2,5,6,7,-76,52,0,4,260,94
142,42,3,3,7,6,34,33,4,7,294,127
142,43,3,4,6,7,33,-57,7,0,327,70
142,44,4,2,5,8,41,26,8,6,368,96
142,45,5,2,11,2,-44,20,4,6,324,116
142,46,3,3,7,6,34,33,8,9,358,149
142,47,4,3,7,6,-57,-67,1,2,301,82
142,48,2,4,6,7,24,43,5,5,325,125
142,49,5,2,10,3,-45,21,0,6,280,146
142,50,3,3,6,7,33,-66,3,0,313,80
142,51,4,3,5,8,41,35,4,5,354,115
142,52,2,5,6,7,24,52,8,7,378,167
142,53,3,3,7,6,-66,-67,2,0,312,100
142,54,4,2,9,4,45,22,7,2,357,122
142,55,3,3,6,7,-67,34,0,6,290,156
142,56,3,3,5,8,32,-65,2,1,322,91
142,57,3,3,8,5,35,32,7,3,357,123
142,58,4,2,6,7,42,25,9,8,399,148
142,59,5,2,8,5,-47,-77,2,1,352,71
142,60,6,2,11,2,65,20,7,1,417,91
142,61,3,3,5,8,32,35,9,6,449,126
142,62,3,3,5,8,-68,-65,1,1,381,61
142,63,3,3,8,5,35,32,6,3,416,93
142,64,4,3,9,4,-55,31,1,4,361,124
142,65,4,3,8,5,44,32,5,6,405,156
142,66,2,6,3,10,21,-36,6,0,426,120
142,67,5,2,10,3,-45,21,1,1,381,141
142,68,4,2,6,7,42,25,3,6,423,166
142,69,4,3,8,5,44,32,7,8,467,198
142,70,4,3,6,7,42,-66,9,2,509,132
143,1,4,3,10,3,46,30,6,0,46,30
143,2,4,2,8,5,-56,23,0,3,-10,53
143,3,2,4,7,6,25,42,5,5,15,95
143,4,4,2,6,7,42,-75,7,0,57,20
143,5,3,4,8,5,-65,41,2,1,-8,61
143,6,3,3,3,10,30,37,2,8,22,98
143,7,2,4,6,7,24,-57,6,1,46,41
143,8,3,3,6,7,33,34,9,5,79,75
143,9,3,3,4,9,-69,-64,0,1,10,11
143,10,4,2,8,5,44,23,4,4,54,34
143,11,3,4,7,6,34,42,8,6,88,76
143,12,4,3,7,6,-57,33,1,9,31,109
143,13,3,3,7,6,34,-67,5,2,65,42
143,14,2,5,3,10,21,55,6,7,86,97
143,15,3,4,6,7,33,-57,9,0,119,40
143,16,3,4,3,10,30,46,9,6,149,86
143,17,4,4,6,7,-58,43,1,9,91,129
143,18,2,4,5,8,23,-56,4,3,114,73
143,19,5,2,9,4,54,22,8,5,168,95
143,20,5,2,8,5,-47,23,1,8,121,118
143,21,5,2,8,5,53,-77,4,1,174,41
143,22,3,3,6,7,33,34,7,5,207,75
143,23,4,3,4,9,40,-64,7,1,247,11
143,24,2,4,6,7,-76,43,1,4,171,54
143,25,4,3,7,6,43,33,4,7,214,87
143,26,5,2,9,4,54,22,8,9,268,109
143,27,2,5,4,9,-78,-46,0,3,190,63
143,28,4,3,5,8,41,35,1,8,231,98
143,29,3,4,6,7,33,-57,4,1,264,41
143,30,3,3,8,5,35,32,9,3,299,73
143,31,5,2,10,3,-45,21,4,4,254,94
143,32,3,4,5,8,32,44,6,8,286,138
143,33,6,2,9,4,63,-78,9,0,349,60
143,34,3,4,5,8,-68,44,1,4,281,104
143,35,4,2,8,5,44,23,5,7,325,127
143,36,4,3,7,6,43,-67,8,0,368,60
143,37,4,4,8,5,-56,41,2,1,312,101
143,38,4,2,10,3,46,21,8,2,358,122
143,39,4,3,7,6,-57,33,1,5,301,155
143,40,5,2,8,5,53,23,4,8,354,178
143,41,4,3,8,5,44,-68,8,0,398,110
143,42,3,3,7,6,-66,33,2,3,332,143
143,43,4,2,6,7,42,25,4,8,374,168
143,44,4,2,8,5,44,-77,8,1,418,91
143,45,4,3,9,4,-55,31,3,2,363,122
143,46,2,4,6,7,24,43,7,5,387,165
143,47,4,3,10,3,-54,30,3,5,333,195
143,48,2,6,2,11,20,-35,3,0,353,160
143,49,5,2,10,3,55,21,8,1,408,181
143,50,2,4,5,8,-77,44,1,5,331,225
143,51,3,3,5,8,32,-65,3,0,363,160
143,52,3,4,4,9,31,45,4,5,394,205
143,53,4,3,7,6,43,33,7,8,437,238
143,54,3,3,7,6,-66,-67,1,1,371,171
143,55,2,5,4,9,22,54,3,5,393,225
143,56,3,5,3,10,30,-45,3,0,423,180
143,57,4,2,7,6,43,24,6,4,466,204
143,58,4,2,5,8,41,-74,7,0,507,130
144,1,4,3,8,5,44,32,4,2,44,32
144,2,4,3,6,7,42,34,6,6,86,66
144,3,3,3,6,7,33,-66,9,0,119,0
144,4,2,4,5,8,-77,44,2,4,42,44
144,5,2,4,3,10,21,-54,3,0,63,-10
144,6,5,2,11,2,56,20,9,0,119,10
144,7,3,4,7,6,-66,42,3,2,53,52
144,8,4,3,7,6,43,33,6,5,96,85
144,9,2,4,6,7,-76,43,0,8,20,128
144,10,5,2,8,5,53,-77,3,1,73,51
144,11,4,2,10,3,46,21,9,2,119,72
144,12,3,3,6,7,-67,34,2,6,52,106
144,13,4,2,8,5,44,23,6,9,96,129
144,14,4,3,7,6,43,-67,9,2,139,62
144,15,4,3,8,5,-56,32,3,4,83,94
144,16,5,2,8,5,53,23,6,7,136,117
144,17,4,3,4,9,40,-64,6,3,176,53
144,18,3,3,7,6,-66,33,0,6,110,86
144,19,5,2,8,5,53,23,3,9,163,109
144,20,5,2,10,3,55,-79,8,0,218,30
144,21,2,4,7,6,-75,42,3,2,143,72
144,22,4,3,8,5,44,32,7,4,187,104
144,23,5,2,8,5,-47,23,0,7,140,127
144,24,5,2,8,5,53,-77,3,0,193,50
144,25,5,2,9,4,54,22,7,2,247,72
144,26,4,2,10,3,-54,21,3,3,193,93
144,27,4,3,7,6,43,33,6,6,236,126
144,28,5,2,11,2,-44,20,2,6,192,146
144,29,4,3,7,6,43,33,5,9,235,179
144,30,2,4,3,10,21,-54,6,5,256,125
144,31,5,2,9,4,-46,22,0,7,210,147
144,32,3,4,6,7,33,-57,3,0,243,90
144,33,3,3,8,5,35,32,8,2,278,122
144,34,3,3,9,4,-64,31,4,3,214,153
144,35,2,4,6,7,24,43,8,6,238,196
144,36,3,4,6,7,-67,43,1,9,171,239
144,37,5,2,9,4,54,-78,5,1,225,161
144,38,4,2,9,4,-55,22,0,3,170,183
144,39,5,2,10,3,55,21,5,4,225,204
144,40,3,4,6,7,33,43,8,7,258,247
144,41,2,4,4,9,-78,-55,0,2,180,192
144,42,5,2,7,6,52,24,2,6,232,216
144,43,3,3,8,5,35,32,7,8,267,248
144,44,4,2,10,3,-54,21,3,9,213,269
144,45,2,6,4,9,22,-37,5,2,235,232
144,46,2,5,5,8,23,53,8,5,258,285
144,47,3,4,6,7,-67,43,1,8,191,328
144,48,3,3,7,6,34,-67,5,1,225,261
144,49,3,4,9,4,-64,40,1,1,161,301
144,50,3,4,7,6,34,42,5,3,195,343
144,51,3,4,6,7,33,43,8,6,228,386
144,52,4,3,7,6,-57,33,1,9,171,419
144,53,3,3,8,5,35,-68,6,1,206,351
144,54,4,2,8,5,-56,23,0,4,150,374
144,55,3,3,9,4,36,31,6,5,186,405
144,56,3,3,5,8,32,-65,8,0,218,340
144,57,2,5,3,10,21,55,9,5,239,395
144,58,5,2,11,2,-44,20,5,5,195,415
144,59,3,3,7,6,34,33,9,8,229,448
144,60,3,3,8,5,-65,-68,4,0,164,380
144,61,5,2,9,4,54,22,8,2,218,402
144,62,3,3,8,5,-65,32,3,4,153,434
144,63,2,4,4,9,22,45,5,9,175,479
144,64,4,2,9,4,-55,-78,0,1,120,401
144,65,2,4,5,8,23,44,3,5,143,445
144,66,3,4,5,8,32,44,5,9,175,489
144,67,6,2,10,3,64,-79,9,0,239,410
144,68,2,5,4,9,-78,54,1,4,161,464
144,69,5,2,8,5,53,23,4,7,214,487
144,70,3,4,7,6,34,42,8,9,248,529
145,1,3,3,8,5,35,32,5,2,35,32
145,2,3,3,6,7,33,34,8,6,68,66
145,3,3,4,6,7,-67,43,1,9,1,109
145,4,3,4,6,7,33,-57,4,2,34,52
145,5,3,4,8,5,35,41,9,3,69,93
145,6,4,3,5,8,-59,35,0,8,10,128
145,7,2,5,2,11,20,-44,0,4,30,84
145,8,4,2,8,5,44,23,4,7,74,107
145,9,4,4,6,7,42,-57,6,0,116,50
145,10,3,4,5,8,32,44,8,4,148,94
145,11,3,4,5,8,-68,44,0,8,80,138
145,12,2,4,4,9,22,-55,2,3,102,83
145,13,5,2,8,5,53,23,5,6,155,106
145,14,4,2,11,2,-53,20,2,6,102,126
145,15,3,3,4,9,31,-64,3,2,133,62
145,16,5,2,11,2,56,20,9,2,189,82
145,17,4,3,5,8,-59,35,0,7,130,117
145,18,3,3,8,5,35,32,5,9,165,149
145,19,4,3,6,7,42,-66,7,3,207,83
145,20,3,4,4,9,31,45,8,8,238,128
145,21,3,3,5,8,-68,-65,0,3,170,63
145,22,2,5,5,8,23,53,3,6,193,116
145,23,3,4,3,10,30,-54,3,2,223,62
145,24,3,5,5,8,32,53,5,5,255,115
145,25,3,3,6,7,33,34,8,9,288,149
145,26,3,4,8,5,-65,-59,3,0,223,90
145,27,2,5,4,9,22,54,5,4,245,144
145,28,5,2,7,6,52,24,7,8,297,168
145,29,4,3,6,7,42,-66,9,2,339,102
145,30,3,4,3,10,30,46,9,8,369,148
145,31,4,3,4,9,40,-64,9,4,409,84
145,32,5,2,7,6,-48,24,1,8,361,108
145,33,3,4,5,8,32,-56,3,2,393,52
145,34,4,2,7,6,43,24,6,6,436,76
145,35,2,5,3,10,21,-45,7,1,457,31
145,36,4,2,7,6,-57,24,0,5,400,55
145,37,4,2,10,3,46,21,6,6,446,76
145,38,3,3,4,9,31,-64,7,2,477,12
145,39,4,3,7,6,-57,33,0,5,420,45
145,40,3,4,4,9,31,-55,1,0,451,-10
145,41,3,4,5,8,32,44,3,4,483,34
145,42,5,2,10,3,55,21,8,5,538,55
146,1,2,4,4,9,22,45,2,5,22,45
146,2,4,3,6,7,42,34,4,9,64,79
146,3,2,4,5,8,23,-56,7,3,87,23
146,4,4,3,6,7,42,34,9,7,129,57
146,5,2,5,4,9,-78,-46,1,1,51,11
146,6,4,2,6,7,42,25,3,6,93,36
146,7,3,3,5,8,32,-65,5,1,125,-29
146,8,4,3,9,4,-55,31,0,2,70,2
146,9,4,4,9,4,45,40,5,2,115,42
146,10,2,4,7,6,-75,42,0,4,40,84
146,11,3,3,7,6,34,33,4,7,74,117
146,12,3,4,6,7,33,-57,7,0,107,60
146,13,5,2,10,3,-45,21,2,1,62,81
146,14,5,2,9,4,54,22,6,3,116,103
146,15,3,3,5,8,32,35,8,8,148,138
146,16,4,2,10,3,-54,21,4,9,94,159
146,17,5,2,7,6,52,-76,6,3,146,83
146,18,2,4,4,9,22,45,8,8,168,128
146,19,5,2,9,4,-46,-78,2,0,122,50
146,20,3,4,7,6,34,42,6,2,156,92
146,21,4,3,9,4,-55,31,1,3,101,123
146,22,4,3,8,5,44,32,5,5,145,155
146,23,2,4,4,9,22,-55,7,0,167,100
146,24,6,2,9,4,-37,22,0,2,130,122
146,25,3,4,4,9,31,45,1,7,161,167
146,26,3,4,3,10,30,-54,1,3,191,113
146,27,4,3,8,5,44,32,5,5,235,145
146,28,4,4,8,5,44,41,9,6,279,186
146,29,2,4,7,6,-75,42,4,8,204,228
146,30,5,2,6,7,51,-75,5,3,255,153
146,31,3,4,3,10,30,46,5,9,285,199
146,32,3,3,7,6,34,-67,9,2,319,132
146,33,3,5,4,9,-69,54,0,6,250,186
146,34,3,3,8,5,35,32,5,8,285,218
146,35,4,3,7,6,43,-67,8,1,328,151
146,36,3,4,7,6,-66,42,2,3,262,193
146,37,4,3,6,7,42,34,4,7,304,227
146,38,3,4,5,8,32,-56,6,1,336,171
146,39,4,3,10,3,-54,30,2,1,282,201
146,40,4,3,7,6,43,33,5,4,325,234
146,41,4,3,9,4,-55,31,0,5,270,265
146,42,4,2,8,5,44,23,4,8,314,288
146,43,5,2,8,5,53,-77,7,1,367,211
146,44,4,2,6,7,42,25,9,6,409,236
146,45,4,3,10,3,-54,30,5,6,355,266
146,46,2,4,5,8,23,-56,8,0,378,210
146,47,5,2,10,3,-45,21,3,1,333,231
146,48,5,2,10,3,55,21,8,2,388,252
146,49,6,2,11,2,-35,20,3,2,353,272
146,50,4,2,8,5,44,23,7,5,397,295
146,51,2,5,3,10,21,-45,8,0,418,250
146,52,2,4,6,7,-76,43,2,3,342,293
146,53,3,3,7,6,34,33,6,6,376,326
146,54,3,4,9,4,-64,40,2,6,312,366
146,55,4,2,10,3,46,21,8,7,358,387
146,56,2,5,6,7,-76,52,2,9,282,439
146,57,2,5,3,10,21,-45,3,4,303,394
146,58,5,2,11,2,56,20,9,4,359,414
146,59,3,3,4,9,-69,-64,0,0,290,350
146,60,3,3,6,7,33,34,3,4,323,384
146,61,2,5,4,9,22,54,5,8,345,438
146,62,3,4,7,6,34,-58,9,0,379,380
146,63,3,3,4,9,-69,36,0,6,310,416
146,64,2,5,4,9,22,-46,2,0,332,370
146,65,3,3,5,8,32,35,4,5,364,405
146,66,6,2,11,2,65,20,9,5,429,425
146,67,3,3,6,7,-67,34,2,9,362,459
146,68,2,5,3,10,21,-45,3,4,383,414
146,69,3,3,8,5,35,32,8,6,418,446
146,70,2,5,4,9,-78,-46,0,0,340,400
146,71,4,3,8,5,44,32,4,2,384,432
146,72,2,5,3,10,21,55,5,7,405,487
146,73,5,2,9,4,54,22,9,9,459,509
147,1,4,3,6,7,42,34,2,4,42,34
147,2,2,6,5,8,23,62,5,6,65,96
147,3,3,3,8,5,-65,32,0,8,0,128
147,4,2,5,3,10,21,-45,1,3,21,83
147,5,3,3,4,9,31,36,2,9,52,119
147,6,5,2,8,5,53,-77,5,2,105,42
147,7,3,3,6,7,33,34,8,6,138,76
147,8,4,2,9,4,-55,22,3,8,83,98
147,9,2,4,5,8,23,-56,6,2,106,42
147,10,4,3,7,6,43,33,9,5,149,75
147,11,3,3,6,7,-67,34,2,9,82,109
147,12,2,5,4,9,22,-46,4,3,104,63
147,13,4,2,5,8,41,26,5,9,145,89
147,14,3,3,5,8,32,-65,7,4,177,24
147,15,3,3,7,6,-66,33,1,7,111,57
147,16,4,2,9,4,45,22,6,9,156,79
147,17,4,3,9,4,-55,-69,1,0,101,10
147,18,4,3,6,7,42,34,3,4,143,44
147,19,4,3,4,9,40,-64,3,0,183,-20
147,20,3,3,7,6,34,33,7,3,217,13
147,21,4,2,10,3,-54,21,3,4,163,34
147,22,5,2,8,5,53,23,6,7,216,57
147,23,2,5,4,9,22,-46,8,1,238,11
147,24,4,3,5,8,41,35,9,6,279,46
147,25,2,4,5,8,-77,-56,2,0,202,-10
147,26,5,2,10,3,55,21,7,1,257,11
147,27,3,4,6,7,-67,43,0,4,190,54
147,28,2,4,5,8,23,44,3,8,213,98
147,29,3,3,6,7,33,-66,6,2,246,32
147,30,4,3,8,5,-56,32,0,4,190,64
147,31,5,2,9,4,54,22,4,6,244,86
147,32,3,3,5,8,32,-65,6,1,276,21
147,33,5,3,9,4,-46,31,0,2,230,52
147,34,3,4,5,8,32,44,2,6,262,96
147,35,5,2,9,4,54,22,6,8,316,118
147,36,4,2,7,6,43,-76,9,2,359,42
147,37,3,3,10,3,-63,30,6,2,296,72
147,38,2,4,7,6,-75,42,1,4,221,114
147,39,3,4,6,7,33,43,4,7,254,157
147,40,2,4,7,6,25,42,9,9,279,199
147,41,4,3,7,6,-57,-67,2,2,222,132
147,42,4,3,8,5,44,32,6,4,266,164
147,43,2,5,3,10,21,55,7,9,287,219
147,44,3,3,4,9,31,-64,8,5,318,155
147,45,3,3,4,9,31,-64,9,1,349,91
147,46,3,3,9,4,-64,31,5,2,285,122
147,47,2,4,4,9,22,45,7,7,307,167
147,48,3,4,6,7,-67,-57,0,0,240,110
147,49,3,4,6,7,33,43,3,3,273,153
147,50,2,5,5,8,23,53,6,6,296,206
147,51,3,4,4,9,31,-55,7,1,327,151
147,52,4,3,5,8,41,35,8,6,368,186
147,53,5,2,11,2,-44,20,4,6,324,206
147,54,4,2,6,7,42,-75,6,1,366,131
147,55,3,3,7,6,-66,33,0,4,300,164
147,56,4,2,9,4,45,22,5,6,345,186
147,57,3,3,5,8,32,-65,7,1,377,121
147,58,4,2,9,4,-55,22,2,3,322,143
147,59,4,2,6,7,42,25,4,8,364,168
147,60,3,3,9,4,-64,31,0,9,300,199
147,61,2,4,6,7,24,-57,4,2,324,142
147,62,4,3,9,4,45,31,9,3,369,173
147,63,5,2,9,4,-46,22,3,5,323,195
147,64,3,3,8,5,35,32,8,7,358,227
147,65,2,4,5,8,-77,-56,1,1,281,171
147,66,4,3,6,7,42,34,3,5,323,205
147,67,4,3,7,6,43,33,6,8,366,238
147,68,5,2,7,6,52,-76,8,2,418,162
147,69,3,3,5,8,-68,35,0,7,350,197
147,70,3,3,6,7,33,-66,3,1,383,131
147,71,2,4,3,10,21,46,4,7,404,177
147,72,3,4,5,8,32,-56,6,1,436,121
147,73,3,4,8,5,-65,41,1,2,371,162
147,74,5,2,10,3,55,21,6,3,426,183
147,75,4,3,5,8,41,35,7,8,467,218
147,76,2,4,8,5,-74,41,3,9,393,259
147,77,3,3,6,7,33,-66,6,3,426,193
147,78,3,4,5,8,32,44,8,7,458,237
147,79,4,2,8,5,-56,-77,2,0,402,160
147,80,3,4,6,7,33,43,5,3,435,203
147,81,3,3,9,4,-64,31,1,4,371,234
147,82,3,3,7,6,34,33,5,7,405,267
147,83,6,2,8,5,62,-77,7,0,467,190
147,84,3,4,4,9,31,45,8,5,498,235
147,85,2,5,3,10,21,-45,9,0,519,190
148,1,2,4,4,9,22,45,2,5,22,45
148,2,6,2,9,4,63,22,5,7,85,67
148,3,3,4,6,7,33,-57,8,0,118,10
148,4,2,4,5,8,-77,44,1,4,41,54
148,5,2,5,7,6,25,51,6,5,66,105
148,6,4,3,9,4,-55,31,1,6,11,136
148,7,4,3,9,4,45,31,6,7,56,167
148,8,4,3,7,6,43,-67,9,0,99,100
148,9,4,3,9,4,-55,31,4,1,44,131
148,10,4,2,6,7,42,25,6,6,86,156
148,11,4,2,9,4,-55,22,1,8,31,178
148,12,3,4,6,7,33,-57,4,1,64,121
148,13,4,3,9,4,45,31,9,2,109,152
148,14,4,3,9,4,-55,31,4,3,54,183
148,15,2,4,2,11,20,-53,4,0,74,130
148,16,2,5,6,7,24,52,8,2,98,182
148,17,4,3,10,3,-54,30,4,2,44,212
148,18,3,4,7,6,34,42,8,4,78,254
148,19,3,4,5,8,-68,44,0,8,10,298
148,20,4,3,10,3,46,30,6,8,56,328
148,21,4,3,7,6,43,-67,9,1,99,261
148,22,4,3,8,5,-56,32,3,3,43,293
148,23,4,2,8,5,44,23,7,6,87,316
148,24,3,4,6,7,-67,43,0,9,20,359
148,25,4,3,9,4,45,-69,5,0,65,290
148,26,3,3,6,7,33,34,8,4,98,324
148,27,4,3,6,7,-58,34,0,8,40,358
148,28,5,2,10,3,55,21,5,9,95,379
148,29,6,2,11,2,-35,20,0,9,60,399
148,30,3,5,4,9,31,-46,1,3,91,353
148,31,3,4,5,8,32,44,3,7,123,397
148,32,4,3,7,6,43,-67,6,0,166,330
148,33,3,4,7,6,-66,42,0,2,100,372
148,34,2,4,6,7,24,43,4,5,124,415
148,35,3,4,4,9,31,-55,5,0,155,360
148,36,3,4,6,7,33,43,8,3,188,403
148,37,6,2,11,2,-35,20,3,3,153,423
148,38,2,5,3,10,21,55,4,8,174,478
148,39,3,3,6,7,33,-66,7,2,207,412
148,40,3,4,7,6,-66,42,1,4,141,454
148,41,2,4,5,8,23,44,4,8,164,498
148,42,5,2,9,4,54,-78,8,0,218,420
148,43,2,4,4,9,-78,45,0,5,140,465
148,44,3,3,10,3,37,30,7,5,177,495
148,45,2,5,5,8,-77,53,0,8,100,548
149,1,3,4,6,7,33,43,3,3,33,43
149,2,2,6,4,9,22,63,5,6,55,106
149,3,4,3,4,9,40,-64,5,2,95,42
149,4,3,4,5,8,32,44,7,6,127,86
149,5,3,3,4,9,31,-64,8,2,158,22
149,6,3,3,6,7,-67,34,1,6,91,56
149,7,3,3,6,7,33,-66,4,0,124,-10
149,8,2,5,3,10,21,55,5,5,145,45
149,9,3,3,7,6,34,33,9,8,179,78
149,10,2,5,5,8,-77,-47,2,1,102,31
149,11,2,5,2,11,20,56,2,7,122,87
149,12,6,2,7,6,61,-76,3,1,183,11
149,13,2,6,2,11,20,65,3,6,203,76
149,14,2,4,7,6,25,42,8,8,228,118
149,15,3,3,7,6,-66,-67,2,1,162,51
149,16,2,5,5,8,23,53,5,4,185,104
149,17,3,3,10,3,-63,30,2,4,122,134
149,18,4,2,8,5,44,23,6,7,166,157
149,19,4,3,7,6,43,-67,9,0,209,90
149,20,3,3,10,3,-63,30,6,0,146,120
149,21,6,2,11,2,-35,20,1,0,111,140
149,22,4,3,6,7,42,34,3,4,153,174
149,23,4,3,7,6,43,33,6,7,196,207
149,24,2,5,4,9,22,-46,8,1,218,161
149,25,3,3,9,4,-64,31,4,2,154,192
149,26,5,2,7,6,52,24,6,6,206,216
149,27,3,4,6,7,33,43,9,9,239,259
149,28,5,2,9,4,-46,-78,3,1,193,181
149,29,2,5,6,7,24,52,7,3,217,233
149,30,3,4,4,9,31,45,8,8,248,278
149,31,3,5,6,7,-67,-48,1,0,181,230
149,32,4,2,8,5,44,23,5,3,225,253
149,33,2,5,5,8,23,53,8,6,248,306
149,34,3,4,5,8,-68,-56,0,0,180,250
149,35,3,3,8,5,35,32,5,2,215,282
149,36,3,3,4,9,31,36,6,8,246,318
149,37,2,4,4,9,22,-55,8,3,268,263
149,38,2,5,5,8,-77,53,1,6,191,316
149,39,4,3,9,4,45,31,6,7,236,347
149,40,3,4,8,5,-65,41,1,8,171,388
149,41,2,4,5,8,23,-56,4,2,194,332
149,42,3,4,5,8,32,44,6,6,226,376
149,43,4,2,8,5,-56,23,0,9,170,399
149,44,3,4,5,8,32,-56,2,3,202,343
149,45,2,4,3,10,21,46,3,9,223,389
149,46,5,2,8,5,53,-77,6,2,276,312
149,47,5,2,6,7,51,25,7,7,327,337
149,48,4,2,7,6,-57,-76,0,1,270,261
149,49,4,2,8,5,44,23,4,4,314,284
149,50,2,5,6,7,24,52,8,6,338,336
149,51,6,2,11,2,-35,20,3,6,303,356
149,52,4,3,9,4,45,31,8,7,348,387
149,53,2,4,5,8,-77,-56,1,1,271,331
149,54,5,2,8,5,53,23,4,4,324,354
149,55,6,2,11,2,65,20,9,4,389,374
149,56,3,5,5,8,-68,53,1,7,321,427
149,57,3,3,6,7,33,-66,4,1,354,361
149,58,4,2,8,5,44,23,8,4,398,384
149,59,3,4,6,7,-67,43,1,7,331,427
149,60,5,2,8,5,53,-77,4,0,384,350
149,61,4,2,5,8,41,26,5,6,425,376
149,62,5,2,9,4,54,22,9,8,479,398
149,63,3,4,6,7,-67,-57,2,1,412,341
149,64,2,4,2,11,20,47,2,8,432,388
149,65,4,3,7,6,43,-67,5,1,475,321
149,66,2,4,4,9,22,45,7,6,497,366
149,67,2,4,4,9,22,-55,9,1,519,311
150,1,3,3,10,3,37,30,7,0,37,30
150,2,3,3,4,9,31,36,8,6,68,66
150,3,4,3,5,8,41,-65,9,1,109,1
150,4,4,2,8,5,-56,23,3,4,53,24
150,5,2,4,2,11,20,-53,3,1,73,-29
150,6,4,3,6,7,42,34,5,5,115,5
150,7,3,4,5,8,32,44,7,9,147,49
150,8,4,3,9,4,-55,-69,2,0,92,-20
150,9,2,5,4,9,22,54,4,4,114,34
150,10,5,2,9,4,54,22,8,6,168,56
150,11,3,3,6,7,-67,-66,1,0,101,-10
150,12,3,3,8,5,35,32,6,2,136,22
150,13,2,4,5,8,23,44,9,6,159,66
150,14,2,5,6,7,-76,52,3,8,83,118
150,15,3,5,4,9,31,-46,4,2,114,72
150,16,4,3,8,5,44,32,8,4,158,104
150,17,2,4,6,7,-76,43,2,7,82,147
150,18,4,2,10,3,46,21,8,8,128,168
150,19,2,5,4,9,-78,-46,0,2,50,122
150,20,5,2,9,4,54,22,4,4,104,144
150,21,4,2,7,6,43,24,7,8,147,168
150,22,4,3,6,7,42,-66,9,2,189,102
150,23,2,4,8,5,-74,41,5,3,115,143
150,24,3,4,6,7,33,43,8,6,148,186
150,25,4,2,6,7,-58,-75,0,1,90,111
150,26,4,2,9,4,45,22,5,3,135,133
150,27,4,3,7,6,43,33,8,6,178,166
150,28,2,6,5,8,-77,62,1,8,101,228
150,29,2,5,6,7,24,-48,5,0,125,180
150,30,3,3,9,4,-64,31,1,1,61,211
150,31,5,2,10,3,55,21,6,2,116,232
150,32,3,5,6,7,33,52,9,4,149,284
150,33,4,2,5,8,-59,-74,0,0,90,210
150,34,3,4,5,8,32,44,2,4,122,254
150,35,2,4,4,9,22,45,4,9,144,299
150,36,5,2,9,4,54,-78,8,1,198,221
150,37,4,2,8,5,-56,23,2,4,142,244
150,38,3,4,7,6,34,42,6,6,176,286
150,39,3,3,10,3,-63,30,3,6,113,316
150,40,4,2,6,7,42,-75,5,1,155,241
150,41,5,2,9,4,54,22,9,3,209,263
150,42,4,2,8,5,-56,23,3,6,153,286
150,43,2,4,5,8,23,-56,6,0,176,230
150,44,4,2,8,5,-56,23,0,3,120,253
150,45,4,3,6,7,42,34,2,7,162,287
150,46,4,3,9,4,45,31,7,8,207,318
150,47,5,2,8,5,-47,-77,0,1,160,241
150,48,3,3,8,5,35,32,5,3,195,273
150,49,4,2,9,4,-55,22,0,5,140,295
150,50,2,4,6,7,24,43,4,8,164,338
150,51,4,2,7,6,43,-76,7,2,207,262
150,52,4,2,9,4,-55,22,2,4,152,284
150,53,2,5,2,11,20,-44,2,0,172,240
150,54,4,2,9,4,45,22,7,2,217,262
150,55,2,5,4,9,22,54,9,6,239,316
150,56,4,3,8,5,-56,32,3,8,183,348
150,57,2,5,5,8,23,-47,6,1,206,301
150,58,4,3,7,6,43,33,9,4,249,334
150,59,4,2,6,7,-58,25,1,9,191,359
150,60,2,6,3,10,21,-36,2,3,212,323
150,61,2,5,2,11,20,56,2,9,232,379
150,62,4,2,10,3,46,-79,8,0,278,300
150,63,3,4,5,8,-68,44,0,4,210,344
150,64,5,2,8,5,53,23,3,7,263,367
150,65,4,2,9,4,45,22,8,9,308,389
150,66,2,4,5,8,-77,-56,1,3,231,333
150,67,2,4,6,7,24,43,5,6,255,376
150,68,3,3,6,7,33,-66,8,0,288,310
150,69,3,4,3,10,30,46,8,6,318,356
150,70,3,4,6,7,-67,43,1,9,251,399
150,71,5,2,10,3,55,-79,6,0,306,320
150,72,4,4,7,6,43,42,9,2,349,362
150,73,3,3,7,6,-66,33,3,5,283,395
150,74,4,2,7,6,43,24,6,9,326,419
150,75,3,3,9,4,-64,-69,2,0,262,350
150,76,5,3,8,5,53,32,5,2,315,382
150,77,3,3,5,8,32,35,7,7,347,417
150,78,3,4,4,9,31,-55,8,2,378,362
150,79,2,4,2,11,20,47,8,9,398,409
150,80,3,3,8,5,-65,-68,3,1,333,341
150,81,3,3,8,5,35,32,8,3,368,373
150,82,3,3,6,7,-67,34,1,7,301,407
150,83,5,2,8,5,53,-77,4,0,354,330
150,84,2,5,6,7,24,52,8,2,378,382
150,85,4,3,8,5,-56,32,2,4,322,414
150,86,3,4,6,7,33,43,5,7,355,457
150,87,5,2,9,4,54,22,9,9,409,479
150,88,2,4,5,8,-77,-56,2,3,332,423
150,89,3,4,6,7,33,43,5,6,365,466
150,90,3,4,6,7,33,43,8,9,398,509
151,1,5,2,7,6,52,24,2,4,52,24
151,2,3,3,7,6,34,33,6,7,86,57
151,3,2,5,4,9,22,-46,8,1,108,11
151,4,4,2,7,6,-57,24,1,5,51,35
151,5,4,3,8,5,44,32,5,7,95,67
151,6,5,2,8,5,53,-77,8,0,148,-10
151,7,4,2,9,4,-55,22,3,2,93,12
151,8,3,4,5,8,32,44,5,6,125,56
151,9,3,4,3,10,30,-54,5,2,155,2
151,10,4,2,7,6,43,24,8,6,198,26
151,11,3,3,5,8,-68,-65,0,1,130,-39
151,12,4,2,6,7,42,25,2,6,172,-14
151,13,3,4,7,6,34,42,6,8,206,28
151,14,2,4,5,8,23,-56,9,2,229,-28
151,15,5,2,7,6,-48,24,1,6,181,-4
151,16,2,4,6,7,24,43,5,9,205,39
151,17,3,4,7,6,34,-58,9,1,239,-19
151,18,3,3,5,8,-68,35,1,6,171,16
151,19,4,3,9,4,45,31,6,7,216,47
151,20,5,2,10,3,-45,21,1,8,171,68
151,21,4,2,6,7,42,-75,3,3,213,-7
151,22,3,3,5,8,32,35,5,8,245,28
151,23,3,3,6,7,33,-66,8,2,278,-38
151,24,2,4,5,8,-77,44,1,6,201,6
151,25,3,3,4,9,31,-64,2,2,232,-58
151,26,3,3,8,5,35,32,7,4,267,-26
151,27,5,2,8,5,-47,23,0,7,220,-3
151,28,3,4,4,9,31,-55,1,2,251,-58
151,29,4,3,8,5,44,32,5,4,295,-26
151,30,2,5,6,7,24,52,9,6,319,26
151,31,3,4,7,6,-66,42,3,8,253,68
151,32,6,2,8,5,62,-77,5,1,315,-9
151,33,3,3,7,6,34,33,9,4,349,24
151,34,4,3,8,5,-56,32,3,6,293,56
151,35,2,4,3,10,21,-54,4,2,314,2
151,36,3,4,5,8,32,44,6,6,346,46
151,37,2,7,4,9,22,72,8,8,368,118
151,38,4,3,8,5,-56,-68,2,0,312,50
151,39,3,4,7,6,34,42,6,2,346,92
151,40,4,2,7,6,43,24,9,6,389,116
151,41,3,4,4,9,-69,-55,0,1,320,61
151,42,4,4,5,8,41,44,1,5,361,105
151,43,3,3,5,8,32,-65,3,0,393,40
151,44,3,4,7,6,34,42,7,2,427,82
151,45,3,4,4,9,31,45,8,7,458,127
151,46,4,2,8,5,-56,-77,2,0,402,50
151,47,2,4,6,7,24,43,6,3,426,93
151,48,4,3,6,7,42,34,8,7,468,127
151,49,2,5,4,9,-78,-46,0,1,390,81
151,50,4,3,8,5,44,32,4,3,434,113
151,51,2,5,5,8,23,53,7,6,457,166
151,52,3,4,7,6,-66,42,1,8,391,208
151,53,4,2,10,3,46,21,7,9,437,229
151,54,2,5,2,11,20,-44,7,5,457,185
151,55,3,4,5,8,32,44,9,9,489,229
151,56,2,5,2,11,20,-44,9,5,509,185
152,1,3,3,4,9,31,36,1,6,31,36
152,2,3,3,8,5,35,32,6,8,66,68
152,3,3,4,7,6,-66,-58,0,0,0,10
152,4,3,4,7,6,34,42,4,2,34,52
152,5,3,3,5,8,32,35,6,7,66,87
152,6,3,4,6,7,33,-57,9,0,99,30
152,7,4,3,8,5,-56,32,3,2,43,62
152,8,4,3,8,5,44,32,7,4,87,94
152,9,4,3,6,7,42,34,9,8,129,128
152,10,2,4,4,9,-78,-55,1,3,51,73
152,11,5,2,9,4,54,22,5,5,105,95
152,12,3,3,4,9,31,-64,6,1,136,31
152,13,3,3,8,5,-65,32,1,3,71,63
152,14,4,3,9,4,45,31,6,4,116,94
152,15,4,2,8,5,-56,23,0,7,60,117
152,16,3,3,7,6,34,-67,4,0,94,50
152,17,5,3,8,5,53,32,7,2,147,82
152,18,3,3,8,5,-65,32,2,4,82,114
152,19,3,4,5,8,32,44,4,8,114,158
152,20,3,3,4,9,31,-64,5,4,145,94
152,21,2,4,7,6,-75,42,0,6,70,136
152,22,4,3,8,5,44,32,4,8,114,168
152,23,4,3,8,5,44,-68,8,0,158,100
152,24,3,3,5,8,-68,35,0,5,90,135
152,25,3,3,5,8,32,-65,2,0,122,70
152,26,3,4,6,7,33,43,5,3,155,113
152,27,4,2,10,3,-54,21,1,4,101,134
152,28,4,3,8,5,44,32,5,6,145,166
152,29,4,4,6,7,42,43,7,9,187,209
152,30,3,4,5,8,32,-56,9,3,219,153
152,31,3,5,4,9,-69,54,0,7,150,207
152,32,2,5,3,10,21,-45,1,2,171,162
152,33,4,3,5,8,41,35,2,7,212,197
152,34,3,4,6,7,33,-57,5,0,245,140
152,35,4,4,6,7,42,43,7,3,287,183
152,36,2,5,4,9,22,54,9,7,309,237
152,37,2,5,3,10,-79,-45,0,2,230,192
152,38,3,3,7,6,34,33,4,5,264,225
152,39,2,4,5,8,23,44,7,9,287,269
152,40,2,5,6,7,-76,-48,1,1,211,221
152,41,4,3,9,4,45,31,6,2,256,252
152,42,5,2,7,6,52,24,8,6,308,276
152,43,4,3,6,7,-58,-66,0,0,250,210
152,44,3,3,7,6,34,33,4,3,284,243
152,45,5,2,10,3,55,21,9,4,339,264
152,46,4,3,8,5,-56,32,3,6,283,296
152,47,3,3,6,7,33,-66,6,0,316,230
152,48,2,5,5,8,23,53,9,3,339,283
152,49,3,3,5,8,-68,35,1,8,271,318
152,50,3,5,3,10,30,-45,1,3,301,273
152,51,2,5,7,6,25,51,6,4,326,324
152,52,4,3,7,6,43,33,9,7,369,357
152,53,2,4,4,9,-78,-55,1,2,291,302
152,54,5,3,5,8,50,35,1,7,341,337
152,55,3,3,6,7,33,-66,4,1,374,271
152,56,2,5,3,10,21,55,5,6,395,326
152,57,2,4,3,10,21,-54,6,2,416,272
152,58,3,4,7,6,-66,42,0,4,350,314
152,59,4,2,7,6,43,24,3,8,393,338
152,60,4,2,8,5,44,-77,7,1,437,261
152,61,3,3,7,6,-66,33,1,4,371,294
152,62,3,3,6,7,33,34,4,8,404,328
152,63,3,3,7,6,34,-67,8,1,438,261
152,64,2,4,8,5,-74,41,4,2,364,302
152,65,4,3,5,8,41,35,5,7,405,337
152,66,3,4,3,10,30,-54,5,3,435,283
152,67,2,5,3,10,21,55,6,8,456,338
152,68,3,3,8,5,-65,-68,1,0,391,270
152,69,3,4,5,8,32,44,3,4,423,314
152,70,3,3,7,6,34,33,7,7,457,347
152,71,5,2,9,4,-46,22,1,9,411,369
152,72,4,3,7,6,43,-67,4,2,454,302
152,73,2,4,4,9,22,45,6,7,476,347
152,74,2,4,6,7,-76,-57,0,0,400,290
152,75,5,2,10,3,55,21,5,1,455,311
152,76,2,5,4,9,22,54,7,5,477,365
152,77,4,3,6,7,42,34,9,9,519,399
153,1,5,2,10,3,55,21,5,1,55,21
153,2,5,2,8,5,53,23,8,4,108,44
153,3,6,2,11,2,-35,20,3,4,73,64
153,4,3,3,4,9,31,-64,4,0,104,0
153,5,4,3,10,3,-54,30,0,0,50,30
153,6,3,3,7,6,34,33,4,3,84,63
153,7,4,2,7,6,43,24,7,7,127,87
153,8,5,2,10,3,-45,21,2,8,82,108
153,9,2,4,5,8,23,-56,5,2,105,52
153,10,4,2,8,5,44,23,9,5,149,75
153,11,5,2,10,3,-45,21,4,6,104,96
153,12,3,3,5,8,32,-65,6,1,136,31
153,13,2,5,3,10,21,55,7,6,157,86
153,14,4,3,8,5,-56,32,1,8,101,118
153,15,4,3,8,5,44,-68,5,0,145,50
153,16,4,3,6,7,42,34,7,4,187,84
153,17,3,4,6,7,-67,43,0,7,120,127
153,18,2,6,4,9,22,-37,2,0,142,90
153,19,3,3,8,5,35,32,7,2,177,122
153,20,4,3,8,5,-56,32,1,4,121,154
153,21,2,5,5,8,23,53,4,7,144,207
153,22,4,2,8,5,44,-77,8,0,188,130
153,23,4,4,5,8,41,44,9,4,229,174
153,24,2,4,5,8,-77,44,2,8,152,218
153,25,2,4,6,7,24,-57,6,1,176,161
153,26,3,3,8,5,-65,32,1,3,111,193
153,27,4,3,6,7,42,34,3,7,153,227
153,28,3,3,6,7,33,-66,6,1,186,161
153,29,3,3,8,5,-65,32,1,3,121,193
153,30,3,4,8,5,35,41,6,4,156,234
153,31,4,2,5,8,41,-74,7,0,197,160
153,32,4,2,6,7,42,25,9,5,239,185
153,33,2,5,3,10,-79,-45,0,0,160,140
153,34,4,3,6,7,42,34,2,4,202,174
153,35,3,3,8,5,35,32,7,6,237,206
153,36,3,4,5,8,32,-56,9,0,269,150
153,37,3,3,4,9,-69,36,0,6,200,186
153,38,4,3,9,4,45,31,5,7,245,217
153,39,3,4,3,10,30,-54,5,3,275,163
153,40,2,4,4,9,22,45,7,8,297,208
153,41,3,5,6,7,-67,-48,0,0,230,160
153,42,3,3,6,7,33,34,3,4,263,194
153,43,2,5,3,10,21,55,4,9,284,249
153,44,3,4,5,8,32,-56,6,3,316,193
153,45,4,3,9,4,-55,31,1,4,261,224
153,46,2,4,4,9,22,45,3,9,283,269
153,47,4,3,8,5,44,-68,7,1,327,201
153,48,3,4,6,7,-67,43,0,4,260,244
153,49,5,2,8,5,53,23,3,7,313,267
153,50,3,3,8,5,35,32,8,9,348,299
153,51,4,2,8,5,-56,-77,2,2,292,222
153,52,3,3,9,4,36,31,8,3,328,253
153,53,4,3,7,6,-57,33,1,6,271,286
153,54,3,4,5,8,32,-56,3,0,303,230
153,55,5,2,8,5,53,23,6,3,356,253
153,56,4,2,6,7,42,25,8,8,398,278
153,57,3,3,5,8,-68,-65,0,3,330,213
153,58,2,4,7,6,25,42,5,5,355,255
153,59,5,2,9,4,54,22,9,7,409,277
153,60,4,2,7,6,-57,-76,2,1,352,201
153,61,2,5,3,10,21,55,3,6,373,256
153,62,3,3,5,8,32,-65,5,1,405,191
153,63,3,4,5,8,32,44,7,5,437,235
153,64,4,3,6,7,42,34,9,9,479,269
153,65,3,5,5,8,-68,-47,1,2,411,222
153,66,5,2,10,3,55,21,6,3,466,243
153,67,3,4,4,9,31,45,7,8,497,288
153,68,5,2,10,3,-45,21,2,9,452,309
153,69,5,2,11,2,56,20,8,9,508,329
154,1,3,4,4,9,31,45,1,5,31,45
154,2,3,4,7,6,34,42,5,7,65,87
154,3,4,3,6,7,42,-66,7,1,107,21
154,4,3,4,7,6,-66,42,1,3,41,63
154,5,4,2,9,4,45,22,6,5,86,85
154,6,3,3,8,5,-65,32,1,7,21,117
154,7,4,3,6,7,42,-66,3,1,63,51
154,8,3,4,3,10,30,46,3,7,93,97
154,9,2,5,4,9,22,-46,5,1,115,51
154,10,4,2,4,9,40,27,5,8,155,78
154,11,4,3,9,4,-55,31,0,9,100,109
154,12,2,4,7,6,25,-58,5,1,125,51
154,13,4,3,7,6,43,33,8,4,168,84
154,14,3,3,9,4,-64,31,4,5,104,115
154,15,5,2,9,4,54,22,8,7,158,137
154,16,3,3,6,7,-67,-66,1,1,91,71
154,17,3,4,8,5,35,41,6,2,126,112
154,18,5,2,11,2,-44,20,2,2,82,132
154,19,3,4,4,9,31,45,3,7,113,177
154,20,3,3,7,6,34,-67,7,0,147,110
154,21,3,3,5,8,32,35,9,5,179,145
154,22,3,4,6,7,-67,43,2,8,112,188
154,23,3,3,4,9,31,-64,3,4,143,124
154,24,3,3,8,5,35,32,8,6,178,156
154,25,2,4,8,5,-74,41,4,7,104,197
154,26,3,4,4,9,31,-55,5,2,135,142
154,27,2,5,6,7,24,52,9,4,159,194
154,28,5,2,12,1,-43,-20,6,4,116,174
154,29,2,4,5,8,23,44,9,8,139,218
154,30,5,2,9,4,-46,-78,3,0,93,140
154,31,3,3,7,6,34,33,7,3,127,173
154,32,2,5,3,10,21,55,8,8,148,228
154,33,2,4,4,9,-78,-55,0,3,70,173
154,34,3,3,7,6,34,33,4,6,104,206
154,35,5,2,8,5,53,23,7,9,157,229
154,36,4,3,8,5,-56,-68,1,1,101,161
154,37,4,3,9,4,45,31,6,2,146,192
154,38,3,4,7,6,-66,42,0,4,80,234
154,39,3,4,4,9,31,45,1,9,111,279
154,40,2,4,5,8,23,-56,4,3,134,223
154,41,3,3,8,5,35,32,9,5,169,255
154,42,5,2,8,5,-47,23,2,8,122,278
154,43,3,4,4,9,31,-55,3,3,153,223
154,44,4,2,7,6,43,24,6,7,196,247
154,45,5,2,8,5,53,-77,9,0,249,170
154,46,2,5,4,9,-78,54,1,4,171,224
154,47,4,2,10,3,46,21,7,5,217,245
154,48,3,3,7,6,-66,33,1,8,151,278
154,49,2,5,6,7,24,-48,5,0,175,230
154,50,3,3,6,7,33,34,8,4,208,264
154,51,3,4,4,9,31,45,9,9,239,309
154,52,2,5,4,9,-78,-46,1,3,161,263
154,53,4,3,8,5,44,32,5,5,205,295
154,54,5,2,10,3,-45,21,0,6,160,316
154,55,5,3,6,7,51,-66,1,0,211,250
154,56,3,3,6,7,33,34,4,4,244,284
154,57,2,4,9,4,-73,40,1,4,171,324
154,58,2,4,4,9,22,45,3,9,193,369
154,59,4,3,6,7,42,-66,5,3,235,303
154,60,4,2,7,6,43,24,8,7,278,327
154,61,3,3,6,7,-67,-66,1,1,211,261
154,62,3,4,6,7,33,43,4,4,244,304
154,63,4,3,10,3,-54,30,0,4,190,334
154,64,4,2,7,6,43,24,3,8,233,358
154,65,2,5,3,10,21,-45,4,3,254,313
154,66,2,5,4,9,22,54,6,7,276,367
154,67,3,3,9,4,-64,31,2,8,212,398
154,68,3,5,5,8,32,-47,4,1,244,351
154,69,3,3,5,8,32,35,6,6,276,386
154,70,4,3,8,5,-56,32,0,8,220,418
154,71,5,2,9,4,54,-78,4,0,274,340
154,72,6,2,10,3,64,21,8,1,338,361
154,73,3,3,6,7,-67,34,1,5,271,395
154,74,3,4,5,8,32,44,3,9,303,439
154,75,3,3,9,4,36,-69,9,0,339,370
154,76,5,2,6,7,-49,25,0,5,290,395
154,77,4,3,5,8,41,-65,1,0,331,330
154,78,4,2,6,7,42,25,3,5,373,355
154,79,5,2,8,5,53,23,6,8,426,378
154,80,3,3,5,8,32,-65,8,3,458,313
154,81,4,2,7,6,-57,24,1,7,401,337
154,82,3,3,5,8,32,-65,3,2,433,272
154,83,3,4,5,8,32,44,5,6,465,316
154,84,4,3,6,7,42,-66,7,0,507,250
155,1,4,3,8,5,44,32,4,2,44,32
155,2,5,2,10,3,55,21,9,3,99,53
155,3,4,3,7,6,-57,33,2,6,42,86
155,4,3,3,6,7,33,-66,5,0,75,20
155,5,5,2,9,4,54,22,9,2,129,42
155,6,2,5,6,7,-76,52,3,4,53,94
155,7,2,6,2,11,20,65,3,9,73,159
155,8,3,3,7,6,34,-67,7,2,107,92
155,9,4,2,11,2,-53,20,4,2,54,112
155,10,4,2,7,6,43,24,7,6,97,136
155,11,5,2,10,3,-45,21,2,7,52,157
155,12,3,3,5,8,32,-65,4,2,84,92
155,13,2,4,5,8,23,44,7,6,107,136
155,14,4,2,8,5,-56,23,1,9,51,159
155,15,2,6,4,9,22,-37,3,2,73,122
155,16,3,4,5,8,32,44,5,6,105,166
155,17,2,5,4,9,22,-46,7,0,127,120
155,18,3,4,5,8,32,44,9,4,159,164
155,19,7,2,10,3,-27,21,2,5,132,185
155,20,3,3,7,6,34,33,6,8,166,218
155,21,3,3,6,7,33,-66,9,2,199,152
155,22,4,3,8,5,-56,32,3,4,143,184
155,23,4,3,8,5,44,32,7,6,187,216
155,24,2,4,4,9,22,-55,9,1,209,161
155,25,3,3,5,8,-68,35,1,6,141,196
155,26,2,6,2,11,20,-35,1,1,161,161
155,27,2,5,5,8,23,53,4,4,184,214
155,28,5,3,8,5,53,32,7,6,237,246
155,29,3,3,5,8,32,-65,9,1,269,181
155,30,3,4,4,9,-69,45,0,6,200,226
155,31,3,3,5,8,32,-65,2,1,232,161
155,32,5,2,8,5,53,23,5,4,285,184
155,33,4,3,6,7,42,34,7,8,327,218
155,34,3,4,6,7,-67,-57,0,1,260,161
155,35,3,4,4,9,31,45,1,6,291,206
155,36,2,4,3,10,21,-54,2,2,312,152
155,37,3,5,7,6,34,51,6,3,346,203
155,38,2,4,4,9,22,45,8,8,368,248
155,39,2,4,4,9,-78,-55,0,3,290,193
155,40,3,4,5,8,32,44,2,7,322,237
155,41,2,5,3,10,21,-45,3,2,343,192
155,42,4,3,9,4,45,31,8,3,388,223
155,43,2,5,7,6,-75,51,3,4,313,274
155,44,2,5,4,9,22,54,5,8,335,328
155,45,4,2,8,5,44,-77,9,1,379,251
155,46,3,3,10,3,-63,30,6,1,316,281
155,47,2,4,5,8,23,44,9,5,339,325
155,48,4,3,7,6,-57,33,2,8,282,358
155,49,4,2,7,6,43,-76,5,2,325,282
155,50,5,2,9,4,54,22,9,4,379,304
155,51,3,4,6,7,-67,43,2,7,312,347
155,52,2,4,4,9,22,-55,4,2,334,292
155,53,2,5,4,9,22,54,6,6,356,346
155,54,3,3,5,8,32,-65,8,1,388,281
155,55,3,3,7,6,-66,33,2,4,322,314
155,56,2,5,4,9,22,54,4,8,344,368
155,57,3,4,8,5,35,41,9,9,379,409
155,58,3,3,6,7,-67,-66,2,3,312,343
155,59,4,3,5,8,41,35,3,8,353,378
155,60,4,3,9,4,45,31,8,9,398,409
155,61,2,5,4,9,-78,-46,0,3,320,363
155,62,2,5,4,9,22,54,2,7,342,417
155,63,3,4,7,6,34,42,6,9,376,459
155,64,3,3,6,7,33,-66,9,3,409,393
155,65,4,3,8,5,-56,32,3,5,353,425
155,66,4,2,8,5,44,23,7,8,397,448
155,67,2,4,6,7,-76,-57,1,1,321,391
155,68,3,4,9,4,36,40,7,1,357,431
155,69,3,4,5,8,32,44,9,5,389,475
155,70,2,5,3,10,-79,-45,0,0,310,430
155,71,6,2,9,4,63,22,3,2,373,452
155,72,3,4,5,8,32,44,5,6,405,496
155,73,2,4,4,9,22,-55,7,1,427,441
155,74,4,2,9,4,-55,22,2,3,372,463
155,75,5,2,8,5,53,23,5,6,425,486
155,76,3,4,5,8,32,-56,7,0,457,430
155,77,4,3,8,5,-56,32,1,2,401,462
155,78,2,4,2,11,20,47,1,9,421,509
156,1,5,2,9,4,54,22,4,2,54,22
156,2,3,3,7,6,34,33,8,5,88,55
156,3,4,3,6,7,-58,34,0,9,30,89
156,4,3,3,8,5,35,-68,5,1,65,21
156,5,3,4,6,7,33,43,8,4,98,64
156,6,3,3,6,7,-67,34,1,8,31,98
156,7,3,4,5,8,32,-56,3,2,63,42
156,8,4,3,9,4,45,31,8,3,108,73
156,9,3,3,7,6,-66,33,2,6,42,106
156,10,3,3,4,9,31,-64,3,2,73,42
156,11,3,4,6,7,33,43,6,5,106,85
156,12,2,5,4,9,22,54,8,9,128,139
156,13,4,2,7,6,-57,-76,1,3,71,63
156,14,3,3,7,6,34,33,5,6,105,96
156,15,2,4,3,10,21,-54,6,2,126,42
156,16,3,3,4,9,31,36,7,8,157,78
156,17,2,4,7,6,-75,-58,2,0,82,20
156,18,4,2,8,5,44,23,6,3,126,43
156,19,4,3,9,4,-55,31,1,4,71,74
156,20,4,3,8,5,44,32,5,6,115,106
156,21,2,5,4,9,22,-46,7,0,137,60
156,22,4,3,6,7,42,34,9,4,179,94
156,23,3,4,5,8,-68,44,1,8,111,138
156,24,2,5,5,8,23,-47,4,1,134,91
156,25,2,4,3,10,21,46,5,7,155,137
156,26,4,3,8,5,44,32,9,9,199,169
156,27,4,3,8,5,-56,-68,3,1,143,101
156,28,3,3,10,3,-63,30,0,1,80,131
156,29,4,2,7,6,43,24,3,5,123,155
156,30,5,2,9,4,54,22,7,7,177,177
156,31,4,4,5,8,41,-56,8,1,218,121
156,32,2,4,6,7,-76,43,2,4,142,164
156,33,3,3,7,6,34,33,6,7,176,197
156,34,5,2,7,6,52,-76,8,1,228,121
156,35,5,2,8,5,-47,23,1,4,181,144
156,36,3,4,4,9,31,45,2,9,212,189
156,37,3,3,5,8,32,-65,4,4,244,124
156,38,3,3,5,8,32,35,6,9,276,159
156,39,3,4,5,8,32,-56,8,3,308,103
156,40,3,3,6,7,-67,34,1,7,241,137
156,41,4,2,4,9,40,-73,1,4,281,64
156,42,4,3,7,6,43,33,4,7,324,97
156,43,3,5,5,8,32,-47,6,0,356,50
156,44,4,3,9,4,-55,31,1,1,301,81
156,45,4,3,9,4,45,31,6,2,346,112
156,46,3,4,6,7,33,43,9,5,379,155
156,47,4,3,9,4,-55,31,4,6,324,186
156,48,4,2,9,4,45,22,9,8,369,208
156,49,4,3,7,6,-57,-67,2,1,312,141
156,50,3,3,8,5,35,32,7,3,347,173
156,51,2,5,4,9,22,54,9,7,369,227
156,52,3,4,6,7,-67,-57,2,0,302,170
156,53,5,2,9,4,54,22,6,2,356,192
156,54,4,3,4,9,40,36,6,8,396,228
156,55,2,4,6,7,-76,-57,0,1,320,171
156,56,3,3,5,8,32,35,2,6,352,206
156,57,4,3,9,4,45,31,7,7,397,237
156,58,4,2,10,3,-54,21,3,8,343,258
156,59,3,3,6,7,33,-66,6,2,376,192
156,60,6,2,11,2,-35,20,1,2,341,212
156,61,4,2,7,6,43,24,4,6,384,236
156,62,3,4,7,6,34,42,8,8,418,278
156,63,3,3,7,6,-66,-67,2,1,352,211
156,64,4,3,9,4,45,31,7,2,397,242
156,65,4,4,9,4,-55,40,2,2,342,282
156,66,4,3,9,4,45,31,7,3,387,313
156,67,4,3,5,8,41,35,8,8,428,348
156,68,2,4,7,6,-75,-58,3,0,353,290
156,69,4,2,7,6,43,24,6,4,396,314
156,70,3,4,4,9,31,45,7,9,427,359
156,71,2,6,3,10,21,-36,8,3,448,323
156,72,3,4,9,4,-64,40,4,3,384,363
156,73,4,3,7,6,43,33,7,6,427,396
156,74,5,2,11,2,-44,20,3,6,383,416
156,75,3,3,4,9,31,-64,4,2,414,352
156,76,5,2,7,6,52,24,6,6,466,376
156,77,4,3,6,7,42,-66,8,0,508,310
157,1,3,3,6,7,33,34,3,4,33,34
157,2,4,3,5,8,41,35,4,9,74,69
157,3,3,4,5,8,32,-56,6,3,106,13
157,4,3,4,5,8,32,44,8,7,138,57
157,5,2,5,4,9,-78,-46,0,1,60,11
157,6,3,3,5,8,32,35,2,6,92,46
157,7,2,4,4,9,22,-55,4,1,114,-9
157,8,3,3,8,5,35,32,9,3,149,23
157,9,4,2,9,4,-55,22,4,5,94,45
157,10,3,4,4,9,31,-55,5,0,125,-10
157,11,3,4,5,8,32,44,7,4,157,34
157,12,3,4,5,8,32,44,9,8,189,78
157,13,3,4,4,9,-69,-55,0,3,120,23
157,14,4,2,9,4,45,22,5,5,165,45
157,15,2,4,5,8,23,44,8,9,188,89
157,16,5,2,10,3,-45,-79,3,0,143,10
157,17,3,3,7,6,34,33,7,3,177,43
157,18,5,2,8,5,-47,23,0,6,130,66
157,19,3,3,4,9,31,-64,1,2,161,2
157,20,2,6,4,9,22,63,3,5,183,65
157,21,2,4,5,8,23,44,6,9,206,109
157,22,2,4,7,6,-75,-58,1,1,131,51
157,23,4,3,4,9,40,36,1,7,171,87
157,24,3,4,5,8,32,-56,3,1,203,31
157,25,4,2,7,6,43,24,6,5,246,55
157,26,3,3,4,9,31,-64,7,1,277,-9
157,27,2,4,6,7,-76,43,1,4,201,34
157,28,3,4,6,7,33,43,4,7,234,77
157,29,3,3,7,6,34,-67,8,0,268,10
157,30,2,4,2,11,20,47,8,7,288,57
157,31,2,5,6,7,-76,52,2,9,212,109
157,32,2,5,5,8,23,-47,5,2,235,62
157,33,5,3,8,5,53,32,8,4,288,94
157,34,4,2,7,6,-57,24,1,8,231,118
157,35,3,3,4,9,31,-64,2,4,262,54
157,36,3,3,6,7,33,34,5,8,295,88
157,37,2,4,7,6,-75,-58,0,0,220,30
157,38,3,4,6,7,33,43,3,3,253,73
157,39,5,2,9,4,54,22,7,5,307,95
157,40,4,3,9,4,-55,31,2,6,252,126
157,41,4,3,8,5,44,32,6,8,296,158
157,42,4,3,8,5,-56,-68,0,0,240,90
157,43,6,2,8,5,62,23,2,3,302,113
157,44,4,3,7,6,43,33,5,6,345,146
157,45,5,2,9,4,54,22,9,8,399,168
157,46,3,4,6,7,-67,-57,2,1,332,111
157,47,2,4,7,6,25,42,7,3,357,153
157,48,2,4,2,11,20,-53,7,0,377,100
157,49,4,2,7,6,-57,24,0,4,320,124
157,50,5,2,10,3,55,21,5,5,375,145
157,51,4,2,6,7,42,-75,7,0,417,70
157,52,3,3,5,8,32,35,9,5,449,105
157,53,5,2,9,4,-46,22,3,7,403,127
157,54,2,5,3,10,21,-45,4,2,424,82
157,55,2,4,4,9,22,45,6,7,446,127
157,56,3,3,10,3,-63,30,3,7,383,157
157,57,4,3,8,5,44,32,7,9,427,189
157,58,3,4,8,5,-65,-59,2,0,362,130
157,59,4,3,7,6,43,33,5,3,405,163
157,60,2,5,3,10,21,55,6,8,426,218
157,61,5,2,11,2,-44,20,2,8,382,238
157,62,2,4,6,7,24,-57,6,1,406,181
157,63,4,3,6,7,42,34,8,5,448,215
157,64,4,3,9,4,-55,31,3,6,393,246
157,65,4,3,10,3,46,30,9,6,439,276
157,66,3,3,6,7,-67,-66,2,0,372,210
157,67,4,3,7,6,43,33,5,3,415,243
157,68,5,2,8,5,53,23,8,6,468,266
157,69,4,3,6,7,-58,-66,0,0,410,200
157,70,4,3,8,5,44,32,4,2,454,232
157,71,3,3,9,4,-64,31,0,3,390,263
157,72,5,2,10,3,55,21,5,4,445,284
157,73,4,2,8,5,44,23,9,7,489,307
157,74,3,3,7,6,-66,-67,3,0,423,240
157,75,3,4,4,9,31,45,4,5,454,285
157,76,3,4,7,6,34,42,8,7,488,327
157,77,3,4,5,8,-68,-56,0,1,420,271
157,78,3,3,5,8,32,35,2,6,452,306
157,79,2,4,7,6,25,42,7,8,477,348
157,80,2,4,5,8,-77,-56,0,2,400,292
157,81,3,4,5,8,32,44,2,6,432,336
157,82,3,3,5,8,32,-65,4,1,464,271
157,83,4,2,9,4,45,22,9,3,509,293
158,1,3,4,5,8,32,44,2,4,32,44
158,2,3,3,6,7,33,34,5,8,65,78
158,3,4,2,6,7,42,-75,7,3,107,3
158,4,3,3,8,5,-65,32,2,5,42,35
158,5,2,4,5,8,23,44,5,9,65,79
158,6,3,4,7,6,34,-58,9,1,99,21
158,7,4,2,9,4,-55,22,4,3,44,43
158,8,4,2,6,7,42,25,6,8,86,68
158,9,3,3,9,4,-64,31,2,9,22,99
158,10,2,5,5,8,23,-47,5,2,45,52
158,11,5,2,11,2,-44,20,1,2,1,72
158,12,3,3,5,8,32,35,3,7,33,107
158,13,3,3,6,7,33,-66,6,1,66,41
158,14,4,2,6,7,42,25,8,6,108,66
158,15,4,3,7,6,-57,33,1,9,51,99
158,16,2,4,4,9,22,-55,3,4,73,44
158,17,5,2,10,3,55,21,8,5,128,65
158,18,3,3,5,8,-68,-65,0,0,60,0
158,19,3,3,5,8,32,35,2,5,92,35
158,20,3,4,6,7,33,43,5,8,125,78
158,21,4,3,7,6,43,-67,8,1,168,11
158,22,2,5,4,9,-78,54,0,5,90,65
158,23,4,3,7,6,43,33,3,8,133,98
158,24,4,3,7,6,43,-67,6,1,176,31
158,25,3,4,8,5,-65,41,1,2,111,72
158,26,4,3,6,7,42,34,3,6,153,106
158,27,4,2,9,4,45,22,8,8,198,128
158,28,2,5,3,10,21,-45,9,3,219,83
158,29,2,4,8,5,-74,41,5,4,145,124
158,30,3,4,4,9,31,45,6,9,176,169
158,31,2,5,5,8,23,-47,9,2,199,122
158,32,4,3,9,4,-55,31,4,3,144,153
158,33,4,3,7,6,43,33,7,6,187,186
158,34,4,3,7,6,-57,33,0,9,130,219
158,35,5,2,8,5,53,-77,3,2,183,142
158,36,2,4,7,6,25,42,8,4,208,184
158,37,5,2,8,5,-47,23,1,7,161,207
158,38,4,2,7,6,43,-76,4,1,204,131
158,39,3,3,6,7,33,34,7,5,237,165
158,40,4,2,8,5,-56,23,1,8,181,188
158,41,5,2,8,5,53,-77,4,1,234,111
158,42,4,3,8,5,44,32,8,3,278,143
158,43,3,3,9,4,-64,31,4,4,214,174
158,44,3,3,8,5,35,32,9,6,249,206
158,45,3,4,6,7,-67,43,2,9,182,249
158,46,3,4,7,6,34,-58,6,1,216,191
158,47,4,2,9,4,-55,22,1,3,161,213
158,48,3,4,6,7,33,43,4,6,194,256
158,49,3,4,6,7,33,43,7,9,227,299
158,50,3,3,6,7,-67,-66,0,3,160,233
158,51,5,2,7,6,52,24,2,7,212,257
158,52,3,4,6,7,33,-57,5,0,245,200
158,53,3,3,5,8,32,35,7,5,277,235
158,54,4,3,8,5,-56,32,1,7,221,267
158,55,5,2,11,2,56,20,7,7,277,287
158,56,2,4,4,9,22,-55,9,2,299,232
158,57,2,4,5,8,-77,44,2,6,222,276
158,58,4,3,9,4,45,31,7,7,267,307
158,59,4,2,8,5,-56,-77,1,0,211,230
158,60,4,2,9,4,45,22,6,2,256,252
158,61,4,3,9,4,-55,31,1,3,201,283
158,62,2,4,3,10,21,46,2,9,222,329
158,63,4,2,8,5,44,-77,6,2,266,252
158,64,4,3,9,4,-55,31,1,3,211,283
158,65,5,2,10,3,55,21,6,4,266,304
158,66,3,3,9,4,-64,31,2,5,202,335
158,67,3,4,5,8,32,44,4,9,234,379
158,68,5,2,9,4,54,-78,8,1,288,301
158,69,2,4,4,9,-78,45,0,6,210,346
158,70,3,3,6,7,33,-66,3,0,243,280
158,71,2,5,6,7,24,52,7,2,267,332
158,72,2,5,4,9,22,54,9,6,289,386
158,73,3,4,6,7,-67,43,2,9,222,429
158,74,3,3,8,5,35,-68,7,1,257,361
158,75,3,4,6,7,-67,43,0,4,190,404
158,76,3,3,7,6,34,33,4,7,224,437
158,77,5,2,8,5,53,-77,7,0,277,360
158,78,4,2,10,3,-54,21,3,1,223,381
158,79,5,2,10,3,55,21,8,2,278,402
158,80,2,6,3,10,21,64,9,6,299,466
158,81,4,2,8,5,-56,23,3,9,243,489
158,82,4,3,9,4,45,-69,8,0,288,420
158,83,2,4,4,9,-78,45,0,5,210,465
158,84,3,4,7,6,34,42,4,7,244,507
159,1,3,3,8,5,35,32,5,2,35,32
159,2,4,3,9,4,-55,31,0,3,-20,63
159,3,2,4,5,8,23,44,3,7,3,107
159,4,2,4,6,7,24,-57,7,0,27,50
159,5,3,4,5,8,32,44,9,4,59,94
159,6,4,4,7,6,-57,42,2,6,2,136
159,7,5,2,8,5,53,23,5,9,55,159
159,8,4,2,9,4,-55,-78,0,1,0,81
159,9,4,2,6,7,42,25,2,6,42,106
159,10,3,3,6,7,33,-66,5,0,75,40
159,11,2,5,3,10,21,55,6,5,96,95
159,12,2,4,4,9,22,-55,8,0,118,40
159,13,5,2,10,3,-45,21,3,1,73,61
159,14,2,4,6,7,24,43,7,4,97,104
159,15,3,4,8,5,-65,41,2,5,32,145
159,16,3,5,5,8,32,53,4,8,64,198
159,17,3,4,6,7,33,-57,7,1,97,141
159,18,4,3,7,6,-57,33,0,4,40,174
159,19,3,3,6,7,33,34,3,8,73,208
159,20,2,4,7,6,25,-58,8,0,98,150
159,21,4,2,11,2,-53,20,5,0,45,170
159,22,4,2,6,7,42,25,7,5,87,195
159,23,5,2,8,5,-47,23,0,8,40,218
159,24,4,3,9,4,45,31,5,9,85,249
159,25,6,2,10,3,64,-79,9,0,149,170
159,26,4,3,7,6,-57,33,2,3,92,203
159,27,5,3,9,4,54,31,6,4,146,234
159,28,2,4,4,9,22,45,8,9,168,279
159,29,2,4,5,8,-77,-56,1,3,91,223
159,30,2,5,6,7,24,52,5,5,115,275
159,31,5,2,11,2,-44,20,1,5,71,295
159,32,4,3,10,3,46,30,7,5,117,325
159,33,4,3,7,6,-57,33,0,8,60,358
159,34,2,4,8,5,26,41,6,9,86,399
159,35,2,5,3,10,21,-45,7,4,107,354
159,36,3,3,5,8,32,35,9,9,139,389
159,37,2,5,5,8,-77,-47,2,2,62,342
159,38,2,4,7,6,25,42,7,4,87,384
159,39,4,3,8,5,-56,32,1,6,31,416
159,40,4,3,9,4,45,31,6,7,76,447
159,41,5,2,10,3,-45,21,1,8,31,468
159,42,3,4,6,7,33,-57,4,1,64,411
159,43,4,2,6,7,42,25,6,6,106,436
159,44,4,3,5,8,41,-65,7,1,147,371
159,45,3,3,8,5,-65,32,2,3,82,403
159,46,5,2,8,5,53,23,5,6,135,426
159,47,4,3,9,4,-55,31,0,7,80,457
159,48,2,5,5,8,23,-47,3,0,103,410
159,49,4,2,8,5,44,23,7,3,147,433
159,50,2,4,4,9,22,45,9,8,169,478
159,51,3,3,5,8,-68,-65,1,3,101,413
159,52,3,3,9,4,36,31,7,4,137,444
159,53,2,4,4,9,22,45,9,9,159,489
159,54,5,3,9,4,-46,-69,3,0,113,420
159,55,2,4,5,8,23,44,6,4,136,464
159,56,4,2,6,7,42,25,8,9,178,489
159,57,3,4,4,9,31,-55,9,4,209,434
159,58,2,4,4,9,-78,45,1,9,131,479
159,59,3,4,7,6,34,-58,5,1,165,421
159,60,2,4,4,9,22,45,7,6,187,466
159,61,5,2,9,4,-46,22,1,8,141,488
159,62,5,2,9,4,54,-78,5,0,195,410
159,63,6,2,10,3,64,21,9,1,259,431
159,64,4,3,9,4,-55,31,4,2,204,462
159,65,4,2,8,5,44,23,8,5,248,485
159,66,2,4,6,7,-76,43,2,8,172,528
160,1,3,4,7,6,34,42,4,2,34,42
160,2,4,3,7,6,43,33,7,5,77,75
160,3,3,4,6,7,-67,43,0,8,10,118
160,4,5,2,8,5,53,-77,3,1,63,41
160,5,4,3,8,5,44,32,7,3,107,73
160,6,3,3,5,8,32,35,9,8,139,108
160,7,2,5,3,10,-79,-45,0,3,60,63
160,8,2,5,6,7,24,52,4,5,84,115
160,9,4,3,7,6,43,33,7,8,127,148
160,10,2,4,5,8,-77,-56,0,2,50,92
160,11,3,4,5,8,32,44,2,6,82,136
160,12,4,3,7,6,43,33,5,9,125,169
160,13,2,4,5,8,23,-56,8,3,148,113
160,14,4,2,7,6,-57,24,1,7,91,137
160,15,3,3,7,6,34,-67,5,0,125,70
160,16,3,3,6,7,33,34,8,4,158,104
160,17,4,3,6,7,-58,34,0,8,100,138
160,18,4,3,6,7,42,-66,2,2,142,72
160,19,2,6,5,8,23,62,5,4,165,134
160,20,4,2,8,5,44,23,9,7,209,157
160,21,3,5,4,9,-69,-46,0,1,140,111
160,22,3,4,4,9,31,45,1,6,171,156
160,23,3,3,8,5,35,32,6,8,206,188
160,24,3,4,4,9,31,-55,7,3,237,133
160,25,3,3,6,7,-67,34,0,7,170,167
160,26,5,2,10,3,55,21,5,8,225,188
160,27,5,2,8,5,53,-77,8,1,278,111
160,28,3,4,6,7,-67,43,1,4,211,154
160,29,3,4,6,7,33,43,4,7,244,197
160,30,3,4,7,6,34,42,8,9,278,239
160,31,2,5,5,8,-77,-47,1,2,201,192
160,32,4,2,10,3,46,21,7,3,247,213
160,33,3,4,5,8,32,44,9,7,279,257
160,34,4,4,8,5,-56,41,3,8,223,298
160,35,4,3,5,8,41,-65,4,3,264,233
160,36,3,3,7,6,34,33,8,6,298,266
160,37,4,3,9,4,-55,31,3,7,243,297
160,38,3,3,4,9,31,-64,4,3,274,233
160,39,2,5,4,9,22,54,6,7,296,287
160,40,3,4,4,9,31,-55,7,2,327,232
160,41,4,2,9,4,-55,22,2,4,272,254
160,42,3,4,5,8,32,44,4,8,304,298
160,43,3,3,8,5,35,-68,9,0,339,230
160,44,3,5,7,6,-66,51,3,1,273,281
160,45,3,3,5,8,32,35,5,6,305,316
160,46,3,3,8,5,-65,32,0,8,240,348
160,47,3,4,7,6,34,-58,4,0,274,290
160,48,5,2,9,4,54,22,8,2,328,312
160,49,3,4,4,9,31,45,9,7,359,357
160,50,5,2,10,3,-45,21,4,8,314,378
160,51,4,3,7,6,43,-67,7,1,357,311
160,52,3,3,5,8,32,35,9,6,389,346
160,53,4,4,6,7,-58,43,1,9,331,389
160,54,3,3,5,8,32,-65,3,4,363,324
160,55,2,4,4,9,22,45,5,9,385,369
160,56,3,3,7,6,34,-67,9,2,419,302
160,57,3,3,6,7,-67,34,2,6,352,336
160,58,3,4,7,6,34,42,6,8,386,378
160,59,2,4,5,8,23,-56,9,2,409,322
160,60,4,3,5,8,-59,35,0,7,350,357
160,61,3,3,7,6,34,-67,4,0,384,290
160,62,3,3,7,6,34,33,8,3,418,323
160,63,4,3,7,6,-57,33,1,6,361,356
160,64,3,3,10,3,37,30,8,6,398,386
160,65,3,4,6,7,-67,43,1,9,331,429
160,66,3,4,9,4,36,40,7,9,367,469
160,67,3,3,7,6,-66,-67,1,2,301,402
160,68,5,2,7,6,52,24,3,6,353,426
160,69,3,4,7,6,34,42,7,8,387,468
160,70,5,2,8,5,-47,-77,0,1,340,391
160,71,2,5,3,10,21,55,1,6,361,446
160,72,5,2,9,4,54,22,5,8,415,468
160,73,4,3,9,4,-55,31,0,9,360,499
160,74,2,5,4,9,22,-46,2,3,382,453
160,75,3,4,5,8,32,44,4,7,414,497
160,76,3,3,9,4,-64,31,0,8,350,528
161,1,3,4,7,6,34,42,4,2,34,42
161,2,2,4,7,6,25,42,9,4,59,84
161,3,3,3,7,6,-66,33,3,7,-7,117
161,4,4,3,8,5,44,32,7,9,37,149
161,5,3,4,6,7,-67,-57,0,2,-30,92
161,6,2,4,4,9,22,45,2,7,-8,137
161,7,3,3,8,5,35,32,7,9,27,169
161,8,4,2,7,6,-57,-76,0,3,-30,93
161,9,4,2,10,3,46,21,6,4,16,114
161,10,2,5,3,10,21,55,7,9,37,169
161,11,6,2,10,3,-36,-79,1,0,1,90
161,12,4,3,6,7,42,34,3,4,43,124
161,13,3,4,5,8,32,44,5,8,75,168
161,14,4,3,7,6,43,-67,8,1,118,101
161,15,3,4,7,6,-66,42,2,3,52,143
161,16,4,3,5,8,41,35,3,8,93,178
161,17,4,3,8,5,44,-68,7,0,137,110
161,18,4,2,10,3,-54,21,3,1,83,131
161,19,4,2,9,4,45,22,8,3,128,153
161,20,3,4,4,9,31,45,9,8,159,198
161,21,3,5,7,6,-66,51,3,9,93,249
161,22,3,3,4,9,31,-64,4,5,124,185
161,23,3,4,6,7,33,43,7,8,157,228
161,24,3,3,5,8,32,-65,9,3,189,163
161,25,4,3,6,7,-58,34,1,7,131,197
161,26,2,5,4,9,22,-46,3,1,153,151
161,27,3,4,7,6,34,42,7,3,187,193
161,28,3,4,3,10,30,46,7,9,217,239
161,29,3,4,4,9,31,-55,8,4,248,184
161,30,4,2,9,4,-55,22,3,6,193,206
161,31,4,3,9,4,45,31,8,7,238,237
161,32,2,4,6,7,-76,-57,2,0,162,180
161,33,4,2,9,4,45,22,7,2,207,202
161,34,4,2,4,9,40,27,7,9,247,229
161,35,4,3,9,4,-55,-69,2,0,192,160
161,36,4,3,6,7,42,34,4,4,234,194
161,37,3,3,6,7,33,34,7,8,267,228
161,38,2,5,5,8,-77,-47,0,1,190,181
161,39,3,4,6,7,33,43,3,4,223,224
161,40,2,5,3,10,21,55,4,9,244,279
161,41,3,4,4,9,31,-55,5,4,275,224
161,42,2,4,7,6,-75,42,0,6,200,266
161,43,4,2,10,3,46,21,6,7,246,287
161,44,4,2,8,5,-56,-77,0,0,190,210
161,45,3,3,5,8,32,35,2,5,222,245
161,46,3,3,5,8,32,-65,4,0,254,180
161,47,2,5,3,10,21,55,5,5,275,235
161,48,2,4,3,10,21,-54,6,1,296,181
161,49,2,5,6,7,-76,52,0,3,220,233
161,50,5,2,9,4,54,22,4,5,274,255
161,51,2,4,6,7,24,43,8,8,298,298
161,52,2,4,6,7,-76,-57,2,1,222,241
161,53,4,2,9,4,45,22,7,3,267,263
161,54,4,2,9,4,-55,22,2,5,212,285
161,55,4,3,9,4,45,31,7,6,257,316
161,56,4,2,8,5,-56,23,1,9,201,339
161,57,3,3,5,8,32,-65,3,4,233,274
161,58,4,2,9,4,45,22,8,6,278,296
161,59,4,4,8,5,-56,41,2,7,222,337
161,60,3,3,8,5,35,32,7,9,257,369
161,61,2,4,6,7,-76,-57,1,2,181,312
161,62,3,4,6,7,33,43,4,5,214,355
161,63,4,3,7,6,43,33,7,8,257,388
161,64,2,5,2,11,20,-44,7,4,277,344
161,65,4,3,8,5,-56,32,1,6,221,376
161,66,4,3,7,6,43,33,4,9,264,409
161,67,4,4,8,5,44,-59,8,0,308,350
161,68,3,4,3,10,30,46,8,6,338,396
161,69,2,4,2,11,20,-53,8,3,358,343
161,70,2,4,5,8,-77,44,1,7,281,387
161,71,3,3,3,10,30,-63,1,4,311,324
161,72,2,4,2,11,20,-53,1,1,331,271
161,73,3,3,8,5,35,32,6,3,366,303
161,74,2,4,4,9,22,45,8,8,388,348
161,75,4,3,8,5,-56,-68,2,0,332,280
161,76,2,5,3,10,21,55,3,5,353,335
161,77,4,2,7,6,43,24,6,9,396,359
161,78,3,3,6,7,33,-66,9,3,429,293
161,79,3,3,5,8,-68,35,1,8,361,328
161,80,4,3,9,4,45,31,6,9,406,359
161,81,3,4,7,6,-66,-58,0,1,340,301
161,82,4,3,6,7,42,34,2,5,382,335
161,83,2,4,3,10,21,-54,3,1,403,281
161,84,3,3,7,6,34,33,7,4,437,314
161,85,5,2,9,4,-46,22,1,6,391,336
161,86,6,2,9,4,63,22,4,8,454,358
161,87,6,2,9,4,63,-78,7,0,517,280
162,1,4,2,8,5,44,23,4,3,44,23
162,2,3,3,7,6,34,33,8,6,78,56
162,3,3,4,4,9,31,-55,9,1,109,1
162,4,3,3,4,9,-69,36,0,7,40,37
162,5,3,3,5,8,32,-65,2,2,72,-28
162,6,6,2,9,4,63,22,5,4,135,-6
162,7,2,5,4,9,22,54,7,8,157,48
162,8,4,2,10,3,-54,21,3,9,103,69
162,9,4,3,7,6,43,-67,6,2,146,2
162,10,3,4,6,7,33,43,9,5,179,45
162,11,5,2,10,3,-45,21,4,6,134,66
162,12,3,4,8,5,35,41,9,7,169,107
162,13,3,3,6,7,-67,-66,2,1,102,41
162,14,4,3,4,9,40,36,2,7,142,77
162,15,2,4,5,8,23,-56,5,1,165,21
162,16,4,2,6,7,42,25,7,6,207,46
162,17,3,3,6,7,-67,-66,0,0,140,-20
162,18,5,2,9,4,54,22,4,2,194,2
162,19,3,5,6,7,33,52,7,4,227,54
162,20,2,4,6,7,-76,43,1,7,151,97
162,21,4,3,7,6,43,-67,4,0,194,30
162,22,3,4,3,10,30,46,4,6,224,76
162,23,4,3,7,6,43,33,7,9,267,109
162,24,2,5,4,9,22,-46,9,3,289,63
162,25,3,4,7,6,-66,42,3,5,223,105
162,26,2,4,7,6,25,42,8,7,248,147
162,27,3,3,8,5,-65,32,3,9,183,179
162,28,6,2,8,5,62,-77,5,2,245,102
162,29,3,4,7,6,34,42,9,4,279,144
162,30,5,2,7,6,-48,24,1,8,231,168
162,31,3,4,4,9,31,-55,2,3,262,113
162,32,5,2,8,5,53,23,5,6,315,136
162,33,3,4,4,9,31,-55,6,1,346,81
162,34,4,3,9,4,-55,31,1,2,291,112
162,35,2,4,4,9,22,45,3,7,313,157
162,36,2,6,3,10,21,-36,4,1,334,121
162,37,3,3,8,5,35,32,9,3,369,153
162,38,4,4,7,6,-57,42,2,5,312,195
162,39,3,3,9,4,36,31,8,6,348,226
162,40,3,4,8,5,-65,41,3,7,283,267
162,41,3,4,5,8,32,-56,5,1,315,211
162,42,3,3,4,9,31,36,6,7,346,247
162,43,2,5,5,8,23,-47,9,0,369,200
162,44,2,5,5,8,-77,53,2,3,292,253
162,45,3,3,8,5,35,32,7,5,327,285
162,46,5,2,9,4,-46,22,1,7,281,307
162,47,3,3,7,6,34,-67,5,0,315,240
162,48,3,3,6,7,33,34,8,4,348,274
162,49,2,4,6,7,-76,43,2,7,272,317
162,50,3,4,7,6,34,42,6,9,306,359
162,51,4,3,6,7,42,-66,8,3,348,293
162,52,3,3,9,4,-64,31,4,4,284,324
162,53,2,4,6,7,24,43,8,7,308,367
162,54,4,3,6,7,-58,-66,0,1,250,301
162,55,3,3,7,6,34,33,4,4,284,334
162,56,3,4,6,7,33,43,7,7,317,377
162,57,4,2,8,5,-56,-77,1,0,261,300
162,58,3,3,8,5,35,32,6,2,296,332
162,59,3,3,4,9,31,36,7,8,327,368
162,60,4,3,5,8,41,-65,8,3,368,303
162,61,2,6,2,11,20,65,8,8,388,368
162,62,2,5,3,10,21,-45,9,3,409,323
162,63,6,2,10,3,-36,21,3,4,373,344
162,64,5,2,9,4,54,22,7,6,427,366
162,65,4,2,7,6,-57,-76,0,0,370,290
162,66,4,3,8,5,44,32,4,2,414,322
162,67,4,3,9,4,45,31,9,3,459,353
162,68,5,2,8,5,-47,23,2,6,412,376
162,69,4,2,10,3,46,21,8,7,458,397
162,70,5,2,10,3,-45,21,3,8,413,418
162,71,4,3,9,4,45,31,8,9,458,449
162,72,3,4,7,6,-66,-58,2,1,392,391
162,73,3,3,7,6,34,33,6,4,426,424
162,74,2,5,7,6,-75,51,1,5,351,475
162,75,3,4,5,8,32,44,3,9,383,519
163,1,2,4,5,8,23,44,3,4,23,44
163,2,2,4,5,8,23,44,6,8,46,88
163,3,4,2,10,3,-54,21,2,9,-8,109
163,4,2,6,2,11,20,-35,2,4,12,74
163,5,4,2,7,6,43,24,5,8,55,98
163,6,4,3,7,6,43,-67,8,1,98,31
163,7,3,3,8,5,-65,32,3,3,33,63
163,8,4,3,8,5,44,32,7,5,77,95
163,9,4,3,8,5,-56,32,1,7,21,127
163,10,2,4,5,8,23,-56,4,1,44,71
163,11,4,2,9,4,45,22,9,3,89,93
163,12,3,3,7,6,-66,33,3,6,23,126
163,13,4,4,6,7,42,43,5,9,65,169
163,14,2,4,4,9,22,-55,7,4,87,114
163,15,2,5,5,8,-77,53,0,7,10,167
163,16,5,2,8,5,53,-77,3,0,63,90
163,17,2,4,4,9,22,45,5,5,85,135
163,18,3,3,8,5,-65,32,0,7,20,167
163,19,3,3,9,4,36,31,6,8,56,198
163,20,2,4,5,8,23,-56,9,2,79,142
163,21,4,2,8,5,-56,23,3,5,23,165
163,22,4,2,9,4,45,22,8,7,68,187
163,23,2,4,5,8,-77,-56,1,1,-9,131
163,24,3,4,6,7,33,43,4,4,24,174
163,25,4,3,6,7,42,34,6,8,66,208
163,26,2,5,3,10,21,-45,7,3,87,163
163,27,4,3,8,5,-56,32,1,5,31,195
163,28,4,2,8,5,44,23,5,8,75,218
163,29,2,4,6,7,24,-57,9,1,99,161
163,30,3,3,6,7,-67,34,2,5,32,195
163,31,5,2,11,2,56,20,8,5,88,215
163,32,5,2,9,4,-46,22,2,7,42,237
163,33,3,3,5,8,32,-65,4,2,74,172
163,34,2,5,3,10,21,55,5,7,95,227
163,35,3,4,5,8,32,-56,7,1,127,171
163,36,4,3,10,3,-54,30,3,1,73,201
163,37,2,4,4,9,22,45,5,6,95,246
163,38,3,3,7,6,34,33,9,9,129,279
163,39,2,4,6,7,-76,-57,3,2,53,222
163,40,2,5,4,9,22,54,5,6,75,276
163,41,3,4,7,6,34,42,9,8,109,318
163,42,2,4,6,7,-76,-57,3,1,33,261
163,43,2,5,3,10,21,55,4,6,54,316
163,44,4,3,8,5,44,32,8,8,98,348
163,45,3,3,5,8,-68,-65,0,3,30,283
163,46,3,3,6,7,33,34,3,7,63,317
163,47,4,3,10,3,46,30,9,7,109,347
163,48,3,3,5,8,-68,-65,1,2,41,282
163,49,4,2,7,6,43,24,4,6,84,306
163,50,3,4,7,6,34,42,8,8,118,348
163,51,4,3,7,6,-57,-67,1,1,61,281
163,52,4,3,5,8,41,35,2,6,102,316
163,53,2,5,4,9,22,-46,4,0,124,270
163,54,3,3,6,7,33,34,7,4,157,304
163,55,3,4,8,5,-65,41,2,5,92,345
163,56,3,4,7,6,34,42,6,7,126,387
163,57,3,4,5,8,32,-56,8,1,158,331
163,58,4,2,10,3,-54,21,4,2,104,352
163,59,4,3,7,6,43,33,7,5,147,385
163,60,3,3,6,7,-67,34,0,9,80,419
163,61,3,4,6,7,33,-57,3,2,113,362
163,62,5,2,10,3,55,21,8,3,168,383
163,63,4,3,6,7,-58,34,0,7,110,417
163,64,3,4,4,9,31,-55,1,2,141,362
163,65,3,4,5,8,32,44,3,6,173,406
163,66,3,3,3,10,30,-63,3,3,203,343
163,67,2,5,5,8,23,53,6,6,226,396
163,68,3,3,7,6,-66,33,0,9,160,429
163,69,3,4,7,6,34,-58,4,1,194,371
163,70,4,3,6,7,42,34,6,5,236,405
163,71,2,5,3,10,21,-45,7,0,257,360
163,72,2,4,7,6,-75,42,2,2,182,402
163,73,2,4,4,9,22,45,4,7,204,447
163,74,3,4,4,9,31,-55,5,2,235,392
163,75,3,4,5,8,32,44,7,6,267,436
163,76,3,3,7,6,-66,33,1,9,201,469
163,77,4,2,10,3,46,-79,7,0,247,390
163,78,3,3,7,6,-66,33,1,3,181,423
163,79,2,5,2,11,20,56,1,9,201,479
163,80,5,2,8,5,53,-77,4,2,254,402
163,81,2,5,4,9,22,54,6,6,276,456
163,82,5,2,9,4,-46,22,0,8,230,478
163,83,6,2,10,3,64,21,4,9,294,499
163,84,3,3,8,5,35,-68,9,1,329,431
163,85,6,2,11,2,-35,20,4,1,294,451
163,86,2,5,6,7,24,52,8,3,318,503
164,1,2,4,6,7,24,43,4,3,24,43
164,2,3,3,4,9,31,36,5,9,55,79
164,3,2,4,5,8,23,-56,8,3,78,23
164,4,3,4,3,10,30,46,8,9,108,69
164,5,4,2,5,8,41,-74,9,5,149,-5
164,6,3,4,5,8,-68,44,1,9,81,39
164,7,4,4,5,8,41,-56,2,3,122,-17
164,8,4,3,7,6,43,33,5,6,165,16
164,9,3,4,5,8,32,-56,7,0,197,-40
164,10,2,5,6,7,-76,52,1,2,121,12
164,11,3,4,4,9,31,45,2,7,152,57
164,12,4,2,8,5,44,-77,6,0,196,-20
164,13,3,4,6,7,33,43,9,3,229,23
164,14,4,3,9,4,-55,31,4,4,174,54
164,15,3,4,7,6,34,42,8,6,208,96
164,16,3,4,7,6,-66,42,2,8,142,138
164,17,2,4,5,8,23,-56,5,2,165,82
164,18,3,4,3,10,30,46,5,8,195,128
164,19,4,3,6,7,42,-66,7,2,237,62
164,20,2,4,3,10,21,46,8,8,258,108
164,21,3,4,6,7,-67,-57,1,1,191,51
164,22,3,4,6,7,33,43,4,4,224,94
164,23,3,4,6,7,33,43,7,7,257,137
164,24,2,4,4,9,22,-55,9,2,279,82
164,25,5,2,10,3,-45,21,4,3,234,103
164,26,5,3,10,3,55,30,9,3,289,133
164,27,4,3,8,5,-56,32,3,5,233,165
164,28,3,3,7,6,34,33,7,8,267,198
164,29,5,2,7,6,52,-76,9,2,319,122
164,30,5,2,10,3,-45,21,4,3,274,143
164,31,5,3,8,5,53,32,7,5,327,175
164,32,2,4,4,9,22,-55,9,0,349,120
164,33,3,3,9,4,-64,31,5,1,285,151
164,34,4,3,9,4,-55,31,0,2,230,182
164,35,4,2,7,6,43,24,3,6,273,206
164,36,3,4,3,10,30,-54,3,2,303,152
164,37,4,3,8,5,44,32,7,4,347,184
164,38,3,3,6,7,-67,34,0,8,280,218
164,39,2,4,4,9,22,-55,2,3,302,163
164,40,2,5,3,10,21,55,3,8,323,218
164,41,4,3,8,5,44,-68,7,0,367,150
164,42,3,3,6,7,-67,34,0,4,300,184
164,43,4,3,9,4,45,31,5,5,345,215
164,44,3,4,7,6,34,42,9,7,379,257
164,45,3,4,8,5,-65,41,4,8,314,298
164,46,5,2,9,4,54,-78,8,0,368,220
164,47,4,2,7,6,-57,24,1,4,311,244
164,48,3,4,7,6,34,42,5,6,345,286
164,49,2,5,7,6,-75,51,0,7,270,337
164,50,3,5,3,10,30,-45,0,2,300,292
164,51,3,4,6,7,33,43,3,5,333,335
164,52,4,3,6,7,42,34,5,9,375,369
164,53,2,4,4,9,22,-55,7,4,397,314
164,54,3,3,5,8,32,35,9,9,429,349
164,55,4,3,9,4,-55,-69,4,0,374,280
164,56,3,3,9,4,-64,31,0,1,310,311
164,57,2,4,5,8,23,44,3,5,333,355
164,58,2,4,6,7,24,43,7,8,357,398
164,59,5,2,8,5,-47,-77,0,1,310,321
164,60,3,4,5,8,32,44,2,5,342,365
164,61,4,3,4,9,40,-64,2,1,382,301
164,62,5,2,11,2,56,20,8,1,438,321
164,63,3,4,5,8,-68,44,0,5,370,365
164,64,6,2,9,4,63,22,3,7,433,387
164,65,2,5,4,9,22,-46,5,1,455,341
164,66,3,3,7,6,34,33,9,4,489,374
164,67,2,5,7,6,-75,51,4,5,414,425
164,68,2,5,4,9,22,54,6,9,436,479
164,69,3,3,7,6,-66,-67,0,2,370,412
164,70,4,2,9,4,45,22,5,4,415,434
164,71,4,2,5,8,41,-74,6,0,456,360
164,72,5,2,10,3,-45,21,1,1,411,381
164,73,4,2,6,7,42,25,3,6,453,406
164,74,4,2,10,3,46,21,9,7,499,427
164,75,3,3,5,8,-68,-65,1,2,431,362
164,76,4,2,8,5,44,23,5,5,475,385
164,77,3,4,6,7,33,43,8,8,508,428
165,1,2,5,5,8,23,53,3,3,23,53
165,2,5,2,11,2,56,20,9,3,79,73
165,3,4,3,5,8,-59,35,0,8,20,108
165,4,3,4,4,9,31,-55,1,3,51,53
165,5,3,4,3,10,30,46,1,9,81,99
165,6,3,4,5,8,32,-56,3,3,113,43
165,7,2,4,7,6,25,42,8,5,138,85
165,8,2,4,5,8,-77,44,1,9,61,129
165,9,2,4,3,10,21,-54,2,5,82,75
165,10,5,2,7,6,52,24,4,9,134,99
165,11,4,2,7,6,43,-76,7,3,177,23
165,12,3,4,7,6,-66,42,1,5,111,65
165,13,3,3,7,6,34,33,5,8,145,98
165,14,4,2,7,6,43,-76,8,2,188,22
165,15,4,2,8,5,-56,23,2,5,132,45
165,16,4,3,6,7,42,34,4,9,174,79
165,17,5,2,10,3,55,-79,9,0,229,0
165,18,2,5,4,9,-78,54,1,4,151,54
165,19,3,4,3,10,30,-54,1,0,181,0
165,20,5,2,8,5,53,23,4,3,234,23
165,21,2,5,6,7,24,52,8,5,258,75
165,22,3,4,3,10,30,-54,8,1,288,21
165,23,2,4,6,7,-76,43,2,4,212,64
165,24,3,3,6,7,33,34,5,8,245,98
165,25,4,3,5,8,41,-65,6,3,286,33
165,26,3,4,4,9,31,45,7,8,317,78
165,27,3,4,6,7,-67,-57,0,1,250,21
165,28,4,2,9,4,45,22,5,3,295,43
165,29,4,2,10,3,-54,21,1,4,241,64
165,30,2,5,8,5,26,50,7,4,267,114
165,31,3,3,4,9,31,-64,8,0,298,50
165,32,3,3,4,9,31,36,9,6,329,86
165,33,4,3,8,5,-56,32,3,8,273,118
165,34,3,3,6,7,33,-66,6,2,306,52
165,35,2,6,3,10,21,64,7,6,327,116
165,36,3,4,8,5,-65,41,2,7,262,157
165,37,2,4,5,8,23,-56,5,1,285,101
165,38,4,3,9,4,-55,31,0,2,230,132
165,39,4,2,7,6,43,24,3,6,273,156
165,40,4,3,8,5,44,32,7,8,317,188
165,41,5,2,6,7,51,-75,8,3,368,113
165,42,2,5,4,9,-78,54,0,7,290,167
165,43,3,3,5,8,32,-65,2,2,322,102
165,44,3,4,6,7,33,43,5,5,355,145
165,45,3,3,8,5,-65,32,0,7,290,177
165,46,3,4,7,6,34,42,4,9,324,219
165,47,4,2,9,4,45,-78,9,1,369,141
165,48,3,3,9,4,-64,31,5,2,305,172
165,49,2,4,6,7,24,43,9,5,329,215
165,50,4,3,6,7,-58,34,1,9,271,249
165,51,3,4,6,7,33,-57,4,2,304,192
165,52,3,4,7,6,34,42,8,4,338,234
165,53,2,4,7,6,-75,42,3,6,263,276
165,54,3,3,7,6,34,33,7,9,297,309
165,55,2,6,5,8,-77,-38,0,1,220,271
165,56,5,2,8,5,53,23,3,4,273,294
165,57,4,3,6,7,42,34,5,8,315,328
165,58,2,4,9,4,-73,40,2,8,242,368
165,59,4,3,5,8,41,-65,3,3,283,303
165,60,3,4,5,8,32,44,5,7,315,347
165,61,5,2,9,4,54,22,9,9,369,369
165,62,3,3,6,7,-67,-66,2,3,302,303
165,63,4,2,9,4,45,22,7,5,347,325
165,64,3,4,7,6,-66,42,1,7,281,367
165,65,2,4,4,9,22,-55,3,2,303,312
165,66,4,3,9,4,45,31,8,3,348,343
165,67,5,2,10,3,-45,21,3,4,303,364
165,68,3,4,7,6,34,42,7,6,337,406
165,69,3,3,7,6,-66,33,1,9,271,439
165,70,3,3,9,4,36,-69,7,0,307,370
165,71,3,3,4,9,31,36,8,6,338,406
165,72,3,3,9,4,-64,31,4,7,274,437
165,73,4,3,7,6,43,-67,7,0,317,370
165,74,3,3,3,10,30,37,7,7,347,407
165,75,3,3,9,4,-64,31,3,8,283,438
165,76,4,2,8,5,44,-77,7,1,327,361
165,77,2,5,2,11,20,56,7,7,347,417
165,78,2,5,5,8,-77,-47,0,0,270,370
165,79,3,3,6,7,33,34,3,4,303,404
165,80,3,3,7,6,34,33,7,7,337,437
165,81,3,3,7,6,-66,-67,1,0,271,370
165,82,4,3,8,5,44,32,5,2,315,402
165,83,5,2,8,5,53,23,8,5,368,425
165,84,5,2,9,4,-46,22,2,7,322,447
165,85,2,4,4,9,22,-55,4,2,344,392
165,86,3,3,3,10,30,37,4,9,374,429
165,87,4,3,9,4,45,-69,9,0,419,360
165,88,3,3,7,6,-66,33,3,3,353,393
165,89,3,4,7,6,34,42,7,5,387,435
165,90,3,3,5,8,32,-65,9,0,419,370
165,91,2,4,3,10,-79,46,0,6,340,416
165,92,2,4,6,7,24,43,4,9,364,459
165,93,2,4,5,8,23,-56,7,3,387,403
165,94,4,3,7,6,-57,33,0,6,330,436
165,95,3,4,5,8,32,-56,2,0,362,380
165,96,4,2,10,3,46,21,8,1,408,401
165,97,4,2,10,3,-54,21,4,2,354,422
165,98,4,3,6,7,42,34,6,6,396,456
165,99,2,4,4,9,22,-55,8,1,418,401
165,100,3,4,7,6,-66,42,2,3,352,443
165,101,3,4,4,9,31,45,3,8,383,488
165,102,4,4,6,7,42,-57,5,1,425,431
165,103,3,3,7,6,34,33,9,4,459,464
165,104,5,2,9,4,-46,22,3,6,413,486
165,105,4,2,10,3,46,21,9,7,459,507
166,1,2,5,3,10,21,55,1,5,21,55
166,2,4,3,8,5,44,32,5,7,65,87
166,3,2,4,3,10,21,-54,6,3,86,33
166,4,5,2,6,7,51,25,7,8,137,58
166,5,2,5,4,9,22,-46,9,2,159,12
166,6,3,4,4,9,-69,45,0,7,90,57
166,7,2,5,2,11,20,-44,0,3,110,13
166,8,3,4,9,4,36,40,6,3,146,53
166,9,3,4,7,6,-66,42,0,5,80,95
166,10,3,4,5,8,32,44,2,9,112,139
166,11,4,3,8,5,44,-68,6,1,156,71
166,12,5,2,10,3,-45,21,1,2,111,92
166,13,3,3,9,4,36,31,7,3,147,123
166,14,3,3,6,7,-67,34,0,7,80,157
166,15,3,4,8,5,35,41,5,8,115,198
166,16,3,3,5,8,32,-65,7,3,147,133
166,17,4,3,7,6,-57,33,0,6,90,166
166,18,3,3,6,7,33,-66,3,0,123,100
166,19,2,4,6,7,24,43,7,3,147,143
166,20,6,2,10,3,-36,21,1,4,111,164
166,21,5,2,9,4,54,22,5,6,165,186
166,22,3,3,6,7,33,-66,8,0,198,120
166,23,5,2,10,3,-45,21,3,1,153,141
166,24,4,2,9,4,45,22,8,3,198,163
166,25,3,3,9,4,-64,31,4,4,134,194
166,26,3,4,6,7,33,43,7,7,167,237
166,27,5,2,7,6,52,-76,9,1,219,161
166,28,4,3,9,4,-55,31,4,2,164,192
166,29,2,5,4,9,22,54,6,6,186,246
166,30,4,3,9,4,-55,31,1,7,131,277
166,31,3,4,6,7,33,-57,4,0,164,220
166,32,4,3,7,6,43,33,7,3,207,253
166,33,2,5,4,9,22,54,9,7,229,307
166,34,4,3,5,8,-59,-65,0,2,170,242
166,35,4,3,5,8,41,35,1,7,211,277
166,36,3,3,6,7,33,-66,4,1,244,211
166,37,5,2,11,2,-44,20,0,1,200,231
166,38,2,4,7,6,25,42,5,3,225,273
166,39,5,2,10,3,-45,21,0,4,180,294
166,40,5,2,10,3,55,21,5,5,235,315
166,41,4,3,6,7,42,34,7,9,277,349
166,42,3,3,7,6,-66,-67,1,2,211,282
166,43,2,5,4,9,22,54,3,6,233,336
166,44,2,5,7,6,25,51,8,7,258,387
166,45,5,2,10,3,-45,21,3,8,213,408
166,46,3,4,5,8,32,-56,5,2,245,352
166,47,3,4,7,6,34,42,9,4,279,394
166,48,4,3,9,4,-55,31,4,5,224,425
166,49,2,4,5,8,23,44,7,9,247,469
166,50,5,2,9,4,-46,-78,1,1,201,391
166,51,3,4,6,7,33,43,4,4,234,434
166,52,2,4,5,8,23,44,7,8,257,478
166,53,2,4,4,9,22,-55,9,3,279,423
166,54,4,2,9,4,-55,22,4,5,224,445
166,55,5,2,10,3,55,21,9,6,279,466
166,56,2,4,6,7,-76,43,3,9,203,509
167,1,4,3,9,4,45,31,5,1,45,31
167,2,4,2,9,4,-55,22,0,3,-10,53
167,3,2,6,4,9,22,63,2,6,12,116
167,4,2,4,7,6,25,42,7,8,37,158
167,5,5,2,10,3,-45,21,2,9,-8,179
167,6,3,3,7,6,34,-67,6,2,26,112
167,7,4,3,8,5,-56,32,0,4,-30,144
167,8,2,5,3,10,21,55,1,9,-9,199
167,9,3,3,5,8,32,-65,3,4,23,134
167,10,3,3,6,7,33,34,6,8,56,168
167,11,2,6,3,10,21,-36,7,2,77,132
167,12,3,3,8,5,-65,32,2,4,12,164
167,13,3,4,4,9,31,45,3,9,43,209
167,14,3,4,6,7,33,-57,6,2,76,152
167,15,3,4,6,7,33,43,9,5,109,195
167,16,4,2,7,6,-57,24,2,9,52,219
167,17,4,3,5,8,41,-65,3,4,93,154
167,18,4,2,8,5,44,23,7,7,137,177
167,19,3,3,6,7,-67,-66,0,1,70,111
167,20,4,2,10,3,46,21,6,2,116,132
167,21,5,2,11,2,-44,20,2,2,72,152
167,22,3,3,7,6,34,33,6,5,106,185
167,23,2,4,5,8,23,44,9,9,129,229
167,24,3,4,7,6,-66,-58,3,1,63,171
167,25,5,2,9,4,54,22,7,3,117,193
167,26,4,2,6,7,42,25,9,8,159,218
167,27,4,2,8,5,-56,-77,3,1,103,141
167,28,4,2,6,7,42,25,5,6,145,166
167,29,3,4,8,5,-65,41,0,7,80,207
167,30,2,5,2,11,20,-44,0,3,100,163
167,31,3,3,8,5,35,32,5,5,135,195
167,32,2,4,6,7,24,43,9,8,159,238
167,33,5,2,9,4,-46,-78,3,0,113,160
167,34,3,3,7,6,34,33,7,3,147,193
167,35,3,4,6,7,-67,43,0,6,80,236
167,36,4,3,7,6,43,33,3,9,123,269
167,37,4,2,8,5,44,-77,7,2,167,192
167,38,3,4,4,9,31,45,8,7,198,237
167,39,5,2,9,4,-46,22,2,9,152,259
167,40,3,3,5,8,32,-65,4,4,184,194
167,41,4,2,8,5,44,23,8,7,228,217
167,42,3,3,6,7,-67,-66,1,1,161,151
167,43,3,3,8,5,35,32,6,3,196,183
167,44,6,2,10,3,-36,21,0,4,160,204
167,45,4,2,9,4,45,22,5,6,205,226
167,46,3,4,5,8,32,-56,7,0,237,170
167,47,4,3,9,4,-55,31,2,1,182,201
167,48,3,3,8,5,35,32,7,3,217,233
167,49,3,3,6,7,-67,34,0,7,150,267
167,50,4,2,8,5,44,-77,4,0,194,190
167,51,2,4,5,8,23,44,7,4,217,234
167,52,4,3,9,4,-55,31,2,5,162,265
167,53,4,2,8,5,44,23,6,8,206,288
167,54,4,3,9,4,-55,31,1,9,151,319
167,55,3,3,9,4,36,-69,7,0,187,250
167,56,5,2,10,3,-45,21,2,1,142,271
167,57,2,5,5,8,23,53,5,4,165,324
167,58,3,3,7,6,34,33,9,7,199,357
167,59,3,3,6,7,-67,-66,2,1,132,291
167,60,3,3,6,7,33,34,5,5,165,325
167,61,4,3,9,4,-55,31,0,6,110,356
167,62,4,2,7,6,43,-76,3,0,153,280
167,63,3,3,6,7,33,34,6,4,186,314
167,64,4,3,7,6,43,33,9,7,229,347
167,65,2,5,4,9,-78,-46,1,1,151,301
167,66,5,2,10,3,55,21,6,2,206,322
167,67,3,4,6,7,33,43,9,5,239,365
167,68,4,2,8,5,-56,23,3,8,183,388
167,69,2,5,2,11,20,-44,3,4,203,344
167,70,3,3,7,6,34,33,7,7,237,377
167,71,4,2,10,3,-54,21,3,8,183,398
167,72,3,3,8,5,35,-68,8,0,218,330
167,73,4,3,7,6,-57,33,1,3,161,363
167,74,2,5,3,10,21,55,2,8,182,418
167,75,4,3,8,5,44,-68,6,0,226,350
167,76,4,3,7,6,43,33,9,3,269,383
167,77,4,2,4,9,40,-73,9,0,309,310
167,78,3,4,7,6,-66,42,3,2,243,352
167,79,3,3,9,4,36,31,9,3,279,383
167,80,2,5,2,11,20,56,9,9,299,439
167,81,3,3,7,6,-66,-67,3,2,233,372
167,82,3,3,7,6,34,33,7,5,267,405
167,83,4,4,8,5,-56,41,1,6,211,446
167,84,3,3,7,6,34,33,5,9,245,479
167,85,4,2,8,5,44,-77,9,2,289,402
167,86,4,3,4,9,40,36,9,8,329,438
167,87,2,4,6,7,-76,-57,3,1,253,381
167,88,2,4,4,9,22,45,5,6,275,426
167,89,4,3,7,6,43,33,8,9,318,459
167,90,4,3,7,6,-57,-67,1,2,261,392
167,91,2,4,5,8,23,44,4,6,284,436
167,92,3,4,7,6,34,42,8,8,318,478
167,93,2,4,3,10,21,-54,9,4,339,424
167,94,3,3,6,7,-67,34,2,8,272,458
167,95,3,3,8,5,35,-68,7,0,307,390
167,96,4,3,7,6,-57,33,0,3,250,423
167,97,3,3,7,6,34,33,4,6,284,456
167,98,5,2,9,4,54,22,8,8,338,478
167,99,2,4,7,6,-75,-58,3,0,263,420
167,100,3,3,7,6,34,33,7,3,297,453
167,101,3,3,7,6,-66,33,1,6,231,486
167,102,3,3,8,5,35,32,6,8,266,518
168,1,2,4,3,10,21,46,1,6,21,46
168,2,3,3,7,6,34,33,5,9,55,79
168,3,2,5,5,8,23,-47,8,2,78,32
168,4,4,3,6,7,-58,34,0,6,20,66
168,5,2,4,4,9,22,-55,2,1,42,11
168,6,3,4,7,6,34,42,6,3,76,53
168,7,4,3,6,7,42,34,8,7,118,87
168,8,3,3,6,7,-67,-66,1,1,51,21
168,9,3,4,4,9,31,45,2,6,82,66
168,10,2,4,5,8,23,-56,5,0,105,10
168,11,4,4,4,9,40,45,5,5,145,55
168,12,4,3,9,4,-55,31,0,6,90,86
168,13,3,4,8,5,35,41,5,7,125,127
168,14,2,5,5,8,23,-47,8,0,148,80
168,15,4,2,8,5,-56,23,2,3,92,103
168,16,3,3,5,8,32,35,4,8,124,138
168,17,3,4,4,9,31,-55,5,3,155,83
168,18,3,3,4,9,31,36,6,9,186,119
168,19,2,4,4,9,22,-55,8,4,208,64
168,20,2,5,6,7,-76,52,2,6,132,116
168,21,2,4,6,7,24,43,6,9,156,159
168,22,3,4,6,7,33,-57,9,2,189,102
168,23,2,5,5,8,-77,53,2,5,112,155
168,24,4,2,10,3,46,21,8,6,158,176
168,25,4,3,4,9,40,-64,8,2,198,112
168,26,3,4,6,7,-67,43,1,5,131,155
168,27,3,5,3,10,30,-45,1,0,161,110
168,28,3,3,5,8,32,35,3,5,193,145
168,29,5,2,10,3,55,21,8,6,248,166
168,30,5,2,11,2,-44,20,4,6,204,186
168,31,4,3,7,6,43,33,7,9,247,219
168,32,3,3,7,6,-66,-67,1,2,181,152
168,33,2,4,6,7,24,43,5,5,205,195
168,34,4,3,7,6,43,33,8,8,248,228
168,35,2,4,3,10,21,-54,9,4,269,174
168,36,3,4,4,9,-69,45,0,9,200,219
168,37,2,5,3,10,21,-45,1,4,221,174
168,38,5,2,10,3,55,21,6,5,276,195
168,39,3,3,4,9,31,-64,7,1,307,131
168,40,5,2,8,5,-47,23,0,4,260,154
168,41,4,3,8,5,44,32,4,6,304,186
168,42,3,3,6,7,33,-66,7,0,337,120
168,43,2,4,5,8,-77,44,0,4,260,164
168,44,4,2,8,5,44,23,4,7,304,187
168,45,5,2,9,4,54,22,8,9,358,209
168,46,3,3,5,8,-68,-65,0,4,290,144
168,47,4,2,9,4,45,22,5,6,335,166
168,48,4,2,7,6,43,-76,8,0,378,90
168,49,2,5,6,7,-76,52,2,2,302,142
168,50,2,4,4,9,22,45,4,7,324,187
168,51,3,4,6,7,33,-57,7,0,357,130
168,52,4,4,8,5,-56,41,1,1,301,171
168,53,4,2,10,3,46,21,7,2,347,192
168,54,2,4,4,9,22,45,9,7,369,237
168,55,4,2,7,6,-57,-76,2,1,312,161
168,56,3,3,7,6,34,33,6,4,346,194
168,57,5,2,8,5,53,23,9,7,399,217
168,58,3,4,4,9,-69,-55,0,2,330,162
168,59,3,3,5,8,32,35,2,7,362,197
168,60,3,3,9,4,36,31,8,8,398,228
168,61,3,3,5,8,-68,-65,0,3,330,163
168,62,3,3,7,6,34,33,4,6,364,196
168,63,2,5,4,9,22,-46,6,0,386,150
168,64,3,3,8,5,-65,32,1,2,321,182
168,65,4,3,7,6,43,33,4,5,364,215
168,66,3,3,4,9,31,-64,5,1,395,151
168,67,4,2,10,3,-54,21,1,2,341,172
168,68,4,3,9,4,45,31,6,3,386,203
168,69,6,2,10,3,-36,21,0,4,350,224
168,70,4,2,9,4,45,22,5,6,395,246
168,71,4,2,10,3,-54,21,1,7,341,267
168,72,4,3,7,6,43,-67,4,0,384,200
168,73,4,3,7,6,43,33,7,3,427,233
168,74,2,5,2,11,20,56,7,9,447,289
168,75,3,3,3,10,30,-63,7,6,477,226
168,76,3,3,6,7,-67,-66,0,0,410,160
168,77,4,3,7,6,43,33,3,3,453,193
168,78,3,3,4,9,31,36,4,9,484,229
168,79,3,3,10,3,-63,30,1,9,421,259
168,80,3,3,9,4,36,-69,7,0,457,190
168,81,4,3,7,6,-57,33,0,3,400,223
168,82,5,2,10,3,55,21,5,4,455,244
168,83,3,3,7,6,34,33,9,7,489,277
168,84,4,3,10,3,-54,30,5,7,435,307
168,85,4,3,7,6,43,-67,8,0,478,240
168,86,5,3,8,5,-47,32,1,2,431,272
168,87,2,4,5,8,23,44,4,6,454,316
168,88,3,4,8,5,35,41,9,7,489,357
168,89,2,5,6,7,-76,52,3,9,413,409
168,90,5,2,10,3,55,-79,8,0,468,330
168,91,4,2,7,6,-57,24,1,4,411,354
168,92,3,3,8,5,35,32,6,6,446,386
168,93,3,3,6,7,33,-66,9,0,479,320
168,94,3,3,7,6,-66,33,3,3,413,353
168,95,4,3,8,5,44,32,7,5,457,385
168,96,3,3,8,5,-65,32,2,7,392,417
168,97,3,3,3,10,30,-63,2,4,422,354
168,98,4,3,8,5,44,32,6,6,466,386
168,99,4,3,7,6,43,33,9,9,509,419
169,1,4,2,5,8,41,26,1,6,41,26
169,2,3,4,3,10,30,-54,1,2,71,-28
169,3,3,5,3,10,30,55,1,7,101,27
169,4,2,4,4,9,22,-55,3,2,123,-28
169,5,3,4,4,9,31,45,4,7,154,17
169,6,4,3,6,7,42,-66,6,1,196,-49
169,7,3,5,5,8,32,53,8,4,228,4
169,8,5,2,9,4,-46,22,2,6,182,26
169,9,2,5,4,9,22,-46,4,0,204,-20
169,10,3,3,9,4,-64,31,0,1,140,11
169,11,6,2,10,3,64,21,4,2,204,32
169,12,4,3,9,4,45,31,9,3,249,63
169,13,4,3,5,8,-59,35,0,8,190,98
169,14,3,3,7,6,34,-67,4,1,224,31
169,15,4,3,7,6,43,33,7,4,267,64
169,16,4,3,10,3,-54,30,3,4,213,94
169,17,3,4,9,4,36,40,9,4,249,134
169,18,6,2,10,3,-36,21,3,5,213,155
169,19,4,2,9,4,45,22,8,7,258,177
169,20,2,4,5,8,-77,-56,1,1,181,121
169,21,6,2,9,4,63,22,4,3,244,143
169,22,2,4,7,6,25,42,9,5,269,185
169,23,4,3,9,4,-55,31,4,6,214,216
169,24,3,3,5,8,32,-65,6,1,246,151
169,25,4,2,6,7,42,25,8,6,288,176
169,26,5,2,9,4,-46,22,2,8,242,198
169,27,2,5,3,10,21,-45,3,3,263,153
169,28,2,5,4,9,22,54,5,7,285,207
169,29,4,3,7,6,43,-67,8,0,328,140
169,30,4,3,5,8,41,35,9,5,369,175
169,31,3,4,6,7,-67,43,2,8,302,218
169,32,4,2,8,5,44,-77,6,1,346,141
169,33,4,2,6,7,42,25,8,6,388,166
169,34,2,4,4,9,-78,-55,0,1,310,111
169,35,2,4,5,8,23,44,3,5,333,155
169,36,3,3,7,6,34,33,7,8,367,188
169,37,3,3,5,8,32,-65,9,3,399,123
169,38,3,3,6,7,-67,34,2,7,332,157
169,39,3,4,7,6,34,42,6,9,366,199
169,40,4,2,4,9,40,-73,6,6,406,126
169,41,3,3,6,7,33,-66,9,0,439,60
169,42,2,5,4,9,-78,54,1,4,361,114
169,43,2,4,6,7,24,43,5,7,385,157
169,44,3,3,8,5,-65,32,0,9,320,189
169,45,3,3,7,6,34,-67,4,2,354,122
169,46,5,2,10,3,55,21,9,3,409,143
169,47,2,5,4,9,-78,54,1,7,331,197
169,48,5,2,8,5,53,-77,4,0,384,120
169,49,2,6,3,10,21,64,5,4,405,184
169,50,2,5,3,10,21,55,6,9,426,239
169,51,2,5,3,10,21,-45,7,4,447,194
169,52,4,3,7,6,-57,33,0,7,390,227
169,53,4,2,7,6,43,-76,3,1,433,151
169,54,3,3,9,4,36,31,9,2,469,182
169,55,2,5,4,9,-78,54,1,6,391,236
169,56,3,3,5,8,32,-65,3,1,423,171
169,57,3,3,7,6,34,33,7,4,457,204
169,58,5,2,9,4,-46,22,1,6,411,226
169,59,3,3,4,9,31,-64,2,2,442,162
169,60,2,5,4,9,22,54,4,6,464,216
169,61,2,4,5,8,23,-56,7,0,487,160
169,62,4,3,8,5,-56,32,1,2,431,192
169,63,3,3,4,9,31,36,2,8,462,228
169,64,3,4,4,9,31,-55,3,3,493,173
169,65,3,3,8,5,35,32,8,5,528,205
170,1,4,2,7,6,43,24,3,4,43,24
170,2,4,3,8,5,44,32,7,6,87,56
170,3,3,3,6,7,-67,-66,0,0,20,-10
170,4,2,4,4,9,22,45,2,5,42,35
170,5,4,3,7,6,43,33,5,8,85,68
170,6,3,3,4,9,31,-64,6,4,116,4
170,7,3,3,6,7,33,34,9,8,149,38
170,8,3,3,5,8,-68,-65,1,3,81,-27
170,9,3,4,7,6,34,42,5,5,115,15
170,10,4,2,5,8,41,-74,6,1,156,-59
170,11,5,2,8,5,53,23,9,4,209,-36
170,12,3,4,5,8,-68,44,1,8,141,8
170,13,5,2,10,3,55,21,6,9,196,29
170,14,4,3,8,5,-56,-68,0,1,140,-39
170,15,4,3,7,6,43,33,3,4,183,-6
170,16,2,4,6,7,24,43,7,7,207,37
170,17,4,3,7,6,-57,-67,0,0,150,-30
170,18,3,3,5,8,32,35,2,5,182,5
170,19,2,4,5,8,23,44,5,9,205,49
170,20,4,2,8,5,44,-77,9,2,249,-28
170,21,2,4,7,6,-75,42,4,4,174,14
170,22,3,3,5,8,32,35,6,9,206,49
170,23,3,5,3,10,30,-45,6,4,236,4
170,24,2,4,7,6,-75,42,1,6,161,46
170,25,2,4,8,5,26,41,7,7,187,87
170,26,2,5,5,8,-77,-47,0,0,110,40
170,27,3,3,6,7,33,34,3,4,143,74
170,28,4,2,8,5,44,23,7,7,187,97
170,29,3,3,5,8,32,-65,9,2,219,32
170,30,4,2,10,3,-54,21,5,3,165,53
170,31,4,2,8,5,44,23,9,6,209,76
170,32,3,3,7,6,-66,33,3,9,143,109
170,33,4,3,9,4,45,-69,8,0,188,40
170,34,3,4,7,6,-66,42,2,2,122,82
170,35,3,4,7,6,34,42,6,4,156,124
170,36,3,4,7,6,-66,42,0,6,90,166
170,37,5,2,9,4,54,22,4,8,144,188
170,38,3,3,6,7,33,-66,7,2,177,122
170,39,4,3,8,5,-56,32,1,4,121,154
170,40,2,4,3,10,21,-54,2,0,142,100
170,41,3,3,9,4,36,31,8,1,178,131
170,42,3,3,4,9,31,36,9,7,209,167
170,43,3,5,5,8,-68,-47,1,0,141,120
170,44,2,4,6,7,24,43,5,3,165,163
170,45,4,3,9,4,-55,31,0,4,110,194
170,46,3,4,5,8,32,44,2,8,142,238
170,47,3,3,4,9,31,-64,3,4,173,174
170,48,4,2,6,7,42,25,5,9,215,199
170,49,5,3,8,5,53,-68,8,1,268,131
170,50,3,3,5,8,-68,35,0,6,200,166
170,51,2,4,4,9,22,-55,2,1,222,111
170,52,2,4,2,11,20,47,2,8,242,158
170,53,4,4,4,9,40,-55,2,3,282,103
170,54,5,2,11,2,56,20,8,3,338,123
170,55,5,2,7,6,-48,24,0,7,290,147
170,56,3,4,4,9,31,-55,1,2,321,92
170,57,4,3,7,6,43,33,4,5,364,125
170,58,4,3,8,5,44,32,8,7,408,157
170,59,3,4,7,6,-66,42,2,9,342,199
170,60,3,3,8,5,35,-68,7,1,377,131
170,61,4,3,8,5,-56,32,1,3,321,163
170,62,2,4,6,7,24,43,5,6,345,206
170,63,3,4,7,6,34,42,9,8,379,248
170,64,3,4,5,8,-68,-56,1,2,311,192
170,65,4,2,9,4,45,22,6,4,356,214
170,66,4,3,5,8,41,35,7,9,397,249
170,67,4,2,7,6,-57,-76,0,3,340,173
170,68,2,4,4,9,22,45,2,8,362,218
170,69,5,2,7,6,52,-76,4,2,414,142
170,70,2,5,5,8,23,53,7,5,437,195
170,71,3,4,4,9,31,-55,8,0,468,140
170,72,4,3,8,5,-56,32,2,2,412,172
170,73,2,4,6,7,24,43,6,5,436,215
170,74,2,4,6,7,-76,43,0,8,360,258
170,75,4,3,6,7,42,-66,2,2,402,192
170,76,3,4,4,9,31,45,3,7,433,237
170,77,5,3,9,4,54,31,7,8,487,268
170,78,4,3,6,7,42,-66,9,2,529,202
171,1,4,2,6,7,42,25,2,5,42,25
171,2,2,4,9,4,27,40,9,5,69,65
171,3,4,4,8,5,-56,41,3,6,13,106
171,4,4,3,9,4,45,31,8,7,58,137
171,5,4,2,7,6,-57,-76,1,1,1,61
171,6,4,2,7,6,43,24,4,5,44,85
171,7,3,3,5,8,32,-65,6,0,76,20
171,8,4,3,5,8,41,35,7,5,117,55
171,9,3,3,5,8,32,-65,9,0,149,-10
171,10,3,4,7,6,-66,42,3,2,83,32
171,11,4,2,7,6,43,24,6,6,126,56
171,12,3,3,8,5,-65,32,1,8,61,88
171,13,3,4,5,8,32,-56,3,2,93,32
171,14,3,4,4,9,31,45,4,7,124,77
171,15,2,5,4,9,22,-46,6,1,146,31
171,16,3,4,5,8,32,44,8,5,178,75
171,17,4,3,7,6,-57,33,1,8,121,108
171,18,3,3,5,8,32,-65,3,3,153,43
171,19,4,3,7,6,43,33,6,6,196,76
171,20,3,3,7,6,-66,33,0,9,130,109
171,21,5,2,9,4,54,-78,4,1,184,31
171,22,4,3,5,8,41,35,5,6,225,66
171,23,4,3,7,6,43,33,8,9,268,99
171,24,4,3,6,7,-58,-66,0,3,210,33
171,25,2,4,4,9,22,45,2,8,232,78
171,26,4,2,7,6,43,-76,5,2,275,2
171,27,2,4,4,9,22,45,7,7,297,47
171,28,4,3,9,4,-55,31,2,8,242,78
171,29,4,2,7,6,43,-76,5,2,285,2
171,30,5,2,10,3,-45,21,0,3,240,23
171,31,4,3,8,5,44,32,4,5,284,55
171,32,2,5,4,9,22,54,6,9,306,109
171,33,3,4,6,7,33,-57,9,2,339,52
171,34,4,2,7,6,-57,24,2,6,282,76
171,35,4,3,7,6,43,33,5,9,325,109
171,36,4,3,7,6,43,-67,8,2,368,42
171,37,4,2,10,3,-54,21,4,3,314,63
171,38,4,3,8,5,44,32,8,5,358,95
171,39,3,4,7,6,-66,42,2,7,292,137
171,40,4,3,10,3,46,30,8,7,338,167
171,41,4,3,8,5,-56,32,2,9,282,199
171,42,2,4,7,6,25,-58,7,1,307,141
171,43,3,3,7,6,-66,33,1,4,241,174
171,44,4,2,9,4,45,22,6,6,286,196
171,45,3,3,6,7,33,-66,9,0,319,130
171,46,4,3,5,8,-59,35,0,5,260,165
171,47,5,3,7,6,52,33,2,8,312,198
171,48,2,4,7,6,25,-58,7,0,337,140
171,49,3,5,5,8,32,53,9,3,369,193
171,50,3,4,6,7,-67,43,2,6,302,236
171,51,4,3,8,5,44,32,6,8,346,268
171,52,2,4,2,11,20,-53,6,5,366,215
171,53,2,4,6,7,-76,43,0,8,290,258
171,54,4,2,5,8,41,-74,1,4,331,184
171,55,3,4,6,7,33,43,4,7,364,227
171,56,3,3,7,6,34,-67,8,0,398,160
171,57,4,3,6,7,-58,34,0,4,340,194
171,58,3,3,6,7,33,34,3,8,373,228
171,59,3,3,7,6,34,-67,7,1,407,161
171,60,2,5,2,11,20,56,7,7,427,217
171,61,3,4,7,6,-66,42,1,9,361,259
171,62,4,3,8,5,44,-68,5,1,405,191
171,63,2,5,6,7,24,52,9,3,429,243
171,64,5,2,7,6,-48,24,1,7,381,267
171,65,3,3,5,8,32,-65,3,2,413,202
171,66,2,4,3,10,21,46,4,8,434,248
171,67,3,3,8,5,35,-68,9,0,469,180
171,68,4,3,8,5,-56,32,3,2,413,212
171,69,2,5,4,9,22,54,5,6,435,266
171,70,5,2,8,5,53,23,8,9,488,289
171,71,3,3,4,9,31,-64,9,5,519,225
172,1,3,4,4,9,31,45,1,5,31,45
172,2,2,5,5,8,23,53,4,8,54,98
172,3,3,3,8,5,35,-68,9,0,89,30
172,4,4,2,7,6,-57,24,2,4,32,54
172,5,4,3,6,7,42,34,4,8,74,88
172,6,4,2,8,5,44,-77,8,1,118,11
172,7,2,5,3,10,21,55,9,6,139,66
172,8,2,5,6,7,-76,52,3,8,63,118
172,9,3,4,5,8,32,-56,5,2,95,62
172,10,3,4,4,9,31,45,6,7,126,107
172,11,5,2,9,4,-46,22,0,9,80,129
172,12,2,5,4,9,22,-46,2,3,102,83
172,13,4,3,8,5,44,32,6,5,146,115
172,14,3,3,7,6,-66,33,0,8,80,148
172,15,2,4,3,10,21,-54,1,4,101,94
172,16,5,2,9,4,54,22,5,6,155,116
172,17,2,4,7,6,-75,42,0,8,80,158
172,18,3,4,5,8,32,-56,2,2,112,102
172,19,3,3,7,6,34,33,6,5,146,135
172,20,5,2,8,5,53,23,9,8,199,158
172,21,4,3,7,6,-57,-67,2,1,142,91
172,22,3,4,4,9,31,45,3,6,173,136
172,23,3,3,6,7,33,-66,6,0,206,70
172,24,3,3,4,9,31,36,7,6,237,106
172,25,2,4,6,7,-76,43,1,9,161,149
172,26,3,4,7,6,34,-58,5,1,195,91
172,27,3,3,8,5,-65,32,0,3,130,123
172,28,3,3,8,5,35,32,5,5,165,155
172,29,3,4,7,6,34,42,9,7,199,197
172,30,3,3,7,6,-66,-67,3,0,133,130
172,31,4,2,9,4,45,22,8,2,178,152
172,32,4,3,8,5,-56,32,2,4,122,184
172,33,4,3,10,3,46,30,8,4,168,214
172,34,4,2,7,6,-57,24,1,8,111,238
172,35,2,5,8,5,26,50,7,8,137,288
172,36,3,3,6,7,-67,-66,0,2,70,222
172,37,2,4,3,10,21,46,1,8,91,268
172,38,3,4,5,8,32,-56,3,2,123,212
172,39,2,4,8,5,26,41,9,3,149,253
172,40,5,2,10,3,-45,21,4,4,104,274
172,41,5,2,11,2,-44,20,0,4,60,294
172,42,2,4,6,7,24,43,4,7,84,337
172,43,4,3,6,7,42,-66,6,1,126,271
172,44,3,3,7,6,-66,33,0,4,60,304
172,45,4,3,8,5,44,32,4,6,104,336
172,46,2,5,4,9,22,-46,6,0,126,290
172,47,3,3,7,6,-66,33,0,3,60,323
172,48,4,2,10,3,46,21,6,4,106,344
172,49,4,3,7,6,43,33,9,7,149,377
172,50,4,2,8,5,-56,-77,3,0,93,300
172,51,2,5,5,8,23,53,6,3,116,353
172,52,3,4,4,9,31,45,7,8,147,398
172,53,3,4,5,8,32,-56,9,2,179,342
172,54,4,2,7,6,-57,24,2,6,122,366
172,55,3,3,10,3,37,30,9,6,159,396
172,56,3,4,5,8,-68,-56,1,0,91,340
172,57,5,2,8,5,53,23,4,3,144,363
172,58,2,4,7,6,25,42,9,5,169,405
172,59,2,4,5,8,-77,44,2,9,92,449
172,60,2,6,6,7,24,-39,6,0,116,410
172,61,3,3,5,8,32,35,8,5,148,445
172,62,2,4,4,9,-78,-55,0,0,70,390
172,63,4,3,9,4,45,31,5,1,115,421
172,64,4,2,6,7,42,25,7,6,157,446
172,65,4,3,7,6,-57,33,0,9,100,479
172,66,3,4,6,7,33,-57,3,2,133,422
172,67,4,2,6,7,42,25,5,7,175,447
172,68,4,2,8,5,44,-77,9,0,219,370
172,69,3,4,4,9,-69,45,0,5,150,415
172,70,4,3,7,6,43,33,3,8,193,448
172,71,6,2,10,3,64,21,7,9,257,469
172,72,4,3,10,3,-54,30,3,9,203,499
172,73,4,3,9,4,45,-69,8,0,248,430
172,74,3,4,6,7,-67,43,1,3,181,473
172,75,2,4,3,10,21,46,2,9,202,519
173,1,2,4,7,6,25,42,5,2,25,42
173,2,3,3,8,5,-65,32,0,4,-40,74
173,3,4,3,7,6,43,33,3,7,3,107
173,4,4,3,7,6,43,-67,6,0,46,40
173,5,2,4,8,5,-74,41,2,1,-28,81
173,6,3,4,4,9,31,45,3,6,3,126
173,7,5,2,8,5,53,23,6,9,56,149
173,8,4,4,5,8,41,-56,7,3,97,93
173,9,4,2,9,4,-55,22,2,5,42,115
173,10,3,3,3,10,30,-63,2,2,72,52
173,11,3,3,7,6,34,33,6,5,106,85
173,12,3,3,8,5,-65,32,1,7,41,117
173,13,4,2,6,7,42,-75,3,2,83,42
173,14,5,2,7,6,52,24,5,6,135,66
173,15,4,3,5,8,41,-65,6,1,176,1
173,16,3,4,6,7,33,43,9,4,209,44
173,17,5,2,8,5,-47,23,2,7,162,67
173,18,2,5,4,9,22,-46,4,1,184,21
173,19,3,4,4,9,31,45,5,6,215,66
173,20,3,4,7,6,34,42,9,8,249,108
173,21,2,5,5,8,-77,-47,2,1,172,61
173,22,3,3,7,6,34,33,6,4,206,94
173,23,3,3,3,10,30,-63,6,1,236,31
173,24,3,4,5,8,32,44,8,5,268,75
173,25,4,3,6,7,-58,34,0,9,210,109
173,26,4,3,8,5,44,-68,4,1,254,41
173,27,2,5,3,10,21,55,5,6,275,96
173,28,4,2,8,5,44,23,9,9,319,119
173,29,3,4,5,8,-68,-56,1,3,251,63
173,30,3,3,4,9,31,36,2,9,282,99
173,31,2,4,6,7,24,-57,6,2,306,42
173,32,3,3,6,7,33,34,9,6,339,76
173,33,3,4,5,8,-68,-56,1,0,271,20
173,34,3,3,7,6,34,33,5,3,305,53
173,35,3,4,7,6,34,42,9,5,339,95
173,36,3,4,3,10,30,-54,9,1,369,41
173,37,3,4,4,9,-69,45,0,6,300,86
173,38,3,4,6,7,33,43,3,9,333,129
173,39,5,2,9,4,54,-78,7,1,387,51
173,40,4,3,5,8,41,35,8,6,428,86
173,41,5,2,10,3,-45,21,3,7,383,107
173,42,4,2,6,7,42,-75,5,2,425,32
173,43,2,4,7,6,-75,42,0,4,350,74
173,44,5,2,8,5,53,23,3,7,403,97
173,45,5,2,10,3,55,21,8,8,458,118
173,46,3,3,7,6,-66,-67,2,1,392,51
173,47,4,2,9,4,45,22,7,3,437,73
173,48,3,4,4,9,31,45,8,8,468,118
173,49,4,2,7,6,-57,-76,1,2,411,42
173,50,2,5,3,10,21,55,2,7,432,97
173,51,3,3,7,6,34,-67,6,0,466,30
173,52,4,4,6,7,42,43,8,3,508,73
174,1,2,5,5,8,23,53,3,3,23,53
174,2,3,3,9,4,36,31,9,4,59,84
174,3,2,5,7,6,-75,51,4,5,-16,135
174,4,5,2,7,6,52,24,6,9,36,159
174,5,3,4,6,7,33,-57,9,2,69,102
174,6,4,2,7,6,-57,24,2,6,12,126
174,7,3,3,7,6,34,33,6,9,46,159
174,8,5,2,10,3,-45,-79,1,0,1,80
174,9,3,4,6,7,33,43,4,3,34,123
174,10,4,3,11,2,-53,-30,1,3,-19,93
174,11,3,3,4,9,31,36,2,9,12,129
174,12,3,3,6,7,33,-66,5,3,45,63
174,13,3,4,6,7,33,43,8,6,78,106
174,14,4,3,6,7,-58,-66,0,0,20,40
174,15,4,3,9,4,45,31,5,1,65,71
174,16,3,3,8,5,-65,32,0,3,0,103
174,17,3,4,4,9,31,45,1,8,31,148
174,18,3,4,7,6,34,-58,5,0,65,90
174,19,3,3,9,4,-64,31,1,1,1,121
174,20,2,5,4,9,22,54,3,5,23,175
174,21,4,2,8,5,44,23,7,8,67,198
174,22,3,4,5,8,32,-56,9,2,99,142
174,23,4,3,8,5,-56,32,3,4,43,174
174,24,3,3,7,6,34,33,7,7,77,207
174,25,2,4,5,8,-77,-56,0,1,0,151
174,26,3,3,8,5,35,32,5,3,35,183
174,27,3,4,3,10,30,46,5,9,65,229
174,28,4,3,7,6,43,-67,8,2,108,162
174,29,5,2,9,4,-46,22,2,4,62,184
174,30,3,4,8,5,35,41,7,5,97,225
174,31,2,5,4,9,22,54,9,9,119,279
174,32,2,5,4,9,-78,-46,1,3,41,233
174,33,3,3,5,8,32,35,3,8,73,268
174,34,2,4,3,10,21,-54,4,4,94,214
174,35,6,2,8,5,62,23,6,7,156,237
174,36,3,3,9,4,-64,31,2,8,92,268
174,37,2,5,6,7,24,-48,6,0,116,220
174,38,4,2,9,4,-55,22,1,2,61,242
174,39,3,4,7,6,34,42,5,4,95,284
174,40,3,5,7,6,34,51,9,5,129,335
174,41,6,2,9,4,-37,22,2,7,92,357
174,42,3,3,7,6,34,-67,6,0,126,290
174,43,4,3,9,4,-55,31,1,1,71,321
174,44,2,5,5,8,23,53,4,4,94,374
174,45,3,3,7,6,34,33,8,7,128,407
174,46,4,3,10,3,-54,30,4,7,74,437
174,47,3,3,7,6,34,-67,8,0,108,370
174,48,2,5,5,8,-77,53,1,3,31,423
174,49,3,4,4,9,31,45,2,8,62,468
174,50,3,4,5,8,32,-56,4,2,94,412
174,51,2,4,4,9,22,45,6,7,116,457
174,52,4,4,5,8,41,-56,7,1,157,401
174,53,3,3,6,7,-67,34,0,5,90,435
174,54,4,3,10,3,46,30,6,5,136,465
174,55,5,2,7,6,52,24,8,9,188,489
174,56,4,2,9,4,-55,-78,3,1,133,411
174,57,2,5,2,11,20,56,3,7,153,467
174,58,3,3,4,9,31,-64,4,3,184,403
174,59,2,4,5,8,23,44,7,7,207,447
174,60,2,5,2,11,20,-44,7,3,227,403
174,61,2,4,3,10,21,46,8,9,248,449
174,62,4,2,8,5,-56,-77,2,2,192,372
174,63,4,2,9,4,45,22,7,4,237,394
174,64,3,4,7,6,-66,42,1,6,171,436
174,65,3,4,8,5,35,41,6,7,206,477
174,66,2,4,5,8,23,-56,9,1,229,421
174,67,3,3,6,7,-67,34,2,5,162,455
174,68,2,5,4,9,22,54,4,9,184,509
175,1,4,2,6,7,42,25,2,5,42,25
175,2,3,3,9,4,36,31,8,6,78,56
175,3,2,4,4,9,-78,-55,0,1,0,1
175,4,5,2,10,3,55,21,5,2,55,22
175,5,4,2,11,2,-53,20,2,2,2,42
175,6,4,3,9,4,45,31,7,3,47,73
175,7,3,4,6,7,-67,43,0,6,-20,116
175,8,4,2,8,5,44,23,4,9,24,139
175,9,4,3,9,4,45,-69,9,0,69,70
175,10,4,2,8,5,-56,23,3,3,13,93
175,11,4,3,7,6,43,33,6,6,56,126
175,12,2,5,4,9,22,-46,8,0,78,80
175,13,4,2,7,6,-57,24,1,4,21,104
175,14,3,3,5,8,32,35,3,9,53,139
175,15,2,4,2,11,20,-53,3,6,73,86
175,16,5,2,7,6,52,-76,5,0,125,10
175,17,3,3,6,7,33,34,8,4,158,44
175,18,4,3,6,7,-58,34,0,8,100,78
175,19,2,4,3,10,21,-54,1,4,121,24
175,20,3,3,10,3,37,30,8,4,158,54
175,21,3,4,5,8,-68,44,0,8,90,98
175,22,4,3,6,7,42,-66,2,2,132,32
175,23,4,3,8,5,44,32,6,4,176,64
175,24,5,2,7,6,52,24,8,8,228,88
175,25,3,3,5,8,-68,-65,0,3,160,23
175,26,4,3,6,7,42,34,2,7,202,57
175,27,3,3,9,4,36,31,8,8,238,88
175,28,4,2,7,6,-57,-76,1,2,181,12
175,29,5,2,9,4,54,22,5,4,235,34
175,30,2,4,7,6,-75,42,0,6,160,76
175,31,4,2,5,8,41,-74,1,2,201,2
175,32,5,2,8,5,53,23,4,5,254,25
175,33,4,3,6,7,42,34,6,9,296,59
175,34,4,3,6,7,42,-66,8,3,338,-7
175,35,4,2,9,4,-55,22,3,5,283,15
175,36,3,4,7,6,34,42,7,7,317,57
175,37,3,3,6,7,-67,-66,0,1,250,-9
175,38,5,2,8,5,53,23,3,4,303,14
175,39,3,3,7,6,34,33,7,7,337,47
175,40,4,2,9,4,-55,22,2,9,282,69
175,41,4,2,8,5,44,-77,6,2,326,-8
175,42,3,3,7,6,-66,33,0,5,260,25
175,43,2,4,4,9,22,-55,2,0,282,-30
175,44,3,3,7,6,34,33,6,3,316,3
175,45,2,4,6,7,-76,43,0,6,240,46
175,46,3,4,7,6,34,42,4,8,274,88
175,47,3,3,5,8,32,-65,6,3,306,23
175,48,2,5,2,11,20,56,6,9,326,79
175,49,6,2,10,3,-36,-79,0,0,290,0
175,50,3,3,7,6,34,33,4,3,324,33
175,51,4,3,6,7,42,34,6,7,366,67
175,52,4,2,5,8,41,-74,7,3,407,-7
175,53,3,3,8,5,-65,32,2,5,342,25
175,54,4,2,9,4,45,22,7,7,387,47
175,55,3,3,9,4,-64,31,3,8,323,78
175,56,3,4,7,6,34,-58,7,0,357,20
175,57,2,4,6,7,-76,43,1,3,281,63
175,58,3,3,8,5,35,32,6,5,316,95
175,59,2,4,3,10,21,-54,7,1,337,41
175,60,2,4,6,7,-76,43,1,4,261,84
175,61,3,4,4,9,31,45,2,9,292,129
175,62,3,4,4,9,31,-55,3,4,323,74
175,63,5,2,9,4,54,22,7,6,377,96
175,64,3,3,4,9,31,-64,8,2,408,32
175,65,4,3,8,5,-56,32,2,4,352,64
175,66,3,3,6,7,33,34,5,8,385,98
175,67,2,4,7,6,-75,-58,0,0,310,40
175,68,4,3,5,8,41,35,1,5,351,75
175,69,3,4,3,10,30,-54,1,1,381,21
175,70,3,4,7,6,34,42,5,3,415,63
175,71,2,5,3,10,21,55,6,8,436,118
175,72,3,4,6,7,33,-57,9,1,469,61
175,73,3,4,6,7,-67,43,2,4,402,104
175,74,2,4,5,8,23,44,5,8,425,148
175,75,4,3,6,7,42,-66,7,2,467,82
175,76,4,3,9,4,-55,31,2,3,412,113
175,77,4,2,7,6,43,24,5,7,455,137
175,78,5,2,7,6,52,-76,7,1,507,61
176,1,3,3,8,5,35,32,5,2,35,32
176,2,4,2,6,7,42,25,7,7,77,57
176,3,3,3,4,9,31,-64,8,3,108,-7
176,4,2,4,3,10,21,46,9,9,129,39
176,5,3,3,8,5,-65,-68,4,1,64,-29
176,6,4,2,11,2,-53,20,1,1,11,-9
176,7,3,3,9,4,36,31,7,2,47,22
176,8,4,3,8,5,-56,32,1,4,-9,54
176,9,4,2,9,4,45,22,6,6,36,76
176,10,4,3,6,7,42,-66,8,0,78,10
176,11,4,2,8,5,-56,23,2,3,22,33
176,12,3,3,8,5,35,32,7,5,57,65
176,13,3,4,3,10,30,-54,7,1,87,11
176,14,4,2,7,6,-57,24,0,5,30,35
176,15,3,4,4,9,31,-55,1,0,61,-20
176,16,3,3,6,7,33,34,4,4,94,14
176,17,2,4,4,9,22,45,6,9,116,59
176,18,4,2,8,5,-56,-77,0,2,60,-18
176,19,4,3,7,6,43,33,3,5,103,15
176,20,2,6,4,9,22,63,5,8,125,78
176,21,4,3,6,7,42,-66,7,2,167,12
176,22,2,4,5,8,-77,44,0,6,90,56
176,23,4,3,5,8,41,-65,1,1,131,-9
176,24,5,2,8,5,53,23,4,4,184,14
176,25,3,4,3,10,30,-54,4,0,214,-40
176,26,5,2,9,4,54,22,8,2,268,-18
176,27,2,4,7,6,-75,42,3,4,193,24
176,28,6,2,10,3,64,21,7,5,257,45
176,29,2,6,1,12,-20,-34,7,1,237,11
176,30,4,2,8,5,-56,23,1,4,181,34
176,31,3,3,5,8,32,35,3,9,213,69
176,32,3,4,9,4,36,40,9,9,249,109
176,33,4,3,7,6,-57,-67,2,2,192,42
176,34,6,2,11,2,65,20,7,2,257,62
176,35,3,4,5,8,32,44,9,6,289,106
176,36,5,2,10,3,-45,21,4,7,244,127
176,37,5,2,8,5,53,-77,7,0,297,50
176,38,3,3,9,4,-64,31,3,1,233,81
176,39,3,4,7,6,34,42,7,3,267,123
176,40,3,3,6,7,-67,34,0,7,200,157
176,41,6,2,11,2,65,20,5,7,265,177
176,42,3,3,5,8,32,-65,7,2,297,112
176,43,4,2,7,6,-57,24,0,6,240,136
176,44,3,4,5,8,32,-56,2,0,272,80
176,45,4,3,5,8,41,35,3,5,313,115
176,46,2,6,3,10,21,64,4,9,334,179
176,47,5,2,9,4,54,-78,8,1,388,101
176,48,3,3,5,8,-68,35,0,6,320,136
176,49,2,6,3,10,21,-36,1,0,341,100
176,50,3,4,5,8,32,44,3,4,373,144
176,51,3,4,5,8,32,44,5,8,405,188
176,52,3,4,6,7,33,-57,8,1,438,131
176,53,2,5,5,8,-77,53,1,4,361,184
176,54,4,3,7,6,43,33,4,7,404,217
176,55,5,2,11,2,-44,20,0,7,360,237
176,56,2,6,2,11,20,-35,0,2,380,202
176,57,4,2,7,6,43,24,3,6,423,226
176,58,4,2,9,4,45,22,8,8,468,248
176,59,3,4,6,7,-67,-57,1,1,401,191
176,60,2,5,4,9,22,54,3,5,423,245
176,61,2,5,2,11,20,-44,3,1,443,201
176,62,3,4,6,7,33,43,6,4,476,244
176,63,4,3,8,5,-56,32,0,6,420,276
176,64,3,4,5,8,32,-56,2,0,452,220
176,65,4,3,6,7,42,34,4,4,494,254
176,66,4,2,9,4,45,22,9,6,539,276
177,1,4,3,6,7,42,34,2,4,42,34
177,2,3,3,5,8,32,35,4,9,74,69
177,3,3,3,3,10,30,-63,4,6,104,6
177,4,6,2,11,2,65,20,9,6,169,26
177,5,4,3,8,5,-56,32,3,8,113,58
177,6,3,3,7,6,34,-67,7,1,147,-9
177,7,3,4,5,8,32,44,9,5,179,35
177,8,4,2,9,4,-55,22,4,7,124,57
177,9,4,2,7,6,43,-76,7,1,167,-19
177,10,2,4,8,5,-74,41,3,2,93,22
177,11,3,3,6,7,33,34,6,6,126,56
177,12,2,5,2,11,20,-44,6,2,146,12
177,13,3,4,4,9,31,45,7,7,177,57
177,14,3,3,9,4,-64,31,3,8,113,88
177,15,3,4,5,8,32,-56,5,2,145,32
177,16,3,3,7,6,34,33,9,5,179,65
177,17,3,4,7,6,-66,42,3,7,113,107
177,18,6,2,10,3,64,21,7,8,177,128
177,19,2,4,5,8,-77,-56,0,2,100,72
177,20,3,3,6,7,33,34,3,6,133,106
177,21,3,3,8,5,35,32,8,8,168,138
177,22,3,4,6,7,-67,-57,1,1,101,81
177,23,2,4,5,8,23,44,4,5,124,125
177,24,3,3,7,6,34,33,8,8,158,158
177,25,5,2,8,5,-47,-77,1,1,111,81
177,26,4,3,7,6,43,33,4,4,154,114
177,27,3,3,5,8,32,35,6,9,186,149
177,28,2,5,3,10,21,-45,7,4,207,104
177,29,3,4,6,7,-67,43,0,7,140,147
177,30,3,3,7,6,34,-67,4,0,174,80
177,31,3,4,5,8,32,44,6,4,206,124
177,32,3,4,6,7,33,43,9,7,239,167
177,33,4,3,9,4,-55,31,4,8,184,198
177,34,5,2,11,2,-44,20,0,8,140,218
177,35,2,5,3,10,21,-45,1,3,161,173
177,36,4,2,8,5,44,23,5,6,205,196
177,37,4,3,7,6,43,33,8,9,248,229
177,38,4,3,7,6,-57,-67,1,2,191,162
177,39,3,3,8,5,35,32,6,4,226,194
177,40,3,4,7,6,-66,42,0,6,160,236
177,41,3,3,5,8,32,-65,2,1,192,171
177,42,3,3,7,6,34,33,6,4,226,204
177,43,4,4,9,4,-55,40,1,4,171,244
177,44,3,4,5,8,32,44,3,8,203,288
177,45,5,2,5,8,50,-74,3,4,253,214
177,46,4,2,8,5,44,23,7,7,297,237
177,47,4,3,9,4,-55,31,2,8,242,268
177,48,5,2,8,5,53,-77,5,1,295,191
177,49,4,3,7,6,43,33,8,4,338,224
177,50,3,3,5,8,-68,35,0,9,270,259
177,51,3,3,4,9,31,-64,1,5,301,195
177,52,4,3,6,7,42,34,3,9,343,229
177,53,4,2,7,6,43,-76,6,3,386,153
177,54,3,5,7,6,-66,51,0,4,320,204
177,55,4,3,9,4,45,31,5,5,365,235
177,56,4,2,8,5,44,23,9,8,409,258
177,57,4,3,9,4,-55,31,4,9,354,289
177,58,4,3,7,6,43,-67,7,2,397,222
177,59,4,3,6,7,42,34,9,6,439,256
177,60,3,4,4,9,-69,-55,0,1,370,201
177,61,3,4,5,8,32,44,2,5,402,245
177,62,5,2,8,5,53,23,5,8,455,268
177,63,3,3,5,8,32,-65,7,3,487,203
177,64,2,4,5,8,-77,44,0,7,410,247
177,65,3,4,4,9,31,-55,1,2,441,192
177,66,4,3,8,5,44,32,5,4,485,224
177,67,3,3,8,5,-65,32,0,6,420,256
177,68,3,4,5,8,32,-56,2,0,452,200
177,69,3,3,5,8,32,35,4,5,484,235
177,70,5,2,11,2,-44,20,0,5,440,255
177,71,3,3,8,5,35,32,5,7,475,287
177,72,2,4,6,7,24,-57,9,0,499,230
177,73,2,5,6,7,-76,52,3,2,423,282
177,74,2,4,2,11,20,47,3,9,443,329
177,75,3,3,5,8,32,-65,5,4,475,264
177,76,5,2,9,4,54,22,9,6,529,286
178,1,5,2,8,5,53,23,3,3,53,23
178,2,4,3,7,6,43,33,6,6,96,56
178,3,3,3,7,6,-66,33,0,9,30,89
178,4,4,2,9,4,45,-78,5,1,75,11
178,5,4,2,9,4,-55,22,0,3,20,33
178,6,3,3,6,7,33,34,3,7,53,67
178,7,3,4,5,8,32,-56,5,1,85,11
178,8,5,2,8,5,53,23,8,4,138,34
178,9,4,3,9,4,-55,31,3,5,83,65
178,10,3,4,7,6,34,42,7,7,117,107
178,11,6,2,9,4,-37,22,0,9,80,129
178,12,3,3,8,5,35,-68,5,1,115,61
178,13,4,3,9,4,-55,31,0,2,60,92
178,14,3,3,9,4,36,31,6,3,96,123
178,15,2,4,4,9,22,45,8,8,118,168
178,16,4,3,7,6,-57,-67,1,1,61,101
178,17,3,3,4,9,31,36,2,7,92,137
178,18,2,5,6,7,24,52,6,9,116,189
178,19,3,4,3,10,30,-54,6,5,146,135
178,20,3,3,5,8,32,-65,8,0,178,70
178,21,3,3,8,5,-65,32,3,2,113,102
178,22,5,2,8,5,53,23,6,5,166,125
178,23,3,3,3,10,30,-63,6,2,196,62
178,24,2,4,6,7,-76,43,0,5,120,105
178,25,4,3,6,7,42,34,2,9,162,139
178,26,3,3,8,5,35,-68,7,1,197,71
178,27,4,3,7,6,-57,33,0,4,140,104
178,28,3,4,7,6,34,42,4,6,174,146
178,29,2,5,8,5,-74,50,0,6,100,196
178,30,3,3,7,6,34,33,4,9,134,229
178,31,2,4,2,11,20,-53,4,6,154,176
178,32,3,3,9,4,-64,31,0,7,90,207
178,33,2,4,3,10,21,-54,1,3,111,153
178,34,2,5,3,10,21,55,2,8,132,208
178,35,5,3,8,5,53,-68,5,0,185,140
178,36,4,2,7,6,43,24,8,4,228,164
178,37,3,3,7,6,-66,33,2,7,162,197
178,38,3,3,7,6,34,-67,6,0,196,130
178,39,3,3,6,7,33,34,9,4,229,164
178,40,4,3,8,5,-56,32,3,6,173,196
178,41,3,3,7,6,34,33,7,9,207,229
178,42,3,3,7,6,-66,-67,1,2,141,162
178,43,3,4,6,7,33,43,4,5,174,205
178,44,4,3,8,5,44,32,8,7,218,237
178,45,2,5,6,7,-76,52,2,9,142,289
178,46,3,3,5,8,32,-65,4,4,174,224
178,47,3,3,6,7,33,34,7,8,207,258
178,48,3,4,7,6,-66,-58,1,0,141,200
178,49,2,5,4,9,22,54,3,4,163,254
178,50,3,4,5,8,32,44,5,8,195,298
178,51,4,3,5,8,41,-65,6,3,236,233
178,52,2,4,6,7,-76,43,0,6,160,276
178,53,4,2,8,5,44,23,4,9,204,299
178,54,2,5,3,10,21,-45,5,4,225,254
178,55,3,3,5,8,32,35,7,9,257,289
178,56,4,2,9,4,-55,-78,2,1,202,211
178,57,4,3,9,4,45,31,7,2,247,242
178,58,5,2,9,4,-46,22,1,4,201,264
178,59,2,6,4,9,22,63,3,7,223,327
178,60,2,5,4,9,22,-46,5,1,245,281
178,61,3,3,5,8,32,35,7,6,277,316
178,62,3,3,5,8,32,-65,9,1,309,251
178,63,3,4,5,8,-68,44,1,5,241,295
178,64,3,3,5,8,32,-65,3,0,273,230
178,65,2,4,5,8,23,44,6,4,296,274
178,66,4,3,6,7,42,34,8,8,338,308
178,67,2,4,8,5,-74,41,4,9,264,349
178,68,4,2,9,4,45,-78,9,1,309,271
178,69,2,5,2,11,20,56,9,7,329,327
178,70,3,3,5,8,-68,-65,1,2,261,262
178,71,3,4,7,6,34,42,5,4,295,304
178,72,5,2,9,4,54,22,9,6,349,326
178,73,4,3,4,9,40,-64,9,2,389,262
178,74,3,3,7,6,-66,33,3,5,323,295
178,75,4,3,5,8,41,-65,4,0,364,230
178,76,6,2,11,2,65,20,9,0,429,250
178,77,4,3,6,7,-58,34,1,4,371,284
178,78,2,5,5,8,23,53,4,7,394,337
178,79,3,3,5,8,32,-65,6,2,426,272
178,80,4,3,7,6,43,33,9,5,469,305
178,81,6,2,9,4,-37,22,2,7,432,327
178,82,2,4,5,8,23,-56,5,1,455,271
178,83,4,2,8,5,44,23,9,4,499,294
178,84,3,3,6,7,-67,34,2,8,432,328
178,85,4,3,8,5,44,-68,6,0,476,260
178,86,4,3,7,6,43,33,9,3,519,293
179,1,2,4,4,9,22,45,2,5,22,45
179,2,4,3,5,8,41,-65,3,0,63,-20
179,3,4,3,9,4,45,31,8,1,108,11
179,4,2,4,4,9,-78,45,0,6,30,56
179,5,4,3,5,8,41,-65,1,1,71,-9
179,6,4,3,9,4,45,31,6,2,116,22
179,7,3,4,7,6,-66,42,0,4,50,64
179,8,3,5,5,8,32,53,2,7,82,117
179,9,2,5,7,6,25,51,7,8,107,168
179,10,4,2,6,7,42,-75,9,3,149,93
179,11,4,3,6,7,-58,34,1,7,91,127
179,12,2,4,3,10,21,-54,2,3,112,73
179,13,3,3,6,7,33,34,5,7,145,107
179,14,2,5,3,10,21,-45,6,2,166,62
179,15,4,3,8,5,-56,32,0,4,110,94
179,16,4,3,7,6,43,33,3,7,153,127
179,17,2,5,5,8,23,-47,6,0,176,80
179,18,3,3,6,7,33,34,9,4,209,114
179,19,5,2,7,6,-48,24,1,8,161,138
179,20,2,4,5,8,23,-56,4,2,184,82
179,21,4,3,6,7,42,34,6,6,226,116
179,22,4,2,9,4,-55,22,1,8,171,138
179,23,3,4,4,9,31,-55,2,3,202,83
179,24,3,4,6,7,33,43,5,6,235,126
179,25,2,5,4,9,22,-46,7,0,257,80
179,26,2,4,4,9,22,45,9,5,279,125
179,27,3,4,8,5,-65,41,4,6,214,166
179,28,4,3,8,5,44,32,8,8,258,198
179,29,4,2,8,5,-56,-77,2,1,202,121
179,30,2,4,4,9,22,45,4,6,224,166
179,31,3,4,6,7,33,43,7,9,257,209
179,32,4,3,7,6,-57,-67,0,2,200,142
179,33,4,3,6,7,42,34,2,6,242,176
179,34,3,4,6,7,33,43,5,9,275,219
179,35,3,5,5,8,32,-47,7,2,307,172
179,36,3,4,5,8,32,44,9,6,339,216
179,37,3,5,6,7,-67,52,2,8,272,268
179,38,4,3,9,4,45,31,7,9,317,299
179,39,4,3,8,5,-56,-68,1,1,261,231
179,40,3,4,8,5,35,41,6,2,296,272
179,41,5,2,10,3,-45,21,1,3,251,293
179,42,5,2,10,3,55,21,6,4,306,314
179,43,3,3,5,8,32,35,8,9,338,349
179,44,3,3,7,6,-66,-67,2,2,272,282
179,45,2,5,4,9,22,54,4,6,294,336
179,46,3,4,4,9,31,-55,5,1,325,281
179,47,4,2,6,7,42,25,7,6,367,306
179,48,3,3,4,9,31,-64,8,2,398,242
179,49,2,5,3,10,21,55,9,7,419,297
179,50,2,5,6,7,-76,52,3,9,343,349
179,51,2,5,4,9,22,-46,5,3,365,303
179,52,4,3,6,7,42,34,7,7,407,337
179,53,3,5,6,7,-67,52,0,9,340,389
179,54,2,4,4,9,22,-55,2,4,362,334
179,55,4,2,9,4,45,22,7,6,407,356
179,56,2,4,5,8,-77,-56,0,0,330,300
179,57,3,4,3,10,30,46,0,6,360,346
179,58,4,3,7,6,43,33,3,9,403,379
179,59,3,4,7,6,34,-58,7,1,437,321
179,60,3,5,4,9,31,54,8,5,468,375
179,61,3,3,5,8,-68,-65,0,0,400,310
179,62,2,5,5,8,23,53,3,3,423,363
179,63,3,5,6,7,33,52,6,5,456,415
179,64,2,5,3,10,21,-45,7,0,477,370
179,65,4,3,4,9,40,36,7,6,517,406
180,1,5,3,9,4,54,31,4,1,54,31
180,2,2,5,4,9,22,54,6,5,76,85
180,3,2,5,3,10,21,-45,7,0,97,40
180,4,2,4,5,8,-77,44,0,4,20,84
180,5,4,3,6,7,42,34,2,8,62,118
180,6,2,5,5,8,23,-47,5,1,85,71
180,7,2,4,5,8,23,44,8,5,108,115
180,8,3,3,8,5,-65,32,3,7,43,147
180,9,3,4,6,7,33,-57,6,0,76,90
180,10,4,2,9,4,-55,22,1,2,21,112
180,11,5,2,8,5,53,23,4,5,74,135
180,12,5,2,7,6,52,24,6,9,126,159
180,13,3,4,4,9,31,-55,7,4,157,104
180,14,3,3,5,8,32,35,9,9,189,139
180,15,3,4,6,7,-67,-57,2,2,122,82
180,16,2,4,5,8,23,44,5,6,145,126
180,17,5,2,8,5,53,23,8,9,198,149
180,18,3,3,6,7,-67,-66,1,3,131,83
180,19,2,4,7,6,25,42,6,5,156,125
180,20,3,3,6,7,33,34,9,9,189,159
180,21,2,6,3,10,-79,-36,0,3,110,123
180,22,2,4,6,7,24,43,4,6,134,166
180,23,4,3,6,7,42,-66,6,0,176,100
180,24,2,5,7,6,-75,51,1,1,101,151
180,25,3,3,8,5,35,32,6,3,136,183
180,26,2,4,6,7,-76,43,0,6,60,226
180,27,3,3,8,5,35,32,5,8,95,258
180,28,4,2,11,2,-53,20,2,8,42,278
180,29,3,4,7,6,34,-58,6,0,76,220
180,30,4,3,4,9,40,36,6,6,116,256
180,31,2,5,3,10,21,-45,7,1,137,211
180,32,3,4,6,7,-67,43,0,4,70,254
180,33,4,3,5,8,41,35,1,9,111,289
180,34,4,3,6,7,42,-66,3,3,153,223
180,35,4,3,7,6,43,33,6,6,196,256
180,36,3,4,6,7,33,43,9,9,229,299
180,37,4,2,6,7,-58,-75,1,4,171,224
180,38,4,2,8,5,44,23,5,7,215,247
180,39,3,3,6,7,33,-66,8,1,248,181
180,40,3,4,7,6,-66,42,2,3,182,223
180,41,4,3,8,5,44,32,6,5,226,255
180,42,2,5,4,9,22,54,8,9,248,309
180,43,4,3,7,6,-57,-67,1,2,191,242
180,44,4,2,6,7,42,25,3,7,233,267
180,45,3,4,8,5,35,41,8,8,268,308
180,46,5,2,10,3,-45,21,3,9,223,329
180,47,3,3,5,8,32,-65,5,4,255,264
180,48,5,2,11,2,-44,20,1,4,211,284
180,49,2,5,5,8,23,53,4,7,234,337
180,50,2,6,2,11,20,-35,4,2,254,302
180,51,2,4,6,7,24,43,8,5,278,345
180,52,3,3,6,7,-67,34,1,9,211,379
180,53,2,5,4,9,22,-46,3,3,233,333
180,54,6,2,11,2,65,20,8,3,298,353
180,55,3,3,9,4,-64,31,4,4,234,384
180,56,2,4,6,7,24,43,8,7,258,427
180,57,3,3,5,8,-68,-65,0,2,190,362
180,58,4,2,9,4,45,22,5,4,235,384
180,59,2,4,4,9,22,45,7,9,257,429
180,60,2,4,7,6,-75,-58,2,1,182,371
180,61,2,4,4,9,22,45,4,6,204,416
180,62,3,3,8,5,35,32,9,8,239,448
180,63,3,4,6,7,-67,-57,2,1,172,391
180,64,4,3,8,5,44,32,6,3,216,423
180,65,4,2,10,3,-54,21,2,4,162,444
180,66,5,2,8,5,53,23,5,7,215,467
180,67,4,3,10,3,-54,30,1,7,161,497
180,68,3,4,8,5,35,41,6,8,196,538
181,1,4,3,6,7,42,34,2,4,42,34
181,2,3,3,6,7,33,34,5,8,75,68
181,3,4,4,4,9,40,-55,5,3,115,13
181,4,3,4,7,6,34,42,9,5,149,55
181,5,3,4,6,7,-67,43,2,8,82,98
181,6,4,3,6,7,42,-66,4,2,124,32
181,7,2,4,5,8,23,44,7,6,147,76
181,8,3,3,7,6,-66,33,1,9,81,109
181,9,4,2,10,3,46,-79,7,0,127,30
181,10,3,3,8,5,-65,32,2,2,62,62
181,11,4,2,6,7,42,25,4,7,104,87
181,12,3,4,4,9,31,-55,5,2,135,32
181,13,3,3,6,7,33,34,8,6,168,66
181,14,3,3,6,7,-67,-66,1,0,101,0
181,15,2,5,6,7,24,52,5,2,125,52
181,16,2,4,7,6,-75,42,0,4,50,94
181,17,3,4,4,9,31,45,1,9,81,139
181,18,3,3,6,7,33,-66,4,3,114,73
181,19,3,3,4,9,31,36,5,9,145,109
181,20,4,3,9,4,-55,-69,0,0,90,40
181,21,3,3,7,6,34,33,4,3,124,73
181,22,2,4,6,7,24,43,8,6,148,116
181,23,3,3,6,7,-67,-66,1,0,81,50
181,24,3,3,5,8,32,35,3,5,113,85
181,25,2,5,4,9,22,54,5,9,135,139
181,26,4,3,8,5,44,-68,9,1,179,71
181,27,2,4,4,9,-78,45,1,6,101,116
181,28,4,2,8,5,44,23,5,9,145,139
181,29,5,2,8,5,53,-77,8,2,198,62
181,30,3,4,7,6,-66,42,2,4,132,104
181,31,2,4,3,10,21,-54,3,0,153,50
181,32,3,4,5,8,32,44,5,4,185,94
181,33,4,3,7,6,43,33,8,7,228,127
181,34,5,2,9,4,-46,22,2,9,182,149
181,35,3,3,5,8,32,-65,4,4,214,84
181,36,6,2,8,5,62,23,6,7,276,107
181,37,2,5,5,8,23,-47,9,0,299,60
181,38,3,4,8,5,-65,41,4,1,234,101
181,39,3,3,4,9,31,36,5,7,265,137
181,40,2,4,5,8,23,-56,8,1,288,81
181,41,5,2,11,2,-44,20,4,1,244,101
181,42,5,2,11,2,-44,20,0,1,200,121
181,43,3,4,7,6,34,42,4,3,234,163
181,44,5,2,8,5,53,23,7,6,287,186
181,45,4,2,8,5,-56,23,1,9,231,209
181,46,3,3,5,8,32,-65,3,4,263,144
181,47,5,2,10,3,55,21,8,5,318,165
181,48,3,3,5,8,-68,-65,0,0,250,100
181,49,4,3,5,8,41,35,1,5,291,135
181,50,3,3,4,9,31,-64,2,1,322,71
181,51,2,5,4,9,22,54,4,5,344,125
181,52,3,3,7,6,34,33,8,8,378,158
181,53,3,3,8,5,-65,-68,3,0,313,90
181,54,3,3,7,6,34,33,7,3,347,123
181,55,4,3,8,5,-56,32,1,5,291,155
181,56,2,4,5,8,23,44,4,9,314,199
181,57,3,4,5,8,32,-56,6,3,346,143
181,58,3,4,4,9,31,45,7,8,377,188
181,59,3,3,4,9,31,-64,8,4,408,124
181,60,4,3,7,6,-57,33,1,7,351,157
181,61,3,4,4,9,31,-55,2,2,382,102
181,62,3,3,10,3,37,30,9,2,419,132
181,63,4,2,10,3,-54,21,5,3,365,153
181,64,3,4,5,8,32,44,7,7,397,197
181,65,3,4,4,9,31,-55,8,2,428,142
181,66,5,3,7,6,-48,33,0,5,380,175
181,67,2,4,6,7,24,43,4,8,404,218
181,68,3,3,7,6,34,-67,8,1,438,151
181,69,2,5,3,10,21,55,9,6,459,206
181,70,3,3,7,6,-66,33,3,9,393,239
181,71,3,4,6,7,33,-57,6,2,426,182
181,72,3,3,6,7,33,34,9,6,459,216
181,73,3,3,5,8,-68,-65,1,1,391,151
181,74,4,2,9,4,45,22,6,3,436,173
181,75,4,3,8,5,-56,32,0,5,380,205
181,76,3,4,5,8,32,44,2,9,412,249
181,77,3,3,5,8,32,-65,4,4,444,184
181,78,3,3,7,6,34,33,8,7,478,217
181,79,2,6,4,9,-78,-37,0,0,400,180
181,80,3,4,4,9,31,45,1,5,431,225
181,81,2,5,3,10,21,-45,2,0,452,180
181,82,2,4,3,10,21,46,3,6,473,226
181,83,4,2,8,5,44,23,7,9,517,249
182,1,2,5,5,8,23,53,3,3,23,53
182,2,4,3,10,3,46,30,9,3,69,83
182,3,4,3,9,4,-55,31,4,4,14,114
182,4,4,3,5,8,41,35,5,9,55,149
182,5,4,2,10,3,-54,-79,1,0,1,70
182,6,2,4,7,6,25,42,6,2,26,112
182,7,4,2,9,4,-55,22,1,4,-29,134
182,8,4,2,7,6,43,24,4,8,14,158
182,9,5,2,8,5,53,-77,7,1,67,81
182,10,4,3,8,5,-56,32,1,3,11,113
182,11,2,4,4,9,22,45,3,8,33,158
182,12,2,6,3,10,21,-36,4,2,54,122
182,13,4,2,8,5,44,23,8,5,98,145
182,14,3,3,8,5,-65,32,3,7,33,177
182,15,3,3,5,8,32,-65,5,2,65,112
182,16,2,5,4,9,22,54,7,6,87,166
182,17,3,4,8,5,-65,41,2,7,22,207
182,18,4,2,9,4,45,22,7,9,67,229
182,19,3,4,7,6,-66,-58,1,1,1,171
182,20,4,2,7,6,43,24,4,5,44,195
182,21,4,2,5,8,41,-74,5,1,85,121
182,22,4,3,8,5,44,32,9,3,129,153
182,23,4,3,7,6,-57,33,2,6,72,186
182,24,3,3,7,6,34,33,6,9,106,219
182,25,3,3,6,7,33,-66,9,3,139,153
182,26,2,4,3,10,-79,46,0,9,60,199
182,27,4,2,9,4,45,-78,5,1,105,121
182,28,6,2,10,3,64,21,9,2,169,142
182,29,3,3,5,8,-68,35,1,7,101,177
182,30,2,4,5,8,23,-56,4,1,124,121
182,31,3,3,4,9,31,36,5,7,155,157
182,32,5,2,8,5,53,-77,8,0,208,80
182,33,2,4,7,6,-75,42,3,2,133,122
182,34,3,3,7,6,34,33,7,5,167,155
182,35,3,3,6,7,-67,34,0,9,100,189
182,36,4,4,4,9,40,-55,0,4,140,134
182,37,3,4,7,6,34,42,4,6,174,176
182,38,4,2,11,2,-53,20,1,6,121,196
182,39,4,3,7,6,43,33,4,9,164,229
182,40,5,2,7,6,52,-76,6,3,216,153
182,41,3,4,5,8,32,44,8,7,248,197
182,42,2,4,3,10,21,-54,9,3,269,143
182,43,2,4,5,8,-77,44,2,7,192,187
182,44,4,3,5,8,41,-65,3,2,233,122
182,45,3,3,6,7,33,34,6,6,266,156
182,46,4,2,11,2,-53,20,3,6,213,176
182,47,4,3,6,7,42,-66,5,0,255,110
182,48,4,4,8,5,44,41,9,1,299,151
182,49,3,3,6,7,-67,34,2,5,232,185
182,50,3,3,5,8,32,-65,4,0,264,120
182,51,5,2,9,4,54,22,8,2,318,142
182,52,3,3,9,4,-64,31,4,3,254,173
182,53,4,3,6,7,42,34,6,7,296,207
182,54,4,2,9,4,-55,22,1,9,241,229
182,55,4,3,6,7,42,-66,3,3,283,163
182,56,4,2,8,5,44,23,7,6,327,186
182,57,4,3,8,5,-56,32,1,8,271,218
182,58,3,3,6,7,33,-66,4,2,304,152
182,59,4,3,6,7,42,34,6,6,346,186
182,60,3,4,6,7,33,43,9,9,379,229
182,61,3,4,7,6,-66,-58,3,1,313,171
182,62,2,4,8,5,26,41,9,2,339,212
182,63,3,3,9,4,-64,31,5,3,275,243
182,64,2,5,4,9,22,54,7,7,297,297
182,65,4,2,6,7,42,-75,9,2,339,222
182,66,3,4,7,6,-66,42,3,4,273,264
182,67,2,5,3,10,21,55,4,9,294,319
182,68,2,4,5,8,23,-56,7,3,317,263
182,69,5,2,6,7,51,25,8,8,368,288
182,70,4,3,10,3,-54,30,4,8,314,318
182,71,2,4,6,7,24,-57,8,1,338,261
182,72,3,3,3,10,30,37,8,8,368,298
182,73,4,2,8,5,-56,-77,2,1,312,221
182,74,5,2,10,3,55,21,7,2,367,242
182,75,3,5,5,8,32,53,9,5,399,295
182,76,3,4,7,6,-66,42,3,7,333,337
182,77,4,2,8,5,44,-77,7,0,377,260
182,78,4,2,7,6,-57,24,0,4,320,284
182,79,4,2,8,5,44,23,4,7,364,307
182,80,2,6,2,11,20,-35,4,2,384,272
182,81,2,4,2,11,20,47,4,9,404,319
182,82,2,5,4,9,22,-46,6,3,426,273
182,83,2,4,4,9,22,45,8,8,448,318
182,84,3,4,6,7,-67,-57,1,1,381,261
182,85,4,2,8,5,44,23,5,4,425,284
182,86,5,2,9,4,54,22,9,6,479,306
182,87,2,4,4,9,-78,-55,1,1,401,251
182,88,3,3,6,7,33,34,4,5,434,285
182,89,5,2,9,4,54,22,8,7,488,307
182,90,3,4,6,7,-67,-57,1,0,421,250
182,91,5,2,10,3,55,21,6,1,476,271
182,92,4,4,7,6,43,42,9,3,519,313
183,1,3,4,5,8,32,44,2,4,32,44
183,2,4,3,6,7,42,34,4,8,74,78
183,3,3,4,6,7,33,-57,7,1,107,21
183,4,3,4,5,8,32,44,9,5,139,65
183,5,3,3,6,7,-67,34,2,9,72,99
183,6,3,3,10,3,37,30,9,9,109,129
183,7,4,3,6,7,-58,-66,1,3,51,63
183,8,3,3,9,4,36,31,7,4,87,94
183,9,4,3,6,7,42,34,9,8,129,128
183,10,2,4,5,8,-77,-56,2,2,52,72
183,11,2,6,3,10,21,64,3,6,73,136
183,12,3,3,5,8,32,-65,5,1,105,71
183,13,2,4,7,6,-75,42,0,3,30,113
183,14,3,4,7,6,34,42,4,5,64,155
183,15,2,5,6,7,24,52,8,7,88,207
183,16,5,2,8,5,-47,-77,1,0,41,130
183,17,3,4,6,7,33,43,4,3,74,173
183,18,3,4,5,8,32,44,6,7,106,217
183,19,5,2,10,3,-45,21,1,8,61,238
183,20,3,3,9,4,36,31,7,9,97,269
183,21,3,4,6,7,-67,-57,0,2,30,212
183,22,2,4,5,8,23,44,3,6,53,256
183,23,4,2,10,3,46,21,9,7,99,277
183,24,3,4,4,9,-69,-55,0,2,30,222
183,25,2,5,6,7,24,52,4,4,54,274
183,26,2,4,4,9,22,45,6,9,76,319
183,27,3,3,5,8,32,-65,8,4,108,254
183,28,2,4,5,8,-77,44,1,8,31,298
183,29,2,5,2,11,20,-44,1,4,51,254
183,30,3,3,7,6,34,33,5,7,85,287
183,31,5,3,8,5,53,32,8,9,138,319
183,32,2,5,4,9,-78,-46,0,3,60,273
183,33,3,4,7,6,34,42,4,5,94,315
183,34,3,3,6,7,33,34,7,9,127,349
183,35,3,4,6,7,-67,-57,0,2,60,292
183,36,3,3,9,4,36,31,6,3,96,323
183,37,3,3,4,9,31,36,7,9,127,359
183,38,3,4,3,10,30,-54,7,5,157,305
183,39,3,3,6,7,-67,34,0,9,90,339
183,40,2,4,5,8,23,-56,3,3,113,283
183,41,3,4,5,8,32,44,5,7,145,327
183,42,4,3,7,6,43,-67,8,0,188,260
183,43,2,4,6,7,-76,43,2,3,112,303
183,44,2,4,6,7,24,43,6,6,136,346
183,45,4,2,7,6,43,-76,9,0,179,270
183,46,4,4,6,7,-58,43,1,3,121,313
183,47,3,3,7,6,34,33,5,6,155,346
183,48,3,4,4,9,31,-55,6,1,186,291
183,49,5,2,9,4,-46,22,0,3,140,313
183,50,2,6,5,8,23,62,3,5,163,375
183,51,3,4,7,6,34,42,7,7,197,417
183,52,4,3,5,8,41,-65,8,2,238,352
183,53,4,3,7,6,-57,33,1,5,181,385
183,54,3,3,3,10,30,-63,1,2,211,322
183,55,5,2,10,3,55,21,6,3,266,343
183,56,3,3,9,4,-64,31,2,4,202,374
183,57,3,3,7,6,34,33,6,7,236,407
183,58,3,4,5,8,32,-56,8,1,268,351
183,59,4,2,7,6,-57,24,1,5,211,375
183,60,4,2,8,5,44,23,5,8,255,398
183,61,5,2,9,4,54,-78,9,0,309,320
183,62,2,5,2,11,20,56,9,6,329,376
183,63,4,4,6,7,-58,43,1,9,271,419
183,64,2,4,3,10,21,-54,2,5,292,365
183,65,4,3,7,6,43,33,5,8,335,398
183,66,2,6,3,10,21,-36,6,2,356,362
183,67,3,3,6,7,33,34,9,6,389,396
183,68,4,2,8,5,-56,23,3,9,333,419
183,69,5,2,8,5,53,-77,6,2,386,342
183,70,4,3,7,6,43,33,9,5,429,375
183,71,4,3,6,7,-58,34,1,9,371,409
183,72,2,5,4,9,22,-46,3,3,393,363
183,73,2,4,4,9,22,45,5,8,415,408
183,74,2,5,4,9,22,-46,7,2,437,362
183,75,3,4,5,8,32,44,9,6,469,406
183,76,3,3,4,9,-69,-64,0,2,400,342
183,77,2,4,6,7,24,43,4,5,424,385
183,78,2,4,5,8,23,44,7,9,447,429
183,79,3,4,7,6,-66,-58,1,1,381,371
183,80,2,4,6,7,24,43,5,4,405,414
183,81,3,4,5,8,32,44,7,8,437,458
183,82,3,4,7,6,-66,-58,1,0,371,400
183,83,3,3,4,9,31,36,2,6,402,436
183,84,4,3,7,6,43,33,5,9,445,469
183,85,4,3,7,6,43,-67,8,2,488,402
183,86,3,3,6,7,-67,34,1,6,421,436
183,87,3,4,9,4,36,40,7,6,457,476
183,88,3,3,6,7,-67,-66,0,0,390,410
183,89,2,6,4,9,22,63,2,3,412,473
183,90,4,3,5,8,41,35,3,8,453,508
184,1,5,2,8,5,53,23,3,3,53,23
184,2,4,3,8,5,44,32,7,5,97,55
184,3,2,4,6,7,-76,43,1,8,21,98
184,4,3,4,7,6,34,-58,5,0,55,40
184,5,3,4,5,8,32,44,7,4,87,84
184,6,3,4,5,8,32,44,9,8,119,128
184,7,3,3,6,7,-67,-66,2,2,52,62
184,8,4,3,7,6,43,33,5,5,95,95
184,9,5,3,8,5,53,32,8,7,148,127
184,10,3,3,5,8,-68,-65,0,2,80,62
184,11,3,4,6,7,33,43,3,5,113,105
184,12,3,3,9,4,36,31,9,6,149,136
184,13,4,3,6,7,-58,-66,1,0,91,70
184,14,3,3,6,7,33,34,4,4,124,104
184,15,2,5,3,10,21,55,5,9,145,159
184,16,4,3,7,6,43,-67,8,2,188,92
184,17,5,2,9,4,-46,22,2,4,142,114
184,18,5,2,10,3,55,21,7,5,197,135
184,19,3,4,5,8,32,44,9,9,229,179
184,20,3,4,7,6,-66,-58,3,1,163,121
184,21,2,4,5,8,23,44,6,5,186,165
184,22,5,3,7,6,52,33,8,8,238,198
184,23,3,4,6,7,-67,-57,1,1,171,141
184,24,3,3,4,9,31,36,2,7,202,177
184,25,3,3,4,9,31,-64,3,3,233,113
184,26,3,4,7,6,34,42,7,5,267,155
184,27,3,4,7,6,-66,42,1,7,201,197
184,28,2,5,4,9,22,-46,3,1,223,151
184,29,3,3,9,4,36,31,9,2,259,182
184,30,4,3,7,6,-57,33,2,5,202,215
184,31,2,5,5,8,23,53,5,8,225,268
184,32,4,3,10,3,-54,30,1,8,171,298
184,33,3,4,5,8,32,-56,3,2,203,242
184,34,2,4,5,8,23,44,6,6,226,286
184,35,4,2,8,5,-56,23,0,9,170,309
184,36,4,3,5,8,41,-65,1,4,211,244
184,37,3,3,7,6,34,33,5,7,245,277
184,38,3,3,6,7,33,-66,8,1,278,211
184,39,2,5,4,9,-78,54,0,5,200,265
184,40,4,3,6,7,42,34,2,9,242,299
184,41,3,3,6,7,33,-66,5,3,275,233
184,42,4,2,6,7,42,25,7,8,317,258
184,43,4,3,7,6,-57,-67,0,1,260,191
184,44,4,3,7,6,43,33,3,4,303,224
184,45,5,2,10,3,55,21,8,5,358,245
184,46,5,2,10,3,-45,21,3,6,313,266
184,47,5,2,8,5,53,23,6,9,366,289
184,48,4,2,9,4,-55,-78,1,1,311,211
184,49,3,4,5,8,32,44,3,5,343,255
184,50,2,4,4,9,22,-55,5,0,365,200
184,51,4,2,7,6,43,24,8,4,408,224
184,52,2,5,4,9,-78,54,0,8,330,278
184,53,4,2,6,7,42,-75,2,3,372,203
184,54,2,4,9,4,27,40,9,3,399,243
184,55,3,3,8,5,-65,32,4,5,334,275
184,56,2,4,4,9,22,-55,6,0,356,220
184,57,4,3,8,5,-56,32,0,2,300,252
184,58,3,3,8,5,35,32,5,4,335,284
184,59,3,3,9,4,-64,31,1,5,271,315
184,60,4,2,8,5,44,23,5,8,315,338
184,61,5,2,8,5,53,-77,8,1,368,261
184,62,2,4,5,8,-77,44,1,5,291,305
184,63,2,5,4,9,22,54,3,9,313,359
184,64,3,4,8,5,35,-59,8,0,348,300
184,65,2,4,5,8,-77,44,1,4,271,344
184,66,5,2,10,3,55,21,6,5,326,365
184,67,2,5,5,8,23,53,9,8,349,418
184,68,2,5,2,11,20,-44,9,4,369,374
184,69,4,2,9,4,-55,22,4,6,314,396
184,70,4,2,8,5,44,23,8,9,358,419
184,71,4,3,5,8,41,-65,9,4,399,354
184,72,3,4,6,7,-67,43,2,7,332,397
184,73,3,3,7,6,34,-67,6,0,366,330
184,74,2,4,7,6,-75,42,1,2,291,372
184,75,3,5,5,8,32,53,3,5,323,425
184,76,3,3,5,8,32,-65,5,0,355,360
184,77,3,4,4,9,31,45,6,5,386,405
184,78,3,3,7,6,-66,33,0,8,320,438
184,79,4,3,6,7,42,-66,2,2,362,372
184,80,4,2,8,5,44,23,6,5,406,395
184,81,4,3,8,5,-56,32,0,7,350,427
184,82,2,4,6,7,24,-57,4,0,374,370
184,83,2,4,4,9,22,45,6,5,396,415
184,84,5,2,9,4,-46,22,0,7,350,437
184,85,5,3,6,7,51,-66,1,1,401,371
184,86,5,2,9,4,54,22,5,3,455,393
184,87,4,2,9,4,-55,22,0,5,400,415
184,88,6,2,7,6,61,24,1,9,461,439
184,89,2,4,5,8,23,-56,4,3,484,383
184,90,2,4,7,6,25,42,9,5,509,425
185,1,4,2,8,5,44,23,4,3,44,23
185,2,2,4,7,6,25,42,9,5,69,65
185,3,4,3,7,6,-57,33,2,8,12,98
185,4,4,2,9,4,45,-78,7,0,57,20
185,5,2,4,6,7,-76,43,1,3,-19,63
185,6,3,4,7,6,34,42,5,5,15,105
185,7,5,2,10,3,-45,21,0,6,-30,126
185,8,3,4,7,6,34,42,4,8,4,168
185,9,4,2,8,5,44,-77,8,1,48,91
185,10,3,3,4,9,31,36,9,7,79,127
185,11,3,4,7,6,-66,42,3,9,13,169
185,12,4,2,5,8,41,-74,4,5,54,95
185,13,4,3,6,7,42,34,6,9,96,129
185,14,4,3,7,6,43,-67,9,2,139,62
185,15,4,2,10,3,-54,21,5,3,85,83
185,16,4,3,4,9,40,36,5,9,125,119
185,17,3,3,6,7,33,-66,8,3,158,53
185,18,3,4,6,7,-67,43,1,6,91,96
185,19,4,2,7,6,43,-76,4,0,134,20
185,20,3,3,5,8,32,35,6,5,166,55
185,21,3,3,6,7,33,34,9,9,199,89
185,22,4,2,6,7,-58,-75,1,4,141,14
185,23,2,4,7,6,25,42,6,6,166,56
185,24,3,3,8,5,-65,32,1,8,101,88
185,25,3,4,5,8,32,-56,3,2,133,32
185,26,2,5,4,9,22,54,5,6,155,86
185,27,3,4,6,7,33,43,8,9,188,129
185,28,3,4,3,10,30,-54,8,5,218,75
185,29,3,3,5,8,-68,-65,0,0,150,10
185,30,4,4,5,8,41,44,1,4,191,54
185,31,2,5,4,9,22,54,3,8,213,108
185,32,5,2,9,4,54,-78,7,0,267,30
185,33,2,5,4,9,22,54,9,4,289,84
185,34,2,4,7,6,-75,42,4,6,214,126
185,35,3,3,8,5,35,32,9,8,249,158
185,36,5,2,6,7,-49,-75,0,3,200,83
185,37,4,2,8,5,44,23,4,6,244,106
185,38,3,3,3,10,30,-63,4,3,274,43
185,39,4,3,9,4,45,31,9,4,319,74
185,40,5,2,7,6,-48,24,1,8,271,98
185,41,3,4,6,7,33,-57,4,1,304,41
185,42,3,3,5,8,32,35,6,6,336,76
185,43,3,4,7,6,-66,42,0,8,270,118
185,44,3,4,6,7,33,-57,3,1,303,61
185,45,3,3,5,8,32,35,5,6,335,96
185,46,5,2,9,4,54,22,9,8,389,118
185,47,3,3,5,8,-68,-65,1,3,321,53
185,48,3,3,5,8,32,35,3,8,353,88
185,49,3,3,10,3,-63,30,0,8,290,118
185,50,2,5,5,8,23,-47,3,1,313,71
185,51,3,3,9,4,36,31,9,2,349,102
185,52,4,3,5,8,-59,35,0,7,290,137
185,53,4,3,7,6,43,-67,3,0,333,70
185,54,3,4,5,8,32,44,5,4,365,114
185,55,3,3,5,8,32,35,7,9,397,149
185,56,4,2,9,4,-55,-78,2,1,342,71
185,57,2,5,7,6,25,51,7,2,367,122
185,58,5,2,9,4,-46,22,1,4,321,144
185,59,3,3,8,5,35,32,6,6,356,176
185,60,2,4,5,8,23,-56,9,0,379,120
185,61,3,3,7,6,-66,33,3,3,313,153
185,62,3,4,6,7,33,43,6,6,346,196
185,63,3,3,7,6,-66,33,0,9,280,229
185,64,2,5,5,8,23,-47,3,2,303,182
185,65,2,5,4,9,22,54,5,6,325,236
185,66,3,4,5,8,32,-56,7,0,357,180
185,67,5,2,9,4,-46,22,1,2,311,202
185,68,4,3,9,4,45,31,6,3,356,233
185,69,2,4,5,8,23,44,9,7,379,277
185,70,2,4,7,6,-75,42,4,9,304,319
185,71,2,4,4,9,22,-55,6,4,326,264
185,72,3,3,7,6,-66,33,0,7,260,297
185,73,4,2,8,5,44,-77,4,0,304,220
185,74,4,2,6,7,42,25,6,5,346,245
185,75,2,4,7,6,-75,42,1,7,271,287
185,76,4,3,8,5,44,32,5,9,315,319
185,77,3,3,6,7,33,-66,8,3,348,253
185,78,3,3,7,6,-66,33,2,6,282,286
185,79,5,2,8,5,53,23,5,9,335,309
185,80,4,3,7,6,43,-67,8,2,378,242
185,81,5,2,10,3,-45,21,3,3,333,263
185,82,5,2,9,4,54,22,7,5,387,285
185,83,3,3,8,5,-65,32,2,7,322,317
185,84,2,5,3,10,21,-45,3,2,343,272
185,85,3,3,8,5,35,32,8,4,378,304
185,86,5,2,10,3,-45,21,3,5,333,325
185,87,3,3,6,7,33,34,6,9,366,359
185,88,4,3,8,5,-56,-68,0,1,310,291
185,89,3,4,9,4,36,40,6,1,346,331
185,90,3,3,8,5,-65,32,1,3,281,363
185,91,3,3,8,5,35,32,6,5,316,395
185,92,3,3,6,7,33,34,9,9,349,429
185,93,5,2,8,5,-47,-77,2,2,302,352
185,94,5,3,8,5,53,32,5,4,355,384
185,95,2,4,5,8,23,44,8,8,378,428
185,96,5,2,7,6,-48,-76,0,2,330,352
185,97,3,4,6,7,33,43,3,5,363,395
185,98,3,3,9,4,36,31,9,6,399,426
185,99,4,3,6,7,-58,-66,1,0,341,360
185,100,2,4,5,8,23,44,4,4,364,404
185,101,2,4,4,9,22,45,6,9,386,449
185,102,2,4,4,9,22,-55,8,4,408,394
185,103,2,5,5,8,-77,53,1,7,331,447
185,104,3,3,6,7,33,-66,4,1,364,381
185,105,4,2,8,5,44,23,8,4,408,404
185,106,2,6,3,10,21,64,9,8,429,468
185,107,5,3,7,6,-48,-67,1,1,381,401
185,108,3,4,6,7,33,43,4,4,414,444
185,109,2,4,4,9,22,45,6,9,436,489
185,110,4,3,5,8,41,-65,7,4,477,424
185,111,3,3,7,6,-66,33,1,7,411,457
185,112,3,3,5,8,32,-65,3,2,443,392
185,113,3,4,6,7,33,43,6,5,476,435
185,114,4,3,8,5,-56,32,0,7,420,467
185,115,2,4,6,7,24,-57,4,0,444,410
185,116,4,2,7,6,43,24,7,4,487,434
185,117,2,4,7,6,-75,42,2,6,412,476
185,118,3,4,5,8,32,-56,4,0,444,420
185,119,2,4,5,8,23,44,7,4,467,464
185,120,5,2,9,4,-46,22,1,6,421,486
185,121,5,2,8,5,53,23,4,9,474,509
186,1,3,3,9,4,36,31,6,1,36,31
186,2,4,3,8,5,-56,32,0,3,-20,63
186,3,3,4,5,8,32,44,2,7,12,107
186,4,3,3,7,6,34,-67,6,0,46,40
186,5,2,5,3,10,21,55,7,5,67,95
186,6,2,4,8,5,-74,41,3,6,-7,136
186,7,4,3,5,8,41,-65,4,1,34,71
186,8,4,2,6,7,42,25,6,6,76,96
186,9,5,2,7,6,52,-76,8,0,128,20
186,10,3,4,7,6,-66,42,2,2,62,62
186,11,2,5,5,8,23,53,5,5,85,115
186,12,5,2,8,5,53,23,8,8,138,138
186,13,2,4,6,7,-76,-57,2,1,62,81
186,14,5,2,8,5,53,23,5,4,115,104
186,15,3,3,6,7,33,34,8,8,148,138
186,16,3,4,8,5,-65,41,3,9,83,179
186,17,4,2,9,4,45,-78,8,1,128,101
186,18,3,4,7,6,-66,42,2,3,62,143
186,19,3,4,7,6,34,42,6,5,96,185
186,20,3,3,5,8,32,-65,8,0,128,120
186,21,3,4,5,8,-68,44,0,4,60,164
186,22,2,5,6,7,24,52,4,6,84,216
186,23,2,4,5,8,23,-56,7,0,107,160
186,24,3,3,8,5,-65,32,2,2,42,192
186,25,4,2,5,8,41,26,3,8,83,218
186,26,5,2,8,5,53,-77,6,1,136,141
186,27,3,3,7,6,-66,33,0,4,70,174
186,28,6,2,9,4,63,22,3,6,133,196
186,29,3,3,7,6,34,33,7,9,167,229
186,30,4,3,8,5,-56,-68,1,1,111,161
186,31,4,2,9,4,45,22,6,3,156,183
186,32,3,4,5,8,32,44,8,7,188,227
186,33,3,3,7,6,-66,-67,2,0,122,160
186,34,5,2,9,4,54,22,6,2,176,182
186,35,2,5,6,7,-76,52,0,4,100,234
186,36,5,3,7,6,52,33,2,7,152,267
186,37,6,2,11,2,65,20,7,7,217,287
186,38,3,3,6,7,-67,-66,0,1,150,221
186,39,3,3,6,7,33,34,3,5,183,255
186,40,3,3,5,8,32,-65,5,0,215,190
186,41,3,4,7,6,34,42,9,2,249,232
186,42,4,2,7,6,-57,24,2,6,192,256
186,43,3,3,6,7,33,-66,5,0,225,190
186,44,3,4,7,6,34,42,9,2,259,232
186,45,5,2,9,4,-46,22,3,4,213,254
186,46,3,4,4,9,31,45,4,9,244,299
186,47,2,5,5,8,23,-47,7,2,267,252
186,48,2,4,6,7,-76,43,1,5,191,295
186,49,4,3,9,4,45,31,6,6,236,326
186,50,3,4,8,5,-65,41,1,7,171,367
186,51,4,2,6,7,42,-75,3,2,213,292
186,52,3,4,7,6,34,42,7,4,247,334
186,53,3,3,5,8,32,35,9,9,279,369
186,54,4,2,6,7,-58,-75,1,4,221,294
186,55,2,4,5,8,23,44,4,8,244,338
186,56,2,4,7,6,25,-58,9,0,269,280
186,57,3,4,5,8,-68,44,1,4,201,324
186,58,4,3,10,3,46,30,7,4,247,354
186,59,3,4,4,9,31,45,8,9,278,399
186,60,3,4,7,6,-66,-58,2,1,212,341
186,61,3,3,5,8,32,35,4,6,244,376
186,62,3,3,8,5,35,32,9,8,279,408
186,63,3,4,5,8,-68,-56,1,2,211,352
186,64,4,3,7,6,43,33,4,5,254,385
186,65,4,3,9,4,45,31,9,6,299,416
186,66,3,4,5,8,-68,-56,1,0,231,360
186,67,3,3,6,7,33,34,4,4,264,394
186,68,4,2,7,6,43,24,7,8,307,418
186,69,3,4,5,8,32,-56,9,2,339,362
186,70,2,4,4,9,-78,45,1,7,261,407
186,71,4,2,8,5,44,-77,5,0,305,330
186,72,3,3,7,6,34,33,9,3,339,363
186,73,3,4,9,4,-64,40,5,3,275,403
186,74,2,5,4,9,22,54,7,7,297,457
186,75,2,5,4,9,22,-46,9,1,319,411
186,76,3,3,6,7,-67,34,2,5,252,445
186,77,2,5,3,10,21,-45,3,0,273,400
186,78,3,4,7,6,34,42,7,2,307,442
186,79,3,4,6,7,-67,43,0,5,240,485
186,80,2,6,5,8,23,62,3,7,263,547
187,1,3,3,5,8,32,35,2,5,32,35
187,2,3,4,5,8,32,44,4,9,64,79
187,3,5,2,10,3,55,-79,9,0,119,0
187,4,4,2,7,6,-57,24,2,4,62,24
187,5,3,3,6,7,33,34,5,8,95,58
187,6,4,3,7,6,43,-67,8,1,138,-9
187,7,2,4,2,11,20,47,8,8,158,38
187,8,5,2,8,5,-47,-77,1,1,111,-39
187,9,3,3,8,5,35,32,6,3,146,-7
187,10,4,3,7,6,43,33,9,6,189,26
187,11,4,2,7,6,-57,-76,2,0,132,-50
187,12,2,5,5,8,23,53,5,3,155,3
187,13,4,3,10,3,-54,30,1,3,101,33
187,14,2,5,3,10,21,55,2,8,122,88
187,15,5,2,9,4,54,-78,6,0,176,10
187,16,2,5,5,8,23,53,9,3,199,63
187,17,4,3,8,5,-56,32,3,5,143,95
187,18,2,4,2,11,20,-53,3,2,163,42
187,19,3,4,5,8,32,44,5,6,195,86
187,20,3,4,4,9,31,-55,6,1,226,31
187,21,3,4,7,6,-66,42,0,3,160,73
187,22,4,3,5,8,41,35,1,8,201,108
187,23,2,4,4,9,22,-55,3,3,223,53
187,24,2,4,6,7,24,43,7,6,247,96
187,25,4,3,6,7,42,-66,9,0,289,30
187,26,6,2,9,4,-37,22,2,2,252,52
187,27,2,4,6,7,24,43,6,5,276,95
187,28,5,2,9,4,-46,22,0,7,230,117
187,29,2,6,6,7,24,61,4,8,254,178
187,30,3,4,5,8,32,-56,6,2,286,122
187,31,2,4,7,6,-75,42,1,4,211,164
187,32,4,2,8,5,44,23,5,7,255,187
187,33,3,4,4,9,31,-55,6,2,286,132
187,34,2,4,6,7,-76,43,0,5,210,175
187,35,3,3,9,4,36,31,6,6,246,206
187,36,5,2,7,6,52,-76,8,0,298,130
187,37,2,4,6,7,-76,43,2,3,222,173
187,38,5,3,6,7,51,34,3,7,273,207
187,39,2,5,2,11,20,-44,3,3,293,163
187,40,3,3,6,7,33,34,6,7,326,197
187,41,3,4,4,9,31,-55,7,2,357,142
187,42,4,4,5,8,41,44,8,6,398,186
187,43,2,5,2,11,20,-44,8,2,418,142
187,44,5,2,9,4,-46,22,2,4,372,164
187,45,3,4,8,5,35,41,7,5,407,205
187,46,4,2,5,8,41,-74,8,1,448,131
187,47,4,2,8,5,-56,23,2,4,392,154
187,48,5,2,9,4,54,22,6,6,446,176
187,49,4,2,7,6,43,-76,9,0,489,100
187,50,5,2,10,3,-45,21,4,1,444,121
187,51,3,3,5,8,32,35,6,6,476,156
187,52,5,2,7,6,52,-76,8,0,528,80
188,1,4,2,8,5,44,23,4,3,44,23
188,2,5,2,10,3,55,21,9,4,99,44
188,3,3,5,3,10,30,55,9,9,129,99
188,4,4,2,9,4,-55,-78,4,1,74,21
188,5,2,4,4,9,22,45,6,6,96,66
188,6,3,3,5,8,32,-65,8,1,128,1
188,7,4,3,7,6,-57,33,1,4,71,34
188,8,2,4,6,7,24,43,5,7,95,77
188,9,6,2,11,2,-35,20,0,7,60,97
188,10,4,2,8,5,44,-77,4,0,104,20
188,11,3,5,6,7,33,52,7,2,137,72
188,12,2,4,7,6,-75,42,2,4,62,114
188,13,3,3,9,4,36,31,8,5,98,145
188,14,4,2,7,6,-57,24,1,9,41,169
188,15,5,2,8,5,53,-77,4,2,94,92
188,16,2,4,2,11,20,47,4,9,114,139
188,17,5,2,10,3,55,-79,9,0,169,60
188,18,4,2,6,7,-58,25,1,5,111,85
188,19,4,2,9,4,45,22,6,7,156,107
188,20,3,4,5,8,32,-56,8,1,188,51
188,21,3,3,8,5,-65,32,3,3,123,83
188,22,5,2,7,6,52,24,5,7,175,107
188,23,4,3,7,6,43,-67,8,0,218,40
188,24,3,4,7,6,-66,42,2,2,152,82
188,25,4,2,10,3,46,21,8,3,198,103
188,26,2,5,4,9,-78,54,0,7,120,157
188,27,3,3,5,8,32,-65,2,2,152,92
188,28,3,3,8,5,35,32,7,4,187,124
188,29,2,4,5,8,-77,44,0,8,110,168
188,30,3,3,6,7,33,-66,3,2,143,102
188,31,4,2,6,7,42,25,5,7,185,127
188,32,3,4,8,5,-65,41,0,8,120,168
188,33,2,4,3,10,21,-54,1,4,141,114
188,34,2,5,6,7,24,52,5,6,165,166
188,35,4,3,6,7,42,-66,7,0,207,100
188,36,2,5,5,8,-77,53,0,3,130,153
188,37,3,3,8,5,35,32,5,5,165,185
188,38,3,3,5,8,32,-65,7,0,197,120
188,39,5,2,6,7,51,25,8,5,248,145
188,40,3,4,7,6,-66,42,2,7,182,187
188,41,3,3,7,6,34,-67,6,0,216,120
188,42,3,3,8,5,-65,32,1,2,151,152
188,43,4,2,8,5,44,23,5,5,195,175
188,44,3,3,7,6,34,33,9,8,229,208
188,45,3,4,7,6,-66,-58,3,0,163,150
188,46,4,2,9,4,45,22,8,2,208,172
188,47,4,3,5,8,41,35,9,7,249,207
188,48,3,4,8,5,-65,41,4,8,184,248
188,49,3,4,7,6,34,-58,8,0,218,190
188,50,4,2,8,5,-56,23,2,3,162,213
188,51,4,2,8,5,44,23,6,6,206,236
188,52,3,4,6,7,33,43,9,9,239,279
188,53,4,3,5,8,-59,-65,0,4,180,214
188,54,6,2,10,3,64,21,4,5,244,235
188,55,5,3,7,6,52,33,6,8,296,268
188,56,2,4,4,9,22,-55,8,3,318,213
188,57,2,4,6,7,-76,43,2,6,242,256
188,58,4,2,6,7,42,-75,4,1,284,181
188,59,3,3,7,6,34,33,8,4,318,214
188,60,5,2,7,6,-48,24,0,8,270,238
188,61,3,3,5,8,32,-65,2,3,302,173
188,62,2,5,4,9,22,54,4,7,324,227
188,63,3,3,5,8,32,-65,6,2,356,162
188,64,4,2,8,5,-56,23,0,5,300,185
188,65,4,2,10,3,46,21,6,6,346,206
188,66,4,3,7,6,43,33,9,9,389,239
188,67,3,3,8,5,-65,-68,4,1,324,171
188,68,3,3,8,5,35,32,9,3,359,203
188,69,3,4,5,8,-68,44,1,7,291,247
188,70,3,4,7,6,34,42,5,9,325,289
188,71,4,3,10,3,-54,30,1,9,271,319
188,72,2,4,4,9,22,-55,3,4,293,264
188,73,2,5,6,7,24,52,7,6,317,316
188,74,4,2,9,4,-55,22,2,8,262,338
188,75,4,3,9,4,45,31,7,9,307,369
188,76,2,4,4,9,22,-55,9,4,329,314
188,77,2,5,3,10,-79,55,0,9,250,369
188,78,3,4,7,6,34,-58,4,1,284,311
188,79,2,4,3,10,21,46,5,7,305,357
188,80,2,5,4,9,22,-46,7,1,327,311
188,81,3,3,7,6,-66,33,1,4,261,344
188,82,3,4,6,7,33,43,4,7,294,387
188,83,3,5,7,6,34,51,8,8,328,438
188,84,4,3,10,3,-54,30,4,8,274,468
188,85,4,2,7,6,43,-76,7,2,317,392
188,86,3,4,4,9,31,45,8,7,348,437
188,87,2,4,4,9,-78,-55,0,2,270,382
188,88,3,4,5,8,32,44,2,6,302,426
188,89,3,3,4,9,31,-64,3,2,333,362
188,90,2,5,6,7,24,52,7,4,357,414
188,91,2,4,7,6,-75,42,2,6,282,456
188,92,3,4,4,9,31,-55,3,1,313,401
188,93,3,4,7,6,34,42,7,3,347,443
188,94,3,4,5,8,32,44,9,7,379,487
188,95,2,5,5,8,-77,-47,2,0,302,440
188,96,3,3,6,7,33,34,5,4,335,474
188,97,3,3,4,9,31,-64,6,0,366,410
188,98,2,4,6,7,-76,43,0,3,290,453
188,99,3,3,5,8,32,35,2,8,322,488
188,100,3,3,7,6,34,-67,6,1,356,421
188,101,5,2,9,4,-46,22,0,3,310,443
188,102,4,3,6,7,42,34,2,7,352,477
188,103,4,2,8,5,44,-77,6,0,396,400
188,104,3,3,8,5,-65,32,1,2,331,432
188,105,5,3,9,4,54,31,5,3,385,463
188,106,4,3,7,6,43,33,8,6,428,496
188,107,3,4,8,5,-65,41,3,7,363,537
189,1,2,6,3,10,21,64,1,4,21,64
189,2,4,2,9,4,45,22,6,6,66,86
189,3,3,4,7,6,-66,42,0,8,0,128
189,4,4,3,9,4,45,31,5,9,45,159
189,5,4,3,6,7,42,-66,7,3,87,93
189,6,3,3,8,5,-65,32,2,5,22,125
189,7,5,2,11,2,56,20,8,5,78,145
189,8,4,2,7,6,-57,24,1,9,21,169
189,9,2,4,5,8,23,-56,4,3,44,113
189,10,2,5,3,10,21,55,5,8,65,168
189,11,2,4,7,6,-75,-58,0,0,-10,110
189,12,3,4,7,6,34,42,4,2,24,152
189,13,4,2,5,8,41,26,5,8,65,178
189,14,2,4,4,9,22,-55,7,3,87,123
189,15,2,5,6,7,-76,52,1,5,11,175
189,16,5,2,9,4,54,22,5,7,65,197
189,17,2,6,3,10,21,-36,6,1,86,161
189,18,3,3,7,6,-66,33,0,4,20,194
189,19,3,4,7,6,34,42,4,6,54,236
189,20,4,3,7,6,43,33,7,9,97,269
189,21,6,2,12,1,-34,-20,3,9,63,249
189,22,3,3,8,5,35,-68,8,1,98,181
189,23,4,2,10,3,-54,21,4,2,44,202
189,24,3,3,6,7,33,34,7,6,77,236
189,25,5,2,8,5,-47,23,0,9,30,259
189,26,3,3,7,6,34,-67,4,2,64,192
189,27,3,3,9,4,-64,31,0,3,0,223
189,28,2,4,3,10,21,46,1,9,21,269
189,29,3,3,5,8,32,-65,3,4,53,204
189,30,2,6,3,10,21,64,4,8,74,268
189,31,3,4,7,6,34,-58,8,0,108,210
189,32,2,4,4,9,-78,45,0,5,30,255
189,33,2,5,4,9,22,54,2,9,52,309
189,34,4,2,8,5,44,-77,6,2,96,232
189,35,3,4,5,8,32,44,8,6,128,276
189,36,4,3,7,6,-57,33,1,9,71,309
189,37,2,4,4,9,22,-55,3,4,93,254
189,38,3,3,7,6,34,33,7,7,127,287
189,39,2,4,3,10,21,-54,8,3,148,233
189,40,3,3,5,8,-68,35,0,8,80,268
189,41,4,2,7,6,43,-76,3,2,123,192
189,42,3,4,7,6,34,42,7,4,157,234
189,43,6,2,9,4,-37,22,0,6,120,256
189,44,4,3,5,8,41,-65,1,1,161,191
189,45,2,5,4,9,22,54,3,5,183,245
189,46,3,3,3,10,30,-63,3,2,213,182
189,47,3,4,6,7,33,43,6,5,246,225
189,48,5,2,10,3,-45,21,1,6,201,246
189,49,6,2,10,3,64,21,5,7,265,267
189,50,2,4,5,8,23,-56,8,1,288,211
189,51,4,4,6,7,-58,43,0,4,230,254
189,52,3,4,7,6,34,42,4,6,264,296
189,53,3,3,6,7,33,-66,7,0,297,230
189,54,4,3,9,4,-55,31,2,1,242,261
189,55,3,3,4,9,31,36,3,7,273,297
189,56,5,2,10,3,55,21,8,8,328,318
189,57,5,2,10,3,-45,21,3,9,283,339
189,58,3,3,7,6,34,-67,7,2,317,272
189,59,2,5,5,8,-77,53,0,5,240,325
189,60,4,2,8,5,44,23,4,8,284,348
189,61,3,3,8,5,35,-68,9,0,319,280
189,62,4,2,9,4,-55,22,4,2,264,302
189,63,2,5,4,9,22,54,6,6,286,356
189,64,3,4,5,8,32,-56,8,0,318,300
189,65,2,4,5,8,-77,44,1,4,241,344
189,66,3,4,4,9,31,45,2,9,272,389
189,67,4,3,7,6,43,-67,5,2,315,322
189,68,4,3,9,4,-55,31,0,3,260,353
189,69,4,3,7,6,43,33,3,6,303,386
189,70,3,3,5,8,32,-65,5,1,335,321
189,71,4,3,8,5,44,32,9,3,379,353
189,72,4,3,5,8,-59,35,0,8,320,388
189,73,4,3,9,4,45,31,5,9,365,419
189,74,2,5,3,10,21,-45,6,4,386,374
189,75,2,6,3,10,21,64,7,8,407,438
189,76,3,4,5,8,32,-56,9,2,439,382
189,77,4,4,5,8,-59,44,0,6,380,426
189,78,3,4,4,9,31,-55,1,1,411,371
189,79,3,3,3,10,30,37,1,8,441,408
189,80,5,2,10,3,55,21,6,9,496,429
189,81,4,2,9,4,-55,-78,1,1,441,351
189,82,4,2,7,6,43,24,4,5,484,375
189,83,3,4,7,6,34,42,8,7,518,417
190,1,2,6,5,8,23,62,3,2,23,62
190,2,4,3,5,8,41,35,4,7,64,97
190,3,4,2,9,4,45,22,9,9,109,119
190,4,3,3,8,5,-65,-68,4,1,44,51
190,5,2,4,6,7,24,43,8,4,68,94
190,6,3,3,7,6,-66,33,2,7,2,127
190,7,4,3,9,4,45,31,7,8,47,158
190,8,2,5,5,8,-77,-47,0,1,-30,111
190,9,3,3,6,7,33,34,3,5,3,145
190,10,2,4,3,10,21,-54,4,1,24,91
190,11,2,5,2,11,20,56,4,7,44,147
190,12,4,3,9,4,45,31,9,8,89,178
190,13,4,2,6,7,-58,-75,1,3,31,103
190,14,4,3,7,6,43,33,4,6,74,136
190,15,2,4,4,9,22,-55,6,1,96,81
190,16,5,3,9,4,-46,31,0,2,50,112
190,17,4,2,5,8,41,26,1,8,91,138
190,18,5,2,10,3,55,21,6,9,146,159
190,19,4,4,6,7,42,-57,8,2,188,102
190,20,5,2,11,2,-44,20,4,2,144,122
190,21,2,5,3,10,21,55,5,7,165,177
190,22,4,2,9,4,-55,22,0,9,110,199
190,23,6,2,6,7,60,-75,0,4,170,124
190,24,2,5,6,7,24,52,4,6,194,176
190,25,4,3,7,6,43,33,7,9,237,209
190,26,4,3,9,4,-55,-69,2,0,182,140
190,27,3,4,8,5,35,41,7,1,217,181
190,28,4,3,8,5,-56,32,1,3,161,213
190,29,4,2,8,5,44,23,5,6,205,236
190,30,3,3,4,9,31,-64,6,2,236,172
190,31,3,3,5,8,32,35,8,7,268,207
190,32,4,3,6,7,-58,-66,0,1,210,141
190,33,4,3,10,3,46,30,6,1,256,171
190,34,4,2,9,4,-55,22,1,3,201,193
190,35,4,3,7,6,43,33,4,6,244,226
190,36,2,4,5,8,23,-56,7,0,267,170
190,37,3,3,6,7,-67,34,0,4,200,204
190,38,4,2,7,6,43,24,3,8,243,228
190,39,4,2,7,6,43,-76,6,2,286,152
190,40,4,3,8,5,-56,32,0,4,230,184
190,41,5,2,7,6,52,24,2,8,282,208
190,42,2,4,6,7,24,-57,6,1,306,151
190,43,5,2,9,4,-46,22,0,3,260,173
190,44,3,3,6,7,33,34,3,7,293,207
190,45,5,2,7,6,52,-76,5,1,345,131
190,46,3,3,5,8,32,35,7,6,377,166
190,47,2,5,5,8,-77,53,0,9,300,219
190,48,3,4,5,8,32,-56,2,3,332,163
190,49,2,5,5,8,23,53,5,6,355,216
190,50,2,4,7,6,-75,42,0,8,280,258
190,51,4,2,8,5,44,-77,4,1,324,181
190,52,3,4,7,6,34,42,8,3,358,223
190,53,4,3,8,5,-56,32,2,5,302,255
190,54,3,4,5,8,32,44,4,9,334,299
190,55,2,4,6,7,24,-57,8,2,358,242
190,56,3,4,6,7,-67,43,1,5,291,285
190,57,3,4,7,6,34,42,5,7,325,327
190,58,4,2,6,7,42,-75,7,2,367,252
190,59,3,3,5,8,32,35,9,7,399,287
190,60,2,5,5,8,-77,-47,2,0,322,240
190,61,4,2,9,4,45,22,7,2,367,262
190,62,3,4,6,7,-67,43,0,5,300,305
190,63,2,5,3,10,21,-45,1,0,321,260
190,64,3,3,5,8,32,35,3,5,353,295
190,65,4,3,9,4,45,31,8,6,398,326
190,66,3,3,8,5,-65,32,3,8,333,358
190,67,4,3,6,7,42,-66,5,2,375,292
190,68,6,2,9,4,63,22,8,4,438,314
190,69,3,3,6,7,-67,34,1,8,371,348
190,70,4,3,10,3,46,30,7,8,417,378
190,71,3,3,7,6,-66,-67,1,1,351,311
190,72,3,4,7,6,34,42,5,3,385,353
190,73,4,3,7,6,43,33,8,6,428,386
190,74,3,4,5,8,-68,-56,0,0,360,330
190,75,2,4,7,6,25,42,5,2,385,372
190,76,4,3,7,6,43,33,8,5,428,405
190,77,4,2,9,4,-55,22,3,7,373,427
190,78,3,3,5,8,32,-65,5,2,405,362
190,79,4,3,6,7,42,34,7,6,447,396
190,80,5,2,7,6,52,-76,9,0,499,320
190,81,4,2,9,4,-55,22,4,2,444,342
190,82,3,4,6,7,33,43,7,5,477,385
190,83,2,4,4,9,22,-55,9,0,499,330
190,84,5,2,10,3,-45,21,4,1,454,351
190,85,2,4,4,9,22,45,6,6,476,396
190,86,3,4,7,6,-66,42,0,8,410,438
190,87,4,3,7,6,43,-67,3,1,453,371
190,88,3,4,6,7,33,43,6,4,486,414
190,89,4,3,8,5,-56,32,0,6,430,446
190,90,3,4,6,7,33,43,3,9,463,489
190,91,3,3,6,7,33,-66,6,3,496,423
190,92,3,3,7,6,-66,33,0,6,430,456
190,93,2,4,7,6,25,42,5,8,455,498
190,94,4,3,8,5,44,-68,9,0,499,430
190,95,4,3,9,4,-55,31,4,1,444,461
190,96,2,4,7,6,25,42,9,3,469,503
191,1,2,5,5,8,23,53,3,3,23,53
191,2,3,3,8,5,35,32,8,5,58,85
191,3,4,3,9,4,-55,31,3,6,3,116
191,4,3,3,10,3,-63,30,0,6,-60,146
191,5,2,4,6,7,24,43,4,9,-36,189
191,6,4,3,8,5,44,-68,8,1,8,121
191,7,5,2,8,5,-47,23,1,4,-39,144
191,8,2,4,8,5,26,41,7,5,-13,185
191,9,4,2,9,4,-55,22,2,7,-68,207
191,10,2,5,2,11,20,-44,2,3,-48,163
191,11,4,2,10,3,46,21,8,4,-2,184
191,12,3,3,8,5,-65,32,3,6,-67,216
191,13,3,3,7,6,34,33,7,9,-33,249
191,14,2,5,6,7,-76,-48,1,1,-109,201
191,15,4,2,9,4,45,22,6,3,-64,223
191,16,4,2,8,5,-56,23,0,6,-120,246
191,17,2,4,4,9,22,-55,2,1,-98,191
191,18,2,6,2,11,20,65,2,6,-78,256
191,19,5,3,10,3,55,30,7,6,-23,286
191,20,4,2,6,7,42,-75,9,1,19,211
191,21,3,4,3,10,30,46,9,7,49,257
191,22,3,4,9,4,-64,40,5,7,-15,297
191,23,2,5,7,6,-75,51,0,8,-90,348
191,24,3,3,6,7,33,-66,3,2,-57,282
191,25,4,2,11,2,-53,20,0,2,-110,302
191,26,2,4,3,10,21,46,1,8,-89,348
191,27,3,4,4,9,31,-55,2,3,-58,293
191,28,5,2,10,3,55,21,7,4,-3,314
191,29,2,6,4,9,22,63,9,7,19,377
191,30,2,4,8,5,-74,41,5,8,-55,418
191,31,4,2,9,4,-55,-78,0,0,-110,340
191,32,4,3,4,9,40,36,0,6,-70,376
191,33,4,3,8,5,44,32,4,8,-26,408
191,34,3,4,5,8,32,-56,6,2,6,352
191,35,3,4,6,7,33,43,9,5,39,395
191,36,4,3,7,6,-57,33,2,8,-18,428
191,37,2,5,6,7,24,-48,6,0,6,380
191,38,3,4,3,10,30,46,6,6,36,426
191,39,3,3,6,7,33,-66,9,0,69,360
191,40,4,2,11,2,-53,20,6,0,16,380
191,41,3,4,5,8,32,44,8,4,48,424
191,42,2,4,5,8,-77,44,1,8,-29,468
191,43,3,3,9,4,36,31,7,9,7,499
191,44,4,3,5,8,41,-65,8,4,48,434
191,45,3,4,7,6,-66,42,2,6,-18,476
191,46,5,2,6,7,51,-75,3,1,33,401
191,47,4,2,9,4,45,22,8,3,78,423
191,48,4,3,7,6,-57,33,1,6,21,456
191,49,4,3,8,5,44,32,5,8,65,488
191,50,3,4,4,9,31,-55,6,3,96,433
191,51,2,6,6,7,-76,61,0,4,20,494
191,52,3,3,6,7,33,34,3,8,53,528
192,1,2,5,3,10,21,55,1,5,21,55
192,2,2,5,6,7,24,52,5,7,45,107
192,3,3,4,9,4,-64,40,1,7,-19,147
192,4,2,4,6,7,24,-57,5,0,5,90
192,5,4,3,8,5,44,32,9,2,49,122
192,6,4,2,8,5,-56,23,3,5,-7,145
192,7,4,3,8,5,44,32,7,7,37,177
192,8,3,4,5,8,32,-56,9,1,69,121
192,9,2,6,3,10,-79,64,0,5,-10,185
192,10,2,4,4,9,22,-55,2,0,12,130
192,11,2,5,2,11,20,56,2,6,32,186
192,12,4,2,9,4,45,22,7,8,77,208
192,13,4,4,7,6,-57,-58,0,0,20,150
192,14,3,4,8,5,35,41,5,1,55,191
192,15,4,4,7,6,43,42,8,3,98,233
192,16,3,5,3,10,30,55,8,8,128,288
192,17,3,4,7,6,-66,-58,2,0,62,230
192,18,3,3,8,5,35,32,7,2,97,262
192,19,4,3,6,7,42,34,9,6,139,296
192,20,2,5,5,8,-77,53,2,9,62,349
192,21,4,3,8,5,44,-68,6,1,106,281
192,22,3,4,6,7,33,43,9,4,139,324
192,23,5,3,9,4,-46,31,3,5,93,355
192,24,2,4,4,9,22,-55,5,0,115,300
192,25,2,4,6,7,24,43,9,3,139,343
192,26,3,4,8,5,-65,41,4,4,74,384
192,27,3,4,6,7,33,43,7,7,107,427
192,28,5,2,8,5,-47,-77,0,0,60,350
192,29,4,3,9,4,45,31,5,1,105,381
192,30,4,3,9,4,-55,31,0,2,50,412
192,31,3,3,7,6,34,33,4,5,84,445
192,32,3,3,10,3,-63,30,1,5,21,475
192,33,2,5,6,7,24,52,5,7,45,527
193,1,2,6,2,11,20,65,0,5,20,65
193,2,3,3,8,5,35,32,5,7,55,97
193,3,5,2,6,7,51,-75,6,2,106,22
193,4,2,5,4,9,22,54,8,6,128,76
193,5,4,2,10,3,-54,21,4,7,74,97
193,6,4,3,7,6,43,-67,7,0,117,30
193,7,3,4,7,6,-66,42,1,2,51,72
193,8,5,2,9,4,54,22,5,4,105,94
193,9,2,5,6,7,24,52,9,6,129,146
193,10,3,4,5,8,-68,-56,1,0,61,90
193,11,3,3,7,6,34,33,5,3,95,123
193,12,3,3,10,3,-63,30,2,3,32,153
193,13,3,4,5,8,32,44,4,7,64,197
193,14,3,3,6,7,33,-66,7,1,97,131
193,15,2,5,3,10,21,55,8,6,118,186
193,16,3,4,5,8,-68,-56,0,0,50,130
193,17,2,4,7,6,25,42,5,2,75,172
193,18,3,4,5,8,32,44,7,6,107,216
193,19,4,3,9,4,-55,31,2,7,52,247
193,20,4,2,7,6,43,-76,5,1,95,171
193,21,2,5,6,7,24,52,9,3,119,223
193,22,4,2,6,7,-58,25,1,8,61,248
193,23,2,5,5,8,23,-47,4,1,84,201
193,24,3,3,8,5,35,32,9,3,119,233
193,25,3,3,5,8,-68,35,1,8,51,268
193,26,5,2,10,3,55,21,6,9,106,289
193,27,3,4,9,4,-64,40,2,9,42,329
193,28,3,4,7,6,34,-58,6,1,76,271
193,29,4,2,8,5,-56,23,0,4,20,294
193,30,3,3,6,7,33,34,3,8,53,328
193,31,4,2,10,3,46,21,9,9,99,349
193,32,3,3,9,4,-64,-69,5,0,35,280
193,33,2,4,5,8,23,44,8,4,58,324
193,34,5,2,9,4,-46,22,2,6,12,346
193,35,2,5,5,8,23,53,5,9,35,399
193,36,4,3,9,4,-55,-69,0,0,-20,330
193,37,4,2,6,7,42,25,2,5,22,355
193,38,4,2,7,6,43,24,5,9,65,379
193,39,4,3,9,4,-55,-69,0,0,10,310
193,40,3,4,3,10,30,46,0,6,40,356
193,41,2,4,7,6,25,42,5,8,65,398
193,42,2,4,4,9,22,-55,7,3,87,343
193,43,2,4,4,9,22,45,9,8,109,388
193,44,3,3,5,8,-68,-65,1,3,41,323
193,45,4,2,10,3,46,21,7,4,87,344
193,46,2,5,4,9,22,54,9,8,109,398
193,47,3,4,6,7,-67,-57,2,1,42,341
193,48,3,4,5,8,32,44,4,5,74,385
193,49,4,2,8,5,44,23,8,8,118,408
193,50,4,2,7,6,-57,-76,1,2,61,332
193,51,5,2,9,4,54,22,5,4,115,354
193,52,2,4,4,9,22,45,7,9,137,399
193,53,4,3,9,4,-55,-69,2,0,82,330
193,54,4,2,9,4,45,22,7,2,127,352
193,55,2,5,6,7,-76,52,1,4,51,404
193,56,2,6,4,9,22,63,3,7,73,467
193,57,2,5,3,10,21,-45,4,2,94,422
193,58,4,2,8,5,44,23,8,5,138,445
193,59,3,4,3,10,30,-54,8,1,168,391
193,60,3,3,7,6,-66,33,2,4,102,424
193,61,2,4,5,8,23,44,5,8,125,468
193,62,4,3,7,6,43,-67,8,1,168,401
193,63,3,3,5,8,-68,35,0,6,100,436
193,64,3,3,4,9,31,-64,1,2,131,372
193,65,3,4,6,7,33,43,4,5,164,415
193,66,4,3,7,6,43,33,7,8,207,448
193,67,5,2,9,4,-46,-78,1,0,161,370
193,68,3,3,7,6,34,33,5,3,195,403
193,69,5,2,11,2,-44,20,1,3,151,423
193,70,3,3,4,9,31,36,2,9,182,459
193,71,5,2,11,2,56,20,8,9,238,479
193,72,4,2,8,5,-56,-77,2,2,182,402
193,73,3,4,9,4,36,40,8,2,218,442
193,74,6,2,10,3,-36,21,2,3,182,463
193,75,3,3,6,7,33,34,5,7,215,497
193,76,4,2,10,3,-54,21,1,8,161,518
194,1,3,4,7,6,34,42,4,2,34,42
194,2,3,4,5,8,32,44,6,6,66,86
194,3,3,3,7,6,-66,33,0,9,0,119
194,4,3,3,7,6,34,-67,4,2,34,52
194,5,2,4,4,9,22,45,6,7,56,97
194,6,2,4,5,8,23,-56,9,1,79,41
194,7,2,5,6,7,-76,52,3,3,3,93
194,8,3,3,8,5,35,32,8,5,38,125
194,9,4,2,9,4,-55,22,3,7,-17,147
194,10,4,3,9,4,45,31,8,8,28,178
194,11,4,3,5,8,41,-65,9,3,69,113
194,12,3,3,7,6,-66,33,3,6,3,146
194,13,5,2,9,4,54,22,7,8,57,168
194,14,3,3,5,8,32,-65,9,3,89,103
194,15,3,4,3,10,30,46,9,9,119,149
194,16,3,3,4,9,-69,-64,0,5,50,85
194,17,3,3,5,8,32,-65,2,0,82,20
194,18,3,4,4,9,31,45,3,5,113,65
194,19,3,4,5,8,32,44,5,9,145,109
194,20,4,2,7,6,43,-76,8,3,188,33
194,21,2,5,3,10,21,55,9,8,209,88
194,22,4,2,7,6,-57,-76,2,2,152,12
194,23,4,2,8,5,44,23,6,5,196,35
194,24,4,3,6,7,42,34,8,9,238,69
194,25,6,2,9,4,-37,-78,1,1,201,-9
194,26,3,3,5,8,32,35,3,6,233,26
194,27,3,4,7,6,34,42,7,8,267,68
194,28,3,4,7,6,-66,-58,1,0,201,10
194,29,3,4,5,8,32,44,3,4,233,54
194,30,3,3,7,6,34,33,7,7,267,87
194,31,3,4,5,8,32,-56,9,1,299,31
194,32,3,3,5,8,-68,35,1,6,231,66
194,33,2,5,4,9,22,-46,3,0,253,20
194,34,3,3,9,4,36,31,9,1,289,51
194,35,3,3,8,5,-65,32,4,3,224,83
194,36,4,3,4,9,40,36,4,9,264,119
194,37,3,3,6,7,33,-66,7,3,297,53
194,38,3,4,9,4,-64,40,3,3,233,93
194,39,3,4,6,7,33,43,6,6,266,136
194,40,4,2,6,7,42,-75,8,1,308,61
194,41,4,2,8,5,-56,23,2,4,252,84
194,42,2,4,5,8,23,44,5,8,275,128
194,43,2,5,3,10,21,-45,6,3,296,83
194,44,4,3,6,7,42,34,8,7,338,117
194,45,3,3,6,7,-67,-66,1,1,271,51
194,46,4,2,8,5,44,23,5,4,315,74
194,47,3,3,6,7,33,34,8,8,348,108
194,48,2,5,5,8,-77,-47,1,1,271,61
194,49,4,3,9,4,45,31,6,2,316,92
194,50,5,2,8,5,53,23,9,5,369,115
194,51,3,4,5,8,-68,44,1,9,301,159
194,52,3,4,7,6,34,-58,5,1,335,101
194,53,3,4,4,9,31,45,6,6,366,146
194,54,2,6,3,10,21,-36,7,0,387,110
194,55,3,3,6,7,-67,34,0,4,320,144
194,56,2,5,5,8,23,53,3,7,343,197
194,57,2,5,3,10,21,-45,4,2,364,152
194,58,4,3,8,5,44,32,8,4,408,184
194,59,3,4,6,7,-67,43,1,7,341,227
194,60,3,3,6,7,33,-66,4,1,374,161
194,61,4,3,6,7,42,34,6,5,416,195
194,62,2,4,6,7,-76,43,0,8,340,238
194,63,2,4,7,6,25,-58,5,0,365,180
194,64,3,4,6,7,33,43,8,3,398,223
194,65,4,3,6,7,-58,34,0,7,340,257
194,66,3,3,8,5,35,32,5,9,375,289
194,67,5,2,9,4,54,-78,9,1,429,211
194,68,2,5,3,10,-79,55,0,6,350,266
194,69,4,3,7,6,43,33,3,9,393,299
194,70,2,5,3,10,21,-45,4,4,414,254
194,71,5,2,10,3,55,21,9,5,469,275
194,72,3,3,4,9,-69,-64,0,1,400,211
194,73,4,3,9,4,45,31,5,2,445,242
194,74,3,3,8,5,-65,32,0,4,380,274
194,75,2,4,3,10,21,-54,1,0,401,220
194,76,4,3,6,7,42,34,3,4,443,254
194,77,2,4,6,7,24,43,7,7,467,297
194,78,4,4,9,4,-55,40,2,7,412,337
194,79,3,4,7,6,34,42,6,9,446,379
194,80,3,4,7,6,-66,-58,0,1,380,321
194,81,4,3,6,7,42,34,2,5,422,355
194,82,4,3,9,4,45,31,7,6,467,386
194,83,2,5,3,10,21,-45,8,1,488,341
194,84,4,2,11,2,-53,20,5,1,435,361
194,85,2,4,8,5,-74,41,1,2,361,402
194,86,4,3,7,6,43,33,4,5,404,435
194,87,3,4,6,7,33,43,7,8,437,478
194,88,4,3,7,6,-57,-67,0,1,380,411
194,89,4,3,7,6,43,33,3,4,423,444
194,90,5,2,9,4,54,22,7,6,477,466
194,91,3,4,4,9,31,-55,8,1,508,411
195,1,4,3,7,6,43,33,3,3,43,33
195,2,2,5,5,8,23,53,6,6,66,86
195,3,4,3,9,4,-55,31,1,7,11,117
195,4,4,3,5,8,41,-65,2,2,52,52
195,5,5,2,9,4,54,22,6,4,106,74
195,6,3,4,6,7,33,43,9,7,139,117
195,7,5,3,10,3,-45,30,4,7,94,147
195,8,3,4,7,6,34,42,8,9,128,189
195,9,3,3,5,8,-68,-65,0,4,60,124
195,10,3,4,3,10,30,-54,0,0,90,70
195,11,2,5,4,9,22,54,2,4,112,124
195,12,4,2,8,5,44,23,6,7,156,147
195,13,4,3,8,5,-56,32,0,9,100,179
195,14,3,4,6,7,33,-57,3,2,133,122
195,15,4,3,9,4,45,31,8,3,178,153
195,16,2,5,4,9,-78,54,0,7,100,207
195,17,3,3,5,8,32,-65,2,2,132,142
195,18,4,2,8,5,44,23,6,5,176,165
195,19,4,2,9,4,-55,22,1,7,121,187
195,20,5,2,10,3,55,21,6,8,176,208
195,21,3,3,5,8,32,-65,8,3,208,143
195,22,4,3,7,6,-57,33,1,6,151,176
195,23,4,2,8,5,44,23,5,9,195,199
195,24,4,3,7,6,43,-67,8,2,238,132
195,25,4,3,10,3,-54,30,4,2,184,162
195,26,2,4,5,8,23,44,7,6,207,206
195,27,4,3,5,8,41,-65,8,1,248,141
195,28,3,4,6,7,-67,43,1,4,181,184
195,29,6,2,11,2,65,20,6,4,246,204
195,30,4,2,9,4,-55,22,1,6,191,226
195,31,2,6,2,11,20,-35,1,1,211,191
195,32,4,3,6,7,42,34,3,5,253,225
195,33,3,3,7,6,34,33,7,8,287,258
195,34,4,2,7,6,-57,-76,0,2,230,182
195,35,4,2,9,4,45,22,5,4,275,204
195,36,4,3,9,4,-55,31,0,5,220,235
195,37,4,2,8,5,44,23,4,8,264,258
195,38,6,2,9,4,63,-78,7,0,327,180
195,39,2,4,8,5,-74,41,3,1,253,221
195,40,4,2,8,5,44,23,7,4,297,244
195,41,4,3,9,4,-55,31,2,5,242,275
195,42,3,3,8,5,35,32,7,7,277,307
195,43,2,6,3,10,21,-36,8,1,298,271
195,44,4,2,11,2,-53,20,5,1,245,291
195,45,4,3,8,5,44,32,9,3,289,323
195,46,5,2,10,3,-45,21,4,4,244,344
195,47,3,4,7,6,34,42,8,6,278,386
195,48,3,4,5,8,-68,-56,0,0,210,330
195,49,4,2,8,5,44,23,4,3,254,353
195,50,3,4,6,7,33,43,7,6,287,396
195,51,5,2,7,6,52,-76,9,0,339,320
195,52,2,5,4,9,-78,54,1,4,261,374
195,53,3,3,4,9,31,-64,2,0,292,310
195,54,3,4,8,5,35,41,7,1,327,351
195,55,2,4,5,8,-77,44,0,5,250,395
195,56,5,2,11,2,56,20,6,5,306,415
195,57,3,3,8,5,-65,32,1,7,241,447
195,58,4,2,4,9,40,-73,1,4,281,374
195,59,4,2,9,4,45,22,6,6,326,396
195,60,3,3,9,4,-64,31,2,7,262,427
195,61,3,4,5,8,32,-56,4,1,294,371
195,62,4,3,10,3,-54,30,0,1,240,401
195,63,2,4,6,7,24,43,4,4,264,444
195,64,4,2,10,3,-54,21,0,5,210,465
195,65,3,3,7,6,34,33,4,8,244,498
195,66,5,2,7,6,52,-76,6,2,296,422
195,67,4,3,9,4,-55,31,1,3,241,453
195,68,4,2,9,4,45,22,6,5,286,475
195,69,3,3,7,6,-66,33,0,8,220,508
196,1,2,5,3,10,21,55,1,5,21,55
196,2,5,2,9,4,54,22,5,7,75,77
196,3,3,3,5,8,32,-65,7,2,107,12
196,4,4,3,7,6,-57,33,0,5,50,45
196,5,4,2,10,3,46,21,6,6,96,66
196,6,3,4,4,9,31,-55,7,1,127,11
196,7,4,3,8,5,-56,32,1,3,71,43
196,8,4,4,6,7,42,43,3,6,113,86
196,9,5,2,9,4,54,22,7,8,167,108
196,10,3,3,5,8,32,-65,9,3,199,43
196,11,3,3,8,5,-65,32,4,5,134,75
196,12,3,3,6,7,33,34,7,9,167,109
196,13,3,3,5,8,32,-65,9,4,199,44
196,14,2,5,5,8,-77,53,2,7,122,97
196,15,5,2,11,2,56,20,8,7,178,117
196,16,2,6,3,10,21,-36,9,1,199,81
196,17,3,4,7,6,-66,42,3,3,133,123
196,18,4,3,6,7,42,34,5,7,175,157
196,19,2,6,3,10,21,-36,6,1,196,121
196,20,4,3,8,5,-56,32,0,3,140,153
196,21,2,4,5,8,23,44,3,7,163,197
196,22,2,4,6,7,24,-57,7,0,187,140
196,23,4,2,5,8,41,26,8,6,228,166
196,24,3,3,8,5,-65,32,3,8,163,198
196,25,5,2,10,3,55,21,8,9,218,219
196,26,3,4,4,9,31,-55,9,4,249,164
196,27,4,3,8,5,-56,32,3,6,193,196
196,28,4,2,7,6,43,-76,6,0,236,120
196,29,3,3,8,5,-65,32,1,2,171,152
196,30,4,2,6,7,42,25,3,7,213,177
196,31,5,2,10,3,55,21,8,8,268,198
196,32,3,3,6,7,-67,-66,1,2,201,132
196,33,3,3,5,8,32,35,3,7,233,167
196,34,3,4,4,9,31,-55,4,2,264,112
196,35,3,3,7,6,34,33,8,5,298,145
196,36,2,5,5,8,-77,53,1,8,221,198
196,37,4,3,6,7,42,-66,3,2,263,132
196,38,3,3,4,9,31,36,4,8,294,168
196,39,2,5,4,9,22,-46,6,2,316,122
196,40,2,5,4,9,22,54,8,6,338,176
196,41,3,4,7,6,-66,42,2,8,272,218
196,42,3,3,9,4,36,31,8,9,308,249
196,43,3,4,5,8,-68,-56,0,3,240,193
196,44,2,4,3,10,21,46,1,9,261,239
196,45,4,2,5,8,41,-74,2,5,302,165
196,46,4,3,8,5,44,32,6,7,346,197
196,47,3,3,5,8,32,-65,8,2,378,132
196,48,4,3,6,7,-58,34,0,6,320,166
196,49,3,3,7,6,34,33,4,9,354,199
196,50,3,3,5,8,32,-65,6,4,386,134
196,51,3,3,7,6,-66,33,0,7,320,167
196,52,2,5,3,10,21,-45,1,2,341,122
196,53,3,3,8,5,35,32,6,4,376,154
196,54,3,4,6,7,33,43,9,7,409,197
196,55,3,3,5,8,-68,-65,1,2,341,132
196,56,4,2,7,6,43,24,4,6,384,156
196,57,3,3,6,7,33,-66,7,0,417,90
196,58,6,2,11,2,-35,20,2,0,382,110
196,59,3,3,6,7,33,34,5,4,415,144
196,60,4,3,6,7,42,34,7,8,457,178
196,61,4,3,9,4,-55,31,2,9,402,209
196,62,3,4,8,5,35,-59,7,0,437,150
196,63,2,5,4,9,22,54,9,4,459,204
196,64,4,3,10,3,-54,30,5,4,405,234
196,65,3,3,5,8,32,35,7,9,437,269
196,66,4,3,7,6,-57,-67,0,2,380,202
196,67,5,2,7,6,52,24,2,6,432,226
196,68,2,5,4,9,22,-46,4,0,454,180
196,69,2,4,6,7,24,43,8,3,478,223
196,70,3,3,5,8,-68,35,0,8,410,258
196,71,4,2,8,5,44,-77,4,1,454,181
196,72,2,4,6,7,24,43,8,4,478,224
196,73,4,3,6,7,-58,34,0,8,420,258
196,74,4,2,8,5,44,-77,4,1,464,181
196,75,5,2,8,5,53,23,7,4,517,204
197,1,4,3,7,6,43,33,3,3,43,33
197,2,4,2,10,3,46,21,9,4,89,54
197,3,3,3,5,8,-68,35,1,9,21,89
197,4,3,3,6,7,33,-66,4,3,54,23
197,5,2,5,7,6,25,51,9,4,79,74
197,6,4,2,7,6,-57,24,2,8,22,98
197,7,2,5,3,10,21,-45,3,3,43,53
197,8,4,3,8,5,44,32,7,5,87,85
197,9,4,2,8,5,-56,23,1,8,31,108
197,10,3,3,9,4,36,31,7,9,67,139
197,11,4,2,11,2,-53,20,4,9,14,159
197,12,3,3,7,6,34,-67,8,2,48,92
197,13,3,5,4,9,31,54,9,6,79,146
197,14,4,2,7,6,-57,-76,2,0,22,70
197,15,4,3,8,5,44,32,6,2,66,102
197,16,4,4,4,9,40,45,6,7,106,147
197,17,4,2,6,7,42,-75,8,2,148,72
197,18,2,4,4,9,-78,45,0,7,70,117
197,19,2,4,8,5,26,41,6,8,96,158
197,20,5,2,9,4,-46,-78,0,0,50,80
197,21,4,2,10,3,46,21,6,1,96,101
197,22,5,2,8,5,53,23,9,4,149,124
197,23,4,3,9,4,-55,31,4,5,94,155
197,24,4,3,7,6,43,33,7,8,137,188
197,25,3,4,8,5,-65,41,2,9,72,229
197,26,2,5,5,8,23,-47,5,2,95,182
197,27,4,3,7,6,43,33,8,5,138,215
197,28,4,3,9,4,-55,31,3,6,83,246
197,29,3,3,7,6,34,33,7,9,117,279
197,30,4,3,8,5,-56,-68,1,1,61,211
197,31,3,3,9,4,36,31,7,2,97,242
197,32,3,3,8,5,-65,32,2,4,32,274
197,33,5,2,8,5,53,23,5,7,85,297
197,34,3,4,6,7,33,-57,8,0,118,240
197,35,3,3,6,7,-67,34,1,4,51,274
197,36,4,2,8,5,44,23,5,7,95,297
197,37,5,2,8,5,53,-77,8,0,148,220
197,38,4,3,7,6,-57,33,1,3,91,253
197,39,4,3,7,6,43,33,4,6,134,286
197,40,4,2,9,4,45,22,9,8,179,308
197,41,2,4,7,6,-75,-58,4,0,104,250
197,42,4,3,8,5,44,32,8,2,148,282
197,43,3,3,5,8,-68,35,0,7,80,317
197,44,3,4,5,8,32,-56,2,1,112,261
197,45,5,2,8,5,53,23,5,4,165,284
197,46,4,3,8,5,44,32,9,6,209,316
197,47,4,3,6,7,-58,-66,1,0,151,250
197,48,4,3,6,7,42,34,3,4,193,284
197,49,3,4,6,7,33,43,6,7,226,327
197,50,4,3,9,4,-55,31,1,8,171,358
197,51,3,3,7,6,34,-67,5,1,205,291
197,52,4,2,8,5,44,23,9,4,249,314
197,53,3,4,4,9,-69,45,0,9,180,359
197,54,2,4,7,6,25,-58,5,1,205,301
197,55,3,3,5,8,32,35,7,6,237,336
197,56,5,2,9,4,-46,22,1,8,191,358
197,57,3,4,6,7,33,-57,4,1,224,301
197,58,4,3,6,7,42,34,6,5,266,335
197,59,3,3,6,7,33,34,9,9,299,369
197,60,3,4,8,5,-65,-59,4,0,234,310
197,61,4,3,10,3,-54,30,0,0,180,340
197,62,2,4,6,7,24,43,4,3,204,383
197,63,3,4,4,9,31,45,5,8,235,428
197,64,3,3,5,8,32,-65,7,3,267,363
197,65,4,2,9,4,-55,22,2,5,212,385
197,66,4,3,6,7,42,34,4,9,254,419
197,67,3,3,6,7,33,-66,7,3,287,353
197,68,3,3,7,6,-66,33,1,6,221,386
197,69,3,4,8,5,35,41,6,7,256,427
197,70,4,2,6,7,42,-75,8,2,298,352
197,71,3,4,8,5,-65,41,3,3,233,393
197,72,3,4,3,10,30,46,3,9,263,439
197,73,3,5,6,7,33,-48,6,1,296,391
197,74,4,3,6,7,42,34,8,5,338,425
197,75,3,4,8,5,-65,41,3,6,273,466
197,76,3,4,7,6,34,42,7,8,307,508
198,1,5,2,9,4,54,22,4,2,54,22
198,2,5,2,9,4,54,22,8,4,108,44
198,3,3,4,6,7,-67,43,1,7,41,87
198,4,3,3,5,8,32,-65,3,2,73,22
198,5,4,2,9,4,45,22,8,4,118,44
198,6,3,4,3,10,30,-54,8,0,148,-10
198,7,5,2,10,3,-45,21,3,1,103,11
198,8,4,3,7,6,43,33,6,4,146,44
198,9,2,4,5,8,23,44,9,8,169,88
198,10,3,3,6,7,-67,-66,2,2,102,22
198,11,5,2,7,6,52,24,4,6,154,46
198,12,5,2,11,2,-44,20,0,6,110,66
198,13,3,3,9,4,36,31,6,7,146,97
198,14,3,3,5,8,32,-65,8,2,178,32
198,15,4,3,6,7,-58,34,0,6,120,66
198,16,2,4,4,9,22,-55,2,1,142,11
198,17,4,2,10,3,46,21,8,2,188,32
198,18,3,3,4,9,31,36,9,8,219,68
198,19,3,3,6,7,-67,-66,2,2,152,2
198,20,4,3,6,7,42,34,4,6,194,36
198,21,2,5,4,9,22,-46,6,0,216,-10
198,22,4,3,7,6,43,33,9,3,259,23
198,23,3,3,9,4,-64,31,5,4,195,54
198,24,2,4,5,8,23,44,8,8,218,98
198,25,3,3,5,8,-68,-65,0,3,150,33
198,26,2,4,3,10,21,46,1,9,171,79
198,27,3,3,7,6,34,-67,5,2,205,12
198,28,2,4,5,8,23,44,8,6,228,56
198,29,3,4,6,7,-67,43,1,9,161,99
198,30,5,2,8,5,53,-77,4,2,214,22
198,31,5,2,11,2,-44,20,0,2,170,42
198,32,2,4,6,7,24,43,4,5,194,85
198,33,2,4,5,8,23,44,7,9,217,129
198,34,2,5,4,9,22,-46,9,3,239,83
198,35,2,5,5,8,-77,53,2,6,162,136
198,36,5,2,10,3,55,21,7,7,217,157
198,37,4,2,8,5,-56,-77,1,0,161,80
198,38,3,3,7,6,34,33,5,3,195,113
198,39,3,3,5,8,32,35,7,8,227,148
198,40,2,5,6,7,-76,-48,1,0,151,100
198,41,3,3,5,8,32,35,3,5,183,135
198,42,4,3,8,5,44,32,7,7,227,167
198,43,4,3,6,7,42,-66,9,1,269,101
198,44,4,4,7,6,-57,42,2,3,212,143
198,45,5,2,7,6,52,24,4,7,264,167
198,46,5,2,9,4,54,22,8,9,318,189
198,47,3,3,10,3,-63,30,5,9,255,219
198,48,3,4,5,8,32,-56,7,3,287,163
198,49,3,3,6,7,-67,34,0,7,220,197
198,50,4,2,6,7,42,-75,2,2,262,122
198,51,2,4,5,8,23,44,5,6,285,166
198,52,3,4,5,8,32,-56,7,0,317,110
198,53,3,4,7,6,-66,42,1,2,251,152
198,54,3,3,5,8,32,35,3,7,283,187
198,55,3,4,4,9,31,-55,4,2,314,132
198,56,4,2,5,8,41,26,5,8,355,158
198,57,5,2,8,5,53,-77,8,1,408,81
198,58,3,4,7,6,-66,42,2,3,342,123
198,59,3,3,5,8,32,35,4,8,374,158
198,60,2,5,2,11,20,-44,4,4,394,114
198,61,3,4,6,7,33,43,7,7,427,157
198,62,5,2,9,4,-46,22,1,9,381,179
198,63,3,4,6,7,33,-57,4,2,414,122
198,64,2,4,7,6,25,42,9,4,439,164
198,65,3,4,6,7,-67,43,2,7,372,207
198,66,3,4,4,9,31,-55,3,2,403,152
198,67,5,2,9,4,54,22,7,4,457,174
198,68,3,3,5,8,32,35,9,9,489,209
198,69,3,3,6,7,-67,-66,2,3,422,143
198,70,2,5,5,8,23,53,5,6,445,196
198,71,3,3,7,6,34,33,9,9,479,229
198,72,3,4,7,6,-66,-58,3,1,413,171
198,73,2,5,7,6,25,51,8,2,438,222
198,74,3,3,4,9,31,36,9,8,469,258
198,75,4,4,6,7,-58,-57,1,1,411,201
198,76,2,5,3,10,21,55,2,6,432,256
198,77,4,2,8,5,44,23,6,9,476,279
198,78,4,2,10,3,-54,-79,2,0,422,200
198,79,3,4,5,8,32,44,4,4,454,244
198,80,5,2,9,4,54,22,8,6,508,266
199,1,2,4,6,7,24,43,4,3,24,43
199,2,5,2,8,5,53,23,7,6,77,66
199,3,2,5,5,8,-77,53,0,9,0,119
199,4,3,5,3,10,30,-45,0,4,30,74
199,5,3,3,5,8,32,35,2,9,62,109
199,6,2,6,3,10,21,-36,3,3,83,73
199,7,5,2,11,2,56,20,9,3,139,93
199,8,2,4,4,9,-78,45,1,8,61,138
199,9,3,3,4,9,31,-64,2,4,92,74
199,10,3,4,5,8,32,44,4,8,124,118
199,11,3,3,7,6,34,-67,8,1,158,51
199,12,5,2,9,4,-46,22,2,3,112,73
199,13,2,5,4,9,22,54,4,7,134,127
199,14,3,4,7,6,34,42,8,9,168,169
199,15,4,2,9,4,-55,-78,3,1,113,91
199,16,2,4,4,9,22,45,5,6,135,136
199,17,3,4,5,8,32,-56,7,0,167,80
199,18,2,4,5,8,-77,44,0,4,90,124
199,19,2,5,7,6,25,51,5,5,115,175
199,20,4,3,7,6,43,33,8,8,158,208
199,21,3,4,4,9,31,-55,9,3,189,153
199,22,4,3,8,5,-56,32,3,5,133,185
199,23,2,4,7,6,25,42,8,7,158,227
199,24,3,4,6,7,-67,-57,1,0,91,170
199,25,3,3,6,7,33,34,4,4,124,204
199,26,5,2,9,4,54,22,8,6,178,226
199,27,5,2,10,3,-45,21,3,7,133,247
199,28,4,2,7,6,43,-76,6,1,176,171
199,29,3,3,7,6,-66,33,0,4,110,204
199,30,2,5,4,9,22,54,2,8,132,258
199,31,2,6,3,10,21,-36,3,2,153,222
199,32,4,3,7,6,43,33,6,5,196,255
199,33,3,3,5,8,32,-65,8,0,228,190
199,34,2,5,5,8,-77,53,1,3,151,243
199,35,2,4,4,9,22,45,3,8,173,288
199,36,4,3,6,7,42,-66,5,2,215,222
199,37,2,5,4,9,22,54,7,6,237,276
199,38,4,2,8,5,-56,23,1,9,181,299
199,39,4,2,4,9,40,-73,1,6,221,226
199,40,5,2,8,5,53,23,4,9,274,249
199,41,5,2,9,4,54,-78,8,1,328,171
199,42,4,4,7,6,-57,42,1,3,271,213
199,43,5,2,7,6,52,24,3,7,323,237
199,44,3,3,4,9,31,-64,4,3,354,173
199,45,2,5,5,8,23,53,7,6,377,226
199,46,5,3,6,7,51,-66,8,0,428,160
199,47,6,2,8,5,-38,23,0,3,390,183
199,48,2,5,2,11,20,56,0,9,410,239
199,49,4,2,9,4,45,-78,5,1,455,161
199,50,3,3,6,7,33,34,8,5,488,195
199,51,5,2,9,4,-46,22,2,7,442,217
199,52,2,5,4,9,22,-46,4,1,464,171
199,53,3,4,6,7,33,43,7,4,497,214
199,54,2,4,7,6,-75,42,2,6,422,256
199,55,4,4,7,6,43,42,5,8,465,298
199,56,4,3,9,4,-55,31,0,9,410,329
199,57,4,3,7,6,43,-67,3,2,453,262
199,58,4,3,10,3,46,30,9,2,499,292
199,59,4,3,6,7,-58,34,1,6,441,326
199,60,4,3,8,5,44,32,5,8,485,358
199,61,3,3,4,9,31,-64,6,4,516,294
200,1,2,5,3,10,21,55,1,5,21,55
200,2,2,5,5,8,23,53,4,8,44,108
200,3,4,2,10,3,-54,21,0,9,-10,129
200,4,4,3,7,6,43,-67,3,2,33,62
200,5,3,3,6,7,33,34,6,6,66,96
200,6,4,3,8,5,-56,32,0,8,10,128
200,7,4,3,6,7,42,-66,2,2,52,62
200,8,5,2,9,4,54,22,6,4,106,84
200,9,3,4,6,7,33,43,9,7,139,127
200,10,5,2,9,4,-46,22,3,9,93,149
200,11,3,4,6,7,33,-57,6,2,126,92
200,12,3,3,6,7,33,34,9,6,159,126
200,13,2,5,6,7,-76,52,3,8,83,178
200,14,3,4,5,8,32,-56,5,2,115,122
200,15,3,4,8,5,-65,41,0,3,50,163
200,16,2,5,4,9,22,54,2,7,72,217
200,17,4,3,8,5,44,32,6,9,116,249
200,18,3,4,6,7,33,-57,9,2,149,192
200,19,2,5,5,8,-77,53,2,5,72,245
200,20,3,4,7,6,34,42,6,7,106,287
200,21,4,2,8,5,-56,-77,0,0,50,210
200,22,4,3,5,8,41,35,1,5,91,245
200,23,4,3,9,4,45,31,6,6,136,276
200,24,3,3,8,5,-65,32,1,8,71,308
200,25,3,3,8,5,35,-68,6,0,106,240
200,26,3,4,6,7,33,43,9,3,139,283
200,27,3,4,9,4,-64,40,5,3,75,323
200,28,5,2,7,6,52,24,7,7,127,347
200,29,3,3,7,6,-66,-67,1,0,61,280
200,30,4,2,6,7,42,25,3,5,103,305
200,31,4,3,8,5,44,32,7,7,147,337
200,32,3,4,5,8,32,-56,9,1,179,281
200,33,4,4,8,5,-56,41,3,2,123,322
200,34,2,5,3,10,21,55,4,7,144,377
200,35,4,3,6,7,42,-66,6,1,186,311
200,36,3,4,8,5,-65,41,1,2,121,352
200,37,3,4,7,6,34,42,5,4,155,394
200,38,3,3,7,6,34,33,9,7,189,427
200,39,2,5,6,7,-76,52,3,9,113,479
200,40,3,3,6,7,33,-66,6,3,146,413
200,41,3,4,6,7,33,43,9,6,179,456
200,42,4,2,8,5,-56,23,3,9,123,479
200,43,4,3,8,5,44,-68,7,1,167,411
200,44,2,5,3,10,21,55,8,6,188,466
200,45,4,3,7,6,-57,33,1,9,131,499
200,46,4,2,10,3,46,-79,7,0,177,420
200,47,4,3,8,5,-56,32,1,2,121,452
200,48,3,3,4,9,31,36,2,8,152,488
200,49,2,4,4,9,22,-55,4,3,174,433
200,50,3,3,4,9,31,36,5,9,205,469
200,51,3,4,5,8,32,-56,7,3,237,413
200,52,5,2,9,4,-46,22,1,5,191,435
200,53,2,5,6,7,24,52,5,7,215,487
200,54,4,3,6,7,42,-66,7,1,257,421
200,55,4,3,9,4,-55,31,2,2,202,452
200,56,2,4,8,5,26,41,8,3,228,493
200,57,3,3,6,7,-67,34,1,7,161,527
201,1,4,2,8,5,44,23,4,3,44,23
201,2,3,4,6,7,33,43,7,6,77,66
201,3,4,2,7,6,-57,-76,0,0,20,-10
201,4,3,4,5,8,32,44,2,4,52,34
201,5,3,3,4,9,31,-64,3,0,83,-30
201,6,3,3,5,8,32,35,5,5,115,5
201,7,2,5,5,8,23,53,8,8,138,58
201,8,3,3,6,7,-67,-66,1,2,71,-8
201,9,3,4,8,5,35,41,6,3,106,33
201,10,3,3,9,4,-64,31,2,4,42,64
201,11,4,3,6,7,42,34,4,8,84,98
201,12,3,4,8,5,35,41,9,9,119,139
201,13,3,5,4,9,-69,-46,0,3,50,93
201,14,2,5,2,11,20,56,0,9,70,149
201,15,4,3,6,7,42,-66,2,3,112,83
201,16,4,2,8,5,44,23,6,6,156,106
201,17,3,3,9,4,-64,31,2,7,92,137
201,18,5,2,10,3,55,21,7,8,147,158
201,19,3,4,6,7,-67,-57,0,1,80,101
201,20,4,2,8,5,44,23,4,4,124,124
201,21,4,2,7,6,43,24,7,8,167,148
201,22,2,4,4,9,22,-55,9,3,189,93
201,23,3,3,5,8,-68,35,1,8,121,128
201,24,2,5,4,9,22,-46,3,2,143,82
201,25,3,4,4,9,31,45,4,7,174,127
201,26,4,3,6,7,42,-66,6,1,216,61
201,27,4,2,8,5,-56,23,0,4,160,84
201,28,4,2,7,6,43,24,3,8,203,108
201,29,5,2,10,3,55,21,8,9,258,129
201,30,2,5,2,11,20,-44,8,5,278,85
201,31,5,2,11,2,-44,20,4,5,234,105
201,32,4,4,6,7,42,43,6,8,276,148
201,33,2,6,3,10,21,-36,7,2,297,112
201,34,4,3,8,5,-56,32,1,4,241,144
201,35,5,2,8,5,53,23,4,7,294,167
201,36,3,3,9,4,-64,31,0,8,230,198
201,37,2,5,3,10,21,-45,1,3,251,153
201,38,3,4,6,7,33,43,4,6,284,196
201,39,5,2,10,3,55,21,9,7,339,217
201,40,3,3,6,7,-67,-66,2,1,272,151
201,41,2,5,6,7,24,52,6,3,296,203
201,42,5,3,7,6,52,33,8,6,348,236
201,43,2,6,3,10,21,-36,9,0,369,200
201,44,2,4,5,8,-77,44,2,4,292,244
201,45,5,2,10,3,55,21,7,5,347,265
201,46,2,5,2,11,20,-44,7,1,367,221
201,47,3,3,4,9,31,36,8,7,398,257
201,48,2,4,5,8,-77,-56,1,1,321,201
201,49,4,2,8,5,44,23,5,4,365,224
201,50,4,2,7,6,43,24,8,8,408,248
201,51,4,3,7,6,-57,-67,1,1,351,181
201,52,4,2,8,5,44,23,5,4,395,204
201,53,3,4,6,7,33,43,8,7,428,247
201,54,4,3,6,7,-58,-66,0,1,370,181
201,55,4,3,7,6,43,33,3,4,413,214
201,56,4,3,8,5,44,32,7,6,457,246
201,57,5,2,10,3,-45,21,2,7,412,267
201,58,5,2,9,4,54,22,6,9,466,289
201,59,4,3,9,4,-55,-69,1,0,411,220
201,60,3,4,6,7,33,43,4,3,444,263
201,61,3,3,9,4,-64,31,0,4,380,294
201,62,4,3,6,7,42,34,2,8,422,328
201,63,3,3,6,7,33,-66,5,2,455,262
201,64,2,5,2,11,20,56,5,8,475,318
201,65,2,5,5,8,23,-47,8,1,498,271
201,66,4,3,9,4,-55,31,3,2,443,302
201,67,4,3,7,6,43,33,6,5,486,335
201,68,2,5,4,9,22,54,8,9,508,389
202,1,3,4,8,5,35,41,5,1,35,41
202,2,4,3,6,7,42,34,7,5,77,75
202,3,3,4,6,7,-67,43,0,8,10,118
202,4,4,4,8,5,44,41,4,9,54,159
202,5,4,2,7,6,43,-76,7,3,97,83
202,6,3,4,4,9,31,45,8,8,128,128
202,7,3,4,4,9,31,-55,9,3,159,73
202,8,3,3,8,5,-65,32,4,5,94,105
202,9,3,3,7,6,34,33,8,8,128,138
202,10,3,3,6,7,-67,-66,1,2,61,72
202,11,5,2,9,4,54,22,5,4,115,94
202,12,4,2,6,7,42,25,7,9,157,119
202,13,2,6,4,9,22,-37,9,2,179,82
202,14,4,2,9,4,-55,22,4,4,124,104
202,15,2,4,3,10,21,-54,5,0,145,50
202,16,3,3,10,3,-63,30,2,0,82,80
202,17,5,2,9,4,54,22,6,2,136,102
202,18,4,2,8,5,-56,23,0,5,80,125
202,19,4,3,9,4,45,31,5,6,125,156
202,20,7,2,8,5,71,23,6,9,196,179
202,21,2,5,6,7,-76,-48,0,1,120,131
202,22,3,4,6,7,33,43,3,4,153,174
202,23,2,4,6,7,24,43,7,7,177,217
202,24,3,3,8,5,-65,32,2,9,112,249
202,25,4,2,5,8,41,-74,3,5,153,175
202,26,3,3,9,4,36,31,9,6,189,206
202,27,4,3,6,7,-58,-66,1,0,131,140
202,28,4,2,6,7,42,25,3,5,173,165
202,29,4,3,6,7,42,34,5,9,215,199
202,30,4,3,9,4,-55,-69,0,0,160,130
202,31,4,3,8,5,44,32,4,2,204,162
202,32,5,2,10,3,55,21,9,3,259,183
202,33,3,4,4,9,-69,45,0,8,190,228
202,34,4,2,9,4,45,-78,5,0,235,150
202,35,4,3,6,7,42,34,7,4,277,184
202,36,3,4,6,7,-67,43,0,7,210,227
202,37,2,4,4,9,22,-55,2,2,232,172
202,38,3,3,4,9,31,36,3,8,263,208
202,39,4,3,6,7,42,-66,5,2,305,142
202,40,2,4,5,8,23,44,8,6,328,186
202,41,3,3,5,8,-68,-65,0,1,260,121
202,42,2,4,5,8,23,44,3,5,283,165
202,43,5,2,10,3,55,21,8,6,338,186
202,44,2,5,3,10,21,-45,9,1,359,141
202,45,4,2,8,5,-56,23,3,4,303,164
202,46,3,3,6,7,33,34,6,8,336,198
202,47,3,3,5,8,32,-65,8,3,368,133
202,48,4,2,8,5,-56,23,2,6,312,156
202,49,3,3,8,5,35,32,7,8,347,188
202,50,3,3,6,7,-67,-66,0,2,280,122
202,51,3,3,5,8,32,35,2,7,312,157
202,52,6,2,10,3,64,21,6,8,376,178
202,53,3,4,5,8,32,-56,8,2,408,122
202,54,2,4,3,10,21,46,9,8,429,168
202,55,2,4,6,7,-76,-57,3,1,353,111
202,56,2,4,5,8,23,44,6,5,376,155
202,57,3,3,6,7,33,34,9,9,409,189
202,58,4,3,6,7,-58,-66,1,3,351,123
202,59,3,4,6,7,33,43,4,6,384,166
202,60,4,3,7,6,43,33,7,9,427,199
202,61,5,3,10,3,-45,30,2,9,382,229
202,62,3,3,8,5,35,-68,7,1,417,161
202,63,3,4,7,6,-66,42,1,3,351,203
202,64,2,4,7,6,25,42,6,5,376,245
202,65,4,3,9,4,-55,31,1,6,321,276
202,66,3,4,5,8,32,-56,3,0,353,220
202,67,4,2,8,5,44,23,7,3,397,243
202,68,5,2,10,3,-45,21,2,4,352,264
202,69,3,3,8,5,35,32,7,6,387,296
202,70,4,2,8,5,-56,23,1,9,331,319
202,71,3,3,7,6,34,-67,5,2,365,252
202,72,2,4,6,7,24,43,9,5,389,295
202,73,3,4,8,5,-65,41,4,6,324,336
202,74,2,4,6,7,24,43,8,9,348,379
202,75,3,3,6,7,-67,-66,1,3,281,313
202,76,4,2,10,3,46,21,7,4,327,334
202,77,5,3,7,6,52,33,9,7,379,367
202,78,3,4,4,9,-69,-55,0,2,310,312
202,79,3,3,9,4,36,31,6,3,346,343
202,80,4,2,11,2,-53,20,3,3,293,363
202,81,3,3,8,5,35,32,8,5,328,395
202,82,3,4,8,5,-65,41,3,6,263,436
202,83,2,5,3,10,21,-45,4,1,284,391
202,84,4,3,8,5,44,32,8,3,328,423
202,85,3,4,4,9,31,45,9,8,359,468
202,86,3,4,8,5,-65,41,4,9,294,509
203,1,3,3,3,10,30,37,0,7,30,37
203,2,2,4,6,7,24,-57,4,0,54,-20
203,3,3,4,8,5,35,41,9,1,89,21
203,4,2,4,7,6,-75,42,4,3,14,63
203,5,3,4,5,8,32,44,6,7,46,107
203,6,2,4,5,8,23,-56,9,1,69,51
203,7,3,3,9,4,-64,31,5,2,5,82
203,8,4,3,8,5,44,32,9,4,49,114
203,9,4,2,9,4,-55,22,4,6,-6,136
203,10,4,3,8,5,44,32,8,8,38,168
203,11,2,6,3,10,21,-36,9,2,59,132
203,12,3,5,5,8,-68,53,1,5,-9,185
203,13,3,3,10,3,37,30,8,5,28,215
203,14,2,4,4,9,-78,-55,0,0,-50,160
203,15,4,3,5,8,41,35,1,5,-9,195
203,16,3,4,5,8,32,44,3,9,23,239
203,17,3,4,3,10,30,-54,3,5,53,185
203,18,4,3,8,5,44,32,7,7,97,217
203,19,3,4,6,7,-67,-57,0,0,30,160
203,20,6,2,10,3,64,21,4,1,94,181
203,21,4,2,10,3,-54,21,0,2,40,202
203,22,4,2,8,5,44,23,4,5,84,225
203,23,3,3,6,7,33,34,7,9,117,259
203,24,4,2,7,6,-57,-76,0,3,60,183
203,25,4,3,9,4,45,31,5,4,105,214
203,26,4,2,9,4,-55,22,0,6,50,236
203,27,3,4,5,8,32,-56,2,0,82,180
203,28,4,2,6,7,42,25,4,5,124,205
203,29,4,3,5,8,41,-65,5,0,165,140
203,30,5,2,8,5,53,23,8,3,218,163
203,31,3,4,8,5,-65,41,3,4,153,204
203,32,3,4,6,7,33,43,6,7,186,247
203,33,3,3,8,5,-65,32,1,9,121,279
203,34,4,2,9,4,45,-78,6,1,166,201
203,35,3,3,6,7,33,34,9,5,199,235
203,36,4,2,9,4,-55,22,4,7,144,257
203,37,3,3,6,7,33,-66,7,1,177,191
203,38,3,4,5,8,32,44,9,5,209,235
203,39,4,3,8,5,-56,32,3,7,153,267
203,40,5,2,8,5,53,-77,6,0,206,190
203,41,3,4,6,7,33,43,9,3,239,233
203,42,4,2,9,4,-55,22,4,5,184,255
203,43,3,4,6,7,33,43,7,8,217,298
203,44,3,3,8,5,-65,-68,2,0,152,230
203,45,3,4,7,6,34,42,6,2,186,272
203,46,4,2,9,4,-55,22,1,4,131,294
203,47,3,3,4,9,31,-64,2,0,162,230
203,48,4,2,9,4,45,22,7,2,207,252
203,49,5,2,7,6,52,24,9,6,259,276
203,50,4,2,9,4,-55,22,4,8,204,298
203,51,4,3,8,5,44,-68,8,0,248,230
203,52,3,4,7,6,-66,42,2,2,182,272
203,53,5,2,9,4,54,22,6,4,236,294
203,54,2,4,7,6,-75,42,1,6,161,336
203,55,4,4,6,7,42,43,3,9,203,379
203,56,3,3,5,8,32,-65,5,4,235,314
203,57,5,2,7,6,52,24,7,8,287,338
203,58,5,2,8,5,-47,-77,0,1,240,261
203,59,3,3,6,7,33,34,3,5,273,295
203,60,3,3,6,7,33,34,6,9,306,329
203,61,2,4,7,6,-75,-58,1,1,231,271
203,62,3,3,7,6,34,33,5,4,265,304
203,63,3,3,8,5,-65,32,0,6,200,336
203,64,5,2,7,6,52,-76,2,0,252,260
203,65,5,2,9,4,54,22,6,2,306,282
203,66,3,4,7,6,-66,42,0,4,240,324
203,67,4,3,7,6,43,33,3,7,283,357
203,68,2,6,5,8,23,62,6,9,306,419
203,69,2,5,4,9,22,-46,8,3,328,373
203,70,3,3,5,8,-68,35,0,8,260,408
203,71,3,3,5,8,32,-65,2,3,292,343
203,72,5,2,7,6,52,24,4,7,344,367
203,73,4,3,9,4,45,31,9,8,389,398
203,74,4,4,5,8,-59,-56,0,2,330,342
203,75,2,5,4,9,22,54,2,6,352,396
203,76,4,4,5,8,41,-56,3,0,393,340
203,77,3,4,5,8,32,44,5,4,425,384
203,78,2,4,7,6,-75,42,0,6,350,426
203,79,4,4,7,6,43,42,3,8,393,468
203,80,3,3,6,7,33,-66,6,2,426,402
203,81,4,3,7,6,43,33,9,5,469,435
203,82,2,5,3,10,-79,-45,0,0,390,390
203,83,4,4,6,7,42,43,2,3,432,433
203,84,2,6,3,10,21,64,3,7,453,497
203,85,4,2,6,7,42,-75,5,2,495,422
203,86,3,3,7,6,34,33,9,5,529,455
204,1,5,3,7,6,52,33,2,3,52,33
204,2,4,3,9,4,45,31,7,4,97,64
204,3,3,4,7,6,-66,42,1,6,31,106
204,4,4,3,6,7,42,-66,3,0,73,40
204,5,2,5,4,9,22,54,5,4,95,94
204,6,4,3,9,4,-55,31,0,5,40,125
204,7,2,6,4,9,22,63,2,8,62,188
204,8,2,5,6,7,24,-48,6,0,86,140
204,9,4,3,7,6,43,33,9,3,129,173
204,10,3,4,6,7,-67,43,2,6,62,216
204,11,4,4,8,5,44,41,6,7,106,257
204,12,5,2,7,6,52,-76,8,1,158,181
204,13,3,4,8,5,-65,41,3,2,93,222
204,14,5,2,10,3,55,21,8,3,148,243
204,15,3,3,5,8,-68,35,0,8,80,278
204,16,2,4,6,7,24,-57,4,1,104,221
204,17,5,2,8,5,53,23,7,4,157,244
204,18,2,4,4,9,22,45,9,9,179,289
204,19,2,4,4,9,-78,-55,1,4,101,234
204,20,2,5,5,8,23,53,4,7,124,287
204,21,4,3,9,4,45,31,9,8,169,318
204,22,2,4,6,7,-76,-57,3,1,93,261
204,23,3,3,7,6,34,33,7,4,127,294
204,24,5,2,9,4,-46,22,1,6,81,316
204,25,3,3,6,7,33,-66,4,0,114,250
204,26,3,3,7,6,34,33,8,3,148,283
204,27,3,3,8,5,-65,32,3,5,83,315
204,28,2,5,5,8,23,53,6,8,106,368
204,29,4,3,7,6,43,-67,9,1,149,301
204,30,4,3,8,5,-56,32,3,3,93,333
204,31,3,4,5,8,32,44,5,7,125,377
204,32,4,4,7,6,43,42,8,9,168,419
204,33,4,3,8,5,-56,-68,2,1,112,351
204,34,2,4,5,8,23,44,5,5,135,395
204,35,3,3,7,6,34,33,9,8,169,428
204,36,4,3,6,7,-58,-66,1,2,111,362
204,37,3,3,5,8,32,35,3,7,143,397
204,38,2,5,4,9,22,-46,5,1,165,351
204,39,4,3,4,9,40,36,5,7,205,387
204,40,3,4,5,8,32,-56,7,1,237,331
204,41,2,4,3,10,21,46,8,7,258,377
204,42,3,4,6,7,-67,-57,1,0,191,320
204,43,3,3,7,6,34,33,5,3,225,353
204,44,4,2,9,4,-55,22,0,5,170,375
204,45,5,2,8,5,53,23,3,8,223,398
204,46,2,5,4,9,22,-46,5,2,245,352
204,47,5,2,10,3,-45,21,0,3,200,373
204,48,3,4,5,8,32,44,2,7,232,417
204,49,4,2,8,5,44,-77,6,0,276,340
204,50,2,4,4,9,22,45,8,5,298,385
204,51,5,3,9,4,-46,31,2,6,252,416
204,52,4,2,8,5,44,23,6,9,296,439
204,53,4,3,9,4,-55,-69,1,0,241,370
204,54,3,4,4,9,31,45,2,5,272,415
204,55,2,5,5,8,23,53,5,8,295,468
204,56,3,3,9,4,-64,31,1,9,231,499
204,57,4,2,8,5,44,-77,5,2,275,422
204,58,3,5,7,6,34,51,9,3,309,473
204,59,4,3,10,3,-54,30,5,3,255,503
205,1,4,2,8,5,44,23,4,3,44,23
205,2,3,4,7,6,34,42,8,5,78,65
205,3,2,6,3,10,21,64,9,9,99,129
205,4,3,3,7,6,-66,-67,3,2,33,62
205,5,4,2,6,7,42,25,5,7,75,87
205,6,2,5,5,8,23,-47,8,0,98,40
205,7,5,2,7,6,-48,24,0,4,50,64
205,8,3,3,8,5,35,32,5,6,85,96
205,9,4,3,7,6,43,33,8,9,128,129
205,10,2,5,2,11,20,-44,8,5,148,85
205,11,4,3,9,4,-55,31,3,6,93,116
205,12,4,4,5,8,41,-56,4,0,134,60
205,13,3,4,6,7,33,43,7,3,167,103
205,14,2,4,4,9,22,45,9,8,189,148
205,15,6,2,11,2,-35,20,4,8,154,168
205,16,3,3,7,6,34,-67,8,1,188,101
205,17,3,3,8,5,-65,32,3,3,123,133
205,18,3,4,7,6,34,42,7,5,157,175
205,19,3,3,7,6,-66,33,1,8,91,208
205,20,2,5,3,10,21,-45,2,3,112,163
205,21,3,4,7,6,34,42,6,5,146,205
205,22,3,3,9,4,-64,31,2,6,82,236
205,23,4,2,6,7,42,-75,4,1,124,161
205,24,3,3,4,9,31,36,5,7,155,197
205,25,3,5,5,8,32,-47,7,0,187,150
205,26,4,2,11,2,-53,20,4,0,134,170
205,27,5,2,11,2,-44,20,0,0,90,190
205,28,4,3,7,6,43,33,3,3,133,223
205,29,3,4,6,7,33,43,6,6,166,266
205,30,3,4,6,7,33,43,9,9,199,309
205,31,3,3,8,5,-65,-68,4,1,134,241
205,32,2,4,6,7,24,43,8,4,158,284
205,33,4,3,8,5,-56,32,2,6,102,316
205,34,2,5,3,10,21,-45,3,1,123,271
205,35,3,4,7,6,34,42,7,3,157,313
205,36,4,2,8,5,-56,23,1,6,101,336
205,37,2,5,5,8,23,53,4,9,124,389
205,38,2,4,7,6,25,-58,9,1,149,331
205,39,4,3,9,4,-55,31,4,2,94,362
205,40,2,4,6,7,24,43,8,5,118,405
205,41,3,3,7,6,-66,33,2,8,52,438
205,42,2,4,3,10,21,-54,3,4,73,384
205,43,4,2,8,5,44,23,7,7,117,407
205,44,2,4,3,10,21,-54,8,3,138,353
205,45,2,4,6,7,-76,43,2,6,62,396
205,46,6,2,9,4,63,22,5,8,125,418
205,47,4,2,9,4,-55,-78,0,0,70,340
205,48,4,3,7,6,43,33,3,3,113,373
205,49,4,3,6,7,42,34,5,7,155,407
205,50,4,2,10,3,-54,21,1,8,101,428
205,51,5,2,9,4,54,-78,5,0,155,350
205,52,3,3,7,6,34,33,9,3,189,383
205,53,2,4,5,8,-77,44,2,7,112,427
205,54,2,4,4,9,22,-55,4,2,134,372
205,55,4,2,7,6,43,24,7,6,177,396
205,56,3,3,4,9,31,-64,8,2,208,332
205,57,4,2,7,6,-57,24,1,6,151,356
205,58,3,4,6,7,33,43,4,9,184,399
205,59,4,3,6,7,42,-66,6,3,226,333
205,60,2,4,7,6,-75,42,1,5,151,375
205,61,4,2,8,5,44,23,5,8,195,398
205,62,4,3,9,4,-55,31,0,9,140,429
205,63,4,3,6,7,42,-66,2,3,182,363
205,64,5,2,11,2,56,20,8,3,238,383
205,65,5,2,11,2,-44,20,4,3,194,403
205,66,4,2,8,5,44,23,8,6,238,426
205,67,2,5,4,9,-78,-46,0,0,160,380
205,68,5,2,9,4,54,22,4,2,214,402
205,69,4,3,6,7,42,34,6,6,256,436
205,70,3,4,8,5,-65,41,1,7,191,477
205,71,3,3,7,6,34,-67,5,0,225,410
205,72,3,3,7,6,34,33,9,3,259,443
205,73,4,3,8,5,-56,32,3,5,203,475
205,74,2,5,5,8,23,53,6,8,226,528
206,1,3,3,5,8,32,35,2,5,32,35
206,2,3,4,7,6,34,42,6,7,66,77
206,3,3,4,3,10,30,-54,6,3,96,23
206,4,3,3,8,5,-65,32,1,5,31,55
206,5,2,4,4,9,22,-55,3,0,53,0
206,6,2,5,7,6,25,51,8,1,78,51
206,7,3,3,5,8,-68,35,0,6,10,86
206,8,3,4,7,6,34,42,4,8,44,128
206,9,5,2,7,6,52,-76,6,2,96,52
206,10,4,2,7,6,43,24,9,6,139,76
206,11,3,3,6,7,-67,-66,2,0,72,10
206,12,2,4,5,8,23,44,5,4,95,54
206,13,2,5,3,10,21,55,6,9,116,109
206,14,2,4,4,9,22,-55,8,4,138,54
206,15,4,2,9,4,-55,22,3,6,83,76
206,16,3,4,4,9,31,-55,4,1,114,21
206,17,4,4,8,5,44,41,8,2,158,62
206,18,2,6,3,10,21,64,9,6,179,126
206,19,4,2,8,5,-56,23,3,9,123,149
206,20,5,2,10,3,55,-79,8,0,178,70
206,21,4,2,8,5,-56,23,2,3,122,93
206,22,4,2,7,6,43,24,5,7,165,117
206,23,2,4,5,8,23,-56,8,1,188,61
206,24,4,3,6,7,-58,34,0,5,130,95
206,25,6,2,9,4,63,22,3,7,193,117
206,26,4,4,6,7,42,-57,5,0,235,60
206,27,5,2,10,3,-45,21,0,1,190,81
206,28,2,5,3,10,21,55,1,6,211,136
206,29,2,4,4,9,22,-55,3,1,233,81
206,30,4,3,6,7,42,34,5,5,275,115
206,31,2,5,4,9,22,54,7,9,297,169
206,32,4,3,8,5,-56,-68,1,1,241,101
206,33,2,5,2,11,20,56,1,7,261,157
206,34,2,6,3,10,21,-36,2,1,282,121
206,35,3,3,7,6,34,33,6,4,316,154
206,36,6,2,10,3,-36,21,0,5,280,175
206,37,2,5,4,9,22,54,2,9,302,229
206,38,4,3,5,8,41,-65,3,4,343,164
206,39,3,3,5,8,32,35,5,9,375,199
206,40,3,3,6,7,33,-66,8,3,408,133
206,41,3,3,4,9,31,36,9,9,439,169
206,42,2,5,3,10,-79,-45,0,4,360,124
206,43,4,4,8,5,44,41,4,5,404,165
206,44,4,3,7,6,43,33,7,8,447,198
206,45,3,3,6,7,-67,-66,0,2,380,132
206,46,4,2,10,3,46,21,6,3,426,153
206,47,2,4,3,10,21,46,7,9,447,199
206,48,5,2,8,5,-47,-77,0,2,400,122
206,49,3,3,6,7,33,34,3,6,433,156
206,50,3,4,6,7,33,43,6,9,466,199
206,51,5,2,9,4,-46,-78,0,1,420,121
206,52,4,3,7,6,43,33,3,4,463,154
206,53,2,5,5,8,23,53,6,7,486,207
206,54,3,4,3,10,30,-54,6,3,516,153
207,1,4,3,7,6,43,33,3,3,43,33
207,2,4,3,7,6,43,33,6,6,86,66
207,3,2,4,5,8,23,-56,9,0,109,10
207,4,3,4,7,6,-66,42,3,2,43,52
207,5,4,3,7,6,43,33,6,5,86,85
207,6,2,5,5,8,23,53,9,8,109,138
207,7,2,5,4,9,-78,-46,1,2,31,92
207,8,5,2,9,4,54,22,5,4,85,114
207,9,4,3,10,3,-54,30,1,4,31,144
207,10,3,3,5,8,32,35,3,9,63,179
207,11,2,4,4,9,22,-55,5,4,85,124
207,12,3,4,7,6,34,42,9,6,119,166
207,13,4,2,7,6,-57,-76,2,0,62,90
207,14,3,3,6,7,33,34,5,4,95,124
207,15,3,3,8,5,-65,32,0,6,30,156
207,16,3,4,3,10,30,-54,0,2,60,102
207,17,4,2,9,4,45,22,5,4,105,124
207,18,2,4,5,8,23,44,8,8,128,168
207,19,2,4,6,7,-76,-57,2,1,52,111
207,20,5,2,9,4,54,22,6,3,106,133
207,21,4,2,9,4,-55,22,1,5,51,155
207,22,2,5,4,9,22,54,3,9,73,209
207,23,3,4,7,6,34,-58,7,1,107,151
207,24,2,4,6,7,-76,43,1,4,31,194
207,25,4,3,6,7,42,34,3,8,73,228
207,26,3,3,7,6,34,-67,7,1,107,161
207,27,5,2,7,6,52,24,9,5,159,185
207,28,4,2,8,5,-56,23,3,8,103,208
207,29,4,4,7,6,43,-58,6,0,146,150
207,30,2,4,5,8,23,44,9,4,169,194
207,31,5,2,11,2,-44,20,5,4,125,214
207,32,4,2,8,5,44,23,9,7,169,237
207,33,3,4,5,8,-68,-56,1,1,101,181
207,34,4,3,7,6,43,33,4,4,144,214
207,35,4,3,8,5,44,32,8,6,188,246
207,36,3,4,6,7,-67,43,1,9,121,289
207,37,3,3,5,8,32,-65,3,4,153,224
207,38,4,3,9,4,45,31,8,5,198,255
207,39,6,2,10,3,-36,21,2,6,162,276
207,40,5,2,9,4,54,22,6,8,216,298
207,41,3,3,9,4,-64,31,2,9,152,329
207,42,2,4,3,10,21,-54,3,5,173,275
207,43,3,3,9,4,36,31,9,6,209,306
207,44,4,2,8,5,-56,23,3,9,153,329
207,45,5,2,9,4,54,-78,7,1,207,251
207,46,5,2,9,4,-46,22,1,3,161,273
207,47,3,4,7,6,34,42,5,5,195,315
207,48,3,3,8,5,-65,32,0,7,130,347
207,49,2,5,5,8,23,-47,3,0,153,300
207,50,4,2,7,6,43,24,6,4,196,324
207,51,4,2,9,4,-55,22,1,6,141,346
207,52,4,3,9,4,45,31,6,7,186,377
207,53,5,2,10,3,-45,21,1,8,141,398
207,54,3,3,7,6,34,-67,5,1,175,331
207,55,5,2,9,4,54,22,9,3,229,353
207,56,3,4,6,7,-67,43,2,6,162,396
207,57,2,5,4,9,22,-46,4,0,184,350
207,58,2,4,3,10,21,46,5,6,205,396
207,59,4,3,8,5,44,32,9,8,249,428
207,60,3,3,8,5,-65,-68,4,0,184,360
207,61,4,3,7,6,43,33,7,3,227,393
207,62,3,3,5,8,32,35,9,8,259,428
207,63,3,4,6,7,-67,-57,2,1,192,371
207,64,4,2,7,6,43,24,5,5,235,395
207,65,3,4,5,8,32,44,7,9,267,439
207,66,2,4,4,9,22,-55,9,4,289,384
207,67,2,4,5,8,-77,44,2,8,212,428
207,68,2,5,4,9,22,-46,4,2,234,382
207,69,5,2,9,4,54,22,8,4,288,404
207,70,4,3,8,5,-56,32,2,6,232,436
207,71,3,3,6,7,33,-66,5,0,265,370
207,72,2,5,4,9,22,54,7,4,287,424
207,73,2,4,4,9,22,45,9,9,309,469
207,74,2,4,5,8,-77,-56,2,3,232,413
207,75,2,4,6,7,24,43,6,6,256,456
207,76,2,5,3,10,21,-45,7,1,277,411
207,77,3,3,5,8,32,35,9,6,309,446
207,78,3,5,5,8,-68,53,1,9,241,499
207,79,3,3,7,6,34,-67,5,2,275,432
207,80,4,3,7,6,43,33,8,5,318,465
207,81,2,4,7,6,-75,42,3,7,243,507
208,1,5,2,10,3,55,21,5,1,55,21
208,2,3,3,6,7,33,34,8,5,88,55
208,3,3,4,7,6,-66,42,2,7,22,97
208,4,4,3,5,8,41,-65,3,2,63,32
208,5,4,2,8,5,44,23,7,5,107,55
208,6,4,2,10,3,-54,21,3,6,53,76
208,7,3,4,4,9,31,-55,4,1,84,21
208,8,4,2,8,5,44,23,8,4,128,44
208,9,3,4,6,7,-67,43,1,7,61,87
208,10,2,5,5,8,23,-47,4,0,84,40
208,11,4,3,4,9,40,36,4,6,124,76
208,12,4,3,6,7,42,-66,6,0,166,10
208,13,3,3,8,5,-65,32,1,2,101,42
208,14,5,2,10,3,55,21,6,3,156,63
208,15,3,4,4,9,31,45,7,8,187,108
208,16,2,5,3,10,21,-45,8,3,208,63
208,17,4,3,7,6,-57,33,1,6,151,96
208,18,2,4,4,9,22,-55,3,1,173,41
208,19,4,2,9,4,45,22,8,3,218,63
208,20,3,3,7,6,-66,33,2,6,152,96
208,21,2,4,4,9,22,-55,4,1,174,41
208,22,4,3,10,3,-54,30,0,1,120,71
208,23,4,3,7,6,43,33,3,4,163,104
208,24,3,4,7,6,34,42,7,6,197,146
208,25,3,4,6,7,-67,43,0,9,130,189
208,26,2,4,5,8,23,-56,3,3,153,133
208,27,3,3,6,7,33,34,6,7,186,167
208,28,4,3,8,5,-56,32,0,9,130,199
208,29,5,2,7,6,52,-76,2,3,182,123
208,30,4,2,10,3,46,21,8,4,228,144
208,31,2,5,6,7,-76,52,2,6,152,196
208,32,5,2,9,4,54,22,6,8,206,218
208,33,4,2,8,5,-56,-77,0,1,150,141
208,34,2,5,4,9,22,54,2,5,172,195
208,35,4,3,8,5,44,32,6,7,216,227
208,36,2,4,4,9,22,-55,8,2,238,172
208,37,2,6,2,11,20,65,8,7,258,237
208,38,4,3,8,5,-56,32,2,9,202,269
208,39,4,3,8,5,44,-68,6,1,246,201
208,40,4,3,10,3,-54,30,2,1,192,231
208,41,2,5,6,7,24,52,6,3,216,283
208,42,2,4,7,6,-75,42,1,5,141,325
208,43,3,5,4,9,31,54,2,9,172,379
208,44,2,5,5,8,23,-47,5,2,195,332
208,45,4,2,6,7,42,25,7,7,237,357
208,46,2,6,5,8,-77,62,0,9,160,419
208,47,5,2,9,4,54,-78,4,1,214,341
208,48,4,3,8,5,44,32,8,3,258,373
208,49,3,4,5,8,-68,44,0,7,190,417
208,50,2,4,6,7,24,-57,4,0,214,360
208,51,3,4,6,7,33,43,7,3,247,403
208,52,4,4,4,9,40,45,7,8,287,448
208,53,3,4,7,6,-66,-58,1,0,221,390
208,54,2,5,3,10,21,55,2,5,242,445
208,55,4,3,8,5,44,32,6,7,286,477
208,56,3,4,7,6,-66,42,0,9,220,519
209,1,2,4,7,6,25,42,5,2,25,42
209,2,2,5,4,9,22,54,7,6,47,96
209,3,2,4,8,5,-74,41,3,7,-27,137
209,4,5,2,10,3,55,21,8,8,28,158
209,5,5,2,8,5,-47,-77,1,1,-19,81
209,6,4,2,8,5,44,23,5,4,25,104
209,7,2,6,5,8,23,62,8,6,48,166
209,8,3,4,7,6,-66,42,2,8,-18,208
209,9,2,5,4,9,22,-46,4,2,4,162
209,10,2,4,4,9,22,45,6,7,26,207
209,11,4,3,6,7,42,-66,8,1,68,141
209,12,3,3,7,6,-66,33,2,4,2,174
209,13,3,3,8,5,35,32,7,6,37,206
209,14,3,3,8,5,-65,32,2,8,-28,238
209,15,3,3,9,4,36,31,8,9,8,269
209,16,5,2,8,5,-47,-77,1,2,-39,192
209,17,3,3,8,5,35,32,6,4,-4,224
209,18,3,4,5,8,32,44,8,8,28,268
209,19,5,2,8,5,-47,-77,1,1,-19,191
209,20,3,3,8,5,35,32,6,3,16,223
209,21,2,4,4,9,22,45,8,8,38,268
209,22,3,3,9,4,-64,31,4,9,-26,299
209,23,3,3,8,5,35,-68,9,1,9,231
209,24,2,5,4,9,-78,54,1,5,-69,285
209,25,4,3,7,6,43,33,4,8,-26,318
209,26,3,3,7,6,34,-67,8,1,8,251
209,27,4,3,8,5,-56,32,2,3,-48,283
209,28,4,3,7,6,43,33,5,6,-5,316
209,29,3,4,5,8,32,-56,7,0,27,260
209,30,4,2,9,4,-55,22,2,2,-28,282
209,31,5,3,7,6,52,33,4,5,24,315
209,32,2,5,5,8,23,53,7,8,47,368
209,33,3,3,7,6,-66,-67,1,1,-19,301
209,34,2,4,5,8,23,44,4,5,4,345
209,35,3,4,8,5,35,41,9,6,39,386
209,36,2,4,3,10,-79,-54,0,2,-40,332
209,37,3,5,6,7,33,52,3,4,-7,384
209,38,2,4,5,8,23,44,6,8,16,428
209,39,4,3,6,7,42,-66,8,2,58,362
209,40,3,4,5,8,-68,44,0,6,-10,406
209,41,4,3,8,5,44,32,4,8,34,438
209,42,4,3,6,7,42,-66,6,2,76,372
209,43,3,3,7,6,-66,33,0,5,10,405
209,44,3,3,6,7,33,34,3,9,43,439
209,45,2,4,4,9,22,-55,5,4,65,384
209,46,4,3,7,6,43,33,8,7,108,417
209,47,2,4,4,9,-78,-55,0,2,30,362
209,48,2,4,9,4,27,40,7,2,57,402
209,49,3,3,7,6,-66,33,1,5,-9,435
209,50,2,5,6,7,24,52,5,7,15,487
209,51,3,4,5,8,32,-56,7,1,47,431
209,52,3,3,6,7,-67,34,0,5,-20,465
209,53,2,5,7,6,25,51,5,6,5,516
210,1,3,3,5,8,32,35,2,5,32,35
210,2,3,3,8,5,35,32,7,7,67,67
210,3,5,2,8,5,-47,-77,0,0,20,-10
210,4,5,2,11,2,56,20,6,0,76,10
210,5,5,2,9,4,-46,22,0,2,30,32
210,6,4,2,10,3,46,21,6,3,76,53
210,7,4,3,6,7,42,34,8,7,118,87
210,8,3,4,7,6,-66,42,2,9,52,129
210,9,4,2,8,5,44,-77,6,2,96,52
210,10,6,2,10,3,-36,21,0,3,60,73
210,11,3,3,5,8,32,35,2,8,92,108
210,12,4,3,9,4,45,31,7,9,137,139
210,13,3,4,5,8,32,-56,9,3,169,83
210,14,4,3,5,8,-59,35,0,8,110,118
210,15,3,4,6,7,33,-57,3,1,143,61
210,16,2,4,4,9,22,45,5,6,165,106
210,17,4,3,9,4,-55,31,0,7,110,137
210,18,3,4,7,6,34,42,4,9,144,179
210,19,3,3,6,7,33,-66,7,3,177,113
210,20,4,3,7,6,-57,33,0,6,120,146
210,21,5,2,8,5,53,23,3,9,173,169
210,22,4,4,6,7,42,-57,5,2,215,112
210,23,2,4,4,9,22,45,7,7,237,157
210,24,4,3,8,5,-56,32,1,9,181,189
210,25,3,4,4,9,31,-55,2,4,212,134
210,26,6,2,9,4,63,22,5,6,275,156
210,27,3,3,8,5,-65,32,0,8,210,188
210,28,4,3,8,5,44,-68,4,0,254,120
210,29,2,4,5,8,23,44,7,4,277,164
210,30,3,4,5,8,32,44,9,8,309,208
210,31,3,3,7,6,-66,-67,3,1,243,141
210,32,3,4,7,6,34,42,7,3,277,183
210,33,3,3,4,9,31,36,8,9,308,219
210,34,2,4,4,9,-78,-55,0,4,230,164
210,35,2,4,7,6,25,42,5,6,255,206
210,36,2,5,2,11,20,-44,5,2,275,162
210,37,4,2,9,4,-55,22,0,4,220,184
210,38,3,4,7,6,34,42,4,6,254,226
210,39,3,3,6,7,33,-66,7,0,287,160
210,40,3,3,7,6,-66,33,1,3,221,193
210,41,4,2,9,4,45,22,6,5,266,215
210,42,4,2,8,5,-56,23,0,8,210,238
210,43,2,5,4,9,22,-46,2,2,232,192
210,44,5,2,8,5,53,23,5,5,285,215
210,45,2,4,5,8,23,44,8,9,308,259
210,46,2,4,3,10,21,-54,9,5,329,205
210,47,2,5,3,10,-79,-45,0,0,250,160
210,48,3,4,7,6,34,42,4,2,284,202
210,49,4,3,10,3,-54,30,0,2,230,232
210,50,4,2,7,6,43,24,3,6,273,256
210,51,5,3,8,5,53,32,6,8,326,288
210,52,3,3,4,9,31,-64,7,4,357,224
210,53,2,4,6,7,-76,43,1,7,281,267
210,54,3,4,3,10,30,-54,1,3,311,213
210,55,3,4,6,7,33,43,4,6,344,256
210,56,2,5,4,9,22,-46,6,0,366,210
210,57,5,2,10,3,-45,21,1,1,321,231
210,58,3,3,5,8,32,35,3,6,353,266
210,59,5,2,8,5,53,23,6,9,406,289
210,60,4,3,7,6,43,-67,9,2,449,222
210,61,2,6,3,10,-79,64,0,6,370,286
210,62,2,5,4,9,22,-46,2,0,392,240
210,63,3,4,4,9,31,45,3,5,423,285
210,64,4,2,9,4,45,22,8,7,468,307
210,65,3,3,9,4,-64,31,4,8,404,338
210,66,4,2,7,6,43,-76,7,2,447,262
210,67,3,3,5,8,32,35,9,7,479,297
210,68,3,4,5,8,-68,-56,1,1,411,241
210,69,3,3,8,5,35,32,6,3,446,273
210,70,5,2,9,4,-46,22,0,5,400,295
210,71,4,3,7,6,43,33,3,8,443,328
210,72,4,2,9,4,45,-78,8,0,488,250
210,73,5,2,6,7,51,25,9,5,539,275
211,1,3,3,9,4,36,31,6,1,36,31
211,2,5,2,8,5,53,23,9,4,89,54
211,3,4,4,8,5,-56,41,3,5,33,95
211,4,4,3,8,5,44,32,7,7,77,127
211,5,5,2,11,2,-44,20,3,7,33,147
211,6,3,4,6,7,33,-57,6,0,66,90
211,7,2,4,7,6,-75,42,1,2,-9,132
211,8,2,4,8,5,26,41,7,3,17,173
211,9,3,3,8,5,-65,32,2,5,-48,205
211,10,3,5,6,7,33,52,5,7,-15,257
211,11,2,4,8,5,-74,41,1,8,-89,298
211,12,3,3,6,7,33,-66,4,2,-56,232
211,13,4,3,7,6,43,33,7,5,-13,265
211,14,3,5,4,9,31,54,8,9,18,319
211,15,4,3,6,7,-58,-66,0,3,-40,253
211,16,4,2,10,3,46,21,6,4,6,274
211,17,2,4,5,8,23,44,9,8,29,318
211,18,5,2,10,3,-45,21,4,9,-16,339
211,19,4,3,10,3,-54,30,0,9,-70,369
211,20,2,4,7,6,25,-58,5,1,-45,311
211,21,2,5,5,8,23,53,8,4,-22,364
211,22,5,2,6,7,51,25,9,9,29,389
211,23,4,3,8,5,-56,-68,3,1,-27,321
211,24,4,2,8,5,44,23,7,4,17,344
211,25,2,5,3,10,21,55,8,9,38,399
211,26,4,2,8,5,-56,-77,2,2,-18,322
211,27,4,3,6,7,42,34,4,6,24,356
211,28,4,2,8,5,44,23,8,9,68,379
211,29,2,4,4,9,-78,-55,0,4,-10,324
211,30,3,4,7,6,34,42,4,6,24,366
211,31,3,4,3,10,30,-54,4,2,54,312
211,32,5,2,10,3,55,21,9,3,109,333
211,33,3,4,5,8,-68,44,1,7,41,377
211,34,4,3,8,5,44,32,5,9,85,409
211,35,3,3,7,6,34,-67,9,2,119,342
211,36,4,3,6,7,-58,34,1,6,61,376
211,37,4,3,7,6,43,33,4,9,104,409
211,38,2,4,5,8,23,-56,7,3,127,353
211,39,2,4,5,8,-77,44,0,7,50,397
211,40,5,2,8,5,53,-77,3,0,103,320
211,41,3,4,6,7,33,43,6,3,136,363
211,42,4,3,10,3,-54,30,2,3,82,393
211,43,3,3,5,8,32,35,4,8,114,428
211,44,2,5,3,10,21,-45,5,3,135,383
211,45,3,4,5,8,32,44,7,7,167,427
211,46,3,4,5,8,32,-56,9,1,199,371
211,47,5,2,7,6,-48,24,1,5,151,395
211,48,3,3,4,9,31,-64,2,1,182,331
211,49,3,3,7,6,34,33,6,4,216,364
211,50,3,3,4,9,31,-64,7,0,247,300
211,51,3,3,9,4,-64,31,3,1,183,331
211,52,3,4,6,7,33,43,6,4,216,374
211,53,5,2,10,3,-45,21,1,5,171,395
211,54,4,3,9,4,45,31,6,6,216,426
211,55,5,2,11,2,-44,20,2,6,172,446
211,56,2,5,3,10,21,-45,3,1,193,401
211,57,4,2,9,4,45,22,8,3,238,423
211,58,4,2,8,5,-56,23,2,6,182,446
211,59,3,3,5,8,32,-65,4,1,214,381
211,60,4,3,7,6,43,33,7,4,257,414
211,61,3,5,5,8,32,53,9,7,289,467
211,62,2,6,2,11,20,-35,9,2,309,432
211,63,3,3,9,4,-64,31,5,3,245,463
211,64,4,3,8,5,44,32,9,5,289,495
211,65,4,2,7,6,-57,24,2,9,232,519
212,1,3,3,6,7,33,34,3,4,33,34
212,2,4,2,6,7,42,25,5,9,75,59
212,3,4,3,9,4,-55,-69,0,0,20,-10
212,4,4,3,5,8,41,35,1,5,61,25
212,5,3,3,6,7,33,34,4,9,94,59
212,6,5,2,7,6,52,-76,6,3,146,-17
212,7,3,4,7,6,-66,42,0,5,80,25
212,8,4,2,8,5,44,23,4,8,124,48
212,9,4,2,7,6,43,-76,7,2,167,-28
212,10,5,2,9,4,-46,22,1,4,121,-6
212,11,4,2,7,6,43,24,4,8,164,18
212,12,3,3,8,5,35,-68,9,0,199,-50
212,13,4,2,8,5,-56,23,3,3,143,-27
212,14,5,2,9,4,54,22,7,5,197,-5
212,15,3,5,6,7,-67,52,0,7,130,47
212,16,2,5,3,10,21,-45,1,2,151,2
212,17,3,4,4,9,31,45,2,7,182,47
212,18,3,4,7,6,34,42,6,9,216,89
212,19,4,2,10,3,-54,-79,2,0,162,10
212,20,2,4,6,7,24,43,6,3,186,53
212,21,4,3,5,8,41,35,7,8,227,88
212,22,5,2,7,6,52,-76,9,2,279,12
212,23,2,4,5,8,-77,44,2,6,202,56
212,24,2,4,6,7,24,43,6,9,226,99
212,25,3,4,9,4,-64,40,2,9,162,139
212,26,4,2,8,5,44,-77,6,2,206,62
212,27,3,3,8,5,-65,32,1,4,141,94
212,28,2,5,4,9,22,54,3,8,163,148
212,29,3,4,7,6,34,-58,7,0,197,90
212,30,4,4,7,6,-57,42,0,2,140,132
212,31,3,4,4,9,31,45,1,7,171,177
212,32,2,4,5,8,23,-56,4,1,194,121
212,33,3,3,6,7,33,34,7,5,227,155
212,34,3,4,5,8,32,44,9,9,259,199
212,35,4,4,7,6,-57,-58,2,1,202,141
212,36,3,3,8,5,35,32,7,3,237,173
212,37,4,3,4,9,40,36,7,9,277,209
212,38,3,4,9,4,-64,40,3,9,213,249
212,39,2,5,3,10,21,-45,4,4,234,204
212,40,4,3,8,5,44,32,8,6,278,236
212,41,2,5,5,8,-77,53,1,9,201,289
212,42,3,4,9,4,36,40,7,9,237,329
212,43,3,3,9,4,-64,-69,3,0,173,260
212,44,3,3,9,4,36,31,9,1,209,291
212,45,3,3,6,7,-67,34,2,5,142,325
212,46,2,4,4,9,22,-55,4,0,164,270
212,47,4,2,8,5,44,23,8,3,208,293
212,48,5,2,10,3,-45,21,3,4,163,314
212,49,2,4,3,10,21,-54,4,0,184,260
212,50,4,2,7,6,43,24,7,4,227,284
212,51,4,2,8,5,-56,23,1,7,171,307
212,52,3,3,8,5,35,32,6,9,206,339
212,53,2,4,6,7,-76,-57,0,2,130,282
212,54,2,4,8,5,26,41,6,3,156,323
212,55,4,3,7,6,43,33,9,6,199,356
212,56,4,2,7,6,-57,-76,2,0,142,280
212,57,5,2,9,4,54,22,6,2,196,302
212,58,3,3,6,7,33,34,9,6,229,336
212,59,3,3,8,5,-65,32,4,8,164,368
212,60,3,4,5,8,32,-56,6,2,196,312
212,61,2,4,5,8,23,44,9,6,219,356
212,62,3,3,7,6,-66,33,3,9,153,389
212,63,4,2,9,4,45,-78,8,1,198,311
212,64,4,3,8,5,-56,32,2,3,142,343
212,65,3,3,5,8,32,35,4,8,174,378
212,66,4,3,7,6,43,-67,7,1,217,311
212,67,5,3,8,5,-47,32,0,3,170,343
212,68,3,4,6,7,33,43,3,6,203,386
212,69,2,4,5,8,23,-56,6,0,226,330
212,70,3,3,9,4,-64,31,2,1,162,361
212,71,4,3,8,5,44,32,6,3,206,393
212,72,4,3,9,4,-55,31,1,4,151,424
212,73,2,4,4,9,22,45,3,9,173,469
212,74,3,4,6,7,33,-57,6,2,206,412
212,75,3,3,5,8,32,35,8,7,238,447
212,76,4,4,7,6,-57,42,1,9,181,489
212,77,3,4,9,4,36,40,7,9,217,529
213,1,4,2,7,6,43,24,3,4,43,24
213,2,3,4,6,7,33,43,6,7,76,67
213,3,2,5,4,9,22,-46,8,1,98,21
213,4,2,5,6,7,-76,52,2,3,22,73
213,5,3,3,3,10,30,-63,2,0,52,10
213,6,3,4,5,8,32,44,4,4,84,54
213,7,4,3,9,4,45,31,9,5,129,85
213,8,4,3,8,5,-56,32,3,7,73,117
213,9,3,3,7,6,34,-67,7,0,107,50
213,10,5,3,7,6,52,33,9,3,159,83
213,11,4,3,7,6,-57,33,2,6,102,116
213,12,4,3,6,7,42,-66,4,0,144,50
213,13,2,4,9,4,-73,40,1,0,71,90
213,14,2,5,2,11,20,56,1,6,91,146
213,15,3,3,7,6,34,33,5,9,125,179
213,16,5,2,10,3,-45,-79,0,0,80,100
213,17,2,5,5,8,23,53,3,3,103,153
213,18,4,3,7,6,43,33,6,6,146,186
213,19,3,4,4,9,31,-55,7,1,177,131
213,20,2,4,5,8,-77,44,0,5,100,175
213,21,4,3,9,4,45,31,5,6,145,206
213,22,3,3,5,8,32,-65,7,1,177,141
213,23,4,3,6,7,42,34,9,5,219,175
213,24,3,4,7,6,-66,42,3,7,153,217
213,25,4,3,8,5,44,32,7,9,197,249
213,26,3,3,6,7,-67,-66,0,3,130,183
213,27,3,3,4,9,31,36,1,9,161,219
213,28,2,4,4,9,22,-55,3,4,183,164
213,29,4,3,5,8,41,35,4,9,224,199
213,30,4,3,6,7,42,-66,6,3,266,133
213,31,5,2,10,3,-45,21,1,4,221,154
213,32,4,2,8,5,44,23,5,7,265,177
213,33,3,4,6,7,33,-57,8,0,298,120
213,34,3,4,5,8,-68,44,0,4,230,164
213,35,4,3,5,8,41,35,1,9,271,199
213,36,2,4,5,8,23,-56,4,3,294,143
213,37,4,3,6,7,42,34,6,7,336,177
213,38,4,2,9,4,-55,22,1,9,281,199
213,39,2,4,6,7,24,-57,5,2,305,142
213,40,5,2,10,3,-45,21,0,3,260,163
213,41,4,3,6,7,42,34,2,7,302,197
213,42,2,4,5,8,23,-56,5,1,325,141
213,43,3,3,8,5,-65,32,0,3,260,173
213,44,5,2,10,3,55,21,5,4,315,194
213,45,5,2,9,4,54,22,9,6,369,216
213,46,3,3,6,7,-67,-66,2,0,302,150
213,47,5,2,8,5,53,23,5,3,355,173
213,48,4,2,6,7,42,25,7,8,397,198
213,49,4,2,7,6,-57,-76,0,2,340,122
213,50,4,3,10,3,46,30,6,2,386,152
213,51,2,4,4,9,22,45,8,7,408,197
213,52,3,3,8,5,-65,32,3,9,343,229
213,53,4,4,9,4,45,40,8,9,388,269
213,54,2,5,3,10,21,-45,9,4,409,224
213,55,3,4,3,10,30,-54,9,0,439,170
213,56,4,3,9,4,-55,31,4,1,384,201
213,57,3,3,5,8,32,35,6,6,416,236
213,58,2,5,3,10,21,-45,7,1,437,191
213,59,2,5,7,6,-75,51,2,2,362,242
213,60,5,2,8,5,53,23,5,5,415,265
213,61,3,3,7,6,34,33,9,8,449,298
213,62,3,3,5,8,-68,-65,1,3,381,233
213,63,4,3,8,5,44,32,5,5,425,265
213,64,3,5,4,9,31,54,6,9,456,319
213,65,4,3,10,3,-54,30,2,9,402,349
213,66,3,3,8,5,35,-68,7,1,437,281
213,67,3,4,4,9,31,45,8,6,468,326
213,68,3,4,6,7,-67,43,1,9,401,369
213,69,2,4,6,7,24,-57,5,2,425,312
213,70,2,4,6,7,24,43,9,5,449,355
213,71,4,2,8,5,-56,23,3,8,393,378
213,72,3,4,6,7,33,-57,6,1,426,321
213,73,5,3,9,4,-46,31,0,2,380,352
213,74,3,4,6,7,33,43,3,5,413,395
213,75,2,5,3,10,21,-45,4,0,434,350
213,76,4,3,10,3,-54,30,0,0,380,380
213,77,4,4,8,5,44,41,4,1,424,421
213,78,4,3,4,9,40,36,4,7,464,457
213,79,3,3,8,5,35,32,9,9,499,489
213,80,3,3,10,3,-63,30,6,9,436,519
214,1,5,2,9,4,54,22,4,2,54,22
214,2,2,5,2,11,20,56,4,8,74,78
214,3,3,4,5,8,32,-56,6,2,106,22
214,4,4,3,10,3,-54,30,2,2,52,52
214,5,3,3,5,8,32,35,4,7,84,87
214,6,3,4,6,7,33,-57,7,0,117,30
214,7,2,4,6,7,-76,43,1,3,41,73
214,8,4,2,7,6,43,24,4,7,84,97
214,9,3,3,6,7,33,-66,7,1,117,31
214,10,3,4,4,9,31,45,8,6,148,76
214,11,3,3,8,5,-65,32,3,8,83,108
214,12,3,4,8,5,35,41,8,9,118,149
214,13,2,4,4,9,-78,-55,0,4,40,94
214,14,5,2,11,2,56,20,6,4,96,114
214,15,4,3,7,6,43,33,9,7,139,147
214,16,5,2,9,4,-46,22,3,9,93,169
214,17,5,3,7,6,52,-67,5,2,145,102
214,18,6,2,11,2,-35,20,0,2,110,122
214,19,3,3,8,5,35,32,5,4,145,154
214,20,3,3,8,5,-65,32,0,6,80,186
214,21,4,2,6,7,42,-75,2,1,122,111
214,22,2,4,6,7,24,43,6,4,146,154
214,23,2,4,6,7,-76,43,0,7,70,197
214,24,3,4,5,8,32,-56,2,1,102,141
214,25,2,5,7,6,25,51,7,2,127,192
214,26,3,3,5,8,32,35,9,7,159,227
214,27,2,4,4,9,-78,-55,1,2,81,172
214,28,3,3,5,8,32,35,3,7,113,207
214,29,4,2,9,4,45,22,8,9,158,229
214,30,3,3,6,7,-67,-66,1,3,91,163
214,31,4,3,6,7,42,34,3,7,133,197
214,32,2,5,3,10,21,-45,4,2,154,152
214,33,4,2,6,7,42,25,6,7,196,177
214,34,4,3,5,8,41,-65,7,2,237,112
214,35,4,3,6,7,42,34,9,6,279,146
214,36,3,3,7,6,-66,33,3,9,213,179
214,37,3,4,6,7,33,-57,6,2,246,122
214,38,3,3,8,5,-65,32,1,4,181,154
214,39,4,3,8,5,44,32,5,6,225,186
214,40,4,2,7,6,43,-76,8,0,268,110
214,41,3,3,7,6,-66,33,2,3,202,143
214,42,3,3,8,5,35,32,7,5,237,175
214,43,3,3,5,8,32,-65,9,0,269,110
214,44,3,3,6,7,-67,34,2,4,202,144
214,45,3,4,7,6,34,42,6,6,236,186
214,46,5,2,10,3,-45,21,1,7,191,207
214,47,3,3,9,4,36,31,7,8,227,238
214,48,3,4,5,8,32,-56,9,2,259,182
214,49,4,3,7,6,-57,33,2,5,202,215
214,50,3,3,10,3,37,30,9,5,239,245
214,51,4,3,9,4,-55,31,4,6,184,276
214,52,3,3,6,7,33,-66,7,0,217,210
214,53,3,3,4,9,31,36,8,6,248,246
214,54,4,2,8,5,-56,23,2,9,192,269
214,55,4,3,5,8,41,-65,3,4,233,204
214,56,4,3,5,8,41,35,4,9,274,239
214,57,4,2,9,4,45,-78,9,1,319,161
214,58,2,4,6,7,-76,43,3,4,243,204
214,59,3,3,6,7,33,34,6,8,276,238
214,60,2,4,5,8,23,-56,9,2,299,182
214,61,4,3,9,4,-55,31,4,3,244,213
214,62,3,4,8,5,35,41,9,4,279,254
214,63,4,2,7,6,-57,24,2,8,222,278
214,64,3,4,6,7,33,-57,5,1,255,221
214,65,3,3,8,5,-65,32,0,3,190,253
214,66,5,2,11,2,56,20,6,3,246,273
214,67,4,3,9,4,-55,31,1,4,191,304
214,68,3,3,6,7,33,34,4,8,224,338
214,69,4,2,8,5,44,-77,8,1,268,261
214,70,3,3,6,7,-67,34,1,5,201,295
214,71,4,2,9,4,45,22,6,7,246,317
214,72,3,3,8,5,-65,32,1,9,181,349
214,73,3,4,7,6,34,-58,5,1,215,291
214,74,2,5,2,11,20,56,5,7,235,347
214,75,4,2,7,6,43,-76,8,1,278,271
214,76,3,4,4,9,31,45,9,6,309,316
214,77,4,2,10,3,-54,21,5,7,255,337
214,78,5,2,9,4,54,22,9,9,309,359
214,79,3,3,3,10,30,-63,9,6,339,296
214,80,3,4,5,8,-68,-56,1,0,271,240
214,81,4,3,8,5,44,32,5,2,315,272
214,82,2,5,4,9,22,54,7,6,337,326
214,83,6,2,11,2,-35,20,2,6,302,346
214,84,3,4,7,6,34,42,6,8,336,388
214,85,4,2,5,8,41,-74,7,4,377,314
214,86,4,2,9,4,-55,22,2,6,322,336
214,87,2,4,3,10,21,-54,3,2,343,282
214,88,4,3,8,5,44,32,7,4,387,314
214,89,3,3,6,7,-67,34,0,8,320,348
214,90,5,2,7,6,52,-76,2,2,372,272
214,91,4,2,8,5,44,23,6,5,416,295
214,92,2,4,5,8,23,44,9,9,439,339
214,93,2,4,3,10,-79,-54,0,5,360,285
214,94,3,3,8,5,35,32,5,7,395,317
214,95,4,3,7,6,43,-67,8,0,438,250
214,96,2,4,6,7,-76,43,2,3,362,293
214,97,3,3,5,8,32,35,4,8,394,328
214,98,5,2,10,3,55,21,9,9,449,349
214,99,3,4,4,9,-69,-55,0,4,380,294
214,100,4,3,10,3,46,30,6,4,426,324
214,101,3,3,4,9,31,-64,7,0,457,260
214,102,3,4,5,8,32,44,9,4,489,304
214,103,3,3,7,6,-66,33,3,7,423,337
214,104,4,3,10,3,46,30,9,7,469,367
214,105,4,3,6,7,-58,-66,1,1,411,301
214,106,2,5,6,7,24,52,5,3,435,353
214,107,3,3,6,7,33,34,8,7,468,387
214,108,4,3,9,4,-55,31,3,8,413,418
214,109,3,4,5,8,32,-56,5,2,445,362
214,110,3,3,6,7,33,34,8,6,478,396
214,111,2,4,6,7,-76,43,2,9,402,439
214,112,2,5,4,9,22,-46,4,3,424,393
214,113,3,4,9,4,-64,40,0,3,360,433
214,114,4,3,6,7,42,34,2,7,402,467
214,115,5,2,8,5,53,-77,5,0,455,390
214,116,5,2,8,5,53,23,8,3,508,413
215,1,3,3,5,8,32,35,2,5,32,35
215,2,2,5,4,9,22,54,4,9,54,89
215,3,3,3,6,7,33,-66,7,3,87,23
215,4,3,3,8,5,-65,32,2,5,22,55
215,5,4,2,6,7,42,-75,4,0,64,-20
215,6,3,4,5,8,32,44,6,4,96,24
215,7,4,3,9,4,-55,31,1,5,41,55
215,8,3,3,9,4,36,31,7,6,77,86
215,9,4,3,9,4,-55,31,2,7,22,117
215,10,5,2,8,5,53,-77,5,0,75,40
215,11,2,5,4,9,22,54,7,4,97,94
215,12,4,4,7,6,-57,42,0,6,40,136
215,13,2,4,4,9,22,-55,2,1,62,81
215,14,4,3,10,3,46,30,8,1,108,111
215,15,3,3,7,6,-66,33,2,4,42,144
215,16,3,3,6,7,33,34,5,8,75,178
215,17,2,5,4,9,22,-46,7,2,97,132
215,18,5,2,9,4,-46,22,1,4,51,154
215,19,4,3,8,5,44,32,5,6,95,186
215,20,2,4,5,8,23,-56,8,0,118,130
215,21,3,4,7,6,-66,42,2,2,52,172
215,22,4,3,10,3,46,30,8,2,98,202
215,23,4,3,5,8,41,35,9,7,139,237
215,24,4,3,8,5,-56,32,3,9,83,269
215,25,2,4,5,8,23,-56,6,3,106,213
215,26,5,2,8,5,53,23,9,6,159,236
215,27,3,3,5,8,-68,-65,1,1,91,171
215,28,3,3,6,7,33,34,4,5,124,205
215,29,3,4,7,6,34,42,8,7,158,247
215,30,5,2,7,6,-48,-76,0,1,110,171
215,31,4,2,7,6,43,24,3,5,153,195
215,32,4,3,10,3,46,30,9,5,199,225
215,33,2,5,5,8,-77,53,2,8,122,278
215,34,3,3,8,5,35,-68,7,0,157,210
215,35,2,4,5,8,-77,44,0,4,80,254
215,36,3,3,6,7,33,34,3,8,113,288
215,37,2,5,3,10,21,-45,4,3,134,243
215,38,4,2,8,5,44,23,8,6,178,266
215,39,3,4,6,7,-67,43,1,9,111,309
215,40,3,3,5,8,32,-65,3,4,143,244
215,41,2,4,4,9,22,45,5,9,165,289
215,42,2,4,5,8,23,-56,8,3,188,233
215,43,5,2,10,3,-45,21,3,4,143,254
215,44,3,3,6,7,33,34,6,8,176,288
215,45,4,4,5,8,41,-56,7,2,217,232
215,46,2,5,4,9,22,54,9,6,239,286
215,47,3,3,7,6,-66,33,3,9,173,319
215,48,2,5,3,10,21,-45,4,4,194,274
215,49,3,3,8,5,35,32,9,6,229,306
215,50,3,3,5,8,-68,-65,1,1,161,241
215,51,5,2,6,7,51,25,2,6,212,266
215,52,4,3,6,7,42,-66,4,0,254,200
215,53,4,2,10,3,-54,21,0,1,200,221
215,54,4,2,10,3,46,21,6,2,246,242
215,55,2,5,5,8,23,53,9,5,269,295
215,56,3,3,5,8,-68,-65,1,0,201,230
215,57,2,4,4,9,22,45,3,5,223,275
215,58,5,2,9,4,54,22,7,7,277,297
215,59,3,3,5,8,32,-65,9,2,309,232
215,60,5,2,7,6,-48,24,1,6,261,256
215,61,3,3,8,5,35,32,6,8,296,288
215,62,3,5,8,5,-65,50,1,8,231,338
215,63,2,4,6,7,24,-57,5,1,255,281
215,64,3,3,6,7,33,34,8,5,288,315
215,65,3,4,8,5,-65,41,3,6,223,356
215,66,3,4,5,8,32,-56,5,0,255,300
215,67,5,3,6,7,51,34,6,4,306,334
215,68,3,4,7,6,-66,42,0,6,240,376
215,69,2,4,4,9,22,-55,2,1,262,321
215,70,3,3,7,6,34,33,6,4,296,354
215,71,4,3,8,5,-56,32,0,6,240,386
215,72,3,4,6,7,33,43,3,9,273,429
215,73,3,4,5,8,32,-56,5,3,305,373
215,74,3,4,5,8,32,44,7,7,337,417
215,75,3,4,4,9,31,-55,8,2,368,362
215,76,4,2,8,5,-56,23,2,5,312,385
215,77,5,3,7,6,52,33,4,8,364,418
215,78,4,4,9,4,45,40,9,8,409,458
215,79,4,3,6,7,-58,-66,1,2,351,392
215,80,3,3,5,8,32,35,3,7,383,427
215,81,2,5,3,10,21,-45,4,2,404,382
215,82,3,4,3,10,30,46,4,8,434,428
215,83,3,5,5,8,32,-47,6,1,466,381
215,84,3,4,6,7,33,43,9,4,499,424
215,85,4,2,10,3,-54,21,5,5,445,445
215,86,4,3,6,7,42,34,7,9,487,479
215,87,5,3,8,5,-47,-68,0,1,440,411
215,88,3,4,4,9,31,45,1,6,471,456
215,89,4,3,7,6,43,33,4,9,514,489
216,1,3,3,7,6,34,33,4,3,34,33
216,2,3,5,7,6,34,51,8,4,68,84
216,3,2,4,2,11,20,-53,8,1,88,31
216,4,2,5,5,8,-77,53,1,4,11,84
216,5,4,2,8,5,44,23,5,7,55,107
216,6,4,3,9,4,-55,31,0,8,0,138
216,7,2,4,3,10,21,-54,1,4,21,84
216,8,4,3,6,7,42,34,3,8,63,118
216,9,3,4,8,5,35,41,8,9,98,159
216,10,3,3,6,7,-67,-66,1,3,31,93
216,11,3,4,6,7,33,43,4,6,64,136
216,12,4,3,9,4,45,31,9,7,109,167
216,13,4,3,8,5,-56,32,3,9,53,199
216,14,4,3,9,4,45,-69,8,0,98,130
216,15,4,2,9,4,-55,22,3,2,43,152
216,16,2,4,4,9,22,45,5,7,65,197
216,17,4,3,7,6,43,-67,8,0,108,130
216,18,3,3,5,8,-68,35,0,5,40,165
216,19,3,3,5,8,32,-65,2,0,72,100
216,20,3,3,8,5,35,32,7,2,107,132
216,21,4,3,5,8,41,35,8,7,148,167
216,22,2,4,5,8,-77,-56,1,1,71,111
216,23,2,4,3,10,21,46,2,7,92,157
216,24,4,3,6,7,42,-66,4,1,134,91
216,25,2,4,6,7,24,43,8,4,158,134
216,26,3,3,8,5,-65,32,3,6,93,166
216,27,4,3,7,6,43,33,6,9,136,199
216,28,3,3,5,8,32,-65,8,4,168,134
216,29,4,3,6,7,-58,34,0,8,110,168
216,30,2,4,5,8,23,-56,3,2,133,112
216,31,4,3,5,8,41,35,4,7,174,147
216,32,3,3,9,4,-64,31,0,8,110,178
216,33,3,3,6,7,33,-66,3,2,143,112
216,34,3,3,5,8,32,35,5,7,175,147
216,35,3,4,5,8,32,-56,7,1,207,91
216,36,5,2,10,3,-45,21,2,2,162,112
216,37,4,2,6,7,42,25,4,7,204,137
216,38,4,2,6,7,42,-75,6,2,246,62
216,39,3,3,9,4,-64,31,2,3,182,93
216,40,4,3,8,5,44,32,6,5,226,125
216,41,4,3,9,4,-55,31,1,6,171,156
216,42,3,3,8,5,35,32,6,8,206,188
216,43,5,2,7,6,52,-76,8,2,258,112
216,44,3,4,6,7,-67,43,1,5,191,155
216,45,3,3,5,8,32,-65,3,0,223,90
216,46,3,4,5,8,32,44,5,4,255,134
216,47,5,2,5,8,50,-74,5,0,305,60
216,48,3,4,7,6,34,42,9,2,339,102
216,49,5,2,7,6,-48,24,1,6,291,126
216,50,3,4,6,7,33,43,4,9,324,169
216,51,3,3,4,9,31,-64,5,5,355,105
216,52,2,5,2,11,20,-44,5,1,375,61
216,53,4,4,5,8,41,44,6,5,416,105
216,54,3,3,6,7,33,34,9,9,449,139
216,55,4,3,9,4,-55,-69,4,0,394,70
216,56,3,4,7,6,34,42,8,2,428,112
216,57,4,3,8,5,-56,32,2,4,372,144
216,58,3,3,3,10,30,-63,2,1,402,81
216,59,3,3,4,9,31,36,3,7,433,117
216,60,4,3,8,5,44,32,7,9,477,149
216,61,3,4,5,8,32,-56,9,3,509,93
217,1,5,2,8,5,53,23,3,3,53,23
217,2,3,4,5,8,32,44,5,7,85,67
217,3,5,2,9,4,54,22,9,9,139,89
217,4,3,3,5,8,-68,-65,1,4,71,24
217,5,4,2,7,6,43,24,4,8,114,48
217,6,3,3,7,6,34,-67,8,1,148,-19
217,7,4,2,5,8,41,26,9,7,189,7
217,8,2,6,4,9,-78,-37,1,0,111,-30
217,9,3,4,4,9,31,45,2,5,142,15
217,10,6,2,10,3,64,21,6,6,206,36
217,11,4,2,7,6,43,-76,9,0,249,-40
217,12,2,6,4,9,-78,63,1,3,171,23
217,13,6,2,10,3,64,21,5,4,235,44
217,14,3,3,6,7,33,34,8,8,268,78
217,15,3,4,4,9,31,-55,9,3,299,23
217,16,3,5,6,7,-67,52,2,5,232,75
217,17,2,5,3,10,21,-45,3,0,253,30
217,18,5,2,7,6,52,24,5,4,305,54
217,19,2,4,7,6,-75,42,0,6,230,96
217,20,4,3,9,4,45,31,5,7,275,127
217,21,3,3,7,6,34,-67,9,0,309,60
217,22,3,4,7,6,-66,42,3,2,243,102
217,23,3,3,4,9,31,36,4,8,274,138
217,24,3,4,5,8,32,-56,6,2,306,82
217,25,2,4,4,9,22,45,8,7,328,127
217,26,2,4,3,10,21,-54,9,3,349,73
217,27,3,3,8,5,-65,32,4,5,284,105
217,28,4,2,6,7,42,-75,6,0,326,30
217,29,4,2,11,2,-53,20,3,0,273,50
217,30,4,3,9,4,45,31,8,1,318,81
217,31,3,4,5,8,-68,44,0,5,250,125
217,32,2,4,5,8,23,44,3,9,273,169
217,33,2,4,6,7,24,-57,7,2,297,112
217,34,3,4,7,6,-66,42,1,4,231,154
217,35,5,3,9,4,54,31,5,5,285,185
217,36,4,3,8,5,44,32,9,7,329,217
217,37,3,4,5,8,-68,-56,1,1,261,161
217,38,2,4,5,8,23,44,4,5,284,205
217,39,5,2,7,6,52,24,6,9,336,229
217,40,2,4,4,9,22,-55,8,4,358,174
217,41,3,4,6,7,-67,43,1,7,291,217
217,42,2,4,3,10,21,-54,2,3,312,163
217,43,3,4,8,5,35,41,7,4,347,204
217,44,3,3,8,5,-65,32,2,6,282,236
217,45,4,2,11,2,47,20,9,6,329,256
217,46,2,4,6,7,-76,43,3,9,253,299
217,47,3,4,6,7,33,-57,6,2,286,242
217,48,4,3,8,5,-56,32,0,4,230,274
217,49,3,4,4,9,31,45,1,9,261,319
217,50,4,3,7,6,43,-67,4,2,304,252
217,51,4,3,7,6,43,33,7,5,347,285
217,52,3,3,7,6,-66,33,1,8,281,318
217,53,4,2,8,5,44,-77,5,1,325,241
217,54,3,4,5,8,32,44,7,5,357,285
217,55,2,4,4,9,22,-55,9,0,379,230
217,56,3,3,6,7,-67,34,2,4,312,264
217,57,4,3,8,5,44,32,6,6,356,296
217,58,3,4,6,7,33,43,9,9,389,339
217,59,3,3,5,8,-68,-65,1,4,321,274
217,60,2,5,5,8,23,53,4,7,344,327
217,61,4,3,8,5,44,32,8,9,388,359
217,62,3,3,6,7,-67,-66,1,3,321,293
217,63,5,2,10,3,55,21,6,4,376,314
217,64,4,3,9,4,-55,31,1,5,321,345
217,65,4,3,10,3,46,30,7,5,367,375
217,66,3,4,3,10,30,-54,7,1,397,321
217,67,5,2,7,6,52,24,9,5,449,345
217,68,4,3,8,5,-56,32,3,7,393,377
217,69,4,4,7,6,43,42,6,9,436,419
217,70,4,3,6,7,42,-66,8,3,478,353
217,71,4,3,8,5,-56,32,2,5,422,385
217,72,3,3,4,9,31,-64,3,1,453,321
217,73,5,2,10,3,55,21,8,2,508,342
218,1,2,4,3,10,21,46,1,6,21,46
218,2,2,5,3,10,21,-45,2,1,42,1
218,3,2,5,4,9,22,54,4,5,64,55
218,4,5,2,9,4,54,22,8,7,118,77
218,5,5,2,8,5,-47,-77,1,0,71,0
218,6,4,3,8,5,44,32,5,2,115,32
218,7,3,4,3,10,30,46,5,8,145,78
218,8,5,2,10,3,-45,21,0,9,100,99
218,9,2,4,4,9,22,-55,2,4,122,44
218,10,3,4,5,8,32,44,4,8,154,88
218,11,4,3,8,5,44,-68,8,0,198,20
218,12,3,3,8,5,-65,32,3,2,133,52
218,13,3,4,7,6,34,42,7,4,167,94
218,14,2,4,7,6,-75,42,2,6,92,136
218,15,3,3,6,7,33,-66,5,0,125,70
218,16,2,5,5,8,23,53,8,3,148,123
218,17,2,5,3,10,21,55,9,8,169,178
218,18,6,2,10,3,-36,21,3,9,133,199
218,19,4,2,8,5,44,-77,7,2,177,122
218,20,2,5,3,10,21,55,8,7,198,177
218,21,2,4,7,6,-75,42,3,9,123,219
218,22,5,2,6,7,51,-75,4,4,174,144
218,23,5,2,9,4,54,22,8,6,228,166
218,24,4,3,8,5,-56,32,2,8,172,198
218,25,3,3,7,6,34,-67,6,1,206,131
218,26,5,2,11,2,-44,20,2,1,162,151
218,27,5,2,7,6,52,24,4,5,214,175
218,28,3,4,6,7,33,43,7,8,247,218
218,29,3,4,6,7,-67,-57,0,1,180,161
218,30,3,3,6,7,33,34,3,5,213,195
218,31,2,6,2,11,20,-35,3,0,233,160
218,32,3,3,7,6,34,33,7,3,267,193
218,33,2,5,3,10,21,55,8,8,288,248
218,34,3,4,5,8,-68,-56,0,2,220,192
218,35,3,3,5,8,32,35,2,7,252,227
218,36,4,3,9,4,45,31,7,8,297,258
218,37,3,4,5,8,32,-56,9,2,329,202
218,38,3,3,5,8,-68,35,1,7,261,237
218,39,4,3,8,5,44,32,5,9,305,269
218,40,3,3,6,7,33,-66,8,3,338,203
218,41,4,2,8,5,-56,23,2,6,282,226
218,42,2,4,6,7,24,43,6,9,306,269
218,43,2,4,8,5,-74,-59,2,0,232,210
218,44,2,5,6,7,24,52,6,2,256,262
218,45,5,2,9,4,-46,22,0,4,210,284
218,46,4,2,9,4,45,22,5,6,255,306
218,47,4,3,7,6,43,33,8,9,298,339
218,48,2,5,3,10,21,-45,9,4,319,294
218,49,3,5,8,5,-65,50,4,4,254,344
218,50,3,3,8,5,35,32,9,6,289,376
218,51,3,3,9,4,-64,31,5,7,225,407
218,52,3,3,5,8,32,-65,7,2,257,342
218,53,3,5,5,8,32,53,9,5,289,395
218,54,2,5,3,10,-79,-45,0,0,210,350
218,55,2,5,3,10,21,55,1,5,231,405
218,56,3,4,4,9,31,-55,2,0,262,350
218,57,4,3,5,8,41,35,3,5,303,385
218,58,3,3,9,4,36,31,9,6,339,416
218,59,2,4,3,10,-79,-54,0,2,260,362
218,60,5,2,7,6,52,24,2,6,312,386
218,61,3,4,4,9,31,-55,3,1,343,331
218,62,3,3,7,6,34,33,7,4,377,364
218,63,3,3,4,9,31,-64,8,0,408,300
218,64,4,3,7,6,-57,33,1,3,351,333
218,65,3,3,6,7,33,34,4,7,384,367
218,66,2,6,5,8,23,62,7,9,407,429
218,67,2,4,4,9,22,-55,9,4,429,374
218,68,4,3,7,6,-57,33,2,7,372,407
218,69,3,4,9,4,36,40,8,7,408,447
218,70,4,2,7,6,-57,-76,1,1,351,371
218,71,5,2,11,2,56,20,7,1,407,391
218,72,5,2,10,3,-45,21,2,2,362,412
218,73,3,3,3,10,30,37,2,9,392,449
218,74,3,3,5,8,32,-65,4,4,424,384
218,75,4,3,7,6,43,33,7,7,467,417
218,76,3,4,8,5,-65,41,2,8,402,458
218,77,4,2,8,5,44,-77,6,1,446,381
218,78,2,4,6,7,-76,43,0,4,370,424
218,79,3,3,4,9,31,-64,1,0,401,360
218,80,3,3,4,9,31,36,2,6,432,396
218,81,3,3,7,6,34,33,6,9,466,429
218,82,2,4,8,5,-74,-59,2,0,392,370
218,83,4,3,8,5,44,32,6,2,436,402
218,84,4,3,7,6,43,33,9,5,479,435
218,85,3,4,4,9,-69,-55,0,0,410,380
218,86,2,5,3,10,21,55,1,5,431,435
218,87,4,3,6,7,42,34,3,9,473,469
218,88,2,4,6,7,24,-57,7,2,497,412
218,89,3,3,9,4,-64,31,3,3,433,443
218,90,4,4,7,6,43,42,6,5,476,485
218,91,2,5,5,8,23,53,9,8,499,538
219,1,3,3,8,5,35,32,5,2,35,32
219,2,4,3,3,10,-40,37,5,9,-5,69
219,3,2,4,7,6,-75,-58,0,1,-80,11
219,4,4,2,8,5,44,23,4,4,-36,34
219,5,3,4,5,8,32,44,6,8,-4,78
219,6,4,2,7,6,43,-76,9,2,39,2
219,7,4,3,6,7,-58,34,1,6,-19,36
219,8,2,5,2,11,20,-44,1,2,1,-8
219,9,3,3,8,5,35,32,6,4,36,24
219,10,4,3,8,5,-56,32,0,6,-20,56
219,11,2,5,4,9,22,-46,2,0,2,10
219,12,2,4,6,7,24,43,6,3,26,53
219,13,4,2,9,4,-55,22,1,5,-29,75
219,14,3,4,3,10,30,-54,1,1,1,21
219,15,2,5,4,9,22,54,3,5,23,75
219,16,3,4,5,8,32,44,5,9,55,119
219,17,4,3,7,6,43,-67,8,2,98,52
219,18,3,3,8,5,-65,32,3,4,33,84
219,19,2,4,6,7,24,43,7,7,57,127
219,20,2,4,7,6,-75,42,2,9,-18,169
219,21,2,5,5,8,23,-47,5,2,5,122
219,22,2,4,5,8,23,44,8,6,28,166
219,23,4,2,5,8,41,-74,9,2,69,92
219,24,3,4,5,8,-68,44,1,6,1,136
219,25,4,2,7,6,43,-76,4,0,44,60
219,26,3,4,8,5,35,41,9,1,79,101
219,27,4,3,9,4,-55,31,4,2,24,132
219,28,4,2,9,4,45,22,9,4,69,154
219,29,4,3,4,9,40,-64,9,0,109,90
219,30,3,3,4,9,-69,36,0,6,40,126
219,31,2,5,4,9,22,-46,2,0,62,80
219,32,3,4,6,7,33,43,5,3,95,123
219,33,4,3,9,4,-55,31,0,4,40,154
219,34,4,4,5,8,41,44,1,8,81,198
219,35,3,4,6,7,33,-57,4,1,114,141
219,36,5,2,10,3,55,21,9,2,169,162
219,37,4,3,9,4,-55,31,4,3,114,193
219,38,3,3,10,3,-63,30,1,3,51,223
219,39,4,3,6,7,42,34,3,7,93,257
219,40,4,3,5,8,41,-65,4,2,134,192
219,41,2,5,6,7,24,52,8,4,158,244
219,42,3,3,6,7,-67,34,1,8,91,278
219,43,4,2,6,7,42,-75,3,3,133,203
219,44,4,2,10,3,46,21,9,4,179,224
219,45,2,4,5,8,-77,44,2,8,102,268
219,46,3,4,7,6,34,-58,6,0,136,210
219,47,3,4,7,6,-66,42,0,2,70,252
219,48,3,3,7,6,34,33,4,5,104,285
219,49,2,4,5,8,23,44,7,9,127,329
219,50,2,4,4,9,22,-55,9,4,149,274
219,51,6,2,9,4,-37,22,2,6,112,296
219,52,2,5,5,8,23,53,5,9,135,349
219,53,4,3,5,8,41,-65,6,4,176,284
219,54,3,3,6,7,33,34,9,8,209,318
219,55,4,3,6,7,-58,-66,1,2,151,252
219,56,3,3,8,5,35,32,6,4,186,284
219,57,2,4,8,5,-74,41,2,5,112,325
219,58,2,5,4,9,22,54,4,9,134,379
219,59,3,3,9,4,-64,-69,0,0,70,310
219,60,4,3,7,6,43,33,3,3,113,343
219,61,4,3,8,5,44,32,7,5,157,375
219,62,4,2,8,5,-56,23,1,8,101,398
219,63,4,3,8,5,44,-68,5,0,145,330
219,64,3,4,6,7,33,43,8,3,178,373
219,65,2,5,3,10,21,55,9,8,199,428
219,66,5,2,9,4,-46,-78,3,0,153,350
219,67,4,2,9,4,45,22,8,2,198,372
219,68,2,4,6,7,-76,43,2,5,122,415
219,69,3,3,8,5,35,32,7,7,157,447
219,70,5,2,11,2,-44,20,3,7,113,467
219,71,3,3,7,6,34,-67,7,0,147,400
219,72,3,4,4,9,31,45,8,5,178,445
219,73,2,4,5,8,-77,44,1,9,101,489
219,74,4,2,9,4,45,-78,6,1,146,411
219,75,3,3,7,6,-66,33,0,4,80,444
219,76,3,4,7,6,34,42,4,6,114,486
219,77,3,3,7,6,34,33,8,9,148,519
220,1,2,4,5,8,23,44,3,4,23,44
220,2,2,4,4,9,22,45,5,9,45,89
220,3,3,3,6,7,33,-66,8,3,78,23
220,4,5,3,8,5,-47,32,1,5,31,55
220,5,2,4,5,8,23,44,4,9,54,99
220,6,2,5,3,10,21,-45,5,4,75,54
220,7,3,4,7,6,34,42,9,6,109,96
220,8,4,2,8,5,-56,23,3,9,53,119
220,9,3,3,6,7,33,-66,6,3,86,53
220,10,4,3,10,3,-54,30,2,3,32,83
220,11,4,3,7,6,43,33,5,6,75,116
220,12,2,4,6,7,24,43,9,9,99,159
220,13,3,3,6,7,-67,-66,2,3,32,93
220,14,3,4,7,6,34,42,6,5,66,135
220,15,4,2,8,5,-56,23,0,8,10,158
220,16,4,2,8,5,44,-77,4,1,54,81
220,17,4,3,7,6,43,33,7,4,97,114
220,18,3,3,6,7,-67,34,0,8,30,148
220,19,5,2,8,5,53,-77,3,1,83,71
220,20,2,4,7,6,25,42,8,3,108,113
220,21,3,4,6,7,-67,43,1,6,41,156
220,22,3,3,7,6,34,33,5,9,75,189
220,23,5,2,9,4,54,-78,9,1,129,111
220,24,3,4,7,6,-66,42,3,3,63,153
220,25,3,4,8,5,35,41,8,4,98,194
220,26,4,3,8,5,-56,32,2,6,42,226
220,27,3,4,4,9,31,-55,3,1,73,171
220,28,4,2,9,4,45,22,8,3,118,193
220,29,3,3,8,5,-65,32,3,5,53,225
220,30,2,5,5,8,23,53,6,8,76,278
220,31,4,2,9,4,-55,-78,1,0,21,200
220,32,3,3,10,3,37,30,8,0,58,230
220,33,3,4,6,7,-67,43,1,3,-9,273
220,34,3,3,7,6,34,33,5,6,25,306
220,35,2,4,2,11,20,-53,5,3,45,253
220,36,3,4,7,6,34,42,9,5,79,295
220,37,3,3,6,7,-67,34,2,9,12,329
220,38,5,2,9,4,54,-78,6,1,66,251
220,39,2,5,6,7,-76,52,0,3,-10,303
220,40,4,2,8,5,44,23,4,6,34,326
220,41,2,4,5,8,23,-56,7,0,57,270
220,42,3,4,5,8,32,44,9,4,89,314
220,43,4,2,7,6,-57,24,2,8,32,338
220,44,4,2,9,4,45,-78,7,0,77,260
220,45,2,4,4,9,22,45,9,5,99,305
220,46,4,3,4,9,40,-64,9,1,139,241
220,47,4,2,8,5,-56,23,3,4,83,264
220,48,3,3,9,4,36,31,9,5,119,295
220,49,5,2,9,4,-46,22,3,7,73,317
220,50,3,3,6,7,33,-66,6,1,106,251
220,51,3,4,6,7,33,43,9,4,139,294
220,52,3,3,6,7,-67,34,2,8,72,328
220,53,2,4,7,6,25,-58,7,0,97,270
220,54,5,2,7,6,52,24,9,4,149,294
220,55,2,4,5,8,-77,44,2,8,72,338
220,56,3,4,5,8,32,-56,4,2,104,282
220,57,4,3,7,6,43,33,7,5,147,315
220,58,4,2,6,7,42,-75,9,0,189,240
220,59,5,2,9,4,-46,22,3,2,143,262
220,60,3,4,6,7,33,43,6,5,176,305
220,61,5,2,10,3,-45,21,1,6,131,326
220,62,4,2,7,6,43,-76,4,0,174,250
220,63,3,4,3,10,30,46,4,6,204,296
220,64,6,2,11,2,65,20,9,6,269,316
220,65,3,3,8,5,-65,32,4,8,204,348
220,66,3,3,3,10,30,-63,4,5,234,285
220,67,2,5,5,8,23,53,7,8,257,338
220,68,3,3,6,7,-67,-66,0,2,190,272
220,69,4,4,8,5,44,41,4,3,234,313
220,70,3,4,6,7,33,43,7,6,267,356
220,71,4,4,7,6,-57,42,0,8,210,398
220,72,4,2,5,8,41,-74,1,4,251,324
220,73,2,5,4,9,22,54,3,8,273,378
220,74,3,3,8,5,35,-68,8,0,308,310
220,75,4,3,9,4,-55,31,3,1,253,341
220,76,4,2,9,4,45,22,8,3,298,363
220,77,4,3,8,5,-56,32,2,5,242,395
220,78,3,3,9,4,36,31,8,6,278,426
220,79,3,3,8,5,-65,32,3,8,213,458
220,80,2,5,3,10,21,-45,4,3,234,413
220,81,3,3,7,6,34,33,8,6,268,446
220,82,2,4,4,9,-78,-55,0,1,190,391
220,83,2,5,3,10,21,55,1,6,211,446
220,84,3,5,6,7,33,52,4,8,244,498
220,85,2,4,5,8,23,-56,7,2,267,442
220,86,3,3,7,6,-66,33,1,5,201,475
220,87,3,3,6,7,33,34,4,9,234,509
221,1,4,3,10,3,46,30,6,0,46,30
221,2,3,3,6,7,33,34,9,4,79,64
221,3,4,3,7,6,-57,33,2,7,22,97
221,4,4,3,10,3,46,30,8,7,68,127
221,5,2,5,5,8,-77,-47,1,0,-9,80
221,6,3,3,7,6,34,33,5,3,25,113
221,7,4,3,8,5,44,32,9,5,69,145
221,8,3,3,7,6,-66,33,3,8,3,178
221,9,5,2,9,4,54,-78,7,0,57,100
221,10,4,2,9,4,-55,22,2,2,2,122
221,11,2,5,2,11,20,56,2,8,22,178
221,12,2,5,4,9,22,-46,4,2,44,132
221,13,4,3,5,8,41,35,5,7,85,167
221,14,5,2,11,2,-44,20,1,7,41,187
221,15,3,3,7,6,34,-67,5,0,75,120
221,16,3,3,8,5,-65,32,0,2,10,152
221,17,2,5,3,10,21,55,1,7,31,207
221,18,4,3,7,6,43,-67,4,0,74,140
221,19,3,4,6,7,33,43,7,3,107,183
221,20,2,5,3,10,21,55,8,8,128,238
221,21,4,2,7,6,-57,-76,1,2,71,162
221,22,4,3,7,6,43,33,4,5,114,195
221,23,3,4,8,5,35,41,9,6,149,236
221,24,3,4,5,8,-68,-56,1,0,81,180
221,25,3,5,8,5,35,50,6,0,116,230
221,26,4,2,9,4,-55,22,1,2,61,252
221,27,3,4,3,10,30,46,1,8,91,298
221,28,3,3,7,6,34,-67,5,1,125,231
221,29,4,3,5,8,41,35,6,6,166,266
221,30,2,4,7,6,-75,42,1,8,91,308
221,31,4,3,6,7,42,-66,3,2,133,242
221,32,3,4,5,8,32,44,5,6,165,286
221,33,5,2,7,6,52,-76,7,0,217,210
221,34,4,3,8,5,-56,32,1,2,161,242
221,35,4,3,8,5,44,32,5,4,205,274
221,36,4,2,8,5,44,23,9,7,249,297
221,37,2,5,2,11,20,-44,9,3,269,253
221,38,2,5,4,9,-78,54,1,7,191,307
221,39,4,3,7,6,43,-67,4,0,234,240
221,40,4,2,6,7,42,25,6,5,276,265
221,41,4,3,7,6,43,33,9,8,319,298
221,42,2,4,3,10,-79,-54,0,4,240,244
221,43,4,3,5,8,41,35,1,9,281,279
221,44,2,5,4,9,22,-46,3,3,303,233
221,45,2,5,6,7,24,52,7,5,327,285
221,46,2,5,4,9,22,54,9,9,349,339
221,47,4,4,7,6,-57,-58,2,1,292,281
221,48,3,4,5,8,32,44,4,5,324,325
221,49,2,5,2,11,20,-44,4,1,344,281
221,50,3,3,7,6,34,33,8,4,378,314
221,51,4,3,9,4,-55,31,3,5,323,345
221,52,2,5,3,10,21,-45,4,0,344,300
221,53,4,3,7,6,43,33,7,3,387,333
221,54,4,3,8,5,-56,32,1,5,331,365
221,55,4,2,10,3,46,21,7,6,377,386
221,56,4,3,6,7,42,-66,9,0,419,320
221,57,2,4,6,7,-76,43,3,3,343,363
221,58,3,3,9,4,36,31,9,4,379,394
221,59,3,4,7,6,-66,42,3,6,313,436
221,60,5,2,7,6,52,-76,5,0,365,360
221,61,2,4,4,9,22,45,7,5,387,405
221,62,2,4,4,9,22,-55,9,0,409,350
221,63,3,3,3,10,30,37,9,7,439,387
221,64,3,4,6,7,-67,-57,2,0,372,330
221,65,2,4,6,7,24,43,6,3,396,373
221,66,3,3,5,8,32,35,8,8,428,408
221,67,3,4,6,7,-67,-57,1,1,361,351
221,68,3,4,7,6,34,42,5,3,395,393
221,69,5,2,10,3,-45,21,0,4,350,414
221,70,3,3,4,9,31,-64,1,0,381,350
221,71,3,4,4,9,31,45,2,5,412,395
221,72,5,3,8,5,53,32,5,7,465,427
221,73,3,3,5,8,32,-65,7,2,497,362
221,74,3,3,8,5,-65,32,2,4,432,394
221,75,4,2,9,4,45,22,7,6,477,416
221,76,4,3,8,5,-56,32,1,8,421,448
221,77,3,5,5,8,32,-47,3,1,453,401
221,78,3,3,8,5,35,32,8,3,488,433
221,79,2,5,4,9,-78,54,0,7,410,487
221,80,2,4,5,8,23,-56,3,1,433,431
221,81,3,3,6,7,33,34,6,5,466,465
221,82,5,3,9,4,-46,31,0,6,420,496
221,83,4,2,9,4,45,22,5,8,465,518
222,1,3,3,5,8,32,35,2,5,32,35
222,2,3,4,6,7,33,43,5,8,65,78
222,3,2,5,5,8,23,-47,8,1,88,31
222,4,4,2,7,6,-57,24,1,5,31,55
222,5,4,3,7,6,43,33,4,8,74,88
222,6,3,4,7,6,34,-58,8,0,108,30
222,7,3,3,7,6,-66,33,2,3,42,63
222,8,4,2,7,6,43,24,5,7,85,87
222,9,2,4,3,10,21,-54,6,3,106,33
222,10,4,3,7,6,43,33,9,6,149,66
222,11,3,3,9,4,-64,31,5,7,85,97
222,12,4,2,8,5,44,-77,9,0,129,20
222,13,5,2,9,4,-46,22,3,2,83,42
222,14,4,2,8,5,44,23,7,5,127,65
222,15,2,4,5,8,-77,44,0,9,50,109
222,16,3,3,7,6,34,-67,4,2,84,42
222,17,4,3,5,8,41,35,5,7,125,77
222,18,3,4,7,6,34,42,9,9,159,119
222,19,5,2,9,4,-46,-78,3,1,113,41
222,20,3,3,9,4,36,31,9,2,149,72
222,21,4,3,8,5,-56,32,3,4,93,104
222,22,4,3,8,5,44,32,7,6,137,136
222,23,3,4,4,9,31,-55,8,1,168,81
222,24,4,2,6,7,-58,25,0,6,110,106
222,25,3,4,6,7,33,43,3,9,143,149
222,26,2,4,3,10,21,-54,4,5,164,95
222,27,4,2,8,5,44,23,8,8,208,118
222,28,2,4,8,5,-74,41,4,9,134,159
222,29,3,4,4,9,31,-55,5,4,165,104
222,30,5,2,9,4,54,22,9,6,219,126
222,31,5,3,7,6,-48,33,1,9,171,159
222,32,5,2,7,6,52,-76,3,3,223,83
222,33,2,5,4,9,22,54,5,7,245,137
222,34,4,3,7,6,43,-67,8,0,288,70
222,35,5,2,7,6,-48,24,0,4,240,94
222,36,3,3,6,7,33,34,3,8,273,128
222,37,4,2,8,5,44,-77,7,1,317,51
222,38,4,3,6,7,42,34,9,5,359,85
222,39,3,4,4,9,-69,-55,0,0,290,30
222,40,4,2,8,5,44,23,4,3,334,53
222,41,3,3,6,7,33,34,7,7,367,87
222,42,4,2,9,4,-55,22,2,9,312,109
222,43,5,2,9,4,54,-78,6,1,366,31
222,44,4,2,10,3,-54,21,2,2,312,52
222,45,4,3,9,4,45,31,7,3,357,83
222,46,6,2,9,4,-37,22,0,5,320,105
222,47,3,5,3,10,30,-45,0,0,350,60
222,48,3,4,4,9,31,45,1,5,381,105
222,49,3,4,5,8,32,44,3,9,413,149
222,50,2,5,3,10,21,-45,4,4,434,104
222,51,4,3,6,7,42,34,6,8,476,138
222,52,5,2,11,2,-44,20,2,8,432,158
222,53,3,4,7,6,34,-58,6,0,466,100
222,54,3,4,6,7,33,43,9,3,499,143
222,55,5,2,8,5,-47,23,2,6,452,166
222,56,3,3,7,6,34,33,6,9,486,199
222,57,4,3,7,6,43,-67,9,2,529,132
223,1,4,3,8,5,44,32,4,2,44,32
223,2,3,3,4,9,31,36,5,8,75,68
223,3,3,3,8,5,-65,-68,0,0,10,0
223,4,4,2,6,7,42,25,2,5,52,25
223,5,3,3,9,4,36,31,8,6,88,56
223,6,4,2,9,4,-55,22,3,8,33,78
223,7,3,3,7,6,34,-67,7,1,67,11
223,8,5,2,10,3,-45,21,2,2,22,32
223,9,3,4,5,8,32,44,4,6,54,76
223,10,4,3,7,6,43,33,7,9,97,109
223,11,4,2,9,4,-55,-78,2,1,42,31
223,12,3,3,9,4,36,31,8,2,78,62
223,13,3,4,3,10,30,46,8,8,108,108
223,14,2,4,5,8,-77,-56,1,2,31,52
223,15,3,3,8,5,35,32,6,4,66,84
223,16,5,2,9,4,-46,22,0,6,20,106
223,17,4,3,7,6,43,33,3,9,63,139
223,18,2,4,6,7,24,-57,7,2,87,82
223,19,2,5,6,7,-76,52,1,4,11,134
223,20,4,2,6,7,42,25,3,9,53,159
223,21,3,3,7,6,34,-67,7,2,87,92
223,22,2,5,2,11,20,56,7,8,107,148
223,23,4,3,9,4,-55,31,2,9,52,179
223,24,4,3,9,4,45,-69,7,0,97,110
223,25,4,3,10,3,-54,30,3,0,43,140
223,26,4,3,6,7,42,34,5,4,85,174
223,27,3,4,5,8,32,44,7,8,117,218
223,28,3,3,5,8,32,-65,9,3,149,153
223,29,4,4,7,6,-57,42,2,5,92,195
223,30,2,6,2,11,20,-35,2,0,112,160
223,31,4,3,8,5,44,32,6,2,156,192
223,32,3,4,6,7,33,43,9,5,189,235
223,33,2,4,8,5,-74,41,5,6,115,276
223,34,3,3,4,9,31,-64,6,2,146,212
223,35,3,4,3,10,30,46,6,8,176,258
223,36,3,3,5,8,32,-65,8,3,208,193
223,37,3,3,4,9,31,36,9,9,239,229
223,38,4,2,10,3,-54,-79,5,0,185,150
223,39,3,3,8,5,-65,32,0,2,120,182
223,40,2,5,4,9,22,54,2,6,142,236
223,41,3,3,8,5,35,32,7,8,177,268
223,42,3,3,8,5,-65,-68,2,0,112,200
223,43,3,3,8,5,35,32,7,2,147,232
223,44,3,4,4,9,31,45,8,7,178,277
223,45,2,5,4,9,-78,-46,0,1,100,231
223,46,2,4,3,10,21,46,1,7,121,277
223,47,2,5,3,10,21,-45,2,2,142,232
223,48,4,3,8,5,44,32,6,4,186,264
223,49,4,3,7,6,43,33,9,7,229,297
223,50,2,4,7,6,-75,42,4,9,154,339
223,51,2,4,5,8,23,-56,7,3,177,283
223,52,4,3,7,6,-57,33,0,6,120,316
223,53,2,5,6,7,24,52,4,8,144,368
223,54,3,3,7,6,34,-67,8,1,178,301
223,55,4,3,7,6,-57,33,1,4,121,334
223,56,4,2,9,4,45,22,6,6,166,356
223,57,4,3,7,6,43,33,9,9,209,389
223,58,4,3,8,5,-56,-68,3,1,153,321
223,59,2,4,7,6,25,42,8,3,178,363
223,60,3,4,3,10,30,46,8,9,208,409
223,61,4,3,9,4,-55,-69,3,0,153,340
223,62,4,3,8,5,44,32,7,2,197,372
223,63,5,2,7,6,52,24,9,6,249,396
223,64,3,4,6,7,-67,43,2,9,182,439
223,65,4,2,9,4,45,-78,7,1,227,361
223,66,3,3,7,6,-66,33,1,4,161,394
223,67,3,5,4,9,31,54,2,8,192,448
223,68,3,3,7,6,34,-67,6,1,226,381
223,69,3,4,5,8,32,44,8,5,258,425
223,70,4,2,6,7,-58,-75,0,0,200,350
223,71,3,4,6,7,33,43,3,3,233,393
223,72,3,3,5,8,32,35,5,8,265,428
223,73,4,2,7,6,43,-76,8,2,308,352
223,74,3,3,6,7,-67,34,1,6,241,386
223,75,4,3,10,3,46,30,7,6,287,416
223,76,3,3,5,8,32,-65,9,1,319,351
223,77,3,3,7,6,-66,33,3,4,253,384
223,78,4,3,5,8,41,35,4,9,294,419
223,79,4,3,9,4,45,-69,9,0,339,350
223,80,5,2,9,4,-46,22,3,2,293,372
223,81,3,4,6,7,33,43,6,5,326,415
223,82,3,4,8,5,-65,41,1,6,261,456
223,83,4,3,7,6,43,33,4,9,304,489
223,84,4,2,9,4,45,-78,9,1,349,411
223,85,4,3,9,4,-55,31,4,2,294,442
223,86,5,2,8,5,53,23,7,5,347,465
223,87,4,2,8,5,-56,23,1,8,291,488
223,88,2,5,3,10,21,-45,2,3,312,443
223,89,5,2,7,6,52,24,4,7,364,467
223,90,3,4,6,7,33,-57,7,0,397,410
223,91,3,4,5,8,32,44,9,4,429,454
223,92,4,2,7,6,-57,24,2,8,372,478
223,93,3,4,4,9,31,-55,3,3,403,423
223,94,3,3,5,8,32,35,5,8,435,458
223,95,3,4,7,6,34,-58,9,0,469,400
223,96,4,2,10,3,-54,21,5,1,415,421
223,97,3,4,7,6,34,42,9,3,449,463
223,98,6,2,7,6,-39,24,0,7,410,487
223,99,5,2,8,5,53,-77,3,0,463,410
223,100,3,3,8,5,35,32,8,2,498,442
223,101,4,3,8,5,-56,32,2,4,442,474
223,102,4,3,4,9,40,-64,2,0,482,410
223,103,3,3,4,9,31,36,3,6,513,446
224,1,4,2,9,4,45,22,5,2,45,22
224,2,2,4,3,10,21,46,6,8,66,68
224,3,3,3,6,7,33,-66,9,2,99,2
224,4,3,3,4,9,-69,36,0,8,30,38
224,5,3,3,7,6,34,-67,4,1,64,-29
224,6,3,4,6,7,33,43,7,4,97,14
224,7,4,4,8,5,-56,41,1,5,41,55
224,8,2,4,7,6,25,42,6,7,66,97
224,9,4,3,5,8,41,-65,7,2,107,32
224,10,2,4,6,7,-76,43,1,5,31,75
224,11,3,4,8,5,35,41,6,6,66,116
224,12,4,3,7,6,43,33,9,9,109,149
224,13,4,3,8,5,-56,-68,3,1,53,81
224,14,3,3,5,8,32,35,5,6,85,116
224,15,2,6,4,9,22,63,7,9,107,179
224,16,4,3,7,6,-57,-67,0,2,50,112
224,17,3,4,6,7,33,43,3,5,83,155
224,18,3,3,4,9,31,-64,4,1,114,91
224,19,3,3,5,8,32,35,6,6,146,126
224,20,5,2,9,4,-46,22,0,8,100,148
224,21,2,4,5,8,23,-56,3,2,123,92
224,22,2,5,3,10,21,55,4,7,144,147
224,23,3,3,6,7,33,-66,7,1,177,81
224,24,3,4,5,8,32,44,9,5,209,125
224,25,4,2,6,7,-58,-75,1,0,151,50
224,26,4,3,7,6,43,33,4,3,194,83
224,27,3,3,5,8,32,35,6,8,226,118
224,28,4,2,9,4,-55,-78,1,0,171,40
224,29,3,3,6,7,33,34,4,4,204,74
224,30,4,3,9,4,45,31,9,5,249,105
224,31,3,4,7,6,-66,42,3,7,183,147
224,32,4,3,10,3,46,30,9,7,229,177
224,33,2,5,2,11,20,-44,9,3,249,133
224,34,2,4,3,10,-79,46,0,9,170,179
224,35,4,2,9,4,45,-78,5,1,215,101
224,36,2,4,3,10,21,46,6,7,236,147
224,37,4,3,5,8,41,-65,7,2,277,82
224,38,4,3,7,6,-57,33,0,5,220,115
224,39,2,4,3,10,21,-54,1,1,241,61
224,40,5,2,7,6,52,24,3,5,293,85
224,41,4,3,8,5,44,32,7,7,337,117
224,42,4,3,4,9,40,-64,7,3,377,53
224,43,3,3,7,6,-66,33,1,6,311,86
224,44,4,3,8,5,44,32,5,8,355,118
224,45,4,3,7,6,43,-67,8,1,398,51
224,46,4,2,8,5,-56,23,2,4,342,74
224,47,2,5,3,10,21,55,3,9,363,129
224,48,4,2,10,3,46,-79,9,0,409,50
224,49,3,3,6,7,-67,34,2,4,342,84
224,50,4,3,6,7,42,34,4,8,384,118
224,51,4,3,7,6,43,-67,7,1,427,51
224,52,3,4,5,8,32,44,9,5,459,95
224,53,4,3,7,6,-57,33,2,8,402,128
224,54,4,3,9,4,45,31,7,9,447,159
224,55,3,4,5,8,32,-56,9,3,479,103
224,56,3,4,5,8,-68,44,1,7,411,147
224,57,3,4,6,7,33,-57,4,0,444,90
224,58,3,3,5,8,32,35,6,5,476,125
224,59,2,5,3,10,21,-45,7,0,497,80
224,60,3,3,5,8,32,35,9,5,529,115
225,1,2,4,5,8,23,44,3,4,23,44
225,2,3,4,8,5,35,41,8,5,58,85
225,3,4,2,9,4,-55,22,3,7,3,107
225,4,3,3,7,6,34,-67,7,0,37,40
225,5,3,3,5,8,32,35,9,5,69,75
225,6,2,4,7,6,-75,42,4,7,-6,117
225,7,3,4,8,5,35,41,9,8,29,158
225,8,4,2,5,8,-59,-74,0,4,-30,84
225,9,2,5,3,10,21,55,1,9,-9,139
225,10,3,5,4,9,31,-46,2,3,22,93
225,11,4,3,10,3,46,30,8,3,68,123
225,12,3,4,7,6,-66,42,2,5,2,165
225,13,4,2,5,8,41,-74,3,1,43,91
225,14,5,2,9,4,54,22,7,3,97,113
225,15,6,2,10,3,-36,21,1,4,61,134
225,16,4,3,7,6,43,33,4,7,104,167
225,17,2,4,9,4,-73,40,1,7,31,207
225,18,3,3,7,6,34,-67,5,0,65,140
225,19,2,4,6,7,24,43,9,3,89,183
225,20,4,3,6,7,-58,34,1,7,31,217
225,21,4,2,11,2,47,20,8,7,78,237
225,22,2,4,6,7,-76,-57,2,0,2,180
225,23,2,5,4,9,22,54,4,4,24,234
225,24,3,4,4,9,31,45,5,9,55,279
225,25,3,4,6,7,33,-57,8,2,88,222
225,26,2,4,4,9,-78,45,0,7,10,267
225,27,3,4,8,5,35,41,5,8,45,308
225,28,3,3,6,7,33,-66,8,2,78,242
225,29,4,2,8,5,-56,23,2,5,22,265
225,30,3,3,6,7,33,34,5,9,55,299
225,31,4,3,6,7,42,-66,7,3,97,233
225,32,2,5,3,10,21,55,8,8,118,288
225,33,3,4,5,8,-68,-56,0,2,50,232
225,34,3,4,5,8,32,44,2,6,82,276
225,35,5,2,9,4,54,22,6,8,136,298
225,36,3,5,6,7,33,-48,9,0,169,250
225,37,2,5,4,9,-78,54,1,4,91,304
225,38,3,4,5,8,32,44,3,8,123,348
225,39,3,3,8,5,35,-68,8,0,158,280
225,40,3,3,4,9,31,36,9,6,189,316
225,41,4,3,6,7,-58,-66,1,0,131,250
225,42,3,3,5,8,32,35,3,5,163,285
225,43,4,3,10,3,46,30,9,5,209,315
225,44,3,4,7,6,-66,42,3,7,143,357
225,45,2,4,4,9,22,-55,5,2,165,302
225,46,2,5,5,8,23,53,8,5,188,355
225,47,2,5,4,9,-78,54,0,9,110,409
225,48,4,2,7,6,43,-76,3,3,153,333
225,49,2,5,5,8,23,53,6,6,176,386
225,50,2,5,6,7,-76,52,0,8,100,438
225,51,2,6,2,11,20,-35,0,3,120,403
225,52,2,5,4,9,22,54,2,7,142,457
225,53,3,3,8,5,35,32,7,9,177,489
225,54,4,2,8,5,-56,-77,1,2,121,412
225,55,4,3,7,6,43,33,4,5,164,445
225,56,4,3,7,6,43,33,7,8,207,478
225,57,4,3,5,8,41,-65,8,3,248,413
225,58,4,3,4,9,40,36,8,9,288,449
225,59,2,4,7,6,-75,-58,3,1,213,391
225,60,4,3,9,4,45,31,8,2,258,422
225,61,4,2,5,8,41,26,9,8,299,448
225,62,2,4,8,5,-74,41,5,9,225,489
225,63,3,3,6,7,33,-66,8,3,258,423
225,64,4,3,7,6,-57,33,1,6,201,456
225,65,4,2,7,6,43,-76,4,0,244,380
225,66,4,2,11,2,-53,20,1,0,191,400
225,67,4,3,9,4,45,31,6,1,236,431
225,68,5,2,6,7,51,25,7,6,287,456
225,69,2,4,7,6,-75,42,2,8,212,498
225,70,3,4,5,8,32,-56,4,2,244,442
225,71,4,3,9,4,45,31,9,3,289,473
225,72,5,2,10,3,-45,21,4,4,244,494
225,73,4,3,6,7,42,34,6,8,286,528
226,1,5,2,10,3,55,21,5,1,55,21
226,2,5,2,10,3,-45,21,0,2,10,42
226,3,5,2,6,7,51,25,1,7,61,67
226,4,4,2,10,3,46,21,7,8,107,88
226,5,3,3,8,5,-65,-68,2,0,42,20
226,6,3,3,6,7,33,34,5,4,75,54
226,7,2,4,8,5,-74,41,1,5,1,95
226,8,3,3,6,7,33,34,4,9,34,129
226,9,3,4,3,10,30,-54,4,5,64,75
226,10,3,3,7,6,34,33,8,8,98,108
226,11,2,4,5,8,-77,-56,1,2,21,52
226,12,3,4,5,8,32,44,3,6,53,96
226,13,2,5,2,11,20,-44,3,2,73,52
226,14,4,4,6,7,42,43,5,5,115,95
226,15,2,4,3,10,21,-54,6,1,136,41
226,16,4,2,7,6,43,24,9,5,179,65
226,17,3,4,5,8,-68,44,1,9,111,109
226,18,3,4,6,7,33,-57,4,2,144,52
226,19,3,4,8,5,35,41,9,3,179,93
226,20,4,3,6,7,-58,34,1,7,121,127
226,21,2,5,6,7,24,52,5,9,145,179
226,22,3,3,6,7,33,-66,8,3,178,113
226,23,4,2,7,6,-57,24,1,7,121,137
226,24,3,4,5,8,32,-56,3,1,153,81
226,25,2,6,6,7,24,61,7,2,177,142
226,26,5,2,9,4,-46,22,1,4,131,164
226,27,3,4,7,6,34,42,5,6,165,206
226,28,4,2,5,8,41,-74,6,2,206,132
226,29,5,2,10,3,-45,21,1,3,161,153
226,30,3,4,7,6,34,42,5,5,195,195
226,31,4,3,7,6,43,33,8,8,238,228
226,32,3,3,5,8,-68,-65,0,3,170,163
226,33,3,3,6,7,33,34,3,7,203,197
226,34,2,5,6,7,24,52,7,9,227,249
226,35,3,3,8,5,-65,-68,2,1,162,181
226,36,6,2,11,2,65,20,7,1,227,201
226,37,2,5,5,8,-77,53,0,4,150,254
226,38,4,3,6,7,42,34,2,8,192,288
226,39,3,3,5,8,32,-65,4,3,224,223
226,40,2,5,4,9,22,54,6,7,246,277
226,41,4,3,8,5,-56,32,0,9,190,309
226,42,2,5,2,11,20,-44,0,5,210,265
226,43,2,5,4,9,22,54,2,9,232,319
226,44,3,4,4,9,31,-55,3,4,263,264
226,45,3,3,7,6,34,33,7,7,297,297
226,46,2,4,5,8,-77,-56,0,1,220,241
226,47,3,3,6,7,33,34,3,5,253,275
226,48,4,3,9,4,45,31,8,6,298,306
226,49,5,2,10,3,-45,21,3,7,253,327
226,50,4,2,8,5,44,-77,7,0,297,250
226,51,4,2,7,6,-57,24,0,4,240,274
226,52,4,3,9,4,45,31,5,5,285,305
226,53,2,5,6,7,24,52,9,7,309,357
226,54,3,3,9,4,-64,31,5,8,245,388
226,55,3,3,7,6,34,-67,9,1,279,321
226,56,3,3,6,7,-67,34,2,5,212,355
226,57,4,2,6,7,42,-75,4,0,254,280
226,58,3,3,8,5,35,32,9,2,289,312
226,59,3,3,9,4,-64,31,5,3,225,343
226,60,3,3,5,8,32,35,7,8,257,378
226,61,3,3,8,5,-65,-68,2,0,192,310
226,62,4,3,8,5,44,32,6,2,236,342
226,63,2,4,5,8,23,44,9,6,259,386
226,64,2,5,4,9,-78,-46,1,0,181,340
226,65,5,3,9,4,54,31,5,1,235,371
226,66,3,4,5,8,32,44,7,5,267,415
226,67,3,4,6,7,-67,43,0,8,200,458
226,68,4,3,7,6,43,-67,3,1,243,391
226,69,3,4,8,5,35,41,8,2,278,432
226,70,3,3,9,4,-64,31,4,3,214,463
226,71,4,2,10,3,-54,21,0,4,160,484
226,72,2,4,6,7,24,43,4,7,184,527
227,1,3,3,4,9,31,36,1,6,31,36
227,2,4,2,5,8,41,-74,2,2,72,-38
227,3,2,5,4,9,22,54,4,6,94,16
227,4,5,2,6,7,51,-75,5,1,145,-59
227,5,4,2,8,5,44,23,9,4,189,-36
227,6,3,4,6,7,-67,43,2,7,122,7
227,7,4,3,9,4,45,31,7,8,167,38
227,8,3,3,4,9,31,-64,8,4,198,-26
227,9,5,2,8,5,-47,23,1,7,151,-3
227,10,3,4,6,7,33,-57,4,0,184,-60
227,11,3,3,7,6,34,33,8,3,218,-27
227,12,3,3,6,7,-67,34,1,7,151,7
227,13,5,2,9,4,54,22,5,9,205,29
227,14,2,5,4,9,22,-46,7,3,227,-17
227,15,4,2,9,4,-55,22,2,5,172,5
227,16,4,3,6,7,42,34,4,9,214,39
227,17,3,3,9,4,-64,-69,0,0,150,-30
227,18,3,3,9,4,36,31,6,1,186,1
227,19,4,3,10,3,-54,30,2,1,132,31
227,20,3,3,8,5,35,32,7,3,167,63
227,21,2,4,5,8,-77,44,0,7,90,107
227,22,4,2,6,7,42,-75,2,2,132,32
227,23,2,4,4,9,22,45,4,7,154,77
227,24,4,3,8,5,44,32,8,9,198,109
227,25,4,3,10,3,-54,30,4,9,144,139
227,26,4,3,5,8,41,-65,5,4,185,74
227,27,5,2,11,2,-44,20,1,4,141,94
227,28,3,3,7,6,34,33,5,7,175,127
227,29,3,3,5,8,32,-65,7,2,207,62
227,30,2,4,7,6,-75,42,2,4,132,104
227,31,3,4,5,8,32,44,4,8,164,148
227,32,3,5,3,10,30,-45,4,3,194,103
227,33,3,4,7,6,34,42,8,5,228,145
227,34,3,3,8,5,-65,32,3,7,163,177
227,35,2,4,2,11,20,-53,3,4,183,124
227,36,2,4,7,6,25,42,8,6,208,166
227,37,5,2,10,3,-45,21,3,7,163,187
227,38,3,3,7,6,34,-67,7,0,197,120
227,39,2,5,3,10,21,55,8,5,218,175
227,40,3,4,4,9,31,-55,9,0,249,120
227,41,4,2,9,4,-55,22,4,2,194,142
227,42,2,4,6,7,24,43,8,5,218,185
227,43,3,3,6,7,-67,34,1,9,151,219
227,44,3,3,7,6,34,-67,5,2,185,152
227,45,3,3,6,7,33,34,8,6,218,186
227,46,3,3,5,8,-68,-65,0,1,150,121
227,47,3,3,6,7,33,34,3,5,183,155
227,48,4,3,8,5,44,32,7,7,227,187
227,49,3,3,7,6,-66,-67,1,0,161,120
227,50,5,2,10,3,55,21,6,1,216,141
227,51,3,4,7,6,-66,42,0,3,150,183
227,52,2,5,4,9,22,54,2,7,172,237
227,53,4,2,7,6,43,-76,5,1,215,161
227,54,3,3,6,7,33,34,8,5,248,195
227,55,2,5,4,9,-78,54,0,9,170,249
227,56,2,5,6,7,24,-48,4,1,194,201
227,57,3,3,5,8,32,35,6,6,226,236
227,58,3,3,5,8,32,-65,8,1,258,171
227,59,2,5,4,9,-78,54,0,5,180,225
227,60,4,3,7,6,43,33,3,8,223,258
227,61,3,3,6,7,33,-66,6,2,256,192
227,62,2,4,3,10,21,46,7,8,277,238
227,63,5,2,10,3,-45,21,2,9,232,259
227,64,3,3,4,9,31,-64,3,5,263,195
227,65,2,4,3,10,21,-54,4,1,284,141
227,66,3,4,6,7,33,43,7,4,317,184
227,67,4,3,7,6,-57,33,0,7,260,217
227,68,3,3,7,6,34,-67,4,0,294,150
227,69,4,3,9,4,45,31,9,1,339,181
227,70,2,5,2,11,20,56,9,7,359,237
227,71,3,4,5,8,-68,-56,1,1,291,181
227,72,4,3,8,5,44,32,5,3,335,213
227,73,4,2,6,7,42,25,7,8,377,238
227,74,2,5,4,9,22,-46,9,2,399,192
227,75,3,3,7,6,-66,33,3,5,333,225
227,76,3,4,6,7,33,43,6,8,366,268
227,77,6,2,9,4,63,-78,9,0,429,190
227,78,5,2,10,3,-45,21,4,1,384,211
227,79,3,3,9,4,-64,31,0,2,320,242
227,80,2,4,4,9,22,45,2,7,342,287
227,81,3,4,5,8,32,-56,4,1,374,231
227,82,3,3,7,6,34,33,8,4,408,264
227,83,4,3,7,6,-57,33,1,7,351,297
227,84,2,4,4,9,22,-55,3,2,373,242
227,85,5,2,10,3,55,21,8,3,428,263
227,86,4,4,7,6,-57,42,1,5,371,305
227,87,4,3,7,6,43,33,4,8,414,338
227,88,3,4,6,7,33,-57,7,1,447,281
227,89,4,2,10,3,-54,21,3,2,393,302
227,90,3,3,6,7,33,34,6,6,426,336
227,91,3,3,7,6,-66,33,0,9,360,369
227,92,3,3,8,5,35,-68,5,1,395,301
227,93,3,3,5,8,32,35,7,6,427,336
227,94,2,5,4,9,22,-46,9,0,449,290
227,95,3,3,10,3,-63,30,6,0,386,320
227,96,2,4,7,6,-75,42,1,2,311,362
227,97,4,3,4,9,40,36,1,8,351,398
227,98,5,3,9,4,54,31,5,9,405,429
227,99,3,4,7,6,34,-58,9,1,439,371
227,100,4,4,6,7,-58,43,1,4,381,414
227,101,4,3,5,8,41,35,2,9,422,449
227,102,2,5,6,7,24,-48,6,1,446,401
227,103,4,3,8,5,-56,32,0,3,390,433
227,104,3,4,5,8,32,44,2,7,422,477
227,105,4,3,8,5,44,32,6,9,466,509
228,1,3,4,5,8,32,44,2,4,32,44
228,2,3,3,6,7,33,34,5,8,65,78
228,3,4,3,7,6,43,-67,8,1,108,11
228,4,2,5,6,7,-76,52,2,3,32,63
228,5,4,3,7,6,43,33,5,6,75,96
228,6,4,3,7,6,43,33,8,9,118,129
228,7,3,3,4,9,31,-64,9,5,149,65
228,8,2,5,2,11,20,-44,9,1,169,21
228,9,4,2,10,3,-54,21,5,2,115,42
228,10,3,3,7,6,34,33,9,5,149,75
228,11,5,2,10,3,-45,21,4,6,104,96
228,12,3,3,5,8,32,-65,6,1,136,31
228,13,3,5,5,8,32,53,8,4,168,84
228,14,6,2,10,3,-36,21,2,5,132,105
228,15,2,4,5,8,23,44,5,9,155,149
228,16,3,5,4,9,31,-46,6,3,186,103
228,17,4,3,7,6,43,33,9,6,229,136
228,18,3,4,5,8,-68,-56,1,0,161,80
228,19,2,4,7,6,25,42,6,2,186,122
228,20,4,2,8,5,-56,23,0,5,130,145
228,21,2,5,4,9,22,54,2,9,152,199
228,22,5,2,9,4,54,-78,6,1,206,121
228,23,3,4,6,7,33,43,9,4,239,164
228,24,5,2,10,3,-45,21,4,5,194,185
228,25,3,3,4,9,31,-64,5,1,225,121
228,26,3,4,6,7,33,43,8,4,258,164
228,27,4,3,8,5,-56,32,2,6,202,196
228,28,4,2,9,4,45,22,7,8,247,218
228,29,3,3,6,7,-67,-66,0,2,180,152
228,30,4,3,6,7,42,34,2,6,222,186
228,31,5,3,9,4,54,31,6,7,276,217
228,32,2,5,5,8,23,-47,9,0,299,170
228,33,4,2,10,3,-54,21,5,1,245,191
228,34,4,3,9,4,-55,31,0,2,190,222
228,35,4,2,7,6,43,24,3,6,233,246
228,36,4,3,6,7,42,-66,5,0,275,180
228,37,3,4,4,9,31,45,6,5,306,225
228,38,3,3,7,6,-66,33,0,8,240,258
228,39,3,3,7,6,34,-67,4,1,274,191
228,40,2,5,3,10,21,55,5,6,295,246
228,41,3,3,4,9,31,-64,6,2,326,182
228,42,4,4,6,7,42,43,8,5,368,225
228,43,3,4,6,7,-67,43,1,8,301,268
228,44,4,3,8,5,44,-68,5,0,345,200
228,45,4,3,6,7,42,34,7,4,387,234
228,46,3,3,8,5,-65,32,2,6,322,266
228,47,3,3,5,8,32,-65,4,1,354,201
228,48,4,3,7,6,43,33,7,4,397,234
228,49,2,4,6,7,-76,43,1,7,321,277
228,50,2,4,5,8,23,-56,4,1,344,221
228,51,4,4,6,7,42,43,6,4,386,264
228,52,3,4,6,7,33,43,9,7,419,307
228,53,4,3,9,4,-55,31,4,8,364,338
228,54,3,4,4,9,31,-55,5,3,395,283
228,55,3,4,8,5,-65,41,0,4,330,324
228,56,3,3,5,8,32,35,2,9,362,359
228,57,3,3,6,7,33,-66,5,3,395,293
228,58,3,4,5,8,32,44,7,7,427,337
228,59,3,3,5,8,32,-65,9,2,459,272
228,60,4,2,9,4,-55,22,4,4,404,294
228,61,2,5,5,8,23,53,7,7,427,347
228,62,3,4,7,6,-66,42,1,9,361,389
228,63,4,3,8,5,44,-68,5,1,405,321
228,64,2,5,3,10,21,55,6,6,426,376
228,65,2,5,5,8,23,53,9,9,449,429
228,66,5,2,8,5,-47,-77,2,2,402,352
228,67,5,2,9,4,54,22,6,4,456,374
228,68,4,2,9,4,-55,22,1,6,401,396
228,69,4,2,9,4,45,22,6,8,446,418
228,70,4,3,10,3,-54,30,2,8,392,448
228,71,2,4,3,10,21,-54,3,4,413,394
228,72,3,3,7,6,34,33,7,7,447,427
228,73,3,4,5,8,32,-56,9,1,479,371
228,74,5,2,10,3,-45,21,4,2,434,392
228,75,3,3,6,7,33,34,7,6,467,426
228,76,3,4,6,7,-67,43,0,9,400,469
228,77,3,3,8,5,35,-68,5,1,435,401
228,78,2,4,5,8,23,44,8,5,458,445
228,79,4,3,9,4,-55,31,3,6,403,476
228,80,4,3,9,4,45,31,8,7,448,507
229,1,2,4,5,8,23,44,3,4,23,44
229,2,2,4,6,7,24,43,7,7,47,87
229,3,4,3,8,5,-56,32,1,9,-9,119
229,4,5,3,7,6,52,-67,3,2,43,52
229,5,3,4,6,7,33,43,6,5,76,95
229,6,2,4,8,5,-74,41,2,6,2,136
229,7,3,4,6,7,33,43,5,9,35,179
229,8,5,2,10,3,-45,-79,0,0,-10,100
229,9,2,4,7,6,25,42,5,2,15,142
229,10,2,4,6,7,24,43,9,5,39,185
229,11,3,5,6,7,-67,52,2,7,-28,237
229,12,2,4,5,8,23,-56,5,1,-5,181
229,13,3,4,4,9,31,45,6,6,26,226
229,14,3,3,6,7,33,-66,9,0,59,160
229,15,3,4,5,8,-68,44,1,4,-9,204
229,16,3,3,8,5,35,32,6,6,26,236
229,17,2,5,6,7,-76,52,0,8,-50,288
229,18,3,3,7,6,34,-67,4,1,-16,221
229,19,2,4,2,11,20,47,4,8,4,268
229,20,5,2,5,8,50,-74,4,4,54,194
229,21,4,2,8,5,44,23,8,7,98,217
229,22,5,2,9,4,-46,22,2,9,52,239
229,23,4,2,8,5,44,-77,6,2,96,162
229,24,2,5,4,9,22,54,8,6,118,216
229,25,2,4,6,7,-76,43,2,9,42,259
229,26,3,4,5,8,32,-56,4,3,74,203
229,27,6,2,8,5,62,23,6,6,136,226
229,28,3,3,4,9,31,-64,7,2,167,162
229,29,3,3,8,5,-65,32,2,4,102,194
229,30,4,2,8,5,44,23,6,7,146,217
229,31,2,5,5,8,23,-47,9,0,169,170
229,32,6,2,10,3,-36,21,3,1,133,191
229,33,4,3,9,4,45,31,8,2,178,222
229,34,3,4,6,7,-67,43,1,5,111,265
229,35,4,2,8,5,44,23,5,8,155,288
229,36,2,5,7,6,-75,51,0,9,80,339
229,37,3,4,4,9,31,-55,1,4,111,284
229,38,3,4,8,5,35,41,6,5,146,325
229,39,4,2,7,6,43,24,9,9,189,349
229,40,3,4,7,6,-66,-58,3,1,123,291
229,41,3,3,7,6,34,33,7,4,157,324
229,42,4,2,9,4,-55,22,2,6,102,346
229,43,2,4,4,9,22,-55,4,1,124,291
229,44,3,3,5,8,32,35,6,6,156,326
229,45,3,3,7,6,-66,33,0,9,90,359
229,46,3,3,3,10,30,-63,0,6,120,296
229,47,2,4,6,7,24,43,4,9,144,339
229,48,4,3,9,4,45,-69,9,0,189,270
229,49,4,3,5,8,-59,35,0,5,130,305
229,50,2,4,5,8,23,44,3,9,153,349
229,51,3,3,6,7,33,-66,6,3,186,283
229,52,2,6,3,10,21,64,7,7,207,347
229,53,4,2,6,7,42,-75,9,2,249,272
229,54,2,4,4,9,-78,45,1,7,171,317
229,55,3,4,4,9,31,-55,2,2,202,262
229,56,2,5,6,7,24,52,6,4,226,314
229,57,4,2,8,5,-56,23,0,7,170,337
229,58,2,5,3,10,21,-45,1,2,191,292
229,59,3,3,9,4,36,31,7,3,227,323
229,60,2,4,4,9,22,45,9,8,249,368
229,61,3,4,6,7,-67,-57,2,1,182,311
229,62,4,3,7,6,43,33,5,4,225,344
229,63,2,5,3,10,21,55,6,9,246,399
229,64,5,2,10,3,-45,-79,1,0,201,320
229,65,5,2,7,6,52,24,3,4,253,344
229,66,4,3,7,6,43,33,6,7,296,377
229,67,3,4,7,6,-66,42,0,9,230,419
229,68,3,3,6,7,33,-66,3,3,263,353
229,69,5,2,9,4,54,22,7,5,317,375
229,70,5,2,8,5,-47,23,0,8,270,398
229,71,3,4,6,7,33,-57,3,1,303,341
229,72,4,3,9,4,45,31,8,2,348,372
229,73,2,4,4,9,-78,45,0,7,270,417
229,74,3,3,6,7,33,-66,3,1,303,351
229,75,3,3,8,5,35,32,8,3,338,383
229,76,5,2,8,5,-47,23,1,6,291,406
229,77,4,2,8,5,44,23,5,9,335,429
229,78,4,3,7,6,43,-67,8,2,378,362
229,79,4,2,9,4,-55,22,3,4,323,384
229,80,4,3,7,6,43,33,6,7,366,417
229,81,2,5,6,7,-76,52,0,9,290,469
229,82,3,4,6,7,33,-57,3,2,323,412
229,83,2,4,3,10,21,46,4,8,344,458
229,84,6,2,9,4,63,-78,7,0,407,380
229,85,3,3,5,8,32,35,9,5,439,415
229,86,3,4,8,5,-65,41,4,6,374,456
229,87,3,3,9,4,-64,31,0,7,310,487
229,88,3,3,6,7,33,-66,3,1,343,421
229,89,3,3,7,6,34,33,7,4,377,454
229,90,3,4,4,9,31,45,8,9,408,499
229,91,3,3,5,8,-68,-65,0,4,340,434
229,92,3,3,5,8,32,35,2,9,372,469
229,93,5,3,9,4,54,-69,6,0,426,400
229,94,4,3,7,6,43,33,9,3,469,433
229,95,3,3,8,5,-65,32,4,5,404,465
229,96,5,2,10,3,55,21,9,6,459,486
229,97,3,3,7,6,-66,33,3,9,393,519
230,1,3,3,5,8,32,35,2,5,32,35
230,2,3,3,7,6,34,33,6,8,66,68
230,3,2,5,6,7,-76,-48,0,0,-10,20
230,4,2,5,4,9,22,54,2,4,12,74
230,5,3,3,6,7,33,34,5,8,45,108
230,6,4,4,8,5,44,41,9,9,89,149
230,7,4,3,7,6,-57,-67,2,2,32,82
230,8,3,3,7,6,34,33,6,5,66,115
230,9,2,4,5,8,23,44,9,9,89,159
230,10,2,4,4,9,-78,-55,1,4,11,104
230,11,5,2,11,2,56,20,7,4,67,124
230,12,3,4,8,5,-65,41,2,5,2,165
230,13,4,3,7,6,43,33,5,8,45,198
230,14,4,3,6,7,42,-66,7,2,87,132
230,15,3,4,4,9,31,45,8,7,118,177
230,16,4,2,11,2,-53,20,5,7,65,197
230,17,4,3,8,5,44,32,9,9,109,229
230,18,3,4,6,7,-67,-57,2,2,42,172
230,19,3,3,7,6,34,33,6,5,76,205
230,20,3,3,6,7,33,34,9,9,109,239
230,21,2,4,6,7,-76,-57,3,2,33,182
230,22,3,3,8,5,35,32,8,4,68,214
230,23,4,2,9,4,-55,22,3,6,13,236
230,24,4,2,9,4,45,22,8,8,58,258
230,25,2,6,5,8,-77,-38,1,0,-19,220
230,26,2,4,3,10,21,46,2,6,2,266
230,27,4,3,7,6,43,33,5,9,45,299
230,28,3,4,7,6,34,-58,9,1,79,241
230,29,4,3,6,7,-58,34,1,5,21,275
230,30,3,3,7,6,34,33,5,8,55,308
230,31,4,3,8,5,44,-68,9,0,99,240
230,32,3,3,5,8,-68,35,1,5,31,275
230,33,2,4,3,10,21,-54,2,1,52,221
230,34,4,3,8,5,44,32,6,3,96,253
230,35,4,2,10,3,-54,21,2,4,42,274
230,36,2,6,3,10,21,64,3,8,63,338
230,37,2,5,4,9,22,-46,5,2,85,292
230,38,3,4,7,6,34,42,9,4,119,334
230,39,2,4,5,8,-77,44,2,8,42,378
230,40,4,3,5,8,41,-65,3,3,83,313
230,41,3,5,6,7,33,52,6,5,116,365
230,42,5,2,9,4,-46,22,0,7,70,387
230,43,4,3,6,7,42,-66,2,1,112,321
230,44,3,3,6,7,33,34,5,5,145,355
230,45,4,3,7,6,43,33,8,8,188,388
230,46,3,3,7,6,-66,-67,2,1,122,321
230,47,3,5,5,8,32,53,4,4,154,374
230,48,3,3,4,9,31,-64,5,0,185,310
230,49,2,4,8,5,-74,41,1,1,111,351
230,50,3,4,6,7,33,43,4,4,144,394
230,51,4,2,10,3,-54,21,0,5,90,415
230,52,5,2,7,6,52,24,2,9,142,439
230,53,3,4,7,6,34,-58,6,1,176,381
230,54,3,3,9,4,-64,31,2,2,112,412
230,55,2,4,5,8,23,44,5,6,135,456
230,56,4,2,6,7,42,-75,7,1,177,381
230,57,2,6,3,10,21,64,8,5,198,445
230,58,5,3,7,6,-48,33,0,8,150,478
230,59,4,3,8,5,44,-68,4,0,194,410
230,60,4,3,7,6,43,33,7,3,237,443
230,61,3,3,4,9,31,36,8,9,268,479
230,62,3,3,7,6,-66,-67,2,2,202,412
230,63,4,2,10,3,46,21,8,3,248,433
230,64,3,4,5,8,-68,44,0,7,180,477
230,65,2,5,4,9,22,-46,2,1,202,431
230,66,2,5,3,10,21,55,3,6,223,486
230,67,2,4,8,5,26,41,9,7,249,527
231,1,4,3,6,7,42,34,2,4,42,34
231,2,3,4,7,6,34,42,6,6,76,76
231,3,3,3,8,5,-65,32,1,8,11,108
231,4,3,4,5,8,32,-56,3,2,43,52
231,5,4,3,7,6,43,33,6,5,86,85
231,6,3,4,8,5,-65,41,1,6,21,126
231,7,4,3,7,6,43,33,4,9,64,159
231,8,2,4,3,10,21,-54,5,5,85,105
231,9,4,3,7,6,43,33,8,8,128,138
231,10,3,5,8,5,-65,50,3,8,63,188
231,11,2,4,6,7,24,-57,7,1,87,131
231,12,4,3,7,6,-57,33,0,4,30,164
231,13,2,5,4,9,22,54,2,8,52,218
231,14,4,4,6,7,42,-57,4,1,94,161
231,15,4,2,10,3,-54,21,0,2,40,182
231,16,4,3,7,6,43,33,3,5,83,215
231,17,4,3,6,7,42,34,5,9,125,249
231,18,2,5,2,11,20,-44,5,5,145,205
231,19,4,3,7,6,43,33,8,8,188,238
231,20,3,3,8,5,-65,-68,3,0,123,170
231,21,3,4,6,7,33,43,6,3,156,213
231,22,4,3,6,7,42,34,8,7,198,247
231,23,4,4,8,5,-56,41,2,8,142,288
231,24,3,3,6,7,33,-66,5,2,175,222
231,25,4,3,9,4,-55,31,0,3,120,253
231,26,2,4,5,8,23,44,3,7,143,297
231,27,4,3,9,4,45,31,8,8,188,328
231,28,4,3,6,7,-58,-66,0,2,130,262
231,29,4,3,7,6,43,33,3,5,173,295
231,30,2,6,2,11,20,-35,3,0,193,260
231,31,4,3,5,8,41,35,4,5,234,295
231,32,3,4,6,7,33,43,7,8,267,338
231,33,4,2,8,5,-56,-77,1,1,211,261
231,34,5,3,8,5,53,32,4,3,264,293
231,35,3,3,4,9,31,36,5,9,295,329
231,36,3,4,5,8,32,-56,7,3,327,273
231,37,2,4,7,6,-75,42,2,5,252,315
231,38,3,3,9,4,36,31,8,6,288,346
231,39,3,4,5,8,-68,-56,0,0,220,290
231,40,2,6,3,10,21,64,1,4,241,354
231,41,2,4,5,8,23,44,4,8,264,398
231,42,2,5,3,10,21,-45,5,3,285,353
231,43,2,4,3,10,21,46,6,9,306,399
231,44,5,2,9,4,-46,-78,0,1,260,321
231,45,5,3,7,6,52,33,2,4,312,354
231,46,4,3,7,6,43,33,5,7,355,387
231,47,3,5,5,8,32,-47,7,0,387,340
231,48,4,3,9,4,-55,31,2,1,332,371
231,49,4,2,7,6,43,24,5,5,375,395
231,50,2,4,5,8,23,44,8,9,398,439
231,51,3,3,6,7,-67,-66,1,3,331,373
231,52,3,4,8,5,35,41,6,4,366,414
231,53,2,4,4,9,22,45,8,9,388,459
231,54,2,4,4,9,-78,-55,0,4,310,404
231,55,5,2,9,4,54,22,4,6,364,426
231,56,4,3,4,9,40,-64,4,2,404,362
231,57,2,4,5,8,23,44,7,6,427,406
231,58,2,4,8,5,-74,41,3,7,353,447
231,59,3,3,5,8,32,-65,5,2,385,382
231,60,3,4,6,7,33,43,8,5,418,425
231,61,4,3,8,5,-56,32,2,7,362,457
231,62,4,2,7,6,43,-76,5,1,405,381
231,63,3,4,5,8,32,44,7,5,437,425
231,64,3,3,4,9,31,-64,8,1,468,361
231,65,2,6,4,9,-78,63,0,4,390,424
231,66,5,2,6,7,51,25,1,9,441,449
231,67,2,4,6,7,24,-57,5,2,465,392
231,68,3,3,8,5,-65,32,0,4,400,424
231,69,5,2,8,5,53,23,3,7,453,447
231,70,2,4,4,9,22,-55,5,2,475,392
231,71,4,2,8,5,44,23,9,5,519,415
232,1,4,3,5,8,41,35,1,5,41,35
232,2,2,5,3,10,21,-45,2,0,62,-10
232,3,5,2,8,5,53,23,5,3,115,13
232,4,2,5,7,6,-75,51,0,4,40,64
232,5,3,4,6,7,33,43,3,7,73,107
232,6,5,2,9,4,54,22,7,9,127,129
232,7,2,5,4,9,22,-46,9,3,149,83
232,8,4,3,7,6,-57,33,2,6,92,116
232,9,4,3,8,5,44,32,6,8,136,148
232,10,3,3,9,4,-64,31,2,9,72,179
232,11,5,2,9,4,54,-78,6,1,126,101
232,12,2,5,5,8,23,53,9,4,149,154
232,13,2,5,3,10,-79,55,0,9,70,209
232,14,4,3,8,5,44,-68,4,1,114,141
232,15,2,5,3,10,21,55,5,6,135,196
232,16,3,4,4,9,31,-55,6,1,166,141
232,17,4,3,6,7,42,34,8,5,208,175
232,18,3,3,8,5,-65,32,3,7,143,207
232,19,5,2,10,3,55,21,8,8,198,228
232,20,4,2,8,5,-56,-77,2,1,142,151
232,21,4,2,6,7,42,25,4,6,184,176
232,22,3,3,8,5,35,32,9,8,219,208
232,23,5,2,9,4,-46,-78,3,0,173,130
232,24,4,2,6,7,42,25,5,5,215,155
232,25,3,4,5,8,32,44,7,9,247,199
232,26,4,2,9,4,-55,-78,2,1,192,121
232,27,4,2,7,6,43,24,5,5,235,145
232,28,3,4,7,6,34,42,9,7,269,187
232,29,2,4,5,8,-77,-56,2,1,192,131
232,30,3,4,5,8,32,44,4,5,224,175
232,31,2,4,6,7,24,43,8,8,248,218
232,32,3,4,5,8,-68,-56,0,2,180,162
232,33,3,4,5,8,32,44,2,6,212,206
232,34,3,4,6,7,33,43,5,9,245,249
232,35,2,5,3,10,21,-45,6,4,266,204
232,36,4,2,8,5,-56,23,0,7,210,227
232,37,3,3,5,8,32,-65,2,2,242,162
232,38,2,6,4,9,22,63,4,5,264,225
232,39,2,4,5,8,23,44,7,9,287,269
232,40,4,2,8,5,-56,-77,1,2,231,192
232,41,3,3,6,7,33,34,4,6,264,226
232,42,2,4,6,7,24,43,8,9,288,269
232,43,2,5,4,9,-78,-46,0,3,210,223
232,44,3,3,8,5,35,32,5,5,245,255
232,45,2,4,5,8,23,44,8,9,268,299
232,46,5,2,10,3,-45,-79,3,0,223,220
232,47,3,4,7,6,34,42,7,2,257,262
232,48,2,5,3,10,21,55,8,7,278,317
232,49,5,2,6,7,51,-75,9,2,329,242
232,50,2,4,7,6,-75,42,4,4,254,284
232,51,4,2,6,7,42,25,6,9,296,309
232,52,4,2,7,6,43,-76,9,3,339,233
232,53,3,4,4,9,-69,45,0,8,270,278
232,54,4,2,11,2,47,20,7,8,317,298
232,55,4,2,8,5,-56,-77,1,1,261,221
232,56,3,4,5,8,32,44,3,5,293,265
232,57,3,4,7,6,34,42,7,7,327,307
232,58,3,4,9,4,-64,40,3,7,263,347
232,59,2,4,4,9,22,-55,5,2,285,292
232,60,3,3,8,5,-65,32,0,4,220,324
232,61,3,3,5,8,32,35,2,9,252,359
232,62,4,2,6,7,42,-75,4,4,294,284
232,63,4,2,6,7,42,25,6,9,336,309
232,64,3,3,5,8,32,-65,8,4,368,244
232,65,4,3,6,7,-58,34,0,8,310,278
232,66,2,5,3,10,21,-45,1,3,331,233
232,67,3,3,8,5,35,32,6,5,366,265
232,68,3,3,6,7,33,34,9,9,399,299
232,69,4,2,7,6,-57,-76,2,3,342,223
232,70,2,4,4,9,22,45,4,8,364,268
232,71,2,5,6,7,24,-48,8,0,388,220
232,72,4,2,9,4,-55,22,3,2,333,242
232,73,4,2,7,6,43,24,6,6,376,266
232,74,4,2,9,4,-55,22,1,8,321,288
232,75,5,2,10,3,55,21,6,9,376,309
232,76,4,3,6,7,42,-66,8,3,418,243
232,77,2,4,7,6,-75,42,3,5,343,285
232,78,5,2,8,5,53,23,6,8,396,308
232,79,2,5,3,10,21,-45,7,3,417,263
232,80,5,2,7,6,52,24,9,7,469,287
232,81,3,4,7,6,-66,42,3,9,403,329
232,82,4,2,8,5,44,-77,7,2,447,252
232,83,2,6,3,10,21,64,8,6,468,316
232,84,3,3,7,6,-66,33,2,9,402,349
232,85,3,4,7,6,34,-58,6,1,436,291
232,86,4,2,10,3,-54,21,2,2,382,312
232,87,3,3,6,7,33,34,5,6,415,346
232,88,2,5,3,10,21,-45,6,1,436,301
232,89,4,3,7,6,43,33,9,4,479,334
232,90,3,3,8,5,-65,32,4,6,414,366
232,91,3,3,3,10,30,-63,4,3,444,303
232,92,3,4,6,7,33,43,7,6,477,346
232,93,4,3,7,6,-57,33,0,9,420,379
232,94,6,2,9,4,63,-78,3,1,483,301
232,95,2,5,6,7,24,52,7,3,507,353
233,1,3,3,8,5,35,32,5,2,35,32
233,2,3,4,6,7,33,43,8,5,68,75
233,3,3,3,7,6,-66,33,2,8,2,108
233,4,3,3,7,6,34,-67,6,1,36,41
233,5,3,4,8,5,-65,41,1,2,-29,82
233,6,3,4,8,5,35,41,6,3,6,123
233,7,3,3,10,3,-63,30,3,3,-57,153
233,8,3,3,8,5,35,32,8,5,-22,185
233,9,3,4,8,5,-65,41,3,6,-87,226
233,10,3,4,4,9,31,-55,4,1,-56,171
233,11,4,2,8,5,44,23,8,4,-12,194
233,12,4,3,5,8,41,35,9,9,29,229
233,13,4,3,6,7,-58,-66,1,3,-29,163
233,14,3,3,5,8,32,35,3,8,3,198
233,15,3,4,6,7,33,-57,6,1,36,141
233,16,3,4,3,10,30,46,6,7,66,187
233,17,3,4,8,5,-65,41,1,8,1,228
233,18,4,3,5,8,41,-65,2,3,42,163
233,19,4,2,7,6,43,24,5,7,85,187
233,20,3,3,6,7,33,-66,8,1,118,121
233,21,2,4,5,8,-77,44,1,5,41,165
233,22,3,4,5,8,32,44,3,9,73,209
233,23,3,4,7,6,34,-58,7,1,107,151
233,24,4,3,7,6,-57,33,0,4,50,184
233,25,5,2,10,3,55,21,5,5,105,205
233,26,3,3,7,6,34,33,9,8,139,238
233,27,3,4,7,6,-66,-58,3,0,73,180
233,28,4,2,6,7,42,25,5,5,115,205
233,29,3,3,8,5,-65,32,0,7,50,237
233,30,2,5,3,10,21,-45,1,2,71,192
233,31,3,4,6,7,33,43,4,5,104,235
233,32,4,2,6,7,42,-75,6,0,146,160
233,33,4,3,8,5,-56,32,0,2,90,192
233,34,3,3,7,6,34,33,4,5,124,225
233,35,4,3,6,7,42,34,6,9,166,259
233,36,2,4,8,5,-74,-59,2,0,92,200
233,37,4,3,6,7,42,34,4,4,134,234
233,38,2,4,2,11,20,-53,4,1,154,181
233,39,2,5,4,9,22,54,6,5,176,235
233,40,2,4,2,11,20,-53,6,2,196,182
233,41,5,2,8,5,53,23,9,5,249,205
233,42,3,3,7,6,-66,33,3,8,183,238
233,43,3,4,5,8,32,-56,5,2,215,182
233,44,3,3,7,6,34,33,9,5,249,215
233,45,3,4,7,6,-66,42,3,7,183,257
233,46,3,3,5,8,32,-65,5,2,215,192
233,47,3,3,8,5,-65,32,0,4,150,224
233,48,2,5,6,7,24,52,4,6,174,276
233,49,3,4,9,4,-64,40,0,6,110,316
233,50,4,3,8,5,44,32,4,8,154,348
233,51,3,3,7,6,34,-67,8,1,188,281
233,52,5,2,10,3,-45,21,3,2,143,302
233,53,3,3,5,8,32,35,5,7,175,337
233,54,3,4,5,8,32,-56,7,1,207,281
233,55,2,4,4,9,22,45,9,6,229,326
233,56,3,4,4,9,-69,-55,0,1,160,271
233,57,4,3,7,6,43,33,3,4,203,304
233,58,3,4,9,4,36,40,9,4,239,344
233,59,3,4,7,6,-66,42,3,6,173,386
233,60,4,3,7,6,43,33,6,9,216,419
233,61,3,4,4,9,31,-55,7,4,247,364
233,62,3,3,7,6,-66,33,1,7,181,397
233,63,3,3,5,8,32,-65,3,2,213,332
233,64,3,3,6,7,33,34,6,6,246,366
233,65,3,4,6,7,33,43,9,9,279,409
233,66,2,5,6,7,-76,-48,3,1,203,361
233,67,3,4,7,6,34,42,7,3,237,403
233,68,4,2,6,7,42,25,9,8,279,428
233,69,6,2,10,3,-36,21,3,9,243,449
233,70,4,2,5,8,41,-74,4,5,284,375
233,71,4,2,9,4,45,22,9,7,329,397
233,72,2,5,3,10,-79,-45,0,2,250,352
233,73,5,2,8,5,53,23,3,5,303,375
233,74,3,3,7,6,34,33,7,8,337,408
233,75,3,3,5,8,32,-65,9,3,369,343
233,76,4,2,9,4,-55,22,4,5,314,365
233,77,3,4,4,9,31,-55,5,0,345,310
233,78,4,2,8,5,44,23,9,3,389,333
233,79,5,2,8,5,-47,23,2,6,342,356
233,80,3,3,9,4,36,31,8,7,378,387
233,81,4,3,6,7,-58,-66,0,1,320,321
233,82,3,3,5,8,32,35,2,6,352,356
233,83,2,4,3,10,21,-54,3,2,373,302
233,84,5,2,11,2,56,20,9,2,429,322
233,85,3,3,6,7,-67,34,2,6,362,356
233,86,5,2,8,5,53,23,5,9,415,379
233,87,4,3,8,5,44,-68,9,1,459,311
233,88,2,4,4,9,-78,45,1,6,381,356
233,89,4,3,8,5,44,32,5,8,425,388
233,90,4,3,9,4,-55,31,0,9,370,419
233,91,3,4,7,6,34,-58,4,1,404,361
233,92,2,5,4,9,22,54,6,5,426,415
233,93,3,4,7,6,-66,42,0,7,360,457
233,94,3,3,6,7,33,-66,3,1,393,391
233,95,2,6,4,9,22,63,5,4,415,454
233,96,2,4,5,8,23,44,8,8,438,498
233,97,4,2,10,3,-54,21,4,9,384,519
234,1,4,3,8,5,44,32,4,2,44,32
234,2,4,3,5,8,41,35,5,7,85,67
234,3,3,3,7,6,34,-67,9,0,119,0
234,4,4,3,8,5,-56,32,3,2,63,32
234,5,5,2,9,4,54,22,7,4,117,54
234,6,4,2,9,4,-55,22,2,6,62,76
234,7,3,3,4,9,31,-64,3,2,93,12
234,8,4,2,5,8,41,26,4,8,134,38
234,9,3,3,9,4,-64,31,0,9,70,69
234,10,2,5,2,11,20,-44,0,5,90,25
234,11,2,5,5,8,23,53,3,8,113,78
234,12,2,5,3,10,21,-45,4,3,134,33
234,13,2,5,3,10,21,55,5,8,155,88
234,14,4,3,9,4,-55,31,0,9,100,119
234,15,3,4,4,9,31,-55,1,4,131,64
234,16,2,5,3,10,21,55,2,9,152,119
234,17,3,4,8,5,35,-59,7,0,187,60
234,18,3,3,8,5,-65,32,2,2,122,92
234,19,4,3,5,8,41,35,3,7,163,127
234,20,2,4,5,8,23,-56,6,1,186,71
234,21,4,2,8,5,-56,23,0,4,130,94
234,22,4,3,8,5,44,32,4,6,174,126
234,23,4,2,7,6,43,-76,7,0,217,50
234,24,4,2,7,6,-57,24,0,4,160,74
234,25,3,3,7,6,34,33,4,7,194,107
234,26,2,4,6,7,24,-57,8,0,218,50
234,27,5,2,6,7,51,25,9,5,269,75
234,28,2,5,3,10,-79,-45,0,0,190,30
234,29,4,3,5,8,41,35,1,5,231,65
234,30,3,4,6,7,33,43,4,8,264,108
234,31,2,4,3,10,21,-54,5,4,285,54
234,32,2,4,6,7,24,43,9,7,309,97
234,33,2,6,4,9,-78,-37,1,0,231,60
234,34,4,2,6,7,42,25,3,5,273,85
234,35,5,2,10,3,55,21,8,6,328,106
234,36,3,3,10,3,-63,30,5,6,265,136
234,37,3,3,6,7,33,-66,8,0,298,70
234,38,4,3,9,4,-55,31,3,1,243,101
234,39,2,5,6,7,24,52,7,3,267,153
234,40,2,4,6,7,-76,43,1,6,191,196
234,41,4,2,8,5,44,23,5,9,235,219
234,42,4,2,9,4,-55,-78,0,1,180,141
234,43,3,3,8,5,35,32,5,3,215,173
234,44,3,4,8,5,-65,41,0,4,150,214
234,45,2,5,4,9,22,54,2,8,172,268
234,46,2,5,6,7,24,-48,6,0,196,220
234,47,3,3,6,7,33,34,9,4,229,254
234,48,2,5,3,10,-79,55,0,9,150,309
234,49,5,2,9,4,54,-78,4,1,204,231
234,50,2,4,4,9,22,45,6,6,226,276
234,51,3,3,6,7,33,-66,9,0,259,210
234,52,3,4,6,7,-67,43,2,3,192,253
234,53,3,4,4,9,31,45,3,8,223,298
234,54,3,5,5,8,32,-47,5,1,255,251
234,55,3,3,8,5,-65,32,0,3,190,283
234,56,4,3,6,7,42,34,2,7,232,317
234,57,3,4,5,8,32,-56,4,1,264,261
234,58,4,3,7,6,43,33,7,4,307,294
234,59,2,6,3,10,21,64,8,8,328,358
234,60,4,4,8,5,-56,41,2,9,272,399
234,61,3,4,7,6,34,-58,6,1,306,341
234,62,3,3,5,8,32,35,8,6,338,376
234,63,2,4,7,6,-75,42,3,8,263,418
234,64,2,5,4,9,22,-46,5,2,285,372
234,65,4,3,7,6,43,33,8,5,328,405
234,66,4,2,10,3,-54,21,4,6,274,426
234,67,4,2,7,6,43,-76,7,0,317,350
234,68,3,3,5,8,32,35,9,5,349,385
234,69,3,3,4,9,-69,-64,0,1,280,321
234,70,5,2,7,6,52,24,2,5,332,345
234,71,3,4,6,7,33,43,5,8,365,388
234,72,4,3,9,4,-55,31,0,9,310,419
234,73,6,2,10,3,64,-79,4,0,374,340
234,74,3,4,6,7,33,43,7,3,407,383
234,75,3,4,4,9,31,45,8,8,438,428
234,76,3,3,6,7,-67,-66,1,2,371,362
234,77,3,4,7,6,34,42,5,4,405,404
234,78,4,3,9,4,-55,31,0,5,350,435
234,79,5,2,8,5,53,23,3,8,403,458
234,80,3,3,7,6,34,-67,7,1,437,391
234,81,4,3,9,4,-55,31,2,2,382,422
234,82,3,4,7,6,34,42,6,4,416,464
234,83,4,3,7,6,43,33,9,7,459,497
234,84,2,4,6,7,-76,-57,3,0,383,440
234,85,3,4,5,8,32,44,5,4,415,484
234,86,3,3,8,5,-65,32,0,6,350,516
235,1,4,4,6,7,42,43,2,3,42,43
235,2,3,3,6,7,33,34,5,7,75,77
235,3,2,4,2,11,20,-53,5,4,95,24
235,4,5,2,10,3,-45,21,0,5,50,45
235,5,3,3,4,9,31,-64,1,1,81,-19
235,6,5,2,9,4,54,22,5,3,135,3
235,7,5,3,9,4,54,31,9,4,189,34
235,8,3,3,4,9,-69,-64,0,0,120,-30
235,9,2,4,6,7,24,43,4,3,144,13
235,10,4,2,8,5,44,23,8,6,188,36
235,11,3,4,5,8,-68,-56,0,0,120,-20
235,12,2,5,5,8,23,53,3,3,143,33
235,13,3,3,7,6,34,33,7,6,177,66
235,14,3,4,5,8,32,-56,9,0,209,10
235,15,4,3,8,5,-56,32,3,2,153,42
235,16,2,4,5,8,23,44,6,6,176,86
235,17,4,3,7,6,43,33,9,9,219,119
235,18,4,3,7,6,-57,-67,2,2,162,52
235,19,3,3,5,8,32,35,4,7,194,87
235,20,3,3,5,8,32,-65,6,2,226,22
235,21,2,5,3,10,21,55,7,7,247,77
235,22,2,5,5,8,-77,-47,0,0,170,30
235,23,2,5,4,9,22,54,2,4,192,84
235,24,4,3,9,4,45,31,7,5,237,115
235,25,3,3,10,3,-63,30,4,5,174,145
235,26,3,3,6,7,33,34,7,9,207,179
235,27,4,4,8,5,-56,-59,1,0,151,120
235,28,3,4,4,9,31,45,2,5,182,165
235,29,4,3,5,8,41,-65,3,0,223,100
235,30,4,2,7,6,43,24,6,4,266,124
235,31,6,2,10,3,-36,21,0,5,230,145
235,32,4,3,6,7,42,34,2,9,272,179
235,33,2,5,4,9,22,-46,4,3,294,133
235,34,2,5,3,10,21,55,5,8,315,188
235,35,3,3,7,6,34,-67,9,1,349,121
235,36,2,5,6,7,-76,52,3,3,273,173
235,37,5,3,9,4,54,31,7,4,327,204
235,38,2,5,4,9,22,54,9,8,349,258
235,39,6,2,11,2,-35,20,4,8,314,278
235,40,4,3,5,8,41,-65,5,3,355,213
235,41,2,5,5,8,23,53,8,6,378,266
235,42,4,3,8,5,-56,32,2,8,322,298
235,43,2,5,7,6,25,51,7,9,347,349
235,44,5,3,7,6,52,-67,9,2,399,282
235,45,2,5,4,9,-78,54,1,6,321,336
235,46,3,4,6,7,33,43,4,9,354,379
235,47,3,3,8,5,35,-68,9,1,389,311
235,48,5,2,11,2,-44,20,5,1,345,331
235,49,2,4,5,8,23,44,8,5,368,375
235,50,4,3,9,4,-55,31,3,6,313,406
235,51,3,4,7,6,34,42,7,8,347,448
235,52,2,5,5,8,-77,-47,0,1,270,401
235,53,5,2,10,3,55,21,5,2,325,422
235,54,4,3,6,7,42,34,7,6,367,456
235,55,3,3,5,8,32,-65,9,1,399,391
235,56,4,4,6,7,-58,43,1,4,341,434
235,57,3,3,4,9,31,-64,2,0,372,370
235,58,3,3,5,8,32,35,4,5,404,405
235,59,4,3,10,3,-54,30,0,5,350,435
235,60,3,3,8,5,35,32,5,7,385,467
235,61,3,3,8,5,-65,32,0,9,320,499
235,62,3,3,6,7,33,-66,3,3,353,433
235,63,2,5,3,10,21,55,4,8,374,488
235,64,3,4,3,10,30,-54,4,4,404,434
235,65,5,2,10,3,55,21,9,5,459,455
235,66,5,2,9,4,-46,22,3,7,413,477
235,67,5,2,9,4,54,22,7,9,467,499
235,68,3,4,4,9,31,-55,8,4,498,444
235,69,5,2,7,6,-48,24,0,8,450,468
235,70,2,5,4,9,22,-46,2,2,472,422
235,71,2,4,3,10,21,46,3,8,493,468
235,72,4,3,8,5,44,-68,7,0,537,400
236,1,3,3,5,8,32,35,2,5,32,35
236,2,5,2,8,5,53,23,5,8,85,58
236,3,4,3,7,6,43,-67,8,1,128,-9
236,4,6,2,10,3,-36,21,2,2,92,12
236,5,3,3,9,4,36,31,8,3,128,43
236,6,2,5,5,8,-77,53,1,6,51,96
236,7,2,4,7,6,25,42,6,8,76,138
236,8,2,4,6,7,-76,-57,0,1,0,81
236,9,3,4,5,8,32,44,2,5,32,125
236,10,5,2,10,3,55,21,7,6,87,146
236,11,5,2,7,6,52,-76,9,0,139,70
236,12,4,3,8,5,-56,32,3,2,83,102
236,13,3,4,4,9,31,45,4,7,114,147
236,14,4,3,6,7,42,-66,6,1,156,81
236,15,3,4,6,7,33,43,9,4,189,124
236,16,3,3,5,8,-68,35,1,9,121,159
236,17,3,3,5,8,32,-65,3,4,153,94
236,18,4,3,7,6,43,33,6,7,196,127
236,19,4,3,7,6,43,-67,9,0,239,60
236,20,2,4,6,7,-76,43,3,3,163,103
236,21,3,3,6,7,33,34,6,7,196,137
236,22,2,4,8,5,-74,41,2,8,122,178
236,23,2,4,2,11,20,-53,2,5,142,125
236,24,5,3,9,4,54,31,6,6,196,156
236,25,2,5,3,10,21,-45,7,1,217,111
236,26,2,4,3,10,21,46,8,7,238,157
236,27,6,2,9,4,-37,22,1,9,201,179
236,28,4,3,7,6,43,-67,4,2,244,112
236,29,4,2,5,8,41,26,5,8,285,138
236,30,4,2,5,8,41,-74,6,4,326,64
236,31,4,3,8,5,-56,32,0,6,270,96
236,32,3,4,6,7,33,43,3,9,303,139
236,33,3,3,6,7,33,-66,6,3,336,73
236,34,4,3,4,9,40,36,6,9,376,109
236,35,3,4,8,5,-65,-59,1,0,311,50
236,36,4,2,7,6,43,24,4,4,354,74
236,37,3,3,6,7,33,34,7,8,387,108
236,38,4,3,10,3,-54,30,3,8,333,138
236,39,4,2,8,5,44,-77,7,1,377,61
236,40,4,2,10,3,-54,21,3,2,323,82
236,41,4,3,7,6,43,33,6,5,366,115
236,42,5,2,9,4,-46,22,0,7,320,137
236,43,4,2,5,8,41,-74,1,3,361,63
236,44,3,3,7,6,34,33,5,6,395,96
236,45,4,3,8,5,44,32,9,8,439,128
236,46,3,4,6,7,-67,-57,2,1,372,71
236,47,3,3,7,6,34,33,6,4,406,104
236,48,3,5,5,8,32,53,8,7,438,157
236,49,4,3,9,4,-55,31,3,8,383,188
236,50,2,4,6,7,24,-57,7,1,407,131
236,51,3,3,8,5,-65,32,2,3,342,163
236,52,3,4,7,6,34,42,6,5,376,205
236,53,4,3,6,7,42,34,8,9,418,239
236,54,3,3,5,8,-68,-65,0,4,350,174
236,55,3,3,7,6,34,33,4,7,384,207
236,56,5,3,10,3,55,30,9,7,439,237
236,57,5,2,9,4,-46,22,3,9,393,259
236,58,2,5,2,11,20,-44,3,5,413,215
236,59,3,3,7,6,34,33,7,8,447,248
236,60,3,4,8,5,-65,41,2,9,382,289
236,61,3,3,6,7,33,-66,5,3,415,223
236,62,3,4,7,6,34,42,9,5,449,265
236,63,4,3,5,8,-59,-65,0,0,390,200
236,64,4,2,9,4,45,22,5,2,435,222
236,65,3,4,7,6,34,42,9,4,469,264
236,66,5,2,9,4,-46,22,3,6,423,286
236,67,5,2,7,6,52,-76,5,0,475,210
236,68,4,2,11,2,-53,20,2,0,422,230
236,69,3,3,5,8,32,35,4,5,454,265
236,70,4,3,5,8,41,-65,5,0,495,200
236,71,3,3,7,6,34,33,9,3,529,233
237,1,2,6,2,11,20,65,0,5,20,65
237,2,4,3,7,6,43,33,3,8,63,98
237,3,4,2,7,6,43,-76,6,2,106,22
237,4,5,2,10,3,-45,21,1,3,61,43
237,5,3,3,8,5,35,32,6,5,96,75
237,6,6,2,9,4,63,22,9,7,159,97
237,7,3,3,6,7,-67,-66,2,1,92,31
237,8,4,3,6,7,42,34,4,5,134,65
237,9,3,3,7,6,34,33,8,8,168,98
237,10,4,2,7,6,-57,-76,1,2,111,22
237,11,3,3,6,7,33,34,4,6,144,56
237,12,5,2,9,4,54,22,8,8,198,78
237,13,2,4,4,9,-78,-55,0,3,120,23
237,14,4,3,6,7,42,34,2,7,162,57
237,15,4,3,8,5,44,32,6,9,206,89
237,16,3,4,6,7,33,-57,9,2,239,32
237,17,3,3,9,4,-64,31,5,3,175,63
237,18,4,3,5,8,41,35,6,8,216,98
237,19,4,3,9,4,-55,31,1,9,161,129
237,20,4,3,7,6,43,-67,4,2,204,62
237,21,2,4,4,9,22,45,6,7,226,107
237,22,3,4,5,8,32,-56,8,1,258,51
237,23,2,5,6,7,-76,52,2,3,182,103
237,24,4,3,8,5,44,32,6,5,226,135
237,25,3,3,5,8,32,-65,8,0,258,70
237,26,3,4,7,6,-66,42,2,2,192,112
237,27,3,4,4,9,31,45,3,7,223,157
237,28,5,3,9,4,54,31,7,8,277,188
237,29,4,2,10,3,-54,21,3,9,223,209
237,30,3,4,5,8,32,-56,5,3,255,153
237,31,5,3,8,5,53,32,8,5,308,185
237,32,2,4,5,8,-77,44,1,9,231,229
237,33,5,2,9,4,54,-78,5,1,285,151
237,34,2,5,3,10,21,55,6,6,306,206
237,35,5,2,11,2,-44,20,2,6,262,226
237,36,4,2,9,4,45,22,7,8,307,248
237,37,2,4,4,9,22,-55,9,3,329,193
237,38,3,4,6,7,-67,43,2,6,262,236
237,39,4,2,9,4,45,22,7,8,307,258
237,40,2,4,6,7,-76,-57,1,1,231,201
237,41,2,5,4,9,22,54,3,5,253,255
237,42,4,3,9,4,45,31,8,6,298,286
237,43,3,3,6,7,-67,-66,1,0,231,220
237,44,3,4,7,6,34,42,5,2,265,262
237,45,3,4,7,6,34,42,9,4,299,304
237,46,3,3,6,7,-67,34,2,8,232,338
237,47,3,3,6,7,33,-66,5,2,265,272
237,48,2,5,3,10,21,55,6,7,286,327
237,49,2,4,3,10,21,-54,7,3,307,273
237,50,3,3,9,4,-64,31,3,4,243,304
237,51,4,2,10,3,46,21,9,5,289,325
237,52,4,3,8,5,-56,32,3,7,233,357
237,53,5,2,8,5,53,-77,6,0,286,280
237,54,3,3,6,7,33,34,9,4,319,314
237,55,5,2,8,5,-47,23,2,7,272,337
237,56,4,3,9,4,45,31,7,8,317,368
237,57,4,3,7,6,-57,-67,0,1,260,301
237,58,3,3,7,6,34,33,4,4,294,334
237,59,4,3,7,6,43,33,7,7,337,367
237,60,3,4,4,9,31,-55,8,2,368,312
237,61,5,2,8,5,-47,23,1,5,321,335
237,62,4,2,11,2,47,20,8,5,368,355
237,63,3,4,5,8,-68,44,0,9,300,399
237,64,4,2,8,5,44,-77,4,2,344,322
237,65,3,3,6,7,33,34,7,6,377,356
237,66,5,2,9,4,-46,22,1,8,331,378
237,67,3,4,7,6,34,-58,5,0,365,320
237,68,2,5,5,8,23,53,8,3,388,373
237,69,4,3,8,5,-56,32,2,5,332,405
237,70,6,2,11,2,65,20,7,5,397,425
237,71,2,5,5,8,-77,53,0,8,320,478
237,72,5,2,10,3,55,21,5,9,375,499
237,73,3,4,5,8,32,-56,7,3,407,443
237,74,4,2,9,4,-55,22,2,5,352,465
237,75,3,3,6,7,33,34,5,9,385,499
237,76,3,4,5,8,32,-56,7,3,417,443
237,77,4,3,7,6,-57,33,0,6,360,476
237,78,3,4,4,9,31,-55,1,1,391,421
237,79,3,3,7,6,34,33,5,4,425,454
237,80,2,5,2,11,20,-44,5,0,445,410
237,81,2,4,6,7,24,43,9,3,469,453
237,82,5,2,8,5,-47,23,2,6,422,476
237,83,3,4,6,7,33,43,5,9,455,519
238,1,3,5,6,7,33,52,3,2,33,52
238,2,4,3,6,7,42,34,5,6,75,86
238,3,2,5,2,11,20,-44,5,2,95,42
238,4,4,3,8,5,44,32,9,4,139,74
238,5,3,5,6,7,-67,52,2,6,72,126
238,6,2,5,3,10,21,-45,3,1,93,81
238,7,4,2,8,5,44,23,7,4,137,104
238,8,3,4,5,8,32,44,9,8,169,148
238,9,4,3,10,3,-54,30,5,8,115,178
238,10,2,5,3,10,21,-45,6,3,136,133
238,11,3,4,5,8,32,44,8,7,168,177
238,12,2,6,2,11,20,-35,8,2,188,142
238,13,4,2,6,7,-58,25,0,7,130,167
238,14,2,4,5,8,23,-56,3,1,153,111
238,15,5,2,9,4,54,22,7,3,207,133
238,16,4,4,8,5,-56,41,1,4,151,174
238,17,3,3,6,7,33,34,4,8,184,208
238,18,4,3,5,8,41,-65,5,3,225,143
238,19,5,2,8,5,53,23,8,6,278,166
238,20,3,3,6,7,-67,-66,1,0,211,100
238,21,3,3,8,5,35,32,6,2,246,132
238,22,4,2,8,5,-56,23,0,5,190,155
238,23,5,2,10,3,55,21,5,6,245,176
238,24,3,4,5,8,32,-56,7,0,277,120
238,25,3,4,5,8,32,44,9,4,309,164
238,26,3,4,4,9,-69,45,0,9,240,209
238,27,4,2,8,5,44,-77,4,2,284,132
238,28,4,3,6,7,42,34,6,6,326,166
238,29,2,4,6,7,-76,43,0,9,250,209
238,30,2,5,5,8,23,-47,3,2,273,162
238,31,2,5,5,8,23,53,6,5,296,215
238,32,3,3,6,7,33,34,9,9,329,249
238,33,3,3,7,6,-66,-67,3,2,263,182
238,34,2,4,4,9,22,45,5,7,285,227
238,35,4,3,4,9,40,-64,5,3,325,163
238,36,3,3,8,5,-65,32,0,5,260,195
238,37,3,3,5,8,32,-65,2,0,292,130
238,38,2,4,4,9,22,45,4,5,314,175
238,39,4,3,8,5,44,32,8,7,358,207
238,40,2,4,4,9,-78,-55,0,2,280,152
238,41,3,4,4,9,31,45,1,7,311,197
238,42,3,5,6,7,33,52,4,9,344,249
238,43,2,4,3,10,21,-54,5,5,365,195
238,44,5,2,11,2,-44,20,1,5,321,215
238,45,5,2,10,3,55,21,6,6,376,236
238,46,4,3,8,5,-56,32,0,8,320,268
238,47,5,2,8,5,53,-77,3,1,373,191
238,48,2,4,4,9,22,45,5,6,395,236
238,49,3,3,5,8,32,-65,7,1,427,171
238,50,3,3,5,8,32,35,9,6,459,206
238,51,3,3,6,7,-67,-66,2,0,392,140
238,52,4,3,7,6,43,33,5,3,435,173
238,53,3,3,6,7,33,34,8,7,468,207
238,54,3,3,6,7,-67,-66,1,1,401,141
238,55,2,4,5,8,23,44,4,5,424,185
238,56,3,3,8,5,35,32,9,7,459,217
238,57,5,2,7,6,-48,-76,1,1,411,141
238,58,3,5,6,7,33,52,4,3,444,193
238,59,5,2,9,4,54,22,8,5,498,215
238,60,3,4,7,6,-66,42,2,7,432,257
238,61,2,4,3,10,21,-54,3,3,453,203
238,62,4,3,8,5,44,32,7,5,497,235
238,63,3,3,9,4,-64,31,3,6,433,266
238,64,4,2,9,4,45,22,8,8,478,288
238,65,6,2,10,3,-36,21,2,9,442,309
238,66,5,2,9,4,54,-78,6,1,496,231
238,67,3,3,8,5,-65,32,1,3,431,263
238,68,4,3,7,6,43,33,4,6,474,296
238,69,2,5,4,9,22,-46,6,0,496,250
238,70,2,5,7,6,-75,51,1,1,421,301
238,71,4,3,9,4,45,31,6,2,466,332
238,72,2,4,8,5,-74,41,2,3,392,373
238,73,4,2,7,6,43,24,5,7,435,397
238,74,2,4,8,5,-74,41,1,8,361,438
238,75,2,5,5,8,23,-47,4,1,384,391
238,76,3,4,8,5,35,41,9,2,419,432
238,77,3,3,4,9,-69,36,0,8,350,468
238,78,5,2,9,4,54,-78,4,0,404,390
238,79,3,4,6,7,33,43,7,3,437,433
238,80,3,3,6,7,-67,34,0,7,370,467
238,81,4,2,6,7,42,-75,2,2,412,392
238,82,3,4,6,7,33,43,5,5,445,435
238,83,3,3,7,6,34,33,9,8,479,468
238,84,4,3,8,5,-56,-68,3,0,423,400
238,85,3,4,7,6,34,42,7,2,457,442
238,86,2,5,4,9,22,54,9,6,479,496
238,87,4,3,6,7,-58,-66,1,0,421,430
238,88,2,5,4,9,22,54,3,4,443,484
238,89,3,4,5,8,32,44,5,8,475,528
239,1,4,3,9,4,45,31,5,1,45,31
239,2,3,3,7,6,34,33,9,4,79,64
239,3,3,3,9,4,-64,31,5,5,15,95
239,4,4,3,10,3,-54,30,1,5,-39,125
239,5,3,3,8,5,35,32,6,7,-4,157
239,6,2,5,3,10,21,-45,7,2,17,112
239,7,4,2,8,5,-56,23,1,5,-39,135
239,8,3,4,5,8,32,44,3,9,-7,179
239,9,2,4,5,8,23,-56,6,3,16,123
239,10,4,4,5,8,41,44,7,7,57,167
239,11,3,4,8,5,-65,41,2,8,-8,208
239,12,2,5,3,10,21,-45,3,3,13,163
239,13,3,3,8,5,35,32,8,5,48,195
239,14,3,3,5,8,-68,-65,0,0,-20,130
239,15,4,2,6,7,42,25,2,5,22,155
239,16,4,2,8,5,44,23,6,8,66,178
239,17,4,2,9,4,-55,-78,1,0,11,100
239,18,2,4,5,8,23,44,4,4,34,144
239,19,4,3,8,5,44,32,8,6,78,176
239,20,4,3,6,7,-58,-66,0,0,20,110
239,21,5,2,9,4,54,22,4,2,74,132
239,22,5,2,11,2,-44,20,0,2,30,152
239,23,4,2,5,8,41,26,1,8,71,178
239,24,3,3,3,10,30,-63,1,5,101,115
239,25,4,3,6,7,42,34,3,9,143,149
239,26,3,3,7,6,34,-67,7,2,177,82
239,27,3,4,4,9,31,45,8,7,208,127
239,28,3,3,8,5,-65,32,3,9,143,159
239,29,3,3,5,8,32,-65,5,4,175,94
239,30,3,4,5,8,32,44,7,8,207,138
239,31,3,3,8,5,-65,-68,2,0,142,70
239,32,4,3,9,4,45,31,7,1,187,101
239,33,4,3,9,4,-55,31,2,2,132,132
239,34,3,4,7,6,34,42,6,4,166,174
239,35,2,4,4,9,22,45,8,9,188,219
239,36,4,4,8,5,-56,-59,2,0,132,160
239,37,3,4,5,8,32,44,4,4,164,204
239,38,3,3,8,5,35,32,9,6,199,236
239,39,4,2,7,6,-57,-76,2,0,142,160
239,40,4,2,6,7,42,25,4,5,184,185
239,41,4,2,8,5,44,23,8,8,228,208
239,42,3,3,6,7,-67,-66,1,2,161,142
239,43,3,4,7,6,34,42,5,4,195,184
239,44,3,3,3,10,30,-63,5,1,225,121
239,45,3,3,6,7,33,34,8,5,258,155
239,46,2,5,5,8,-77,53,1,8,181,208
239,47,2,4,4,9,22,-55,3,3,203,153
239,48,3,3,9,4,36,31,9,4,239,184
239,49,4,3,6,7,-58,34,1,8,181,218
239,50,3,3,5,8,32,-65,3,3,213,153
239,51,4,3,7,6,43,33,6,6,256,186
239,52,5,2,10,3,-45,21,1,7,211,207
239,53,3,4,6,7,33,-57,4,0,244,150
239,54,3,4,5,8,32,44,6,4,276,194
239,55,3,4,6,7,33,43,9,7,309,237
239,56,5,3,9,4,-46,31,3,8,263,268
239,57,4,4,7,6,43,-58,6,0,306,210
239,58,4,4,7,6,43,42,9,2,349,252
239,59,3,5,5,8,-68,53,1,5,281,305
239,60,4,3,9,4,45,31,6,6,326,336
239,61,2,5,5,8,23,53,9,9,349,389
239,62,3,4,6,7,-67,-57,2,2,282,332
239,63,3,4,7,6,34,42,6,4,316,374
239,64,2,4,6,7,-76,43,0,7,240,417
239,65,3,3,5,8,32,-65,2,2,272,352
239,66,3,3,7,6,34,33,6,5,306,385
239,67,2,4,5,8,23,44,9,9,329,429
239,68,5,2,7,6,-48,-76,1,3,281,353
239,69,4,3,6,7,42,34,3,7,323,387
239,70,3,4,4,9,31,-55,4,2,354,332
239,71,4,3,9,4,45,31,9,3,399,363
239,72,3,4,4,9,-69,45,0,8,330,408
239,73,3,3,5,8,32,-65,2,3,362,343
239,74,3,4,5,8,32,44,4,7,394,387
239,75,4,3,8,5,44,32,8,9,438,419
239,76,4,3,7,6,-57,-67,1,2,381,352
239,77,4,3,8,5,44,32,5,4,425,384
239,78,5,3,7,6,52,33,7,7,477,417
239,79,2,4,7,6,-75,42,2,9,402,459
239,80,2,4,4,9,22,-55,4,4,424,404
239,81,2,4,3,10,21,-54,5,0,445,350
239,82,3,4,6,7,33,43,8,3,478,393
239,83,2,4,5,8,-77,44,1,7,401,437
239,84,3,3,5,8,32,-65,3,2,433,372
239,85,2,4,3,10,21,46,4,8,454,418
239,86,2,5,4,9,22,-46,6,2,476,372
239,87,3,3,7,6,-66,33,0,5,410,405
239,88,3,4,6,7,33,43,3,8,443,448
239,89,3,4,5,8,32,-56,5,2,475,392
239,90,4,3,5,8,41,35,6,7,516,427
240,1,2,5,4,9,22,54,2,4,22,54
240,2,4,3,6,7,42,34,4,8,64,88
240,3,3,3,7,6,34,-67,8,1,98,21
240,4,5,2,9,4,-46,22,2,3,52,43
240,5,3,3,4,9,31,36,3,9,83,79
240,6,5,2,10,3,55,-79,8,0,138,0
240,7,3,3,6,7,-67,34,1,4,71,34
240,8,2,5,5,8,23,53,4,7,94,87
240,9,4,2,6,7,42,-75,6,2,136,12
240,10,3,4,5,8,32,44,8,6,168,56
240,11,3,3,4,9,31,-64,9,2,199,-8
240,12,4,4,5,8,-59,44,0,6,140,36
240,13,6,2,11,2,65,20,5,6,205,56
240,14,3,3,5,8,32,-65,7,1,237,-9
240,15,5,3,8,5,-47,32,0,3,190,23
240,16,5,2,9,4,54,22,4,5,244,45
240,17,4,3,6,7,42,34,6,9,286,79
240,18,3,3,4,9,31,-64,7,5,317,15
240,19,3,4,6,7,-67,43,0,8,250,58
240,20,3,5,4,9,31,-46,1,2,281,12
240,21,3,3,4,9,31,36,2,8,312,48
240,22,2,4,5,8,23,-56,5,2,335,-8
240,23,2,4,4,9,22,45,7,7,357,37
240,24,2,4,8,5,-74,41,3,8,283,78
240,25,4,2,10,3,46,21,9,9,329,99
240,26,4,3,9,4,-55,-69,4,0,274,30
240,27,3,3,4,9,31,36,5,6,305,66
240,28,3,4,5,8,32,-56,7,0,337,10
240,29,3,4,5,8,32,44,9,4,369,54
240,30,3,3,9,4,-64,31,5,5,305,85
240,31,2,4,6,7,24,43,9,8,329,128
240,32,5,2,10,3,-45,21,4,9,284,149
240,33,4,2,7,6,43,-76,7,3,327,73
240,34,2,5,3,10,21,55,8,8,348,128
240,35,3,3,5,8,-68,-65,0,3,280,63
240,36,3,4,7,6,34,42,4,5,314,105
240,37,2,4,8,5,-74,41,0,6,240,146
240,38,3,4,5,8,32,-56,2,0,272,90
240,39,3,4,5,8,32,44,4,4,304,134
240,40,4,3,7,6,43,33,7,7,347,167
240,41,3,3,8,5,-65,32,2,9,282,199
240,42,5,2,11,2,56,20,8,9,338,219
240,43,4,3,6,7,-58,-66,0,3,280,153
240,44,3,3,6,7,33,34,3,7,313,187
240,45,2,4,4,9,22,-55,5,2,335,132
240,46,4,3,8,5,44,32,9,4,379,164
240,47,4,3,6,7,-58,34,1,8,321,198
240,48,3,3,8,5,35,-68,6,0,356,130
240,49,5,2,10,3,-45,21,1,1,311,151
240,50,4,3,5,8,41,35,2,6,352,186
240,51,2,5,4,9,22,-46,4,0,374,140
240,52,4,2,7,6,43,24,7,4,417,164
240,53,4,3,6,7,42,34,9,8,459,198
240,54,3,3,6,7,-67,-66,2,2,392,132
240,55,4,3,10,3,46,30,8,2,438,162
240,56,2,4,5,8,-77,44,1,6,361,206
240,57,5,2,6,7,51,-75,2,1,412,131
240,58,2,4,7,6,25,42,7,3,437,173
240,59,2,5,3,10,21,55,8,8,458,228
240,60,4,3,7,6,-57,-67,1,1,401,161
240,61,3,4,4,9,31,45,2,6,432,206
240,62,2,4,6,7,24,43,6,9,456,249
240,63,2,5,6,7,-76,-48,0,1,380,201
240,64,4,3,7,6,43,33,3,4,423,234
240,65,4,3,9,4,45,31,8,5,468,265
240,66,3,3,8,5,-65,32,3,7,403,297
240,67,3,3,7,6,34,-67,7,0,437,230
240,68,3,3,6,7,-67,34,0,4,370,264
240,69,4,3,6,7,42,34,2,8,412,298
240,70,3,3,6,7,33,-66,5,2,445,232
240,71,2,4,6,7,24,43,9,5,469,275
240,72,2,5,5,8,-77,53,2,8,392,328
240,73,2,4,4,9,22,-55,4,3,414,273
240,74,3,3,7,6,34,33,8,6,448,306
240,75,3,4,5,8,-68,-56,0,0,380,250
240,76,2,4,7,6,25,42,5,2,405,292
240,77,5,2,9,4,54,22,9,4,459,314
240,78,5,3,10,3,-45,30,4,4,414,344
240,79,2,4,7,6,25,42,9,6,439,386
240,80,3,4,8,5,-65,41,4,7,374,427
240,81,4,2,5,8,41,-74,5,3,415,353
240,82,4,2,7,6,43,24,8,7,458,377
240,83,6,2,10,3,-36,21,2,8,422,398
240,84,4,3,7,6,43,-67,5,1,465,331
240,85,3,4,5,8,32,44,7,5,497,375
240,86,4,3,6,7,42,34,9,9,539,409
241,1,4,3,8,5,44,32,4,2,44,32
241,2,5,2,11,2,-44,20,0,2,0,52
241,3,3,3,6,7,33,34,3,6,33,86
241,4,4,2,10,3,46,21,9,7,79,107
241,5,2,5,4,9,-78,-46,1,1,1,61
241,6,6,2,8,5,62,23,3,4,63,84
241,7,3,4,4,9,31,45,4,9,94,129
241,8,3,3,6,7,33,-66,7,3,127,63
241,9,4,3,9,4,-55,31,2,4,72,94
241,10,3,3,6,7,33,34,5,8,105,128
241,11,4,3,10,3,-54,30,1,8,51,158
241,12,2,5,3,10,21,-45,2,3,72,113
241,13,4,2,10,3,46,21,8,4,118,134
241,14,2,5,3,10,21,55,9,9,139,189
241,15,4,3,6,7,-58,-66,1,3,81,123
241,16,4,2,7,6,43,24,4,7,124,147
241,17,5,2,10,3,55,21,9,8,179,168
241,18,3,3,7,6,-66,-67,3,1,113,101
241,19,3,3,6,7,33,34,6,5,146,135
241,20,3,4,6,7,33,43,9,8,179,178
241,21,4,3,9,4,-55,31,4,9,124,209
241,22,3,3,4,9,31,-64,5,5,155,145
241,23,3,3,7,6,34,33,9,8,189,178
241,24,2,4,4,9,-78,-55,1,3,111,123
241,25,3,3,8,5,35,32,6,5,146,155
241,26,3,4,4,9,31,-55,7,0,177,100
241,27,2,4,5,8,-77,44,0,4,100,144
241,28,3,3,7,6,34,33,4,7,134,177
241,29,3,3,7,6,34,-67,8,0,168,110
241,30,4,2,11,2,-53,20,5,0,115,130
241,31,2,4,7,6,-75,42,0,2,40,172
241,32,3,4,7,6,34,42,4,4,74,214
241,33,2,4,5,8,23,44,7,8,97,258
241,34,4,4,5,8,41,-56,8,2,138,202
241,35,3,3,3,10,30,37,8,9,168,239
241,36,5,2,8,5,-47,-77,1,2,121,162
241,37,2,6,4,9,22,63,3,5,143,225
241,38,4,2,6,7,42,-75,5,0,185,150
241,39,2,4,5,8,23,44,8,4,208,194
241,40,6,2,9,4,-37,22,1,6,171,216
241,41,4,2,11,2,47,20,8,6,218,236
241,42,2,5,4,9,-78,-46,0,0,140,190
241,43,3,3,7,6,34,33,4,3,174,223
241,44,2,5,5,8,23,53,7,6,197,276
241,45,2,4,4,9,22,-55,9,1,219,221
241,46,4,3,8,5,-56,32,3,3,163,253
241,47,5,2,11,2,56,20,9,3,219,273
241,48,4,3,9,4,-55,31,4,4,164,304
241,49,4,3,4,9,40,-64,4,0,204,240
241,50,4,3,9,4,45,31,9,1,249,271
241,51,3,4,8,5,-65,41,4,2,184,312
241,52,2,5,3,10,21,55,5,7,205,367
241,53,4,3,9,4,-55,31,0,8,150,398
241,54,3,3,5,8,32,-65,2,3,182,333
241,55,3,3,6,7,33,34,5,7,215,367
241,56,4,3,6,7,42,-66,7,1,257,301
241,57,2,4,7,6,-75,42,2,3,182,343
241,58,3,3,7,6,34,33,6,6,216,376
241,59,4,3,8,5,-56,32,0,8,160,408
241,60,3,4,7,6,34,-58,4,0,194,350
241,61,3,3,6,7,33,34,7,4,227,384
241,62,3,4,7,6,-66,42,1,6,161,426
241,63,3,4,8,5,35,41,6,7,196,467
241,64,4,3,8,5,-56,32,0,9,140,499
241,65,2,5,5,8,23,-47,3,2,163,452
241,66,3,4,5,8,32,44,5,6,195,496
241,67,4,2,8,5,44,23,9,9,239,519
242,1,4,3,6,7,42,34,2,4,42,34
242,2,3,5,5,8,32,53,4,7,74,87
242,3,2,4,8,5,-74,41,0,8,0,128
242,4,3,3,7,6,34,-67,4,1,34,61
242,5,5,3,8,5,53,32,7,3,87,93
242,6,3,4,6,7,-67,43,0,6,20,136
242,7,3,3,9,4,36,31,6,7,56,167
242,8,4,2,9,4,-55,22,1,9,1,189
242,9,6,2,9,4,63,-78,4,1,64,111
242,10,3,3,5,8,32,35,6,6,96,146
242,11,2,4,5,8,23,-56,9,0,119,90
242,12,3,3,5,8,-68,35,1,5,51,125
242,13,3,3,6,7,33,34,4,9,84,159
242,14,4,4,7,6,43,-58,7,1,127,101
242,15,3,4,6,7,-67,43,0,4,60,144
242,16,3,3,8,5,35,32,5,6,95,176
242,17,4,3,5,8,41,-65,6,1,136,111
242,18,4,3,8,5,-56,32,0,3,80,143
242,19,4,2,9,4,45,22,5,5,125,165
242,20,2,4,4,9,22,-55,7,0,147,110
242,21,4,2,9,4,-55,22,2,2,92,132
242,22,3,3,8,5,35,32,7,4,127,164
242,23,2,4,5,8,-77,44,0,8,50,208
242,24,3,3,5,8,32,-65,2,3,82,143
242,25,3,3,9,4,36,31,8,4,118,174
242,26,2,5,2,11,20,-44,8,0,138,130
242,27,5,2,10,3,-45,21,3,1,93,151
242,28,3,3,7,6,34,33,7,4,127,184
242,29,4,2,8,5,-56,23,1,7,71,207
242,30,2,4,5,8,23,-56,4,1,94,151
242,31,5,2,8,5,53,23,7,4,147,174
242,32,3,3,7,6,-66,33,1,7,81,207
242,33,3,4,5,8,32,-56,3,1,113,151
242,34,5,2,11,2,56,20,9,1,169,171
242,35,3,3,7,6,-66,33,3,4,103,204
242,36,4,2,6,7,42,25,5,9,145,229
242,37,4,3,9,4,-55,-69,0,0,90,160
242,38,3,3,6,7,33,34,3,4,123,194
242,39,3,4,5,8,32,44,5,8,155,238
242,40,3,5,5,8,32,-47,7,1,187,191
242,41,3,4,5,8,32,44,9,5,219,235
242,42,2,4,5,8,-77,44,2,9,142,279
242,43,2,5,5,8,23,-47,5,2,165,232
242,44,3,4,7,6,34,42,9,4,199,274
242,45,5,2,10,3,-45,21,4,5,154,295
242,46,4,2,9,4,45,22,9,7,199,317
242,47,3,3,9,4,-64,31,5,8,135,348
242,48,2,4,6,7,24,-57,9,1,159,291
242,49,4,4,7,6,-57,42,2,3,102,333
242,50,4,3,9,4,45,31,7,4,147,364
242,51,2,4,5,8,-77,44,0,8,70,408
242,52,4,3,9,4,45,31,5,9,115,439
242,53,5,2,9,4,54,-78,9,1,169,361
242,54,3,4,4,9,-69,45,0,6,100,406
242,55,4,3,8,5,44,32,4,8,144,438
242,56,2,5,4,9,22,-46,6,2,166,392
242,57,4,3,5,8,41,35,7,7,207,427
242,58,3,3,4,9,31,-64,8,3,238,363
242,59,3,4,5,8,-68,44,0,7,170,407
242,60,3,4,4,9,31,-55,1,2,201,352
242,61,4,3,9,4,45,31,6,3,246,383
242,62,3,4,8,5,-65,41,1,4,181,424
242,63,4,3,6,7,42,34,3,8,223,458
242,64,3,4,7,6,34,-58,7,0,257,400
242,65,3,3,9,4,-64,31,3,1,193,431
242,66,2,5,3,10,21,55,4,6,214,486
242,67,2,4,6,7,24,43,8,9,238,529
243,1,3,5,4,9,31,54,1,4,31,54
243,2,2,4,6,7,24,43,5,7,55,97
243,3,3,3,6,7,33,-66,8,1,88,31
243,4,5,2,11,2,-44,20,4,1,44,51
243,5,2,6,4,9,22,63,6,4,66,114
243,6,3,4,5,8,32,44,8,8,98,158
243,7,2,4,5,8,-77,-56,1,2,21,102
243,8,2,4,6,7,24,43,5,5,45,145
243,9,2,5,4,9,22,54,7,9,67,199
243,10,3,3,5,8,32,-65,9,4,99,134
243,11,4,3,6,7,-58,34,1,8,41,168
243,12,3,3,7,6,34,-67,5,1,75,101
243,13,2,4,2,11,20,47,5,8,95,148
243,14,3,4,8,5,-65,41,0,9,30,189
243,15,3,4,6,7,33,-57,3,2,63,132
243,16,6,2,9,4,63,22,6,4,126,154
243,17,4,2,6,7,42,25,8,9,168,179
243,18,3,4,4,9,31,-55,9,4,199,124
243,19,3,3,6,7,-67,34,2,8,132,158
243,20,2,4,4,9,22,-55,4,3,154,103
243,21,4,3,5,8,41,35,5,8,195,138
243,22,3,4,8,5,-65,41,0,9,130,179
243,23,2,4,2,11,20,-53,0,6,150,126
243,24,3,3,6,7,33,-66,3,0,183,60
243,25,3,3,9,4,36,31,9,1,219,91
243,26,3,3,10,3,-63,30,6,1,156,121
243,27,2,5,3,10,21,55,7,6,177,176
243,28,3,3,7,6,-66,33,1,9,111,209
243,29,3,4,6,7,33,-57,4,2,144,152
243,30,4,3,5,8,41,35,5,7,185,187
243,31,4,3,7,6,43,-67,8,0,228,120
243,32,4,3,8,5,-56,32,2,2,172,152
243,33,2,4,4,9,22,45,4,7,194,197
243,34,4,3,5,8,41,-65,5,2,235,132
243,35,2,5,5,8,23,53,8,5,258,185
243,36,4,2,7,6,-57,24,1,9,201,209
243,37,3,3,7,6,34,-67,5,2,235,142
243,38,5,2,11,2,-44,20,1,2,191,162
243,39,3,4,6,7,33,43,4,5,224,205
243,40,3,3,6,7,33,34,7,9,257,239
243,41,4,3,8,5,-56,-68,1,1,201,171
243,42,2,4,4,9,22,45,3,6,223,216
243,43,2,4,6,7,24,43,7,9,247,259
243,44,2,4,4,9,22,-55,9,4,269,204
243,45,3,3,8,5,-65,32,4,6,204,236
243,46,3,3,6,7,33,-66,7,0,237,170
243,47,3,4,6,7,-67,43,0,3,170,213
243,48,4,2,9,4,45,22,5,5,215,235
243,49,4,4,9,4,-55,40,0,5,160,275
243,50,2,4,5,8,23,44,3,9,183,319
243,51,4,2,7,6,43,-76,6,3,226,243
243,52,3,4,6,7,33,43,9,6,259,286
243,53,3,4,7,6,-66,42,3,8,193,328
243,54,3,3,9,4,36,31,9,9,229,359
243,55,3,3,5,8,-68,-65,1,4,161,294
243,56,2,6,3,10,21,64,2,8,182,358
243,57,3,3,5,8,32,-65,4,3,214,293
243,58,6,2,10,3,64,21,8,4,278,314
243,59,3,4,5,8,-68,44,0,8,210,358
243,60,2,4,6,7,24,-57,4,1,234,301
243,61,2,5,5,8,23,53,7,4,257,354
243,62,3,3,5,8,32,35,9,9,289,389
243,63,2,4,4,9,-78,-55,1,4,211,334
243,64,3,3,9,4,36,31,7,5,247,365
243,65,2,4,4,9,22,-55,9,0,269,310
243,66,4,3,8,5,-56,32,3,2,213,342
243,67,4,4,6,7,42,43,5,5,255,385
243,68,4,2,6,7,42,-75,7,0,297,310
243,69,2,4,5,8,-77,44,0,4,220,354
243,70,3,3,5,8,32,35,2,9,252,389
243,71,4,2,6,7,42,-75,4,4,294,314
243,72,4,2,6,7,42,25,6,9,336,339
243,73,2,5,4,9,22,-46,8,3,358,293
243,74,4,3,8,5,-56,32,2,5,302,325
243,75,3,4,6,7,33,43,5,8,335,368
243,76,3,3,6,7,33,-66,8,2,368,302
243,77,4,3,7,6,-57,33,1,5,311,335
243,78,2,6,4,9,22,63,3,8,333,398
243,79,4,3,6,7,42,-66,5,2,375,332
243,80,3,3,8,5,-65,32,0,4,310,364
243,81,4,3,8,5,44,32,4,6,354,396
243,82,4,3,7,6,43,33,7,9,397,429
243,83,2,4,8,5,-74,-59,3,0,323,370
243,84,4,3,5,8,41,35,4,5,364,405
243,85,3,3,8,5,35,32,9,7,399,437
243,86,3,3,6,7,-67,-66,2,1,332,371
243,87,3,3,9,4,36,31,8,2,368,402
243,88,3,3,7,6,-66,33,2,5,302,435
243,89,3,3,7,6,34,33,6,8,336,468
243,90,2,4,6,7,-76,-57,0,1,260,411
243,91,3,3,9,4,36,31,6,2,296,442
243,92,4,2,6,7,42,25,8,7,338,467
243,93,3,3,9,4,-64,31,4,8,274,498
243,94,5,2,8,5,53,-77,7,1,327,421
243,95,5,2,8,5,-47,23,0,4,280,444
243,96,3,3,5,8,32,35,2,9,312,479
243,97,4,3,9,4,45,-69,7,0,357,410
243,98,3,4,7,6,-66,42,1,2,291,452
243,99,6,2,10,3,64,21,5,3,355,473
243,100,4,4,7,6,43,42,8,5,398,515
244,1,2,4,4,9,22,45,2,5,22,45
244,2,3,3,6,7,33,34,5,9,55,79
244,3,4,2,8,5,44,-77,9,2,99,2
244,4,3,4,6,7,-67,43,2,5,32,45
244,5,4,2,7,6,43,24,5,9,75,69
244,6,2,4,4,9,22,-55,7,4,97,14
244,7,2,4,4,9,22,45,9,9,119,59
244,8,4,3,6,7,-58,-66,1,3,61,-7
244,9,4,3,5,8,41,35,2,8,102,28
244,10,3,3,8,5,35,-68,7,0,137,-40
244,11,4,3,8,5,-56,32,1,2,81,-8
244,12,4,3,8,5,44,32,5,4,125,24
244,13,2,5,6,7,24,52,9,6,149,76
244,14,2,4,7,6,-75,42,4,8,74,118
244,15,3,3,6,7,33,-66,7,2,107,52
244,16,2,6,4,9,22,63,9,5,129,115
244,17,3,4,6,7,-67,43,2,8,62,158
244,18,3,3,8,5,35,-68,7,0,97,90
244,19,4,3,9,4,-55,31,2,1,42,121
244,20,4,3,8,5,44,32,6,3,86,153
244,21,3,4,7,6,-66,42,0,5,20,195
244,22,4,2,7,6,43,24,3,9,63,219
244,23,4,3,8,5,44,-68,7,1,107,151
244,24,3,4,4,9,31,45,8,6,138,196
244,25,3,4,5,8,-68,-56,0,0,70,140
244,26,4,3,8,5,44,32,4,2,114,172
244,27,4,3,10,3,-54,30,0,2,60,202
244,28,2,6,4,9,22,63,2,5,82,265
244,29,3,3,6,7,33,34,5,9,115,299
244,30,3,4,7,6,34,-58,9,1,149,241
244,31,5,2,10,3,-45,21,4,2,104,262
244,32,3,4,5,8,32,44,6,6,136,306
244,33,4,3,9,4,-55,31,1,7,81,337
244,34,3,3,5,8,32,-65,3,2,113,272
244,35,2,4,3,10,21,46,4,8,134,318
244,36,2,4,6,7,24,-57,8,1,158,261
244,37,2,4,5,8,-77,44,1,5,81,305
244,38,4,2,6,7,42,-75,3,0,123,230
244,39,3,4,3,10,30,46,3,6,153,276
244,40,2,5,7,6,25,51,8,7,178,327
244,41,4,2,7,6,-57,-76,1,1,121,251
244,42,4,3,9,4,45,31,6,2,166,282
244,43,4,3,9,4,-55,31,1,3,111,313
244,44,5,2,10,3,55,21,6,4,166,334
244,45,4,3,9,4,-55,31,1,5,111,365
244,46,2,5,4,9,22,54,3,9,133,419
244,47,3,3,5,8,32,-65,5,4,165,354
244,48,2,4,4,9,22,45,7,9,187,399
244,49,4,2,7,6,-57,-76,0,3,130,323
244,50,5,2,10,3,55,21,5,4,185,344
244,51,5,2,9,4,54,22,9,6,239,366
244,52,5,2,10,3,-45,21,4,7,194,387
244,53,2,5,2,11,20,-44,4,3,214,343
244,54,5,2,10,3,55,21,9,4,269,364
244,55,6,2,9,4,-37,22,2,6,232,386
244,56,4,3,9,4,45,31,7,7,277,417
244,57,4,3,8,5,-56,32,1,9,221,449
244,58,3,3,6,7,33,-66,4,3,254,383
244,59,3,3,5,8,32,35,6,8,286,418
244,60,3,3,7,6,-66,-67,0,1,220,351
244,61,4,3,7,6,43,33,3,4,263,384
244,62,2,4,4,9,22,45,5,9,285,429
244,63,2,6,4,9,22,-37,7,2,307,392
244,64,4,2,8,5,-56,23,1,5,251,415
244,65,4,3,7,6,43,33,4,8,294,448
244,66,2,4,5,8,23,-56,7,2,317,392
244,67,5,2,10,3,-45,21,2,3,272,413
244,68,4,2,8,5,44,23,6,6,316,436
244,69,5,2,8,5,53,23,9,9,369,459
244,70,2,4,6,7,-76,-57,3,2,293,402
244,71,2,5,3,10,21,55,4,7,314,457
244,72,4,2,7,6,43,-76,7,1,357,381
244,73,2,5,5,8,-77,53,0,4,280,434
244,74,5,2,8,5,53,23,3,7,333,457
244,75,2,4,4,9,22,-55,5,2,355,402
244,76,4,2,9,4,-55,22,0,4,300,424
244,77,2,5,4,9,22,54,2,8,322,478
244,78,2,5,4,9,22,-46,4,2,344,432
244,79,5,2,7,6,52,24,6,6,396,456
244,80,5,2,10,3,-45,21,1,7,351,477
244,81,5,2,10,3,55,21,6,8,406,498
244,82,4,3,6,7,42,-66,8,2,448,432
244,83,5,2,10,3,-45,21,3,3,403,453
244,84,4,2,10,3,46,21,9,4,449,474
244,85,3,3,8,5,-65,32,4,6,384,506
245,1,4,3,9,4,45,31,5,1,45,31
245,2,6,2,11,2,-35,20,0,1,10,51
245,3,2,5,3,10,21,55,1,6,31,106
245,4,4,3,4,9,40,-64,1,2,71,42
245,5,2,6,2,11,20,65,1,7,91,107
245,6,5,3,10,3,55,30,6,7,146,137
245,7,5,2,7,6,52,-76,8,1,198,61
245,8,3,4,8,5,-65,41,3,2,133,102
245,9,4,4,8,5,44,41,7,3,177,143
245,10,2,4,5,8,-77,44,0,7,100,187
245,11,3,4,7,6,34,42,4,9,134,229
245,12,3,3,7,6,34,-67,8,2,168,162
245,13,2,4,4,9,-78,45,0,7,90,207
245,14,3,4,7,6,34,42,4,9,124,249
245,15,4,2,7,6,43,-76,7,3,167,173
245,16,4,3,8,5,-56,32,1,5,111,205
245,17,2,5,5,8,23,53,4,8,134,258
245,18,4,2,10,3,-54,21,0,9,80,279
245,19,4,3,8,5,44,-68,4,1,124,211
245,20,3,4,5,8,32,44,6,5,156,255
245,21,4,2,6,7,42,-75,8,0,198,180
245,22,3,4,4,9,31,45,9,5,229,225
245,23,2,4,6,7,-76,43,3,8,153,268
245,24,3,4,6,7,33,-57,6,1,186,211
245,25,2,4,4,9,22,45,8,6,208,256
245,26,3,3,8,5,-65,32,3,8,143,288
245,27,3,4,6,7,33,-57,6,1,176,231
245,28,3,4,7,6,-66,42,0,3,110,273
245,29,3,4,3,10,30,46,0,9,140,319
245,30,2,5,3,10,21,-45,1,4,161,274
245,31,3,3,5,8,32,35,3,9,193,309
245,32,3,4,7,6,34,-58,7,1,227,251
245,33,2,4,5,8,-77,44,0,5,150,295
245,34,2,4,5,8,23,44,3,9,173,339
245,35,2,4,7,6,25,-58,8,1,198,281
245,36,3,5,7,6,-66,51,2,2,132,332
245,37,5,2,7,6,52,24,4,6,184,356
245,38,4,3,8,5,44,32,8,8,228,388
245,39,3,3,7,6,-66,-67,2,1,162,321
245,40,3,3,6,7,33,34,5,5,195,355
245,41,2,4,4,9,22,-55,7,0,217,300
245,42,3,3,7,6,-66,33,1,3,151,333
245,43,4,2,8,5,44,23,5,6,195,356
245,44,4,3,7,6,43,33,8,9,238,389
245,45,4,2,7,6,-57,-76,1,3,181,313
245,46,3,4,6,7,33,43,4,6,214,356
245,47,2,4,8,5,-74,41,0,7,140,397
245,48,2,4,3,10,21,-54,1,3,161,343
245,49,3,3,5,8,32,35,3,8,193,378
245,50,3,4,5,8,32,-56,5,2,225,322
245,51,4,3,7,6,43,33,8,5,268,355
245,52,5,2,10,3,-45,21,3,6,223,376
245,53,2,4,6,7,24,43,7,9,247,419
245,54,2,6,5,8,-77,-38,0,1,170,381
245,55,3,3,5,8,32,35,2,6,202,416
245,56,4,3,8,5,44,32,6,8,246,448
245,57,4,2,11,2,-53,20,3,8,193,468
245,58,5,2,9,4,54,-78,7,0,247,390
245,59,2,4,7,6,-75,42,2,2,172,432
245,60,3,4,5,8,32,44,4,6,204,476
245,61,3,4,8,5,35,41,9,7,239,517
246,1,5,2,9,4,54,22,4,2,54,22
246,2,4,2,6,7,42,25,6,7,96,47
246,3,3,3,8,5,-65,32,1,9,31,79
246,4,2,4,8,5,26,-59,7,0,57,20
246,5,3,5,4,9,31,54,8,4,88,74
246,6,4,3,9,4,-55,31,3,5,33,105
246,7,2,5,3,10,21,-45,4,0,54,60
246,8,3,3,7,6,34,33,8,3,88,93
246,9,4,3,6,7,-58,34,0,7,30,127
246,10,3,3,6,7,33,-66,3,1,63,61
246,11,3,4,6,7,33,43,6,4,96,104
246,12,4,2,7,6,43,24,9,8,139,128
246,13,5,2,9,4,-46,-78,3,0,93,50
246,14,4,2,7,6,43,24,6,4,136,74
246,15,2,6,2,11,20,65,6,9,156,139
246,16,2,6,3,10,21,-36,7,3,177,103
246,17,3,3,5,8,32,35,9,8,209,138
246,18,3,3,9,4,-64,31,5,9,145,169
246,19,5,3,7,6,52,-67,7,2,197,102
246,20,2,4,6,7,-76,43,1,5,121,145
246,21,4,3,7,6,43,33,4,8,164,178
246,22,4,2,8,5,44,-77,8,1,208,101
246,23,2,6,3,10,21,64,9,5,229,165
246,24,4,2,6,7,-58,-75,1,0,171,90
246,25,4,3,6,7,42,34,3,4,213,124
246,26,4,2,8,5,44,23,7,7,257,147
246,27,2,5,4,9,22,-46,9,1,279,101
246,28,2,5,3,10,-79,55,0,6,200,156
246,29,4,2,6,7,42,-75,2,1,242,81
246,30,4,3,9,4,45,31,7,2,287,112
246,31,4,3,8,5,-56,32,1,4,231,144
246,32,4,2,8,5,44,23,5,7,275,167
246,33,2,4,6,7,24,-57,9,0,299,110
246,34,4,2,7,6,-57,24,2,4,242,134
246,35,2,6,3,10,21,64,3,8,263,198
246,36,2,4,6,7,24,-57,7,1,287,141
246,37,3,3,8,5,-65,32,2,3,222,173
246,38,3,3,6,7,33,34,5,7,255,207
246,39,3,3,7,6,34,-67,9,0,289,140
246,40,4,2,6,7,-58,25,1,5,231,165
246,41,2,5,4,9,22,54,3,9,253,219
246,42,2,5,4,9,22,-46,5,3,275,173
246,43,4,3,8,5,44,32,9,5,319,205
246,44,4,2,8,5,-56,23,3,8,263,228
246,45,4,2,11,2,-53,20,0,8,210,248
246,46,2,4,6,7,24,-57,4,1,234,191
246,47,4,3,7,6,43,33,7,4,277,224
246,48,2,4,6,7,-76,43,1,7,201,267
246,49,3,3,6,7,33,-66,4,1,234,201
246,50,3,4,6,7,33,43,7,4,267,244
246,51,2,4,7,6,-75,42,2,6,192,286
246,52,3,3,7,6,34,33,6,9,226,319
246,53,5,3,7,6,52,-67,8,2,278,252
246,54,4,3,9,4,-55,31,3,3,223,283
246,55,3,4,8,5,35,41,8,4,258,324
246,56,2,4,5,8,-77,44,1,8,181,368
246,57,4,3,7,6,43,-67,4,1,224,301
246,58,2,4,7,6,25,42,9,3,249,343
246,59,2,4,9,4,-73,40,6,3,176,383
246,60,2,4,4,9,22,45,8,8,198,428
246,61,4,3,8,5,-56,-68,2,0,142,360
246,62,5,2,10,3,55,21,7,1,197,381
246,63,5,2,9,4,-46,22,1,3,151,403
246,64,2,4,4,9,22,45,3,8,173,448
246,65,5,2,9,4,54,-78,7,0,227,370
246,66,3,4,7,6,-66,42,1,2,161,412
246,67,4,2,6,7,42,25,3,7,203,437
246,68,3,4,8,5,35,41,8,8,238,478
246,69,6,2,9,4,-37,-78,1,0,201,400
246,70,3,4,7,6,34,42,5,2,235,442
246,71,4,2,5,8,41,26,6,8,276,468
246,72,5,3,9,4,-46,31,0,9,230,499
246,73,4,3,8,5,44,-68,4,1,274,431
246,74,2,4,3,10,21,46,5,7,295,477
246,75,4,3,5,8,41,-65,6,2,336,412
246,76,3,3,5,8,32,35,8,7,368,447
246,77,3,3,8,5,-65,32,3,9,303,479
246,78,4,3,7,6,43,-67,6,2,346,412
246,79,4,2,6,7,42,25,8,7,388,437
246,80,3,3,8,5,-65,32,3,9,323,469
246,81,3,4,5,8,32,-56,5,3,355,413
246,82,3,4,6,7,33,43,8,6,388,456
246,83,2,4,3,10,21,-54,9,2,409,402
246,84,5,2,8,5,-47,23,2,5,362,425
246,85,2,4,6,7,24,43,6,8,386,468
246,86,3,3,8,5,-65,-68,1,0,321,400
246,87,5,2,8,5,53,23,4,3,374,423
246,88,4,2,7,6,43,24,7,7,417,447
246,89,5,2,9,4,-46,22,1,9,371,469
246,90,2,5,4,9,22,-46,3,3,393,423
246,91,6,2,10,3,64,21,7,4,457,444
246,92,2,4,5,8,-77,44,0,8,380,488
246,93,3,4,7,6,34,-58,4,0,414,430
246,94,3,3,8,5,35,32,9,2,449,462
246,95,5,2,6,7,-49,25,0,7,400,487
246,96,2,5,2,11,20,-44,0,3,420,443
246,97,3,3,8,5,35,32,5,5,455,475
246,98,3,3,8,5,-65,32,0,7,390,507
247,1,3,5,7,6,34,51,4,1,34,51
247,2,4,2,8,5,44,23,8,4,78,74
247,3,5,2,11,2,-44,20,4,4,34,94
247,4,6,2,7,6,61,24,5,8,95,118
247,5,2,5,2,11,20,-44,5,4,115,74
247,6,4,2,9,4,-55,22,0,6,60,96
247,7,4,2,7,6,43,-76,3,0,103,20
247,8,3,3,5,8,32,35,5,5,135,55
247,9,4,2,7,6,43,24,8,9,178,79
247,10,2,5,4,9,-78,-46,0,3,100,33
247,11,4,3,8,5,44,32,4,5,144,65
247,12,3,3,6,7,33,34,7,9,177,99
247,13,3,3,6,7,-67,-66,0,3,110,33
247,14,4,3,8,5,44,32,4,5,154,65
247,15,4,3,6,7,42,34,6,9,196,99
247,16,5,2,10,3,-45,-79,1,0,151,20
247,17,3,3,7,6,34,33,5,3,185,53
247,18,3,4,4,9,31,45,6,8,216,98
247,19,4,3,8,5,-56,-68,0,0,160,30
247,20,3,3,5,8,32,35,2,5,192,65
247,21,5,2,8,5,53,23,5,8,245,88
247,22,4,2,7,6,43,-76,8,2,288,12
247,23,2,4,7,6,-75,42,3,4,213,54
247,24,3,3,6,7,33,34,6,8,246,88
247,25,4,2,7,6,43,-76,9,2,289,12
247,26,3,3,7,6,-66,33,3,5,223,45
247,27,2,5,4,9,22,54,5,9,245,99
247,28,3,3,9,4,-64,-69,1,0,181,30
247,29,3,4,4,9,31,45,2,5,212,75
247,30,2,4,5,8,23,44,5,9,235,119
247,31,2,5,3,10,21,-45,6,4,256,74
247,32,5,2,7,6,52,24,8,8,308,98
247,33,3,3,5,8,-68,-65,0,3,240,33
247,34,3,3,7,6,34,33,4,6,274,66
247,35,3,3,6,7,33,-66,7,0,307,0
247,36,4,3,6,7,42,34,9,4,349,34
247,37,3,4,5,8,-68,44,1,8,281,78
247,38,4,3,5,8,41,-65,2,3,322,13
247,39,3,3,8,5,35,32,7,5,357,45
247,40,3,4,5,8,32,44,9,9,389,89
247,41,3,3,6,7,-67,-66,2,3,322,23
247,42,3,4,6,7,33,43,5,6,355,66
247,43,3,4,8,5,-65,41,0,7,290,107
247,44,3,3,5,8,32,-65,2,2,322,42
247,45,4,3,8,5,44,32,6,4,366,74
247,46,3,4,7,6,-66,42,0,6,300,116
247,47,4,3,6,7,42,-66,2,0,342,50
247,48,4,3,7,6,43,33,5,3,385,83
247,49,4,2,6,7,42,25,7,8,427,108
247,50,2,4,7,6,-75,-58,2,0,352,50
247,51,2,4,7,6,25,42,7,2,377,92
247,52,4,3,10,3,-54,30,3,2,323,122
247,53,2,6,4,9,22,63,5,5,345,185
247,54,2,5,3,10,21,-45,6,0,366,140
247,55,3,3,4,9,31,36,7,6,397,176
247,56,2,4,4,9,22,-55,9,1,419,121
247,57,4,2,10,3,-54,21,5,2,365,142
247,58,4,3,8,5,44,32,9,4,409,174
247,59,4,3,7,6,-57,33,2,7,352,207
247,60,2,4,3,10,21,-54,3,3,373,153
247,61,2,5,5,8,23,53,6,6,396,206
247,62,3,3,4,9,31,-64,7,2,427,142
247,63,4,2,7,6,-57,24,0,6,370,166
247,64,5,2,9,4,54,22,4,8,424,188
247,65,2,5,4,9,22,-46,6,2,446,142
247,66,4,2,10,3,-54,21,2,3,392,163
247,67,2,5,2,11,20,56,2,9,412,219
247,68,2,5,3,10,21,-45,3,4,433,174
247,69,5,3,7,6,52,33,5,7,485,207
247,70,4,2,7,6,43,-76,8,1,528,131
248,1,2,4,3,10,21,46,1,6,21,46
248,2,4,2,7,6,43,-76,4,0,64,-30
248,3,2,4,7,6,25,42,9,2,89,12
248,4,5,2,9,4,-46,22,3,4,43,34
248,5,3,3,4,9,31,-64,4,0,74,-30
248,6,2,5,5,8,23,53,7,3,97,23
248,7,5,2,8,5,-47,23,0,6,50,46
248,8,4,3,6,7,42,-66,2,0,92,-20
248,9,4,2,5,8,41,26,3,6,133,6
248,10,4,3,9,4,45,31,8,7,178,37
248,11,2,4,8,5,-74,41,4,8,104,78
248,12,3,3,5,8,32,-65,6,3,136,13
248,13,4,3,9,4,-55,31,1,4,81,44
248,14,4,2,7,6,43,24,4,8,124,68
248,15,4,3,5,8,41,-65,5,3,165,3
248,16,5,2,8,5,53,23,8,6,218,26
248,17,4,3,8,5,-56,32,2,8,162,58
248,18,5,2,9,4,54,-78,6,0,216,-20
248,19,4,4,7,6,43,42,9,2,259,22
248,20,3,3,4,9,-69,36,0,8,190,58
248,21,3,3,5,8,32,-65,2,3,222,-7
248,22,2,4,5,8,23,44,5,7,245,37
248,23,4,2,6,7,42,-75,7,2,287,-38
248,24,4,2,9,4,-55,22,2,4,232,-16
248,25,2,5,3,10,21,55,3,9,253,39
248,26,3,3,8,5,35,-68,8,1,288,-29
248,27,4,3,7,6,-57,33,1,4,231,4
248,28,2,5,3,10,21,55,2,9,252,59
248,29,3,4,6,7,33,-57,5,2,285,2
248,30,3,4,6,7,33,43,8,5,318,45
248,31,4,2,5,8,41,-74,9,1,359,-29
248,32,4,3,7,6,-57,33,2,4,302,4
248,33,4,3,9,4,45,31,7,5,347,35
248,34,2,5,3,10,21,-45,8,0,368,-10
248,35,5,2,10,3,-45,21,3,1,323,11
248,36,2,5,6,7,24,52,7,3,347,63
248,37,3,4,6,7,-67,43,0,6,280,106
248,38,3,4,5,8,32,-56,2,0,312,50
248,39,3,3,9,4,36,31,8,1,348,81
248,40,5,2,9,4,-46,22,2,3,302,103
248,41,3,3,8,5,35,32,7,5,337,135
248,42,3,3,6,7,-67,34,0,9,270,169
248,43,4,3,8,5,44,-68,4,1,314,101
248,44,3,3,9,4,-64,31,0,2,250,132
248,45,3,4,8,5,35,41,5,3,285,173
248,46,3,3,7,6,34,33,9,6,319,206
248,47,3,4,6,7,-67,43,2,9,252,249
248,48,5,2,10,3,55,-79,7,0,307,170
248,49,4,2,5,8,41,26,8,6,348,196
248,50,4,2,9,4,-55,22,3,8,293,218
248,51,4,2,9,4,45,-78,8,0,338,140
248,52,3,3,6,7,-67,34,1,4,271,174
248,53,4,3,7,6,43,33,4,7,314,207
248,54,2,4,8,5,-74,41,0,8,240,248
248,55,3,3,7,6,34,-67,4,1,274,181
248,56,5,3,8,5,53,32,7,3,327,213
248,57,5,2,9,4,-46,22,1,5,281,235
248,58,4,3,7,6,43,33,4,8,324,268
248,59,3,4,8,5,35,41,9,9,359,309
248,60,2,5,4,9,-78,-46,1,3,281,263
248,61,4,2,8,5,44,23,5,6,325,286
248,62,5,3,9,4,54,31,9,7,379,317
248,63,5,3,9,4,-46,31,3,8,333,348
248,64,4,3,7,6,43,-67,6,1,376,281
248,65,2,4,4,9,22,45,8,6,398,326
248,66,3,3,6,7,-67,-66,1,0,331,260
248,67,2,4,2,11,20,47,1,7,351,307
248,68,5,2,7,6,52,-76,3,1,403,231
248,69,4,3,8,5,44,32,7,3,447,263
248,70,3,4,8,5,-65,41,2,4,382,304
248,71,2,4,2,11,20,-53,2,1,402,251
248,72,3,3,10,3,37,30,9,1,439,281
248,73,3,3,7,6,-66,33,3,4,373,314
248,74,4,2,6,7,42,25,5,9,415,339
248,75,2,4,4,9,22,-55,7,4,437,284
248,76,4,3,10,3,-54,30,3,4,383,314
248,77,2,4,4,9,22,45,5,9,405,359
248,78,2,4,7,6,-75,-58,0,1,330,301
248,79,4,2,5,8,41,26,1,7,371,327
248,80,2,4,4,9,22,-55,3,2,393,272
248,81,3,3,8,5,35,32,8,4,428,304
248,82,5,2,9,4,-46,22,2,6,382,326
248,83,3,3,7,6,34,33,6,9,416,359
248,84,3,4,4,9,31,-55,7,4,447,304
248,85,3,4,5,8,32,44,9,8,479,348
248,86,3,3,7,6,-66,-67,3,1,413,281
248,87,3,4,6,7,33,43,6,4,446,324
248,88,4,2,9,4,-55,22,1,6,391,346
248,89,4,2,7,6,43,-76,4,0,434,270
248,90,2,4,5,8,23,44,7,4,457,314
248,91,2,4,7,6,-75,42,2,6,382,356
248,92,4,3,9,4,45,31,7,7,427,387
248,93,4,4,8,5,-56,41,1,8,371,428
248,94,3,4,8,5,35,41,6,9,406,469
248,95,6,2,11,2,-35,20,1,9,371,489
248,96,3,4,5,8,32,-56,3,3,403,433
248,97,4,2,10,3,46,21,9,4,449,454
248,98,6,2,8,5,-38,23,1,7,411,477
248,99,5,2,11,2,56,20,7,7,467,497
248,100,4,3,4,9,40,-64,7,3,507,433
249,1,4,2,9,4,45,22,5,2,45,22
249,2,2,5,4,9,22,54,7,6,67,76
249,3,4,4,5,8,41,-56,8,0,108,20
249,4,3,4,7,6,-66,42,2,2,42,62
249,5,4,3,8,5,44,32,6,4,86,94
249,6,4,2,7,6,43,24,9,8,129,118
249,7,2,6,2,11,20,-35,9,3,149,83
249,8,4,2,4,9,40,-73,9,0,189,10
249,9,4,3,8,5,-56,32,3,2,133,42
249,10,4,2,9,4,45,22,8,4,178,64
249,11,3,4,4,9,31,45,9,9,209,109
249,12,4,2,8,5,-56,-77,3,2,153,32
249,13,3,4,3,10,30,46,3,8,183,78
249,14,2,5,3,10,21,-45,4,3,204,33
249,15,4,3,7,6,43,33,7,6,247,66
249,16,4,3,8,5,-56,32,1,8,191,98
249,17,3,3,5,8,32,-65,3,3,223,33
249,18,3,4,6,7,33,43,6,6,256,76
249,19,2,5,3,10,21,-45,7,1,277,31
249,20,5,2,8,5,-47,23,0,4,230,54
249,21,3,3,7,6,34,33,4,7,264,87
249,22,3,4,4,9,31,-55,5,2,295,32
249,23,2,5,4,9,22,54,7,6,317,86
249,24,2,4,3,10,21,-54,8,2,338,32
249,25,4,3,6,7,-58,34,0,6,280,66
249,26,4,2,5,8,41,-74,1,2,321,-8
249,27,4,4,8,5,44,41,5,3,365,33
249,28,4,3,5,8,41,35,6,8,406,68
249,29,4,3,6,7,42,-66,8,2,448,2
249,30,3,3,7,6,-66,33,2,5,382,35
249,31,3,3,7,6,34,33,6,8,416,68
249,32,2,4,3,10,21,-54,7,4,437,14
249,33,3,4,3,10,30,-54,7,0,467,-40
249,34,3,4,5,8,32,44,9,4,499,4
249,35,3,3,6,7,-67,34,2,8,432,38
249,36,3,4,5,8,32,-56,4,2,464,-18
249,37,4,2,9,4,45,22,9,4,509,4
250,1,3,3,7,6,34,33,4,3,34,33
250,2,4,2,6,7,42,25,6,8,76,58
250,3,3,4,5,8,32,-56,8,2,108,2
250,4,4,2,9,4,-55,22,3,4,53,24
250,5,3,3,7,6,34,33,7,7,87,57
250,6,2,4,7,6,-75,42,2,9,12,99
250,7,3,4,9,4,36,40,8,9,48,139
250,8,2,4,5,8,-77,-56,1,3,-29,83
250,9,4,3,7,6,43,33,4,6,14,116
250,10,3,3,9,4,-64,31,0,7,-50,147
250,11,2,5,3,10,21,-45,1,2,-29,102
250,12,5,2,9,4,54,22,5,4,25,124
250,13,2,5,5,8,23,53,8,7,48,177
250,14,2,5,3,10,21,-45,9,2,69,132
250,15,4,3,7,6,-57,33,2,5,12,165
250,16,2,4,4,9,22,-55,4,0,34,110
250,17,2,4,6,7,24,43,8,3,58,153
250,18,3,3,7,6,-66,33,2,6,-8,186
250,19,3,4,6,7,33,43,5,9,25,229
250,20,2,4,6,7,24,-57,9,2,49,172
250,21,2,4,4,9,-78,45,1,7,-29,217
250,22,4,2,8,5,44,-77,5,0,15,140
250,23,2,4,5,8,23,44,8,4,38,184
250,24,3,3,6,7,-67,34,1,8,-29,218
250,25,2,5,5,8,23,-47,4,1,-6,171
250,26,2,6,2,11,20,65,4,6,14,236
250,27,2,5,5,8,23,53,7,9,37,289
250,28,3,3,9,4,-64,-69,3,0,-27,220
250,29,4,2,10,3,46,21,9,1,19,241
250,30,3,3,8,5,-65,32,4,3,-46,273
250,31,2,5,5,8,23,53,7,6,-23,326
250,32,3,3,10,3,-63,30,4,6,-86,356
250,33,3,4,6,7,33,43,7,9,-53,399
250,34,4,3,8,5,-56,-68,1,1,-109,331
250,35,4,2,8,5,44,23,5,4,-65,354
250,36,5,2,10,3,-45,21,0,5,-110,375
250,37,2,4,6,7,24,43,4,8,-86,418
250,38,3,3,7,6,34,-67,8,1,-52,351
250,39,2,6,3,10,21,64,9,5,-31,415
250,40,4,3,6,7,-58,34,1,9,-89,449
250,41,5,2,10,3,55,-79,6,0,-34,370
250,42,4,2,7,6,43,24,9,4,9,394
250,43,4,3,7,6,-57,33,2,7,-48,427
250,44,3,3,8,5,35,32,7,9,-13,459
250,45,4,2,5,8,41,-74,8,5,28,385
250,46,2,4,4,9,-78,-55,0,0,-50,330
250,47,2,4,5,8,23,44,3,4,-27,374
250,48,3,3,4,9,31,-64,4,0,4,310
250,49,3,4,7,6,34,42,8,2,38,352
250,50,4,3,9,4,-55,31,3,3,-17,383
250,51,2,6,2,11,20,65,3,8,3,448
250,52,4,3,7,6,43,-67,6,1,46,381
250,53,6,2,10,3,-36,21,0,2,10,402
250,54,2,5,4,9,22,54,2,6,32,456
250,55,3,4,6,7,33,43,5,9,65,499
250,56,2,5,6,7,24,-48,9,1,89,451
250,57,3,3,8,5,-65,32,4,3,24,483
250,58,4,2,6,7,42,25,6,8,66,508
251,1,4,3,6,7,42,34,2,4,42,34
251,2,3,4,4,9,31,45,3,9,73,79
251,3,5,2,10,3,55,-79,8,0,128,0
251,4,2,5,6,7,-76,52,2,2,52,52
251,5,5,2,7,6,52,24,4,6,104,76
251,6,5,2,7,6,52,-76,6,0,156,0
251,7,2,5,3,10,21,55,7,5,177,55
251,8,4,2,8,5,-56,23,1,8,121,78
251,9,2,5,5,8,23,-47,4,1,144,31
251,10,4,2,6,7,42,25,6,6,186,56
251,11,5,2,10,3,-45,21,1,7,141,77
251,12,3,3,5,8,32,-65,3,2,173,12
251,13,5,2,10,3,55,21,8,3,228,33
251,14,3,4,6,7,-67,43,1,6,161,76
251,15,4,3,8,5,44,32,5,8,205,108
251,16,4,3,9,4,-55,31,0,9,150,139
251,17,2,5,5,8,23,-47,3,2,173,92
251,18,5,2,9,4,54,22,7,4,227,114
251,19,4,4,6,7,42,43,9,7,269,157
251,20,3,3,6,7,-67,-66,2,1,202,91
251,21,4,3,7,6,43,33,5,4,245,124
251,22,6,2,7,6,61,24,6,8,306,148
251,23,4,3,7,6,43,-67,9,1,349,81
251,24,4,3,6,7,-58,34,1,5,291,115
251,25,4,3,6,7,42,34,3,9,333,149
251,26,3,3,3,10,30,-63,3,6,363,86
251,27,4,3,7,6,43,33,6,9,406,119
251,28,3,3,6,7,33,-66,9,3,439,53
251,29,2,4,5,8,-77,44,2,7,362,97
251,30,3,3,3,10,30,-63,2,4,392,34
251,31,3,3,7,6,34,33,6,7,426,67
251,32,3,4,7,6,-66,42,0,9,360,109
251,33,2,4,6,7,24,-57,4,2,384,52
251,34,3,4,3,10,30,46,4,8,414,98
251,35,5,2,10,3,55,21,9,9,469,119
251,36,2,5,5,8,-77,-47,2,2,392,72
251,37,3,3,5,8,32,35,4,7,424,107
251,38,4,3,6,7,42,-66,6,1,466,41
251,39,2,4,5,8,23,44,9,5,489,85
251,40,4,4,5,8,-59,44,0,9,430,129
251,41,3,3,5,8,32,-65,2,4,462,64
251,42,4,2,9,4,45,22,7,6,507,86
252,1,2,5,3,10,21,55,1,5,21,55
252,2,3,3,7,6,34,33,5,8,55,88
252,3,5,3,8,5,53,-68,8,0,108,20
252,4,3,3,4,9,31,36,9,6,139,56
252,5,3,4,5,8,-68,-56,1,0,71,0
252,6,3,3,5,8,32,35,3,5,103,35
252,7,5,2,9,4,54,22,7,7,157,57
252,8,3,4,5,8,32,-56,9,1,189,1
252,9,4,2,9,4,-55,22,4,3,134,23
252,10,4,2,9,4,45,22,9,5,179,45
252,11,5,2,10,3,-45,21,4,6,134,66
252,12,3,4,7,6,34,42,8,8,168,108
252,13,3,3,4,9,31,-64,9,4,199,44
252,14,3,3,8,5,-65,32,4,6,134,76
252,15,4,3,5,8,41,-65,5,1,175,11
252,16,3,3,4,9,31,36,6,7,206,47
252,17,4,2,9,4,-55,22,1,9,151,69
252,18,4,3,10,3,46,30,7,9,197,99
252,19,3,4,7,6,-66,-58,1,1,131,41
252,20,3,4,6,7,33,43,4,4,164,84
252,21,2,5,4,9,22,54,6,8,186,138
252,22,2,4,4,9,22,-55,8,3,208,83
252,23,3,4,6,7,-67,43,1,6,141,126
252,24,2,4,5,8,23,-56,4,0,164,70
252,25,3,4,7,6,34,42,8,2,198,112
252,26,4,2,7,6,-57,24,1,6,141,136
252,27,2,5,3,10,21,-45,2,1,162,91
252,28,3,3,7,6,34,33,6,4,196,124
252,29,5,2,10,3,-45,21,1,5,151,145
252,30,4,3,6,7,42,34,3,9,193,179
252,31,3,3,6,7,33,-66,6,3,226,113
252,32,4,3,9,4,-55,31,1,4,171,144
252,33,5,2,11,2,56,20,7,4,227,164
252,34,3,3,4,9,31,-64,8,0,258,100
252,35,4,3,6,7,-58,34,0,4,200,134
252,36,3,3,5,8,32,35,2,9,232,169
252,37,3,3,7,6,34,-67,6,2,266,102
252,38,5,2,7,6,52,24,8,6,318,126
252,39,4,3,7,6,-57,33,1,9,261,159
252,40,2,4,5,8,23,-56,4,3,284,103
252,41,2,4,4,9,22,45,6,8,306,148
252,42,2,4,5,8,23,-56,9,2,329,92
252,43,4,2,5,8,-59,26,0,8,270,118
252,44,4,2,9,4,45,-78,5,0,315,40
252,45,2,6,2,11,20,65,5,5,335,105
252,46,2,4,4,9,22,-55,7,0,357,50
252,47,4,4,6,7,42,43,9,3,399,93
252,48,4,3,6,7,-58,34,1,7,341,127
252,49,3,4,4,9,31,-55,2,2,372,72
252,50,4,3,8,5,44,32,6,4,416,104
252,51,4,2,8,5,-56,23,0,7,360,127
252,52,2,5,4,9,22,-46,2,1,382,81
252,53,3,3,6,7,33,34,5,5,415,115
252,54,3,4,5,8,32,44,7,9,447,159
252,55,3,3,8,5,-65,-68,2,1,382,91
252,56,4,3,9,4,45,31,7,2,427,122
252,57,2,5,6,7,-76,52,1,4,351,174
252,58,5,2,8,5,53,23,4,7,404,197
252,59,5,2,7,6,52,-76,6,1,456,121
252,60,2,4,6,7,-76,43,0,4,380,164
252,61,3,3,7,6,34,33,4,7,414,197
252,62,4,3,5,8,41,-65,5,2,455,132
252,63,3,3,8,5,-65,32,0,4,390,164
252,64,2,5,3,10,21,55,1,9,411,219
252,65,3,3,5,8,32,-65,3,4,443,154
252,66,4,3,9,4,45,31,8,5,488,185
252,67,3,3,8,5,-65,32,3,7,423,217
252,68,2,5,4,9,22,-46,5,1,445,171
252,69,4,2,7,6,43,24,8,5,488,195
252,70,3,4,4,9,31,-55,9,0,519,140
253,1,3,3,6,7,33,34,3,4,33,34
253,2,3,4,5,8,32,44,5,8,65,78
253,3,2,6,4,9,22,-37,7,1,87,41
253,4,5,2,8,5,-47,23,0,4,40,64
253,5,3,3,5,8,32,35,2,9,72,99
253,6,3,3,7,6,34,-67,6,2,106,32
253,7,5,2,11,2,-44,20,2,2,62,52
253,8,4,3,8,5,44,32,6,4,106,84
253,9,4,2,6,7,42,25,8,9,148,109
253,10,3,3,9,4,-64,-69,4,0,84,40
253,11,3,3,8,5,35,32,9,2,119,72
253,12,4,3,6,7,-58,34,1,6,61,106
253,13,3,4,6,7,33,43,4,9,94,149
253,14,3,3,3,10,30,-63,4,6,124,86
253,15,2,6,2,11,20,-35,4,1,144,51
253,16,2,5,5,8,23,53,7,4,167,104
253,17,4,3,7,6,-57,33,0,7,110,137
253,18,4,3,10,3,46,30,6,7,156,167
253,19,5,2,11,2,-44,20,2,7,112,187
253,20,4,2,6,7,42,-75,4,2,154,112
253,21,4,3,6,7,42,34,6,6,196,146
253,22,3,3,6,7,33,-66,9,0,229,80
253,23,4,3,9,4,-55,31,4,1,174,111
253,24,2,4,6,7,24,43,8,4,198,154
253,25,3,3,5,8,-68,35,0,9,130,189
253,26,3,3,6,7,33,-66,3,3,163,123
253,27,3,3,5,8,32,35,5,8,195,158
253,28,3,4,6,7,33,-57,8,1,228,101
253,29,4,3,6,7,-58,34,0,5,170,135
253,30,3,3,8,5,35,32,5,7,205,167
253,31,4,2,7,6,43,-76,8,1,248,91
253,32,3,4,4,9,31,45,9,6,279,136
253,33,2,5,3,10,-79,-45,0,1,200,91
253,34,4,3,7,6,43,33,3,4,243,124
253,35,2,5,5,8,23,53,6,7,266,177
253,36,3,4,7,6,-66,42,0,9,200,219
253,37,4,3,6,7,42,-66,2,3,242,153
253,38,3,3,5,8,32,35,4,8,274,188
253,39,4,2,9,4,45,-78,9,0,319,110
253,40,3,4,5,8,-68,44,1,4,251,154
253,41,2,4,2,11,20,-53,1,1,271,101
253,42,3,3,6,7,33,34,4,5,304,135
253,43,4,2,9,4,45,22,9,7,349,157
253,44,4,2,7,6,-57,-76,2,1,292,81
253,45,3,4,7,6,34,42,6,3,326,123
253,46,4,2,6,7,42,25,8,8,368,148
253,47,2,5,2,11,20,-44,8,4,388,104
253,48,2,4,4,9,-78,45,0,9,310,149
253,49,2,5,6,7,24,-48,4,1,334,101
253,50,4,3,7,6,43,33,7,4,377,134
253,51,3,3,6,7,-67,34,0,8,310,168
253,52,6,2,8,5,62,-77,2,1,372,91
253,53,4,2,7,6,43,24,5,5,415,115
253,54,2,4,3,10,21,-54,6,1,436,61
253,55,4,2,8,5,-56,23,0,4,380,84
253,56,4,4,8,5,44,41,4,5,424,125
253,57,3,4,4,9,31,-55,5,0,455,70
253,58,3,3,5,8,32,35,7,5,487,105
253,59,3,3,8,5,-65,32,2,7,422,137
253,60,4,3,5,8,41,-65,3,2,463,72
253,61,3,3,9,4,36,31,9,3,499,103
253,62,4,2,9,4,-55,22,4,5,444,125
253,63,4,3,5,8,41,-65,5,0,485,60
253,64,3,3,7,6,34,33,9,3,519,93
254,1,2,5,2,11,20,56,0,6,20,56
254,2,4,3,4,9,40,-64,0,2,60,-8
254,3,4,3,5,8,41,35,1,7,101,27
254,4,3,3,5,8,32,-65,3,2,133,-38
254,5,2,4,9,4,-73,40,0,2,60,2
254,6,3,3,5,8,32,35,2,7,92,37
254,7,2,5,4,9,22,-46,4,1,114,-9
254,8,2,5,6,7,24,52,8,3,138,43
254,9,2,5,3,10,21,55,9,8,159,98
254,10,2,4,4,9,-78,-55,1,3,81,43
254,11,4,3,6,7,42,34,3,7,123,77
254,12,2,4,5,8,23,-56,6,1,146,21
254,13,2,5,5,8,23,53,9,4,169,74
254,14,5,2,8,5,-47,23,2,7,122,97
254,15,4,3,7,6,43,-67,5,0,165,30
254,16,5,2,9,4,54,22,9,2,219,52
254,17,4,3,5,8,-59,35,0,7,160,87
254,18,2,5,3,10,21,-45,1,2,181,42
254,19,3,3,6,7,33,34,4,6,214,76
254,20,3,3,6,7,33,-66,7,0,247,10
254,21,4,2,6,7,42,25,9,5,289,35
254,22,3,3,7,6,-66,33,3,8,223,68
254,23,3,4,6,7,33,-57,6,1,256,11
254,24,3,4,8,5,-65,41,1,2,191,52
254,25,4,3,7,6,43,33,4,5,234,85
254,26,6,2,10,3,64,21,8,6,298,106
254,27,4,2,7,6,-57,-76,1,0,241,30
254,28,3,3,8,5,35,32,6,2,276,62
254,29,4,3,5,8,41,35,7,7,317,97
254,30,4,3,9,4,-55,31,2,8,262,128
254,31,4,2,8,5,44,-77,6,1,306,51
254,32,2,5,3,10,21,55,7,6,327,106
254,33,4,3,7,6,-57,33,0,9,270,139
254,34,3,4,4,9,31,-55,1,4,301,84
254,35,4,3,9,4,45,31,6,5,346,115
254,36,2,5,2,11,20,-44,6,1,366,71
254,37,3,4,6,7,33,43,9,4,399,114
254,38,5,2,9,4,-46,22,3,6,353,136
254,39,3,3,6,7,33,-66,6,0,386,70
254,40,5,3,6,7,51,34,7,4,437,104
254,41,3,4,6,7,-67,43,0,7,370,147
254,42,5,2,8,5,53,-77,3,0,423,70
254,43,3,4,5,8,32,44,5,4,455,114
254,44,3,4,8,5,-65,41,0,5,390,155
254,45,4,2,8,5,44,23,4,8,434,178
254,46,5,2,9,4,54,-78,8,0,488,100
254,47,4,2,10,3,-54,21,4,1,434,121
254,48,5,2,9,4,54,22,8,3,488,143
254,49,3,3,6,7,-67,34,1,7,421,177
254,50,5,2,9,4,54,22,5,9,475,199
254,51,4,2,8,5,44,-77,9,2,519,122
255,1,2,5,4,9,22,54,2,4,22,54
255,2,3,3,6,7,33,34,5,8,55,88
255,3,2,5,4,9,22,-46,7,2,77,42
255,4,2,5,4,9,22,54,9,6,99,96
255,5,4,2,10,3,-54,21,5,7,45,117
255,6,4,3,9,4,-55,31,0,8,-10,148
255,7,4,3,5,8,41,-65,1,3,31,83
255,8,4,3,5,8,41,35,2,8,72,118
255,9,5,2,7,6,52,-76,4,2,124,42
255,10,3,3,7,6,34,33,8,5,158,75
255,11,4,2,7,6,-57,24,1,9,101,99
255,12,2,5,5,8,23,-47,4,2,124,52
255,13,4,2,7,6,43,24,7,6,167,76
255,14,3,3,7,6,-66,33,1,9,101,109
255,15,5,2,9,4,54,-78,5,1,155,31
255,16,3,4,4,9,31,45,6,6,186,76
255,17,2,5,4,9,22,-46,8,0,208,30
255,18,3,3,8,5,-65,32,3,2,143,62
255,19,2,5,2,11,20,56,3,8,163,118
255,20,5,2,10,3,55,21,8,9,218,139
255,21,4,3,5,8,41,-65,9,4,259,74
255,22,3,4,8,5,-65,41,4,5,194,115
255,23,3,3,4,9,31,-64,5,1,225,51
255,24,3,3,7,6,34,33,9,4,259,84
255,25,3,4,7,6,-66,42,3,6,193,126
255,26,4,3,8,5,44,32,7,8,237,158
255,27,3,3,8,5,-65,-68,2,0,172,90
255,28,4,2,9,4,45,22,7,2,217,112
255,29,4,3,5,8,41,35,8,7,258,147
255,30,3,4,8,5,-65,41,3,8,193,188
255,31,3,3,5,8,32,-65,5,3,225,123
255,32,4,2,10,3,-54,21,1,4,171,144
255,33,4,3,8,5,44,32,5,6,215,176
255,34,3,3,8,5,-65,32,0,8,150,208
255,35,3,3,5,8,32,-65,2,3,182,143
255,36,4,4,7,6,43,42,5,5,225,185
255,37,3,4,4,9,31,-55,6,0,256,130
255,38,3,4,6,7,33,43,9,3,289,173
255,39,3,4,5,8,-68,44,1,7,221,217
255,40,3,4,3,10,30,-54,1,3,251,163
255,41,3,3,5,8,32,35,3,8,283,198
255,42,2,4,6,7,24,-57,7,1,307,141
255,43,3,4,3,10,30,46,7,7,337,187
255,44,3,3,5,8,32,-65,9,2,369,122
255,45,5,2,10,3,-45,21,4,3,324,143
255,46,3,3,8,5,35,32,9,5,359,175
255,47,5,2,10,3,-45,21,4,6,314,196
255,48,3,3,7,6,34,33,8,9,348,229
255,49,6,2,10,3,-36,-79,2,0,312,150
255,50,2,4,5,8,23,44,5,4,335,194
255,51,4,3,9,4,-55,31,0,5,280,225
255,52,3,4,4,9,31,-55,1,0,311,170
255,53,3,3,7,6,34,33,5,3,345,203
255,54,3,5,4,9,31,54,6,7,376,257
255,55,3,4,4,9,31,-55,7,2,407,202
255,56,3,3,9,4,-64,31,3,3,343,233
255,57,3,4,9,4,36,40,9,3,379,273
255,58,4,2,9,4,-55,22,4,5,324,295
255,59,3,4,6,7,33,43,7,8,357,338
255,60,3,4,5,8,32,-56,9,2,389,282
255,61,3,4,5,8,-68,44,1,6,321,326
255,62,3,3,3,10,30,-63,1,3,351,263
255,63,3,3,3,10,30,-63,1,0,381,200
255,64,5,2,9,4,54,22,5,2,435,222
255,65,5,2,10,3,-45,21,0,3,390,243
255,66,3,5,6,7,33,52,3,5,423,295
255,67,4,2,9,4,45,22,8,7,468,317
255,68,3,4,5,8,-68,-56,0,1,400,261
255,69,3,4,8,5,35,41,5,2,435,302
255,70,3,4,5,8,32,44,7,6,467,346
255,71,4,2,8,5,-56,23,1,9,411,369
255,72,3,4,7,6,34,-58,5,1,445,311
255,73,4,2,10,3,-54,21,1,2,391,332
255,74,3,4,3,10,30,46,1,8,421,378
255,75,4,4,9,4,45,40,6,8,466,418
255,76,2,5,4,9,22,-46,8,2,488,372
255,77,4,2,9,4,-55,22,3,4,433,394
255,78,3,4,5,8,32,44,5,8,465,438
255,79,3,4,7,6,34,-58,9,0,499,380
255,80,3,3,6,7,-67,34,2,4,432,414
255,81,2,5,4,9,22,54,4,8,454,468
255,82,4,3,10,3,-54,30,0,8,400,498
255,83,3,4,6,7,33,-57,3,1,433,441
255,84,3,4,6,7,33,43,6,4,466,484
255,85,4,3,9,4,-55,31,1,5,411,515
256,1,3,3,6,7,33,34,3,4,33,34
256,2,3,3,5,8,32,35,5,9,65,69
256,3,3,3,4,9,31,-64,6,5,96,5
256,4,4,3,9,4,-55,31,1,6,41,36
256,5,4,3,8,5,44,32,5,8,85,68
256,6,3,4,5,8,32,-56,7,2,117,12
256,7,2,4,7,6,-75,42,2,4,42,54
256,8,3,4,7,6,34,42,6,6,76,96
256,9,3,3,6,7,33,-66,9,0,109,30
256,10,2,5,3,10,-79,55,0,5,30,85
256,11,3,4,7,6,34,42,4,7,64,127
256,12,2,4,6,7,24,-57,8,0,88,70
256,13,5,2,8,5,-47,23,1,3,41,93
256,14,3,5,8,5,35,50,6,3,76,143
256,15,3,3,8,5,-65,32,1,5,11,175
256,16,2,5,3,10,21,-45,2,0,32,130
256,17,3,4,6,7,33,43,5,3,65,173
256,18,3,4,8,5,-65,41,0,4,0,214
256,19,3,3,5,8,32,35,2,9,32,249
256,20,3,4,5,8,32,-56,4,3,64,193
256,21,5,2,7,6,52,24,6,7,116,217
256,22,2,5,3,10,21,-45,7,2,137,172
256,23,4,2,6,7,42,25,9,7,179,197
256,24,5,3,9,4,-46,31,3,8,133,228
256,25,4,2,10,3,46,21,9,9,179,249
256,26,2,5,5,8,-77,-47,2,2,102,202
256,27,3,3,5,8,32,35,4,7,134,237
256,28,3,3,7,6,34,-67,8,0,168,170
256,29,3,3,7,6,-66,33,2,3,102,203
256,30,3,4,5,8,32,44,4,7,134,247
256,31,3,4,7,6,34,42,8,9,168,289
256,32,3,4,4,9,31,-55,9,4,199,234
256,33,4,2,10,3,-54,21,5,5,145,255
256,34,4,2,7,6,43,24,8,9,188,279
256,35,5,2,8,5,-47,-77,1,2,141,202
256,36,3,3,8,5,35,32,6,4,176,234
256,37,5,2,9,4,-46,22,0,6,130,256
256,38,3,4,5,8,32,-56,2,0,162,200
256,39,4,2,9,4,45,22,7,2,207,222
256,40,3,4,5,8,32,44,9,6,239,266
256,41,5,2,11,2,-44,20,5,6,195,286
256,42,2,5,4,9,22,-46,7,0,217,240
256,43,3,3,8,5,-65,32,2,2,152,272
256,44,3,4,7,6,34,42,6,4,186,314
256,45,4,2,6,7,42,25,8,9,228,339
256,46,3,4,5,8,-68,-56,0,3,160,283
256,47,2,5,5,8,23,53,3,6,183,336
256,48,5,2,7,6,52,-76,5,0,235,260
256,49,2,5,2,11,20,56,5,6,255,316
256,50,3,3,8,5,-65,32,0,8,190,348
256,51,4,3,7,6,43,-67,3,1,233,281
256,52,3,3,6,7,33,34,6,5,266,315
256,53,3,4,4,9,31,-55,7,0,297,260
256,54,3,3,5,8,32,35,9,5,329,295
256,55,4,3,10,3,-54,30,5,5,275,325
256,56,3,3,4,9,31,-64,6,1,306,261
256,57,3,3,5,8,32,35,8,6,338,296
256,58,3,3,5,8,-68,-65,0,1,270,231
256,59,2,5,3,10,21,55,1,6,291,286
256,60,3,4,6,7,33,43,4,9,324,329
256,61,2,5,3,10,21,-45,5,4,345,284
256,62,3,3,8,5,-65,32,0,6,280,316
256,63,3,4,4,9,31,-55,1,1,311,261
256,64,4,3,6,7,42,34,3,5,353,295
256,65,2,4,7,6,25,42,8,7,378,337
256,66,5,2,8,5,-47,-77,1,0,331,260
256,67,3,4,4,9,31,45,2,5,362,305
256,68,5,2,9,4,54,22,6,7,416,327
256,69,2,4,4,9,22,-55,8,2,438,272
256,70,4,3,9,4,-55,31,3,3,383,303
256,71,2,4,3,10,21,46,4,9,404,349
256,72,4,2,9,4,45,-78,9,1,449,271
256,73,3,3,4,9,-69,36,0,7,380,307
256,74,4,3,6,7,42,-66,2,1,422,241
256,75,2,5,4,9,22,54,4,5,444,295
256,76,4,2,8,5,44,23,8,8,488,318
256,77,2,4,7,6,-75,-58,3,0,413,260
256,78,3,3,6,7,33,34,6,4,446,294
256,79,3,4,7,6,-66,42,0,6,380,336
256,80,4,3,6,7,42,-66,2,0,422,270
256,81,4,3,5,8,41,35,3,5,463,305
256,82,2,6,3,10,21,64,4,9,484,369
256,83,3,4,6,7,33,-57,7,2,517,312
257,1,2,6,2,11,20,65,0,5,20,65
257,2,3,3,3,10,30,-63,0,2,50,2
257,3,2,5,3,10,21,55,1,7,71,57
257,4,3,3,6,7,33,-66,4,1,104,-9
257,5,3,4,3,10,30,46,4,7,134,37
257,6,4,3,5,8,41,-65,5,2,175,-28
257,7,2,5,4,9,22,54,7,6,197,26
257,8,2,5,5,8,-77,53,0,9,120,79
257,9,2,5,3,10,21,-45,1,4,141,34
257,10,3,3,8,5,35,32,6,6,176,66
257,11,3,3,7,6,-66,33,0,9,110,99
257,12,4,3,7,6,43,-67,3,2,153,32
257,13,2,5,4,9,22,54,5,6,175,86
257,14,3,3,7,6,34,33,9,9,209,119
257,15,4,2,8,5,-56,-77,3,2,153,42
257,16,4,2,5,8,41,26,4,8,194,68
257,17,3,3,7,6,34,-67,8,1,228,1
257,18,3,3,6,7,-67,34,1,5,161,35
257,19,4,3,9,4,45,31,6,6,206,66
257,20,5,2,8,5,53,23,9,9,259,89
257,21,4,3,7,6,-57,-67,2,2,202,22
257,22,2,4,4,9,22,45,4,7,224,67
257,23,3,3,6,7,33,-66,7,1,257,1
257,24,3,4,6,7,-67,43,0,4,190,44
257,25,2,4,4,9,22,45,2,9,212,89
257,26,5,2,7,6,52,-76,4,3,264,13
257,27,3,4,7,6,34,42,8,5,298,55
257,28,3,4,7,6,-66,42,2,7,232,97
257,29,3,5,8,5,35,50,7,7,267,147
257,30,3,5,6,7,-67,52,0,9,200,199
257,31,4,3,9,4,45,-69,5,0,245,130
257,32,2,5,5,8,23,53,8,3,268,183
257,33,5,3,7,6,-48,33,0,6,220,216
257,34,3,3,6,7,33,-66,3,0,253,150
257,35,2,5,4,9,22,54,5,4,275,204
257,36,2,4,7,6,-75,42,0,6,200,246
257,37,5,2,10,3,55,21,5,7,255,267
257,38,3,4,5,8,32,-56,7,1,287,211
257,39,5,2,8,5,-47,23,0,4,240,234
257,40,4,3,6,7,42,34,2,8,282,268
257,41,5,2,10,3,55,21,7,9,337,289
257,42,4,2,9,4,-55,-78,2,1,282,211
257,43,3,3,9,4,36,31,8,2,318,242
257,44,3,4,9,4,-64,40,4,2,254,282
257,45,2,5,4,9,22,54,6,6,276,336
257,46,3,4,5,8,32,-56,8,0,308,280
257,47,5,3,10,3,-45,30,3,0,263,310
257,48,3,4,5,8,32,44,5,4,295,354
257,49,5,2,10,3,-45,21,0,5,250,375
257,50,3,3,5,8,32,-65,2,0,282,310
257,51,5,2,10,3,55,21,7,1,337,331
257,52,2,4,4,9,22,45,9,6,359,376
257,53,2,4,6,7,-76,43,3,9,283,419
257,54,3,5,7,6,34,-49,7,0,317,370
257,55,2,5,3,10,21,55,8,5,338,425
257,56,3,4,6,7,-67,43,1,8,271,468
257,57,2,4,3,10,21,-54,2,4,292,414
257,58,3,3,9,4,36,31,8,5,328,445
257,59,4,4,8,5,-56,41,2,6,272,486
257,60,4,2,8,5,44,23,6,9,316,509
258,1,2,5,4,9,22,54,2,4,22,54
258,2,5,2,7,6,52,24,4,8,74,78
258,3,4,3,6,7,42,-66,6,2,116,12
258,4,4,3,8,5,-56,32,0,4,60,44
258,5,3,4,4,9,31,45,1,9,91,89
258,6,3,3,7,6,34,-67,5,2,125,22
258,7,4,3,8,5,44,32,9,4,169,54
258,8,3,3,6,7,-67,34,2,8,102,88
258,9,4,3,9,4,45,31,7,9,147,119
258,10,4,3,10,3,-54,30,3,9,93,149
258,11,4,2,8,5,44,-77,7,2,137,72
258,12,3,3,4,9,31,36,8,8,168,108
258,13,2,5,5,8,-77,-47,1,1,91,61
258,14,3,4,7,6,34,42,5,3,125,103
258,15,4,3,9,4,-55,31,0,4,70,134
258,16,4,2,7,6,43,24,3,8,113,158
258,17,3,3,6,7,33,-66,6,2,146,92
258,18,4,3,10,3,-54,30,2,2,92,122
258,19,4,3,8,5,44,32,6,4,136,154
258,20,3,3,5,8,32,35,8,9,168,189
258,21,4,3,8,5,-56,-68,2,1,112,121
258,22,2,4,6,7,24,43,6,4,136,164
258,23,5,3,8,5,53,32,9,6,189,196
258,24,3,3,6,7,-67,-66,2,0,122,130
258,25,2,5,5,8,23,53,5,3,145,183
258,26,3,4,6,7,33,43,8,6,178,226
258,27,3,4,5,8,-68,-56,0,0,110,170
258,28,3,3,6,7,33,34,3,4,143,204
258,29,3,4,7,6,34,42,7,6,177,246
258,30,2,4,7,6,-75,42,2,8,102,288
258,31,5,2,6,7,51,-75,3,3,153,213
258,32,4,3,9,4,45,31,8,4,198,244
258,33,2,4,6,7,-76,43,2,7,122,287
258,34,4,4,8,5,44,41,6,8,166,328
258,35,4,3,8,5,-56,-68,0,0,110,260
258,36,4,2,8,5,44,23,4,3,154,283
258,37,2,5,3,10,21,55,5,8,175,338
258,38,4,3,9,4,-55,31,0,9,120,369
258,39,3,4,4,9,31,-55,1,4,151,314
258,40,2,4,5,8,23,44,4,8,174,358
258,41,3,3,5,8,32,-65,6,3,206,293
258,42,3,4,6,7,33,43,9,6,239,336
258,43,2,4,4,9,-78,-55,1,1,161,281
258,44,4,2,8,5,44,23,5,4,205,304
258,45,3,4,5,8,32,44,7,8,237,348
258,46,3,3,7,6,-66,-67,1,1,171,281
258,47,5,2,10,3,55,21,6,2,226,302
258,48,4,3,8,5,-56,32,0,4,170,334
258,49,3,3,6,7,33,34,3,8,203,368
258,50,5,2,9,4,54,-78,7,0,257,290
258,51,2,5,5,8,-77,53,0,3,180,343
258,52,4,3,5,8,41,35,1,8,221,378
258,53,2,5,3,10,21,-45,2,3,242,333
258,54,2,4,5,8,23,44,5,7,265,377
258,55,3,3,8,5,-65,32,0,9,200,409
258,56,5,2,9,4,54,-78,4,1,254,331
258,57,4,2,7,6,43,24,7,5,297,355
258,58,3,3,6,7,-67,34,0,9,230,389
258,59,3,3,4,9,31,-64,1,5,261,325
258,60,4,2,7,6,43,24,4,9,304,349
258,61,4,3,9,4,45,-69,9,0,349,280
258,62,2,5,4,9,-78,54,1,4,271,334
258,63,3,3,6,7,33,34,4,8,304,368
258,64,2,5,5,8,23,-47,7,1,327,321
258,65,3,4,3,10,30,46,7,7,357,367
258,66,3,3,7,6,-66,-67,1,0,291,300
258,67,4,2,8,5,44,23,5,3,335,323
258,68,3,4,3,10,30,46,5,9,365,369
258,69,4,2,8,5,44,-77,9,2,409,292
258,70,3,3,5,8,-68,35,1,7,341,327
258,71,2,5,4,9,22,-46,3,1,363,281
258,72,2,5,4,9,22,54,5,5,385,335
258,73,4,3,5,8,41,-65,6,0,426,270
258,74,4,3,8,5,-56,32,0,2,370,302
258,75,4,3,9,4,45,31,5,3,415,333
258,76,3,3,6,7,33,34,8,7,448,367
258,77,3,4,7,6,-66,42,2,9,382,409
258,78,5,2,7,6,52,-76,4,3,434,333
258,79,2,5,5,8,23,53,7,6,457,386
258,80,2,4,3,10,21,-54,8,2,478,332
258,81,3,4,7,6,-66,42,2,4,412,374
258,82,3,3,8,5,35,32,7,6,447,406
258,83,4,4,6,7,42,43,9,9,489,449
258,84,5,2,11,2,-44,20,5,9,445,469
258,85,3,3,5,8,32,-65,7,4,477,404
258,86,3,3,9,4,-64,31,3,5,413,435
258,87,2,4,5,8,23,44,6,9,436,479
258,88,3,3,3,10,30,-63,6,6,466,416
258,89,2,4,3,10,21,-54,7,2,487,362
258,90,4,2,9,4,-55,22,2,4,432,384
258,91,4,2,8,5,44,23,6,7,476,407
258,92,3,5,4,9,31,-46,7,1,507,361
259,1,3,3,6,7,33,34,3,4,33,34
259,2,2,4,5,8,23,44,6,8,56,78
259,3,2,4,4,9,22,-55,8,3,78,23
259,4,3,4,5,8,-68,44,0,7,10,67
259,5,2,4,5,8,23,-56,3,1,33,11
259,6,3,4,5,8,32,44,5,5,65,55
259,7,2,5,4,9,22,54,7,9,87,109
259,8,2,5,6,7,-76,-48,1,1,11,61
259,9,4,3,7,6,43,33,4,4,54,94
259,10,4,2,8,5,44,23,8,7,98,117
259,11,4,2,7,6,-57,-76,1,1,41,41
259,12,4,3,8,5,44,32,5,3,85,73
259,13,2,5,5,8,23,53,8,6,108,126
259,14,2,4,6,7,-76,43,2,9,32,169
259,15,2,5,5,8,23,-47,5,2,55,122
259,16,3,3,7,6,34,33,9,5,89,155
259,17,3,4,4,9,-69,-55,0,0,20,100
259,18,3,5,7,6,34,51,4,1,54,151
259,19,4,2,11,2,-53,20,1,1,1,171
259,20,4,3,6,7,42,34,3,5,43,205
259,21,4,2,10,3,46,21,9,6,89,226
259,22,3,3,9,4,-64,31,5,7,25,257
259,23,3,3,7,6,34,-67,9,0,59,190
259,24,5,2,7,6,-48,24,1,4,11,214
259,25,4,3,9,4,45,31,6,5,56,245
259,26,3,4,6,7,33,43,9,8,89,288
259,27,5,3,7,6,-48,-67,1,1,41,221
259,28,4,2,8,5,44,23,5,4,85,244
259,29,3,3,5,8,32,35,7,9,117,279
259,30,3,4,4,9,31,-55,8,4,148,224
259,31,3,3,9,4,-64,31,4,5,84,255
259,32,2,4,3,10,21,-54,5,1,105,201
259,33,4,3,7,6,43,33,8,4,148,234
259,34,2,4,5,8,-77,44,1,8,71,278
259,35,4,2,5,8,41,-74,2,4,112,204
259,36,4,3,4,9,40,-64,2,0,152,140
259,37,4,2,7,6,43,24,5,4,195,164
259,38,4,2,6,7,42,25,7,9,237,189
259,39,5,2,7,6,52,-76,9,3,289,113
259,40,3,4,5,8,-68,44,1,7,221,157
259,41,4,3,8,5,44,32,5,9,265,189
259,42,3,4,3,10,30,-54,5,5,295,135
259,43,3,3,5,8,32,-65,7,0,327,70
259,44,5,2,10,3,-45,21,2,1,282,91
259,45,3,3,8,5,35,32,7,3,317,123
259,46,3,3,7,6,-66,33,1,6,251,156
259,47,4,3,5,8,41,-65,2,1,292,91
259,48,4,2,10,3,46,21,8,2,338,112
259,49,3,3,8,5,-65,32,3,4,273,144
259,50,3,4,5,8,32,44,5,8,305,188
259,51,4,2,8,5,44,-77,9,1,349,111
259,52,2,5,4,9,-78,54,1,5,271,165
259,53,2,4,7,6,25,42,6,7,296,207
259,54,3,4,7,6,-66,42,0,9,230,249
259,55,5,2,11,2,56,20,6,9,286,269
259,56,4,2,8,5,-56,-77,0,2,230,192
259,57,4,2,10,3,46,21,6,3,276,213
259,58,4,3,7,6,43,33,9,6,319,246
259,59,3,4,4,9,-69,-55,0,1,250,191
259,60,3,4,5,8,32,44,2,5,282,235
259,61,2,4,6,7,24,43,6,8,306,278
259,62,3,4,4,9,31,-55,7,3,337,223
259,63,2,6,3,10,21,64,8,7,358,287
259,64,3,4,6,7,-67,-57,1,0,291,230
259,65,3,4,6,7,33,43,4,3,324,273
259,66,4,3,9,4,45,31,9,4,369,304
259,67,3,4,4,9,-69,45,0,9,300,349
259,68,3,3,4,9,31,-64,1,5,331,285
259,69,5,2,8,5,53,23,4,8,384,308
259,70,3,3,4,9,31,-64,5,4,415,244
259,71,2,5,5,8,23,53,8,7,438,297
259,72,3,3,7,6,-66,-67,2,0,372,230
259,73,2,4,7,6,25,42,7,2,397,272
259,74,2,4,3,10,21,46,8,8,418,318
259,75,2,4,5,8,-77,-56,1,2,341,262
259,76,2,4,6,7,24,43,5,5,365,305
259,77,3,4,8,5,-65,41,0,6,300,346
259,78,5,2,8,5,53,23,3,9,353,369
259,79,3,3,6,7,33,-66,6,3,386,303
259,80,4,2,10,3,-54,21,2,4,332,324
259,81,3,3,8,5,35,32,7,6,367,356
259,82,3,4,6,7,-67,43,0,9,300,399
259,83,3,4,3,10,30,-54,0,5,330,345
259,84,3,3,7,6,34,33,4,8,364,378
259,85,2,5,4,9,22,-46,6,2,386,332
259,86,4,3,7,6,43,33,9,5,429,365
259,87,5,2,9,4,-46,22,3,7,383,387
259,88,2,4,7,6,25,42,8,9,408,429
259,89,2,4,4,9,-78,-55,0,4,330,374
259,90,4,3,6,7,42,34,2,8,372,408
259,91,6,2,8,5,62,-77,4,1,434,331
259,92,3,3,8,5,35,32,9,3,469,363
259,93,2,4,7,6,-75,42,4,5,394,405
259,94,5,3,8,5,53,32,7,7,447,437
259,95,4,3,9,4,-55,31,2,8,392,468
259,96,4,3,6,7,42,-66,4,2,434,402
259,97,2,5,6,7,24,52,8,4,458,454
259,98,4,2,7,6,-57,24,1,8,401,478
259,99,4,3,8,5,44,-68,5,0,445,410
259,100,3,3,6,7,33,34,8,4,478,444
259,101,3,3,9,4,-64,31,4,5,414,475
259,102,2,5,7,6,25,51,9,6,439,526
260,1,4,3,8,5,44,32,4,2,44,32
260,2,3,3,7,6,34,33,8,5,78,65
260,3,5,2,9,4,-46,22,2,7,32,87
260,4,5,2,9,4,54,22,6,9,86,109
260,5,4,3,7,6,43,-67,9,2,129,42
260,6,4,3,8,5,-56,32,3,4,73,74
260,7,4,3,6,7,42,34,5,8,115,108
260,8,3,3,6,7,33,-66,8,2,148,42
260,9,4,3,7,6,-57,33,1,5,91,75
260,10,2,5,4,9,22,54,3,9,113,129
260,11,2,5,4,9,22,-46,5,3,135,83
260,12,2,4,4,9,22,45,7,8,157,128
260,13,3,3,7,6,-66,-67,1,1,91,61
260,14,6,2,8,5,62,23,3,4,153,84
260,15,5,2,11,2,56,20,9,4,209,104
260,16,3,4,9,4,-64,40,5,4,145,144
260,17,3,3,5,8,32,35,7,9,177,179
260,18,3,4,7,6,-66,-58,1,1,111,121
260,19,3,4,4,9,31,45,2,6,142,166
260,20,5,2,9,4,54,22,6,8,196,188
260,21,5,2,11,2,-44,20,2,8,152,208
260,22,3,4,4,9,31,-55,3,3,183,153
260,23,4,2,9,4,45,22,8,5,228,175
260,24,2,4,5,8,-77,44,1,9,151,219
260,25,4,2,9,4,45,-78,6,1,196,141
260,26,4,3,7,6,43,33,9,4,239,174
260,27,3,3,8,5,-65,32,4,6,174,206
260,28,3,4,8,5,35,41,9,7,209,247
260,29,5,2,11,2,-44,20,5,7,165,267
260,30,2,4,5,8,23,-56,8,1,188,211
260,31,3,4,6,7,-67,43,1,4,121,254
260,32,3,3,6,7,33,34,4,8,154,288
260,33,2,5,4,9,22,-46,6,2,176,242
260,34,3,4,4,9,31,45,7,7,207,287
260,35,3,3,6,7,-67,-66,0,1,140,221
260,36,4,3,6,7,42,34,2,5,182,255
260,37,3,4,4,9,31,-55,3,0,213,200
260,38,5,2,9,4,54,22,7,2,267,222
260,39,3,4,4,9,31,45,8,7,298,267
260,40,2,5,3,10,21,-45,9,2,319,222
260,41,3,4,5,8,-68,44,1,6,251,266
260,42,2,4,7,6,25,42,6,8,276,308
260,43,3,3,4,9,31,-64,7,4,307,244
260,44,3,4,4,9,31,45,8,9,338,289
260,45,2,4,6,7,-76,-57,2,2,262,232
260,46,5,2,9,4,54,22,6,4,316,254
260,47,3,5,5,8,32,53,8,7,348,307
260,48,3,4,5,8,-68,-56,0,1,280,251
260,49,4,2,9,4,45,22,5,3,325,273
260,50,3,4,8,5,-65,41,0,4,260,314
260,51,4,3,6,7,42,34,2,8,302,348
260,52,4,2,7,6,43,-76,5,2,345,272
260,53,3,3,8,5,-65,32,0,4,280,304
260,54,3,3,9,4,36,31,6,5,316,335
260,55,3,4,8,5,-65,41,1,6,251,376
260,56,3,4,4,9,31,-55,2,1,282,321
260,57,3,4,8,5,35,41,7,2,317,362
260,58,5,2,8,5,-47,23,0,5,270,385
260,59,4,4,6,7,42,43,2,8,312,428
260,60,2,6,2,11,20,-35,2,3,332,393
260,61,4,2,8,5,44,23,6,6,376,416
260,62,3,3,4,9,31,-64,7,2,407,352
260,63,3,4,4,9,31,45,8,7,438,397
260,64,4,3,6,7,-58,-66,0,1,380,331
260,65,5,2,9,4,54,22,4,3,434,353
260,66,3,3,9,4,-64,31,0,4,370,384
260,67,4,2,6,7,42,25,2,9,412,409
260,68,4,3,8,5,44,-68,6,1,456,341
260,69,2,4,4,9,22,45,8,6,478,386
260,70,3,3,7,6,-66,33,2,9,412,419
260,71,4,2,9,4,45,-78,7,1,457,341
260,72,4,2,7,6,-57,24,0,5,400,365
260,73,2,4,6,7,24,43,4,8,424,408
260,74,3,4,4,9,31,-55,5,3,455,353
260,75,2,5,5,8,23,53,8,6,478,406
260,76,2,4,4,9,-78,-55,0,1,400,351
260,77,3,4,6,7,33,43,3,4,433,394
260,78,3,3,7,6,34,33,7,7,467,427
260,79,3,4,5,8,32,-56,9,1,499,371
260,80,3,3,7,6,-66,33,3,4,433,404
260,81,3,3,8,5,35,32,8,6,468,436
260,82,2,4,5,8,-77,-56,1,0,391,380
260,83,4,3,9,4,45,31,6,1,436,411
260,84,4,3,7,6,43,33,9,4,479,444
260,85,3,4,5,8,-68,44,1,8,411,488
260,86,4,3,5,8,41,-65,2,3,452,423
260,87,3,3,5,8,32,35,4,8,484,458
260,88,5,2,10,3,55,21,9,9,539,479
261,1,4,3,8,5,44,32,4,2,44,32
261,2,4,3,9,4,45,31,9,3,89,63
261,3,5,2,10,3,-45,21,4,4,44,84
261,4,3,4,7,6,34,42,8,6,78,126
261,5,3,4,5,8,-68,-56,0,0,10,70
261,6,4,3,9,4,45,31,5,1,55,101
261,7,3,4,4,9,31,45,6,6,86,146
261,8,4,3,9,4,-55,31,1,7,31,177
261,9,4,3,9,4,45,31,6,8,76,208
261,10,3,5,6,7,33,-48,9,0,109,160
261,11,5,2,11,2,-44,20,5,0,65,180
261,12,3,3,7,6,34,33,9,3,99,213
261,13,3,3,6,7,-67,34,2,7,32,247
261,14,3,3,6,7,33,-66,5,1,65,181
261,15,3,4,7,6,34,42,9,3,99,223
261,16,2,5,5,8,-77,53,2,6,22,276
261,17,3,3,4,9,31,-64,3,2,53,212
261,18,3,3,5,8,32,35,5,7,85,247
261,19,4,2,8,5,44,-77,9,0,129,170
261,20,2,5,4,9,-78,54,1,4,51,224
261,21,2,5,4,9,22,54,3,8,73,278
261,22,5,2,8,5,53,-77,6,1,126,201
261,23,3,4,6,7,33,43,9,4,159,244
261,24,2,5,3,10,-79,55,0,9,80,299
261,25,5,3,7,6,52,-67,2,2,132,232
261,26,4,3,6,7,42,34,4,6,174,266
261,27,3,4,7,6,34,42,8,8,208,308
261,28,4,3,9,4,-55,31,3,9,153,339
261,29,5,2,11,2,56,20,9,9,209,359
261,30,4,2,10,3,-54,-79,5,0,155,280
261,31,3,5,3,10,30,55,5,5,185,335
261,32,5,2,9,4,54,22,9,7,239,357
261,33,2,5,4,9,-78,-46,1,1,161,311
261,34,4,2,8,5,44,23,5,4,205,334
261,35,3,3,9,4,-64,31,1,5,141,365
261,36,2,5,7,6,25,51,6,6,166,416
261,37,5,2,10,3,-45,21,1,7,121,437
261,38,4,3,7,6,43,-67,4,0,164,370
261,39,3,3,8,5,35,32,9,2,199,402
261,40,3,3,7,6,-66,33,3,5,133,435
261,41,4,3,9,4,45,31,8,6,178,466
261,42,2,4,4,9,-78,-55,0,1,100,411
261,43,3,3,7,6,34,33,4,4,134,444
261,44,3,3,8,5,35,32,9,6,169,476
261,45,5,2,8,5,-47,23,2,9,122,499
261,46,3,3,6,7,33,-66,5,3,155,433
261,47,5,2,9,4,54,22,9,5,209,455
261,48,4,3,9,4,-55,31,4,6,154,486
261,49,3,3,9,4,-64,31,0,7,90,517
262,1,3,3,6,7,33,34,3,4,33,34
262,2,3,4,5,8,32,44,5,8,65,78
262,3,5,2,8,5,53,-77,8,1,118,1
262,4,5,2,9,4,-46,22,2,3,72,23
262,5,4,3,9,4,45,31,7,4,117,54
262,6,5,2,9,4,-46,22,1,6,71,76
262,7,2,4,7,6,25,42,6,8,96,118
262,8,2,5,4,9,22,-46,8,2,118,72
262,9,3,4,5,8,-68,44,0,6,50,116
262,10,4,3,6,7,42,-66,2,0,92,50
262,11,3,4,7,6,34,42,6,2,126,92
262,12,2,7,5,8,23,71,9,3,149,163
262,13,2,6,5,8,-77,62,2,5,72,225
262,14,2,6,4,9,22,63,4,8,94,288
262,15,4,3,7,6,43,-67,7,1,137,221
262,16,3,4,7,6,-66,42,1,3,71,263
262,17,4,3,9,4,45,31,6,4,116,294
262,18,3,3,7,6,-66,33,0,7,50,327
262,19,5,2,8,5,53,-77,3,0,103,250
262,20,4,3,7,6,43,33,6,3,146,283
262,21,2,6,4,9,22,63,8,6,168,346
262,22,3,4,4,9,31,-55,9,1,199,291
262,23,5,2,9,4,-46,22,3,3,153,313
262,24,4,3,7,6,43,33,6,6,196,346
262,25,3,3,6,7,33,-66,9,0,229,280
262,26,3,3,7,6,-66,33,3,3,163,313
262,27,3,3,5,8,32,35,5,8,195,348
262,28,5,2,10,3,-45,21,0,9,150,369
262,29,3,3,9,4,36,-69,6,0,186,300
262,30,4,3,8,5,-56,32,0,2,130,332
262,31,2,5,5,8,23,53,3,5,153,385
262,32,2,4,6,7,24,43,7,8,177,428
262,33,3,3,5,8,32,-65,9,3,209,363
262,34,2,6,2,11,20,65,9,8,229,428
262,35,2,5,5,8,-77,-47,2,1,152,381
262,36,3,4,6,7,33,43,5,4,185,424
262,37,4,3,7,6,43,33,8,7,228,457
262,38,5,2,8,5,-47,-77,1,0,181,380
262,39,2,5,2,11,20,56,1,6,201,436
262,40,4,2,9,4,45,22,6,8,246,458
262,41,2,5,3,10,21,-45,7,3,267,413
262,42,4,2,6,7,42,25,9,8,309,438
262,43,2,5,5,8,-77,-47,2,1,232,391
262,44,2,5,6,7,24,52,6,3,256,443
262,45,4,3,7,6,43,33,9,6,299,476
262,46,3,4,8,5,-65,41,4,7,234,517
263,1,4,3,7,6,43,33,3,3,43,33
263,2,4,3,7,6,43,33,6,6,86,66
263,3,4,2,9,4,-55,22,1,8,31,88
263,4,4,3,9,4,45,31,6,9,76,119
263,5,4,3,6,7,42,-66,8,3,118,53
263,6,2,4,3,10,21,46,9,9,139,99
263,7,2,4,4,9,-78,-55,1,4,61,44
263,8,3,3,5,8,32,35,3,9,93,79
263,9,3,4,4,9,31,-55,4,4,124,24
263,10,5,2,9,4,54,22,8,6,178,46
263,11,5,2,8,5,-47,23,1,9,131,69
263,12,5,2,11,2,56,20,7,9,187,89
263,13,3,3,5,8,32,-65,9,4,219,24
263,14,3,4,5,8,-68,44,1,8,151,68
263,15,3,4,6,7,33,-57,4,1,184,11
263,16,2,4,2,11,20,47,4,8,204,58
263,17,3,5,5,8,32,-47,6,1,236,11
263,18,4,3,9,4,-55,31,1,2,181,42
263,19,4,2,9,4,45,22,6,4,226,64
263,20,4,3,8,5,-56,32,0,6,170,96
263,21,3,4,8,5,35,41,5,7,205,137
263,22,3,3,5,8,32,-65,7,2,237,72
263,23,3,4,8,5,-65,41,2,3,172,113
263,24,4,2,9,4,45,22,7,5,217,135
263,25,4,3,8,5,-56,32,1,7,161,167
263,26,4,3,6,7,42,-66,3,1,203,101
263,27,3,4,6,7,33,43,6,4,236,144
263,28,2,5,4,9,22,54,8,8,258,198
263,29,4,2,8,5,-56,-77,2,1,202,121
263,30,4,3,8,5,44,32,6,3,246,153
263,31,4,4,8,5,-56,41,0,4,190,194
263,32,4,2,9,4,45,22,5,6,235,216
263,33,4,3,9,4,-55,31,0,7,180,247
263,34,5,2,8,5,53,-77,3,0,233,170
263,35,4,3,7,6,43,33,6,3,276,203
263,36,3,4,6,7,33,43,9,6,309,246
263,37,2,4,7,6,-75,42,4,8,234,288
263,38,5,2,11,2,-44,20,0,8,190,308
263,39,5,2,10,3,55,21,5,9,245,329
263,40,3,5,3,10,30,-45,5,4,275,284
263,41,5,2,8,5,53,23,8,7,328,307
263,42,3,4,4,9,31,-55,9,2,359,252
263,43,2,4,6,7,-76,43,3,5,283,295
263,44,2,5,3,10,21,-45,4,0,304,250
263,45,4,2,9,4,45,22,9,2,349,272
263,46,3,4,3,10,30,46,9,8,379,318
263,47,2,6,2,11,20,-35,9,3,399,283
263,48,2,5,6,7,-76,52,3,5,323,335
263,49,5,2,10,3,55,21,8,6,378,356
263,50,2,4,2,11,20,-53,8,3,398,303
263,51,4,3,9,4,-55,31,3,4,343,334
263,52,4,3,9,4,45,31,8,5,388,365
263,53,2,4,4,9,-78,-55,0,0,310,310
263,54,4,4,5,8,41,44,1,4,351,354
263,55,4,3,9,4,45,31,6,5,396,385
263,56,4,3,5,8,41,-65,7,0,437,320
263,57,3,4,5,8,32,44,9,4,469,364
263,58,4,3,9,4,-55,31,4,5,414,395
263,59,2,5,6,7,24,52,8,7,438,447
263,60,5,2,8,5,-47,-77,1,0,391,370
263,61,2,5,4,9,22,54,3,4,413,424
263,62,3,3,8,5,35,32,8,6,448,456
263,63,3,3,4,9,31,-64,9,2,479,392
263,64,3,4,7,6,-66,42,3,4,413,434
263,65,4,3,10,3,46,30,9,4,459,464
263,66,4,3,6,7,-58,34,1,8,401,498
263,67,3,3,5,8,32,-65,3,3,433,433
263,68,3,3,5,8,32,35,5,8,465,468
263,69,4,3,6,7,42,-66,7,2,507,402
264,1,2,4,2,11,20,47,0,7,20,47
264,2,4,3,8,5,44,32,4,9,64,79
264,3,3,3,8,5,35,-68,9,1,99,11
264,4,2,4,4,9,-78,45,1,6,21,56
264,5,3,3,6,7,33,-66,4,0,54,-10
264,6,4,3,8,5,44,32,8,2,98,22
264,7,4,2,8,5,-56,23,2,5,42,45
264,8,4,3,8,5,44,32,6,7,86,77
264,9,2,6,3,10,21,-36,7,1,107,41
264,10,4,3,9,4,-55,31,2,2,52,72
264,11,4,2,8,5,44,23,6,5,96,95
264,12,3,3,7,6,-66,33,0,8,30,128
264,13,2,4,8,5,26,41,6,9,56,169
264,14,5,2,9,4,-46,-78,0,1,10,91
264,15,3,3,6,7,33,34,3,5,43,125
264,16,4,3,5,8,41,-65,4,0,84,60
264,17,3,3,5,8,32,35,6,5,116,95
264,18,4,3,7,6,43,33,9,8,159,128
264,19,4,3,9,4,-55,31,4,9,104,159
264,20,3,3,5,8,32,-65,6,4,136,94
264,21,5,2,9,4,-46,22,0,6,90,116
264,22,2,5,4,9,22,-46,2,0,112,70
264,23,2,5,2,11,20,56,2,6,132,126
264,24,4,2,7,6,43,-76,5,0,175,50
264,25,4,2,8,5,44,23,9,3,219,73
264,26,2,4,4,9,-78,45,1,8,141,118
264,27,3,3,5,8,32,-65,3,3,173,53
264,28,3,3,4,9,31,36,4,9,204,89
264,29,2,5,3,10,21,-45,5,4,225,44
264,30,4,3,9,4,-55,31,0,5,170,75
264,31,4,2,10,3,46,21,6,6,216,96
264,32,3,4,7,6,-66,42,0,8,150,138
264,33,4,3,8,5,44,-68,4,0,194,70
264,34,4,2,11,2,-53,20,1,0,141,90
264,35,2,4,3,10,21,46,2,6,162,136
264,36,6,2,9,4,63,22,5,8,225,158
264,37,4,3,5,8,41,-65,6,3,266,93
264,38,2,5,5,8,23,53,9,6,289,146
264,39,4,3,9,4,-55,31,4,7,234,177
264,40,5,2,9,4,54,22,8,9,288,199
264,41,2,5,4,9,-78,-46,0,3,210,153
264,42,3,4,6,7,33,43,3,6,243,196
264,43,4,2,8,5,44,23,7,9,287,219
264,44,2,4,2,11,20,-53,7,6,307,166
264,45,2,4,4,9,22,-55,9,1,329,111
264,46,4,2,9,4,-55,22,4,3,274,133
264,47,5,2,10,3,55,21,9,4,329,154
264,48,4,2,8,5,-56,23,3,7,273,177
264,49,3,4,6,7,33,-57,6,0,306,120
264,50,4,3,6,7,42,34,8,4,348,154
264,51,3,3,5,8,-68,35,0,9,280,189
264,52,5,2,8,5,53,-77,3,2,333,112
264,53,2,4,6,7,24,43,7,5,357,155
264,54,3,3,6,7,-67,34,0,9,290,189
264,55,4,2,9,4,45,-78,5,1,335,111
264,56,4,3,6,7,42,34,7,5,377,145
264,57,2,4,6,7,-76,43,1,8,301,188
264,58,3,4,7,6,34,-58,5,0,335,130
264,59,5,2,8,5,53,23,8,3,388,153
264,60,3,3,9,4,-64,31,4,4,324,184
264,61,3,3,5,8,32,35,6,9,356,219
264,62,2,5,2,11,20,-44,6,5,376,175
264,63,2,5,6,7,-76,52,0,7,300,227
264,64,2,6,4,9,22,-37,2,0,322,190
264,65,4,2,9,4,45,22,7,2,367,212
264,66,4,3,9,4,-55,31,2,3,312,243
264,67,4,3,6,7,42,34,4,7,354,277
264,68,2,4,5,8,23,-56,7,1,377,221
264,69,3,3,5,8,32,35,9,6,409,256
264,70,5,3,9,4,-46,31,3,7,363,287
264,71,3,4,8,5,35,41,8,8,398,328
264,72,2,4,2,11,20,-53,8,5,418,275
264,73,4,2,5,8,41,-74,9,1,459,201
264,74,3,4,7,6,-66,42,3,3,393,243
264,75,3,4,5,8,32,44,5,7,425,287
264,76,5,2,11,2,-44,20,1,7,381,307
264,77,4,3,5,8,41,-65,2,2,422,242
264,78,3,3,6,7,33,34,5,6,455,276
264,79,3,3,4,9,31,-64,6,2,486,212
264,80,5,2,7,6,52,24,8,6,538,236
265,1,2,4,4,9,22,45,2,5,22,45
265,2,3,4,3,10,30,-54,2,1,52,-9
265,3,4,2,8,5,44,23,6,4,96,14
265,4,3,3,5,8,32,35,8,9,128,49
265,5,3,3,6,7,-67,-66,1,3,61,-17
265,6,4,4,9,4,45,40,6,3,106,23
265,7,4,3,7,6,43,33,9,6,149,56
265,8,4,3,9,4,-55,31,4,7,94,87
265,9,3,3,6,7,33,-66,7,1,127,21
265,10,3,4,8,5,-65,41,2,2,62,62
265,11,2,4,6,7,24,43,6,5,86,105
265,12,5,2,7,6,52,24,8,9,138,129
265,13,4,3,9,4,-55,-69,3,0,83,60
265,14,2,4,5,8,23,44,6,4,106,104
265,15,3,4,7,6,-66,42,0,6,40,146
265,16,4,3,6,7,42,-66,2,0,82,80
265,17,3,4,5,8,32,44,4,4,114,124
265,18,2,4,5,8,23,44,7,8,137,168
265,19,2,4,3,10,21,-54,8,4,158,114
265,20,3,4,7,6,-66,42,2,6,92,156
265,21,4,3,9,4,45,31,7,7,137,187
265,22,3,3,6,7,-67,-66,0,1,70,121
265,23,2,4,4,9,22,45,2,6,92,166
265,24,5,2,6,7,51,-75,3,1,143,91
265,25,4,3,9,4,45,31,8,2,188,122
265,26,3,3,8,5,-65,32,3,4,123,154
265,27,3,3,6,7,33,34,6,8,156,188
265,28,4,4,7,6,43,-58,9,0,199,130
265,29,2,4,4,9,-78,45,1,5,121,175
265,30,3,3,9,4,36,31,7,6,157,206
265,31,3,3,8,5,-65,32,2,8,92,238
265,32,2,4,4,9,22,-55,4,3,114,183
265,33,2,4,5,8,23,44,7,7,137,227
265,34,5,2,10,3,-45,21,2,8,92,248
265,35,6,2,10,3,64,21,6,9,156,269
265,36,3,4,6,7,33,-57,9,2,189,212
265,37,4,2,9,4,-55,22,4,4,134,234
265,38,3,4,5,8,32,44,6,8,166,278
265,39,5,2,7,6,52,-76,8,2,218,202
265,40,5,3,9,4,-46,31,2,3,172,233
265,41,3,4,4,9,31,45,3,8,203,278
265,42,3,3,8,5,35,-68,8,0,238,210
265,43,3,3,6,7,-67,34,1,4,171,244
265,44,2,4,4,9,22,45,3,9,193,289
265,45,3,3,5,8,32,-65,5,4,225,224
265,46,3,3,5,8,32,35,7,9,257,259
265,47,2,5,5,8,-77,-47,0,2,180,212
265,48,2,4,4,9,22,45,2,7,202,257
265,49,5,2,8,5,53,-77,5,0,255,180
265,50,4,3,9,4,-55,31,0,1,200,211
265,51,5,2,9,4,54,22,4,3,254,233
265,52,5,2,10,3,55,21,9,4,309,254
265,53,3,4,7,6,-66,42,3,6,243,296
265,54,3,5,4,9,31,-46,4,0,274,250
265,55,4,3,6,7,42,34,6,4,316,284
265,56,4,3,9,4,-55,31,1,5,261,315
265,57,5,2,6,7,51,-75,2,0,312,240
265,58,2,5,6,7,24,52,6,2,336,292
265,59,4,3,8,5,-56,32,0,4,280,324
265,60,3,4,6,7,33,43,3,7,313,367
265,61,5,2,11,2,56,20,9,7,369,387
265,62,3,3,3,10,30,-63,9,4,399,324
265,63,4,3,6,7,-58,34,1,8,341,358
265,64,3,5,6,7,33,-48,4,0,374,310
265,65,2,5,4,9,22,54,6,4,396,364
265,66,2,4,4,9,22,45,8,9,418,409
265,67,2,5,4,9,-78,-46,0,3,340,363
265,68,3,4,6,7,33,43,3,6,373,406
265,69,3,3,5,8,32,-65,5,1,405,341
265,70,4,2,9,4,-55,22,0,3,350,363
265,71,4,2,7,6,43,24,3,7,393,387
265,72,4,3,9,4,45,31,8,8,438,418
265,73,3,4,6,7,-67,-57,1,1,371,361
265,74,2,5,5,8,23,53,4,4,394,414
265,75,4,3,8,5,44,32,8,6,438,446
265,76,4,3,8,5,-56,32,2,8,382,478
265,77,2,5,4,9,22,-46,4,2,404,432
265,78,5,2,8,5,53,23,7,5,457,455
265,79,2,5,5,8,-77,53,0,8,380,508
266,1,5,2,7,6,52,24,2,4,52,24
266,2,4,3,8,5,44,32,6,6,96,56
266,3,4,2,7,6,43,-76,9,0,139,-20
266,4,4,2,10,3,-54,21,5,1,85,1
266,5,4,4,7,6,43,42,8,3,128,43
266,6,4,3,5,8,41,35,9,8,169,78
266,7,4,3,5,8,-59,-65,0,3,110,13
266,8,5,2,10,3,55,21,5,4,165,34
266,9,3,4,7,6,34,42,9,6,199,76
266,10,3,4,6,7,-67,43,2,9,132,119
266,11,4,3,7,6,43,-67,5,2,175,52
266,12,5,2,8,5,53,23,8,5,228,75
266,13,3,3,9,4,-64,31,4,6,164,106
266,14,3,3,5,8,32,-65,6,1,196,41
266,15,3,3,8,5,-65,32,1,3,131,73
266,16,3,3,7,6,34,33,5,6,165,106
266,17,3,3,8,5,-65,32,0,8,100,138
266,18,3,4,7,6,34,-58,4,0,134,80
266,19,4,2,8,5,44,23,8,3,178,103
266,20,4,2,7,6,-57,24,1,7,121,127
266,21,3,4,6,7,33,-57,4,0,154,70
266,22,3,3,8,5,35,32,9,2,189,102
266,23,2,5,4,9,-78,54,1,6,111,156
266,24,4,3,8,5,44,32,5,8,155,188
266,25,4,3,8,5,44,-68,9,0,199,120
266,26,3,4,6,7,-67,43,2,3,132,163
266,27,3,3,8,5,35,32,7,5,167,195
266,28,4,3,8,5,-56,32,1,7,111,227
266,29,3,3,7,6,34,-67,5,0,145,160
266,30,3,3,7,6,34,33,9,3,179,193
266,31,3,4,5,8,-68,44,1,7,111,237
266,32,4,2,8,5,44,-77,5,0,155,160
266,33,3,3,7,6,34,33,9,3,189,193
266,34,4,4,9,4,-55,40,4,3,134,233
266,35,4,2,9,4,45,22,9,5,179,255
266,36,5,2,8,5,-47,23,2,8,132,278
266,37,4,3,8,5,44,-68,6,0,176,210
266,38,4,3,9,4,-55,31,1,1,121,241
266,39,4,2,7,6,43,24,4,5,164,265
266,40,2,4,2,11,20,-53,4,2,184,212
266,41,2,5,3,10,21,55,5,7,205,267
266,42,3,3,8,5,-65,32,0,9,140,299
266,43,5,2,8,5,53,-77,3,2,193,222
266,44,4,3,8,5,44,32,7,4,237,254
266,45,5,2,11,2,-44,20,3,4,193,274
266,46,3,3,6,7,33,34,6,8,226,308
266,47,3,3,5,8,32,-65,8,3,258,243
266,48,2,6,5,8,-77,62,1,5,181,305
266,49,3,3,8,5,35,32,6,7,216,337
266,50,4,3,6,7,42,-66,8,1,258,271
266,51,5,2,8,5,-47,23,1,4,211,294
266,52,4,3,5,8,41,35,2,9,252,329
266,53,3,4,8,5,35,-59,7,0,287,270
266,54,3,3,7,6,-66,33,1,3,221,303
266,55,4,3,8,5,44,32,5,5,265,335
266,56,3,3,8,5,-65,32,0,7,200,367
266,57,4,2,11,2,47,20,7,7,247,387
266,58,3,3,8,5,-65,32,2,9,182,419
266,59,4,2,7,6,43,-76,5,3,225,343
266,60,2,5,5,8,23,53,8,6,248,396
266,61,3,4,6,7,-67,43,1,9,181,439
266,62,4,2,7,6,43,-76,4,3,224,363
266,63,4,3,9,4,45,31,9,4,269,394
266,64,3,3,6,7,-67,34,2,8,202,428
266,65,3,3,6,7,33,-66,5,2,235,362
266,66,3,4,5,8,32,44,7,6,267,406
266,67,5,2,9,4,-46,22,1,8,221,428
266,68,2,5,2,11,20,-44,1,4,241,384
266,69,5,2,9,4,54,22,5,6,295,406
266,70,3,4,6,7,33,43,8,9,328,449
266,71,5,2,7,6,-48,-76,0,3,280,373
266,72,4,3,6,7,42,34,2,7,322,407
266,73,2,4,4,9,22,-55,4,2,344,352
266,74,3,3,6,7,33,34,7,6,377,386
266,75,2,5,2,11,20,-44,7,2,397,342
266,76,3,3,5,8,32,35,9,7,429,377
266,77,4,3,9,4,-55,31,4,8,374,408
266,78,4,3,6,7,42,-66,6,2,416,342
266,79,3,4,4,9,31,45,7,7,447,387
266,80,4,2,7,6,-57,-76,0,1,390,311
266,81,2,5,3,10,21,55,1,6,411,366
266,82,3,4,7,6,34,42,5,8,445,408
266,83,3,3,7,6,34,-67,9,1,479,341
266,84,4,2,9,4,-55,22,4,3,424,363
266,85,4,2,8,5,44,23,8,6,468,386
266,86,5,2,6,7,51,-75,9,1,519,311
267,1,4,3,6,7,42,34,2,4,42,34
267,2,2,5,4,9,22,54,4,8,64,88
267,3,5,2,7,6,52,-76,6,2,116,12
267,4,2,4,3,10,21,46,7,8,137,58
267,5,2,4,2,11,20,-53,7,5,157,5
267,6,4,3,7,6,-57,33,0,8,100,38
267,7,5,2,9,4,54,-78,4,0,154,-40
267,8,2,5,4,9,22,54,6,4,176,14
267,9,2,5,3,10,21,55,7,9,197,69
267,10,4,3,8,5,-56,-68,1,1,141,1
267,11,3,3,3,10,30,37,1,8,171,38
267,12,4,3,5,8,41,-65,2,3,212,-27
267,13,2,5,3,10,21,55,3,8,233,28
267,14,3,4,7,6,34,-58,7,0,267,-30
267,15,3,3,7,6,-66,33,1,3,201,3
267,16,3,4,7,6,34,42,5,5,235,45
267,17,5,2,9,4,54,22,9,7,289,67
267,18,2,5,6,7,-76,52,3,9,213,119
267,19,4,4,4,9,40,-55,3,4,253,64
267,20,2,4,7,6,25,42,8,6,278,106
267,21,3,4,3,10,30,-54,8,2,308,52
267,22,5,2,7,6,-48,24,0,6,260,76
267,23,3,3,4,9,31,-64,1,2,291,12
267,24,2,4,4,9,22,45,3,7,313,57
267,25,3,3,6,7,33,-66,6,1,346,-9
267,26,3,4,7,6,-66,42,0,3,280,33
267,27,3,4,4,9,31,45,1,8,311,78
267,28,3,4,9,4,36,40,7,8,347,118
267,29,3,5,5,8,32,-47,9,1,379,71
267,30,3,4,6,7,-67,43,2,4,312,114
267,31,5,2,8,5,53,23,5,7,365,137
267,32,3,3,7,6,34,-67,9,0,399,70
267,33,5,2,9,4,-46,22,3,2,353,92
267,34,4,3,9,4,45,31,8,3,398,123
267,35,3,3,7,6,-66,33,2,6,332,156
267,36,5,2,10,3,55,21,7,7,387,177
267,37,3,4,5,8,32,-56,9,1,419,121
267,38,3,5,5,8,-68,53,1,4,351,174
267,39,3,4,7,6,34,42,5,6,385,216
267,40,4,3,7,6,43,33,8,9,428,249
267,41,2,5,3,10,21,-45,9,4,449,204
267,42,4,3,8,5,-56,32,3,6,393,236
267,43,2,6,4,9,22,63,5,9,415,299
267,44,3,3,5,8,32,-65,7,4,447,234
267,45,2,4,6,7,-76,43,1,7,371,277
267,46,4,3,7,6,43,-67,4,0,414,210
267,47,3,4,6,7,33,43,7,3,447,253
267,48,4,2,7,6,-57,24,0,7,390,277
267,49,3,3,6,7,33,-66,3,1,423,211
267,50,2,4,6,7,24,43,7,4,447,254
267,51,4,2,7,6,-57,24,0,8,390,278
267,52,4,3,7,6,43,-67,3,1,433,211
267,53,5,2,7,6,52,24,5,5,485,235
267,54,2,4,6,7,24,43,9,8,509,278
268,1,4,4,6,7,42,43,2,3,42,43
268,2,2,4,3,10,21,46,3,9,63,89
268,3,3,3,7,6,34,-67,7,2,97,22
268,4,2,5,3,10,21,55,8,7,118,77
268,5,3,3,8,5,-65,32,3,9,53,109
268,6,2,5,7,6,25,-49,8,0,78,60
268,7,2,5,3,10,21,55,9,5,99,115
268,8,4,3,8,5,-56,32,3,7,43,147
268,9,2,5,5,8,23,-47,6,0,66,100
268,10,5,3,10,3,-45,30,1,0,21,130
268,11,3,3,8,5,35,32,6,2,56,162
268,12,3,3,5,8,32,35,8,7,88,197
268,13,3,3,6,7,-67,-66,1,1,21,131
268,14,2,4,7,6,25,42,6,3,46,173
268,15,2,5,6,7,-76,52,0,5,-30,225
268,16,4,3,8,5,44,32,4,7,14,257
268,17,3,4,6,7,33,-57,7,0,47,200
268,18,4,3,8,5,-56,32,1,2,-9,232
268,19,4,3,6,7,42,34,3,6,33,266
268,20,2,4,6,7,24,43,7,9,57,309
268,21,4,3,6,7,42,-66,9,3,99,243
268,22,3,4,7,6,-66,42,3,5,33,285
268,23,4,3,7,6,43,33,6,8,76,318
268,24,4,3,8,5,-56,-68,0,0,20,250
268,25,4,2,7,6,43,24,3,4,63,274
268,26,2,5,4,9,22,54,5,8,85,328
268,27,4,2,7,6,43,-76,8,2,128,252
268,28,5,2,11,2,-44,20,4,2,84,272
268,29,4,3,6,7,42,34,6,6,126,306
268,30,2,4,5,8,23,-56,9,0,149,250
268,31,3,3,6,7,-67,34,2,4,82,284
268,32,3,3,9,4,36,31,8,5,118,315
268,33,3,4,6,7,-67,43,1,8,51,358
268,34,4,3,7,6,43,-67,4,1,94,291
268,35,4,4,4,9,40,45,4,6,134,336
268,36,2,5,3,10,21,-45,5,1,155,291
268,37,4,3,6,7,42,34,7,5,197,325
268,38,3,4,5,8,32,44,9,9,229,369
268,39,5,2,6,7,-49,-75,0,4,180,294
268,40,2,5,6,7,24,52,4,6,204,346
268,41,2,4,5,8,23,-56,7,0,227,290
268,42,4,3,8,5,-56,32,1,2,171,322
268,43,3,4,5,8,32,44,3,6,203,366
268,44,3,3,3,10,30,-63,3,3,233,303
268,45,3,4,6,7,33,43,6,6,266,346
268,46,4,2,9,4,-55,22,1,8,211,368
268,47,3,3,9,4,36,31,7,9,247,399
268,48,4,2,10,3,-54,-79,3,0,193,320
268,49,3,4,7,6,34,42,7,2,227,362
268,50,3,4,8,5,-65,41,2,3,162,403
268,51,3,3,7,6,34,33,6,6,196,436
268,52,3,3,7,6,-66,33,0,9,130,469
268,53,5,2,8,5,53,-77,3,2,183,392
268,54,3,3,3,10,30,37,3,9,213,429
268,55,3,4,6,7,33,-57,6,2,246,372
268,56,4,3,8,5,-56,32,0,4,190,404
268,57,3,4,5,8,32,44,2,8,222,448
268,58,3,4,5,8,32,-56,4,2,254,392
268,59,4,3,7,6,43,33,7,5,297,425
268,60,3,3,10,3,-63,30,4,5,234,455
268,61,5,2,8,5,53,23,7,8,287,478
268,62,5,2,7,6,52,-76,9,2,339,402
268,63,5,2,7,6,-48,24,1,6,291,426
268,64,3,3,3,10,30,-63,1,3,321,363
268,65,3,3,4,9,31,36,2,9,352,399
268,66,2,4,6,7,24,-57,6,2,376,342
268,67,4,2,10,3,-54,21,2,3,322,363
268,68,4,3,6,7,42,34,4,7,364,397
268,69,2,4,8,5,-74,41,0,8,290,438
268,70,2,5,3,10,21,-45,1,3,311,393
268,71,4,2,10,3,46,21,7,4,357,414
268,72,3,3,4,9,31,-64,8,0,388,350
268,73,3,3,8,5,-65,32,3,2,323,382
268,74,3,3,6,7,33,34,6,6,356,416
268,75,4,3,8,5,-56,32,0,8,300,448
268,76,3,3,8,5,35,-68,5,0,335,380
268,77,2,4,4,9,22,45,7,5,357,425
268,78,3,3,7,6,-66,33,1,8,291,458
268,79,3,3,6,7,33,-66,4,2,324,392
268,80,2,4,6,7,24,43,8,5,348,435
268,81,4,3,8,5,-56,32,2,7,292,467
268,82,2,4,5,8,23,-56,5,1,315,411
268,83,3,3,10,3,-63,30,2,1,252,441
268,84,6,2,7,6,61,24,3,5,313,465
268,85,4,3,6,7,42,34,5,9,355,499
268,86,2,4,6,7,24,-57,9,2,379,442
268,87,2,5,4,9,-78,54,1,6,301,496
268,88,3,3,5,8,32,-65,3,1,333,431
268,89,3,3,5,8,32,35,5,6,365,466
268,90,4,3,6,7,42,-66,7,0,407,400
268,91,3,3,5,8,32,35,9,5,439,435
268,92,4,3,7,6,-57,33,2,8,382,468
268,93,3,4,6,7,33,-57,5,1,415,411
268,94,3,3,9,4,-64,31,1,2,351,442
268,95,3,3,7,6,34,33,5,5,385,475
268,96,4,3,6,7,42,34,7,9,427,509
269,1,3,3,9,4,36,31,6,1,36,31
269,2,5,2,9,4,-46,22,0,3,-10,53
269,3,5,2,10,3,55,21,5,4,45,74
269,4,2,4,6,7,24,43,9,7,69,117
269,5,3,4,4,9,-69,-55,0,2,0,62
269,6,4,3,9,4,45,31,5,3,45,93
269,7,4,3,7,6,43,33,8,6,88,126
269,8,2,4,4,9,-78,-55,0,1,10,71
269,9,4,3,8,5,44,32,4,3,54,103
269,10,2,4,7,6,25,42,9,5,79,145
269,11,3,3,6,7,-67,34,2,9,12,179
269,12,3,3,6,7,33,-66,5,3,45,113
269,13,3,4,4,9,31,45,6,8,76,158
269,14,2,5,3,10,21,-45,7,3,97,113
269,15,3,3,6,7,-67,34,0,7,30,147
269,16,4,3,8,5,44,32,4,9,74,179
269,17,2,4,5,8,23,-56,7,3,97,123
269,18,2,5,3,10,21,55,8,8,118,178
269,19,4,2,7,6,-57,-76,1,2,61,102
269,20,3,4,7,6,34,42,5,4,95,144
269,21,2,4,6,7,24,43,9,7,119,187
269,22,3,3,7,6,-66,-67,3,0,53,120
269,23,4,2,8,5,44,23,7,3,97,143
269,24,4,3,8,5,-56,32,1,5,41,175
269,25,4,3,9,4,45,31,6,6,86,206
269,26,4,3,8,5,-56,32,0,8,30,238
269,27,3,4,6,7,33,-57,3,1,63,181
269,28,3,3,6,7,33,34,6,5,96,215
269,29,2,5,5,8,23,53,9,8,119,268
269,30,4,2,7,6,-57,-76,2,2,62,192
269,31,4,3,9,4,45,31,7,3,107,223
269,32,4,3,8,5,-56,32,1,5,51,255
269,33,2,4,6,7,24,43,5,8,75,298
269,34,2,4,6,7,24,-57,9,1,99,241
269,35,2,4,8,5,-74,41,5,2,25,282
269,36,5,2,7,6,52,24,7,6,77,306
269,37,3,3,6,7,-67,-66,0,0,10,240
269,38,5,2,10,3,55,21,5,1,65,261
269,39,4,3,6,7,42,34,7,5,107,295
269,40,2,4,7,6,-75,42,2,7,32,337
269,41,2,4,3,10,21,-54,3,3,53,283
269,42,3,4,9,4,36,40,9,3,89,323
269,43,2,4,3,10,-79,46,0,9,10,369
269,44,3,3,5,8,32,-65,2,4,42,304
269,45,3,3,7,6,34,33,6,7,76,337
269,46,3,4,6,7,33,-57,9,0,109,280
269,47,3,3,8,5,-65,32,4,2,44,312
269,48,3,3,9,4,-64,31,0,3,-20,343
269,49,4,4,8,5,44,41,4,4,24,384
269,50,4,3,8,5,44,32,8,6,68,416
269,51,4,3,6,7,-58,-66,0,0,10,350
269,52,4,3,7,6,43,33,3,3,53,383
269,53,3,3,7,6,34,33,7,6,87,416
269,54,3,3,10,3,-63,30,4,6,24,446
269,55,4,3,8,5,44,32,8,8,68,478
269,56,2,6,4,9,-78,-37,0,1,-10,441
269,57,3,3,8,5,35,32,5,3,25,473
269,58,4,4,8,5,44,41,9,4,69,514
270,1,3,4,5,8,32,44,2,4,32,44
270,2,2,4,7,6,25,42,7,6,57,86
270,3,2,4,4,9,22,-55,9,1,79,31
270,4,4,3,9,4,-55,31,4,2,24,62
270,5,4,2,6,7,42,25,6,7,66,87
270,6,2,4,5,8,23,-56,9,1,89,31
270,7,4,2,5,8,-59,26,0,7,30,57
270,8,2,5,2,11,20,-44,0,3,50,13
270,9,4,3,9,4,45,31,5,4,95,44
270,10,4,2,7,6,43,24,8,8,138,68
270,11,2,5,4,9,-78,-46,0,2,60,22
270,12,3,4,7,6,34,42,4,4,94,64
270,13,3,3,8,5,35,32,9,6,129,96
270,14,2,4,8,5,-74,41,5,7,55,137
270,15,4,2,6,7,42,-75,7,2,97,62
270,16,2,5,6,7,-76,52,1,4,21,114
270,17,3,4,6,7,33,43,4,7,54,157
270,18,2,5,3,10,21,-45,5,2,75,112
270,19,5,2,8,5,53,23,8,5,128,135
270,20,4,3,8,5,-56,32,2,7,72,167
270,21,4,4,7,6,43,42,5,9,115,209
270,22,4,2,7,6,43,-76,8,3,158,133
270,23,5,2,8,5,-47,23,1,6,111,156
270,24,3,5,3,10,30,-45,1,1,141,111
270,25,3,4,7,6,34,42,5,3,175,153
270,26,3,4,5,8,32,44,7,7,207,197
270,27,4,3,4,9,40,-64,7,3,247,133
270,28,4,3,8,5,-56,32,1,5,191,165
270,29,3,3,9,4,36,31,7,6,227,196
270,30,2,4,9,4,-73,40,4,6,154,236
270,31,4,2,8,5,44,23,8,9,198,259
270,32,3,3,7,6,-66,-67,2,2,132,192
270,33,2,5,3,10,21,55,3,7,153,247
270,34,3,3,5,8,32,-65,5,2,185,182
270,35,4,2,7,6,43,24,8,6,228,206
270,36,4,3,7,6,-57,33,1,9,171,239
270,37,4,2,8,5,44,-77,5,2,215,162
270,38,3,3,5,8,32,35,7,7,247,197
270,39,2,4,4,9,22,-55,9,2,269,142
270,40,3,3,6,7,-67,34,2,6,202,176
270,41,2,4,6,7,24,43,6,9,226,219
270,42,3,4,6,7,33,-57,9,2,259,162
270,43,2,5,5,8,-77,53,2,5,182,215
270,44,3,3,8,5,35,32,7,7,217,247
270,45,4,3,5,8,41,-65,8,2,258,182
270,46,3,3,6,7,-67,34,1,6,191,216
270,47,5,2,8,5,53,23,4,9,244,239
270,48,4,3,5,8,41,-65,5,4,285,174
270,49,4,2,7,6,43,24,8,8,328,198
270,50,4,2,8,5,-56,-77,2,1,272,121
270,51,4,4,5,8,41,44,3,5,313,165
270,52,2,5,4,9,22,54,5,9,335,219
270,53,2,5,7,6,-75,-49,0,0,260,170
270,54,3,4,7,6,34,42,4,2,294,212
270,55,5,2,8,5,53,23,7,5,347,235
270,56,2,4,7,6,-75,42,2,7,272,277
270,57,4,3,8,5,44,32,6,9,316,309
270,58,4,3,6,7,42,-66,8,3,358,243
270,59,2,4,4,9,-78,45,0,8,280,288
270,60,3,3,7,6,34,-67,4,1,314,221
270,61,2,5,3,10,21,55,5,6,335,276
270,62,3,4,8,5,-65,41,0,7,270,317
270,63,4,3,7,6,43,-67,3,0,313,250
270,64,2,5,6,7,24,52,7,2,337,302
270,65,2,5,5,8,-77,53,0,5,260,355
270,66,4,3,9,4,45,31,5,6,305,386
270,67,3,3,6,7,33,-66,8,0,338,320
270,68,2,5,5,8,-77,53,1,3,261,373
270,69,3,4,6,7,33,43,4,6,294,416
270,70,4,4,7,6,43,42,7,8,337,458
270,71,4,3,9,4,-55,31,2,9,282,489
270,72,4,3,6,7,42,-66,4,3,324,423
270,73,3,4,5,8,32,44,6,7,356,467
270,74,3,3,10,3,-63,30,3,7,293,497
270,75,2,4,6,7,24,-57,7,0,317,440
270,76,5,3,7,6,52,33,9,3,369,473
270,77,2,5,4,9,-78,54,1,7,291,527
271,1,2,4,6,7,24,43,4,3,24,43
271,2,3,4,4,9,31,45,5,8,55,88
271,3,5,2,9,4,54,-78,9,0,109,10
271,4,3,4,5,8,-68,44,1,4,41,54
271,5,5,2,9,4,54,22,5,6,95,76
271,6,6,2,10,3,64,21,9,7,159,97
271,7,3,3,8,5,-65,32,4,9,94,129
271,8,5,2,10,3,55,-79,9,0,149,50
271,9,3,3,5,8,-68,35,1,5,81,85
271,10,2,4,3,10,21,-54,2,1,102,31
271,11,2,4,4,9,22,45,4,6,124,76
271,12,3,4,6,7,33,43,7,9,157,119
271,13,3,3,7,6,-66,-67,1,2,91,52
271,14,3,4,3,10,30,46,1,8,121,98
271,15,3,4,5,8,32,-56,3,2,153,42
271,16,3,4,4,9,31,45,4,7,184,87
271,17,4,2,9,4,45,22,9,9,229,109
271,18,4,2,6,7,-58,-75,1,4,171,34
271,19,4,3,8,5,44,32,5,6,215,66
271,20,5,2,10,3,-45,21,0,7,170,87
271,21,5,2,9,4,54,22,4,9,224,109
271,22,5,2,6,7,51,-75,5,4,275,34
271,23,4,3,6,7,42,34,7,8,317,68
271,24,3,3,9,4,-64,31,3,9,253,99
271,25,3,4,4,9,31,-55,4,4,284,44
271,26,4,2,6,7,42,25,6,9,326,69
271,27,2,5,7,6,-75,-49,1,0,251,20
271,28,5,2,8,5,53,23,4,3,304,43
271,29,4,2,10,3,-54,21,0,4,250,64
271,30,3,3,9,4,36,31,6,5,286,95
271,31,4,3,7,6,43,33,9,8,329,128
271,32,3,3,7,6,-66,-67,3,1,263,61
271,33,4,3,8,5,44,32,7,3,307,93
271,34,3,3,5,8,32,35,9,8,339,128
271,35,3,3,6,7,-67,-66,2,2,272,62
271,36,2,4,5,8,23,44,5,6,295,106
271,37,2,4,6,7,24,43,9,9,319,149
271,38,4,3,8,5,-56,-68,3,1,263,81
271,39,4,3,6,7,42,34,5,5,305,115
271,40,3,5,6,7,33,52,8,7,338,167
271,41,3,3,5,8,-68,-65,0,2,270,102
271,42,4,2,11,2,47,20,7,2,317,122
271,43,3,4,4,9,31,45,8,7,348,167
271,44,3,3,8,5,-65,32,3,9,283,199
271,45,4,3,6,7,42,-66,5,3,325,133
271,46,3,4,5,8,32,44,7,7,357,177
271,47,2,6,3,10,21,-36,8,1,378,141
271,48,4,2,9,4,-55,22,3,3,323,163
271,49,4,3,8,5,44,32,7,5,367,195
271,50,2,4,6,7,-76,43,1,8,291,238
271,51,4,3,10,3,46,30,7,8,337,268
271,52,3,3,6,7,-67,-66,0,2,270,202
271,53,4,3,6,7,42,34,2,6,312,236
271,54,3,4,6,7,33,43,5,9,345,279
271,55,3,4,7,6,34,-58,9,1,379,221
271,56,4,2,7,6,-57,24,2,5,322,245
271,57,4,4,7,6,43,42,5,7,365,287
271,58,3,4,7,6,34,42,9,9,399,329
271,59,4,2,5,8,-59,-74,0,5,340,255
271,60,4,2,7,6,43,24,3,9,383,279
271,61,3,4,7,6,34,-58,7,1,417,221
271,62,3,3,7,6,-66,33,1,4,351,254
271,63,2,4,7,6,25,42,6,6,376,296
271,64,2,5,4,9,22,-46,8,0,398,250
271,65,3,3,8,5,-65,32,3,2,333,282
271,66,3,3,8,5,35,32,8,4,368,314
271,67,5,2,8,5,-47,23,1,7,321,337
271,68,2,5,4,9,22,-46,3,1,343,291
271,69,4,3,6,7,42,34,5,5,385,325
271,70,3,4,5,8,32,44,7,9,417,369
271,71,3,4,6,7,-67,-57,0,2,350,312
271,72,2,5,4,9,22,54,2,6,372,366
271,73,4,3,9,4,45,31,7,7,417,397
271,74,5,2,8,5,-47,-77,0,0,370,320
271,75,3,3,8,5,35,32,5,2,405,352
271,76,5,2,7,6,52,24,7,6,457,376
271,77,5,2,10,3,-45,21,2,7,412,397
271,78,4,4,5,8,41,-56,3,1,453,341
271,79,3,3,7,6,34,33,7,4,487,374
271,80,2,4,6,7,-76,43,1,7,411,417
271,81,2,6,3,10,21,-36,2,1,432,381
271,82,3,4,5,8,32,44,4,5,464,425
271,83,3,3,7,6,34,33,8,8,498,458
271,84,2,4,6,7,-76,-57,2,1,422,401
271,85,4,2,6,7,42,25,4,6,464,426
271,86,3,4,5,8,32,-56,6,0,496,370
271,87,4,2,6,7,42,25,8,5,538,395
272,1,2,5,3,10,21,55,1,5,21,55
272,2,4,3,5,8,41,-65,2,0,62,-10
272,3,6,2,11,2,65,20,7,0,127,10
272,4,4,3,6,7,42,34,9,4,169,44
272,5,2,4,7,6,-75,42,4,6,94,86
272,6,4,3,5,8,41,-65,5,1,135,21
272,7,3,3,7,6,34,33,9,4,169,54
272,8,3,3,6,7,-67,34,2,8,102,88
272,9,4,3,6,7,42,-66,4,2,144,22
272,10,4,3,8,5,44,32,8,4,188,54
272,11,3,3,4,9,31,-64,9,0,219,-10
272,12,4,3,7,6,-57,33,2,3,162,23
272,13,3,4,4,9,31,45,3,8,193,68
272,14,6,2,9,4,63,-78,6,0,256,-10
272,15,2,5,6,7,-76,52,0,2,180,42
272,16,3,4,6,7,33,43,3,5,213,85
272,17,3,4,3,10,30,-54,3,1,243,31
272,18,3,3,8,5,35,32,8,3,278,63
272,19,4,3,8,5,-56,32,2,5,222,95
272,20,4,2,6,7,42,-75,4,0,264,20
272,21,5,2,10,3,55,21,9,1,319,41
272,22,4,2,6,7,-58,25,1,6,261,66
272,23,6,2,10,3,64,21,5,7,325,87
272,24,2,4,5,8,23,-56,8,1,348,31
272,25,4,3,8,5,-56,32,2,3,292,63
272,26,4,2,10,3,46,21,8,4,338,84
272,27,5,2,6,7,51,25,9,9,389,109
272,28,3,3,6,7,-67,-66,2,3,322,43
272,29,2,4,5,8,23,44,5,7,345,87
272,30,3,3,7,6,34,-67,9,0,379,20
272,31,2,5,7,6,-75,51,4,1,304,71
272,32,4,2,5,8,41,26,5,7,345,97
272,33,2,4,5,8,23,-56,8,1,368,41
272,34,5,2,11,2,-44,20,4,1,324,61
272,35,6,2,9,4,63,22,7,3,387,83
272,36,2,5,5,8,-77,53,0,6,310,136
272,37,2,5,3,10,21,-45,1,1,331,91
272,38,4,3,7,6,43,33,4,4,374,124
272,39,3,3,9,4,-64,31,0,5,310,155
272,40,2,4,6,7,24,43,4,8,334,198
272,41,3,3,4,9,31,-64,5,4,365,134
272,42,4,2,10,3,-54,21,1,5,311,155
272,43,5,2,8,5,53,23,4,8,364,178
272,44,4,3,8,5,44,-68,8,0,408,110
272,45,3,4,7,6,-66,42,2,2,342,152
272,46,4,3,7,6,43,33,5,5,385,185
272,47,2,5,5,8,23,53,8,8,408,238
272,48,3,4,6,7,-67,-57,1,1,341,181
272,49,3,4,8,5,35,41,6,2,376,222
272,50,3,3,8,5,-65,32,1,4,311,254
272,51,3,4,5,8,32,44,3,8,343,298
272,52,4,2,9,4,45,-78,8,0,388,220
272,53,3,4,7,6,-66,42,2,2,322,262
272,54,4,3,7,6,43,33,5,5,365,295
272,55,3,3,6,7,33,34,8,9,398,329
272,56,4,2,7,6,-57,-76,1,3,341,253
272,57,3,4,4,9,31,45,2,8,372,298
272,58,4,2,5,8,41,-74,3,4,413,224
272,59,4,2,8,5,44,23,7,7,457,247
272,60,4,3,8,5,-56,32,1,9,401,279
272,61,3,3,5,8,32,-65,3,4,433,214
272,62,4,2,9,4,45,22,8,6,478,236
272,63,3,4,5,8,-68,-56,0,0,410,180
272,64,3,3,9,4,36,31,6,1,446,211
272,65,4,4,5,8,41,44,7,5,487,255
272,66,3,3,6,7,-67,34,0,9,420,289
272,67,4,2,8,5,44,-77,4,2,464,212
272,68,4,3,8,5,44,32,8,4,508,244
273,1,4,3,8,5,44,32,4,2,44,32
273,2,3,4,3,10,30,46,4,8,74,78
273,3,3,5,5,8,32,-47,6,1,106,31
273,4,3,3,4,9,31,36,7,7,137,67
273,5,3,3,6,7,-67,-66,0,1,70,1
273,6,3,3,5,8,32,35,2,6,102,36
273,7,2,4,6,7,24,43,6,9,126,79
273,8,3,3,8,5,-65,-68,1,1,61,11
273,9,4,2,11,2,47,20,8,1,108,31
273,10,3,4,6,7,-67,43,1,4,41,74
273,11,3,3,5,8,32,35,3,9,73,109
273,12,4,3,7,6,43,-67,6,2,116,42
273,13,2,5,4,9,22,54,8,6,138,96
273,14,4,2,7,6,-57,-76,1,0,81,20
273,15,2,4,8,5,26,41,7,1,107,61
273,16,3,3,7,6,-66,33,1,4,41,94
273,17,2,5,4,9,22,54,3,8,63,148
273,18,3,3,6,7,33,-66,6,2,96,82
273,19,2,4,5,8,23,44,9,6,119,126
273,20,4,2,8,5,-56,23,3,9,63,149
273,21,3,3,7,6,34,-67,7,2,97,82
273,22,3,3,6,7,-67,34,0,6,30,116
273,23,3,3,6,7,33,-66,3,0,63,50
273,24,2,4,3,10,21,46,4,6,84,96
273,25,3,4,6,7,33,43,7,9,117,139
273,26,3,4,8,5,-65,-59,2,0,52,80
273,27,5,2,8,5,53,23,5,3,105,103
273,28,3,4,4,9,31,45,6,8,136,148
273,29,2,5,4,9,22,-46,8,2,158,102
273,30,4,2,10,3,-54,21,4,3,104,123
273,31,2,5,2,11,20,56,4,9,124,179
273,32,4,3,9,4,45,-69,9,0,169,110
273,33,3,4,6,7,-67,43,2,3,102,153
273,34,2,6,2,11,20,65,2,8,122,218
273,35,3,3,7,6,34,-67,6,1,156,151
273,36,3,3,5,8,32,35,8,6,188,186
273,37,3,3,7,6,-66,33,2,9,122,219
273,38,3,3,5,8,32,-65,4,4,154,154
273,39,2,4,5,8,23,44,7,8,177,198
273,40,3,4,7,6,-66,-58,1,0,111,140
273,41,3,4,6,7,33,43,4,3,144,183
273,42,2,5,3,10,21,55,5,8,165,238
273,43,5,3,5,8,50,-65,5,3,215,173
273,44,6,2,11,2,-35,20,0,3,180,193
273,45,4,3,6,7,42,34,2,7,222,227
273,46,2,4,6,7,24,-57,6,0,246,170
273,47,3,4,7,6,-66,42,0,2,180,212
273,48,2,5,3,10,21,55,1,7,201,267
273,49,4,2,6,7,42,-75,3,2,243,192
273,50,3,4,6,7,33,43,6,5,276,235
273,51,3,4,4,9,31,-55,7,0,307,180
273,52,4,2,9,4,-55,22,2,2,252,202
273,53,4,3,6,7,42,34,4,6,294,236
273,54,4,3,7,6,43,33,7,9,337,269
273,55,4,3,7,6,-57,-67,0,2,280,202
273,56,3,4,6,7,33,43,3,5,313,245
273,57,3,5,4,9,31,54,4,9,344,299
273,58,3,3,6,7,33,-66,7,3,377,233
273,59,2,4,6,7,-76,43,1,6,301,276
273,60,3,4,6,7,33,43,4,9,334,319
273,61,4,3,8,5,44,-68,8,1,378,251
273,62,3,4,8,5,-65,41,3,2,313,292
273,63,4,3,6,7,42,34,5,6,355,326
273,64,3,3,6,7,33,-66,8,0,388,260
273,65,3,3,7,6,-66,33,2,3,322,293
273,66,4,3,7,6,43,33,5,6,365,326
273,67,4,3,6,7,42,-66,7,0,407,260
273,68,3,3,7,6,-66,33,1,3,341,293
273,69,3,3,6,7,33,34,4,7,374,327
273,70,5,2,9,4,54,22,8,9,428,349
273,71,4,3,6,7,-58,-66,0,3,370,283
273,72,3,4,7,6,34,42,4,5,404,325
273,73,2,5,3,10,21,-45,5,0,425,280
273,74,3,4,6,7,33,43,8,3,458,323
273,75,4,3,7,6,-57,33,1,6,401,356
273,76,3,4,6,7,33,43,4,9,434,399
273,77,3,3,8,5,35,-68,9,1,469,331
273,78,2,4,5,8,-77,44,2,5,392,375
273,79,3,4,8,5,35,41,7,6,427,416
273,80,2,6,4,9,22,63,9,9,449,479
273,81,3,3,6,7,-67,-66,2,3,382,413
273,82,3,3,8,5,35,32,7,5,417,445
273,83,5,2,8,5,-47,23,0,8,370,468
273,84,3,3,9,4,36,31,6,9,406,499
273,85,4,3,7,6,43,-67,9,2,449,432
273,86,3,3,10,3,-63,30,6,2,386,462
273,87,2,4,6,7,-76,43,0,5,310,505
274,1,3,3,7,6,34,33,4,3,34,33
274,2,4,2,9,4,45,22,9,5,79,55
274,3,4,3,4,9,40,-64,9,1,119,-9
274,4,5,2,11,2,-44,20,5,1,75,11
274,5,5,2,9,4,54,22,9,3,129,33
274,6,3,3,8,5,-65,32,4,5,64,65
274,7,2,4,6,7,24,43,8,8,88,108
274,8,3,3,8,5,-65,-68,3,0,23,40
274,9,4,4,7,6,43,42,6,2,66,82
274,10,5,2,10,3,-45,21,1,3,21,103
274,11,3,3,7,6,34,33,5,6,55,136
274,12,4,3,7,6,43,33,8,9,98,169
274,13,3,4,4,9,31,-55,9,4,129,114
274,14,4,2,7,6,-57,24,2,8,72,138
274,15,3,3,6,7,33,-66,5,2,105,72
274,16,3,3,7,6,34,33,9,5,139,105
274,17,3,4,6,7,-67,43,2,8,72,148
274,18,5,2,8,5,53,-77,5,1,125,71
274,19,3,3,9,4,-64,31,1,2,61,102
274,20,2,6,2,11,20,65,1,7,81,167
274,21,2,4,6,7,24,-57,5,0,105,110
274,22,6,2,10,3,64,21,9,1,169,131
274,23,5,2,8,5,-47,23,2,4,122,154
274,24,3,4,7,6,34,42,6,6,156,196
274,25,4,3,9,4,-55,31,1,7,101,227
274,26,4,2,7,6,43,-76,4,1,144,151
274,27,5,2,9,4,54,22,8,3,198,173
274,28,6,2,11,2,-35,20,3,3,163,193
274,29,3,3,6,7,33,34,6,7,196,227
274,30,2,4,5,8,23,-56,9,1,219,171
274,31,2,4,3,10,-79,46,0,7,140,217
274,32,3,4,8,5,35,41,5,8,175,258
274,33,4,2,5,8,41,-74,6,4,216,184
274,34,4,2,9,4,-55,22,1,6,161,206
274,35,2,4,4,9,22,-55,3,1,183,151
274,36,5,2,9,4,54,22,7,3,237,173
274,37,3,4,3,10,30,46,7,9,267,219
274,38,5,2,9,4,-46,-78,1,1,221,141
274,39,5,2,9,4,54,22,5,3,275,163
274,40,2,5,5,8,23,53,8,6,298,216
274,41,4,2,6,7,-58,-75,0,1,240,141
274,42,5,2,11,2,56,20,6,1,296,161
274,43,3,3,6,7,33,34,9,5,329,195
274,44,3,4,6,7,-67,43,2,8,262,238
274,45,5,3,8,5,53,-68,5,0,315,170
274,46,4,2,6,7,42,25,7,5,357,195
274,47,4,3,10,3,-54,30,3,5,303,225
274,48,3,3,6,7,33,34,6,9,336,259
274,49,3,3,5,8,32,-65,8,4,368,194
274,50,4,2,5,8,41,-74,9,0,409,120
274,51,4,2,9,4,-55,22,4,2,354,142
274,52,3,3,7,6,34,33,8,5,388,175
274,53,3,4,5,8,-68,44,0,9,320,219
274,54,3,4,6,7,33,-57,3,2,353,162
274,55,3,3,8,5,35,32,8,4,388,194
274,56,3,4,4,9,31,45,9,9,419,239
274,57,3,3,8,5,-65,-68,4,1,354,171
274,58,3,3,8,5,35,32,9,3,389,203
274,59,4,3,9,4,-55,31,4,4,334,234
274,60,3,4,8,5,35,41,9,5,369,275
274,61,4,2,9,4,-55,22,4,7,314,297
274,62,3,3,8,5,35,32,9,9,349,329
274,63,2,4,8,5,-74,-59,5,0,275,270
274,64,3,3,6,7,33,34,8,4,308,304
274,65,3,4,4,9,31,45,9,9,339,349
274,66,4,2,7,6,-57,-76,2,3,282,273
274,67,4,2,11,2,47,20,9,3,329,293
274,68,3,3,8,5,-65,32,4,5,264,325
274,69,2,5,3,10,21,-45,5,0,285,280
274,70,3,4,4,9,31,45,6,5,316,325
274,71,4,3,7,6,43,33,9,8,359,358
274,72,2,4,4,9,-78,-55,1,3,281,303
274,73,4,2,7,6,43,24,4,7,324,327
274,74,4,2,9,4,45,22,9,9,369,349
274,75,2,6,3,10,-79,-36,0,3,290,313
274,76,2,5,6,7,24,52,4,5,314,365
274,77,3,3,4,9,31,-64,5,1,345,301
274,78,3,4,6,7,33,43,8,4,378,344
274,79,3,3,8,5,-65,32,3,6,313,376
274,80,2,5,4,9,22,-46,5,0,335,330
274,81,3,4,7,6,34,42,9,2,369,372
274,82,4,2,9,4,-55,22,4,4,314,394
274,83,3,4,6,7,33,43,7,7,347,437
274,84,4,3,5,8,41,-65,8,2,388,372
274,85,3,3,7,6,-66,33,2,5,322,405
274,86,3,4,6,7,33,43,5,8,355,448
274,87,2,4,3,10,21,-54,6,4,376,394
274,88,4,2,7,6,43,24,9,8,419,418
274,89,2,4,5,8,-77,-56,2,2,342,362
274,90,4,3,10,3,46,30,8,2,388,392
274,91,3,3,8,5,-65,32,3,4,323,424
274,92,3,3,7,6,34,33,7,7,357,457
274,93,2,5,5,8,-77,-47,0,0,280,410
274,94,5,2,8,5,53,23,3,3,333,433
274,95,3,3,6,7,33,34,6,7,366,467
274,96,4,3,7,6,43,-67,9,0,409,400
274,97,4,3,9,4,-55,31,4,1,354,431
274,98,2,4,4,9,22,45,6,6,376,476
274,99,2,4,6,7,-76,43,0,9,300,519
275,1,2,5,4,9,22,54,2,4,22,54
275,2,3,4,6,7,33,43,5,7,55,97
275,3,2,5,5,8,23,-47,8,0,78,50
275,4,5,2,8,5,-47,23,1,3,31,73
275,5,4,3,6,7,42,34,3,7,73,107
275,6,4,3,8,5,44,32,7,9,117,139
275,7,2,4,8,5,-74,-59,3,0,43,80
275,8,5,2,10,3,55,21,8,1,98,101
275,9,2,4,6,7,-76,43,2,4,22,144
275,10,3,4,3,10,30,-54,2,0,52,90
275,11,2,4,6,7,24,43,6,3,76,133
275,12,4,3,6,7,42,34,8,7,118,167
275,13,4,2,7,6,-57,-76,1,1,61,91
275,14,3,4,4,9,31,45,2,6,92,136
275,15,4,4,8,5,44,41,6,7,136,177
275,16,4,4,7,6,43,42,9,9,179,219
275,17,4,2,11,2,-53,20,6,9,126,239
275,18,3,3,6,7,33,-66,9,3,159,173
275,19,4,3,7,6,-57,33,2,6,102,206
275,20,2,4,4,9,22,-55,4,1,124,151
275,21,3,3,6,7,33,34,7,5,157,185
275,22,4,2,6,7,42,-75,9,0,199,110
275,23,2,5,4,9,-78,54,1,4,121,164
275,24,4,3,7,6,43,33,4,7,164,197
275,25,2,4,7,6,25,42,9,9,189,239
275,26,4,2,8,5,-56,-77,3,2,133,162
275,27,5,2,7,6,52,24,5,6,185,186
275,28,5,2,9,4,54,22,9,8,239,208
275,29,3,3,9,4,-64,31,5,9,175,239
275,30,2,4,3,10,21,-54,6,5,196,185
275,31,3,3,9,4,-64,31,2,6,132,216
275,32,4,2,10,3,46,21,8,7,178,237
275,33,4,3,8,5,-56,32,2,9,122,269
275,34,3,3,8,5,35,-68,7,1,157,201
275,35,4,2,11,2,-53,20,4,1,104,221
275,36,4,2,5,8,41,26,5,7,145,247
275,37,3,4,3,10,30,-54,5,3,175,193
275,38,2,5,4,9,22,54,7,7,197,247
275,39,4,2,8,5,-56,-77,1,0,141,170
275,40,4,3,8,5,44,32,5,2,185,202
275,41,5,2,10,3,-45,21,0,3,140,223
275,42,3,3,8,5,35,32,5,5,175,255
275,43,5,2,8,5,53,23,8,8,228,278
275,44,2,5,4,9,-78,-46,0,2,150,232
275,45,3,3,5,8,32,35,2,7,182,267
275,46,4,4,5,8,41,-56,3,1,223,211
275,47,4,2,7,6,43,24,6,5,266,235
275,48,3,3,7,6,-66,33,0,8,200,268
275,49,4,3,6,7,42,-66,2,2,242,202
275,50,4,3,7,6,43,33,5,5,285,235
275,51,3,3,6,7,33,34,8,9,318,269
275,52,3,4,5,8,-68,-56,0,3,250,213
275,53,2,5,3,10,21,55,1,8,271,268
275,54,2,4,5,8,23,-56,4,2,294,212
275,55,2,4,2,11,20,47,4,9,314,259
275,56,2,5,3,10,21,-45,5,4,335,214
275,57,4,3,6,7,42,34,7,8,377,248
275,58,3,4,5,8,32,-56,9,2,409,192
275,59,6,2,7,6,-39,24,0,6,370,216
275,60,3,3,8,5,35,32,5,8,405,248
275,61,4,3,5,8,41,-65,6,3,446,183
275,62,3,4,8,5,-65,41,1,4,381,224
275,63,2,5,4,9,22,54,3,8,403,278
275,64,5,2,10,3,55,21,8,9,458,299
275,65,4,3,7,6,-57,-67,1,2,401,232
275,66,3,3,9,4,36,31,7,3,437,263
275,67,2,5,4,9,22,54,9,7,459,317
275,68,4,2,6,7,-58,-75,1,2,401,242
275,69,3,4,4,9,31,45,2,7,432,287
275,70,4,2,9,4,45,22,7,9,477,309
275,71,4,3,8,5,-56,-68,1,1,421,241
275,72,4,2,6,7,42,25,3,6,463,266
275,73,4,2,9,4,45,22,8,8,508,288
276,1,3,4,8,5,35,41,5,1,35,41
276,2,2,4,6,7,24,43,9,4,59,84
276,3,4,3,9,4,-55,31,4,5,4,115
276,4,3,3,5,8,32,-65,6,0,36,50
276,5,5,2,8,5,53,23,9,3,89,73
276,6,4,2,7,6,-57,24,2,7,32,97
276,7,4,3,6,7,42,-66,4,1,74,31
276,8,3,4,6,7,33,43,7,4,107,74
276,9,3,3,6,7,-67,34,0,8,40,108
276,10,4,2,8,5,44,-77,4,1,84,31
276,11,2,4,7,6,25,42,9,3,109,73
276,12,5,2,10,3,-45,21,4,4,64,94
276,13,4,3,8,5,44,32,8,6,108,126
276,14,3,3,6,7,-67,-66,1,0,41,60
276,15,3,4,8,5,35,41,6,1,76,101
276,16,4,3,5,8,41,35,7,6,117,136
276,17,4,2,9,4,-55,22,2,8,62,158
276,18,3,3,6,7,33,-66,5,2,95,92
276,19,2,4,7,6,-75,42,0,4,20,134
276,20,3,4,6,7,33,43,3,7,53,177
276,21,3,4,7,6,34,42,7,9,87,219
276,22,2,6,4,9,22,-37,9,2,109,182
276,23,2,5,2,11,20,56,9,8,129,238
276,24,4,3,9,4,-55,31,4,9,74,269
276,25,5,2,10,3,55,-79,9,0,129,190
276,26,3,3,7,6,-66,33,3,3,63,223
276,27,3,3,7,6,34,33,7,6,97,256
276,28,4,3,7,6,-57,33,0,9,40,289
276,29,3,4,4,9,31,-55,1,4,71,234
276,30,2,5,4,9,22,54,3,8,93,288
276,31,3,3,7,6,34,-67,7,1,127,221
276,32,4,3,9,4,-55,31,2,2,72,252
276,33,2,4,7,6,25,42,7,4,97,294
276,34,3,5,5,8,32,53,9,7,129,347
276,35,2,5,5,8,-77,-47,2,0,52,300
276,36,5,2,10,3,55,21,7,1,107,321
276,37,4,3,10,3,-54,30,3,1,53,351
276,38,3,3,6,7,33,34,6,5,86,385
276,39,4,3,8,5,-56,32,0,7,30,417
276,40,4,3,10,3,46,30,6,7,76,447
276,41,4,3,7,6,43,-67,9,0,119,380
276,42,3,4,6,7,-67,43,2,3,52,423
276,43,2,5,4,9,22,54,4,7,74,477
276,44,3,3,7,6,34,-67,8,0,108,410
276,45,3,4,7,6,-66,42,2,2,42,452
276,46,5,2,9,4,54,22,6,4,96,474
276,47,3,3,6,7,33,34,9,8,129,508
277,1,3,3,6,7,33,34,3,4,33,34
277,2,3,4,6,7,33,43,6,7,66,77
277,3,2,5,3,10,21,-45,7,2,87,32
277,4,3,4,9,4,-64,40,3,2,23,72
277,5,2,4,5,8,23,44,6,6,46,116
277,6,3,3,7,6,-66,33,0,9,-20,149
277,7,3,4,6,7,33,-57,3,2,13,92
277,8,4,2,7,6,43,24,6,6,56,116
277,9,3,3,7,6,-66,33,0,9,-10,149
277,10,3,3,8,5,35,-68,5,1,25,81
277,11,3,3,6,7,33,34,8,5,58,115
277,12,3,3,8,5,-65,32,3,7,-7,147
277,13,4,3,8,5,44,32,7,9,37,179
277,14,5,2,11,2,-44,20,3,9,-7,199
277,15,2,5,6,7,24,-48,7,1,17,151
277,16,4,2,5,8,41,26,8,7,58,177
277,17,3,5,7,6,-66,51,2,8,-8,228
277,18,2,6,3,10,21,-36,3,2,13,192
277,19,2,5,7,6,25,51,8,3,38,243
277,20,3,4,6,7,-67,43,1,6,-29,286
277,21,2,4,5,8,23,-56,4,0,-6,230
277,22,3,3,9,4,-64,31,0,1,-70,261
277,23,2,4,5,8,23,44,3,5,-47,305
277,24,5,2,11,2,56,20,9,5,9,325
277,25,3,4,4,9,-69,-55,0,0,-60,270
277,26,5,2,7,6,52,24,2,4,-8,294
277,27,4,2,8,5,44,23,6,7,36,317
277,28,3,4,5,8,32,-56,8,1,68,261
277,29,3,3,9,4,-64,31,4,2,4,292
277,30,3,3,7,6,34,33,8,5,38,325
277,31,2,5,5,8,-77,53,1,8,-39,378
277,32,3,3,4,9,31,-64,2,4,-8,314
277,33,3,3,7,6,34,33,6,7,26,347
277,34,5,2,7,6,52,-76,8,1,78,271
277,35,3,3,8,5,-65,32,3,3,13,303
277,36,3,4,7,6,34,42,7,5,47,345
277,37,2,6,5,8,-77,62,0,7,-30,407
277,38,3,3,5,8,32,-65,2,2,2,342
277,39,5,2,11,2,56,20,8,2,58,362
277,40,4,3,7,6,-57,33,1,5,1,395
277,41,3,3,7,6,34,33,5,8,35,428
277,42,4,2,5,8,41,-74,6,4,76,354
277,43,2,4,6,7,-76,43,0,7,0,397
277,44,2,4,3,10,21,-54,1,3,21,343
277,45,2,4,7,6,25,42,6,5,46,385
277,46,2,5,3,10,21,-45,7,0,67,340
277,47,4,3,8,5,-56,32,1,2,11,372
277,48,4,2,8,5,44,23,5,5,55,395
277,49,4,2,10,3,-54,21,1,6,1,416
277,50,3,3,9,4,36,31,7,7,37,447
277,51,3,3,6,7,-67,-66,0,1,-30,381
277,52,5,2,11,2,56,20,6,1,26,401
277,53,3,4,7,6,-66,42,0,3,-40,443
277,54,4,3,8,5,44,32,4,5,4,475
277,55,3,4,6,7,33,43,7,8,37,518
278,1,2,4,4,9,22,45,2,5,22,45
278,2,2,5,4,9,22,54,4,9,44,99
278,3,2,5,5,8,23,-47,7,2,67,52
278,4,4,2,5,8,41,26,8,8,108,78
278,5,4,3,7,6,-57,-67,1,1,51,11
278,6,5,2,8,5,53,23,4,4,104,34
278,7,3,4,6,7,33,43,7,7,137,77
278,8,3,4,7,6,-66,42,1,9,71,119
278,9,3,3,5,8,32,-65,3,4,103,54
278,10,4,3,10,3,46,30,9,4,149,84
278,11,3,3,5,8,-68,35,1,9,81,119
278,12,3,3,8,5,35,-68,6,1,116,51
278,13,4,3,5,8,41,35,7,6,157,86
278,14,4,2,8,5,-56,23,1,9,101,109
278,15,3,3,6,7,33,-66,4,3,134,43
278,16,2,5,5,8,23,53,7,6,157,96
278,17,3,3,7,6,-66,33,1,9,91,129
278,18,2,4,6,7,24,-57,5,2,115,72
278,19,2,4,6,7,24,43,9,5,139,115
278,20,6,2,9,4,-37,22,2,7,102,137
278,21,3,4,6,7,33,-57,5,0,135,80
278,22,5,2,8,5,53,23,8,3,188,103
278,23,5,2,8,5,-47,23,1,6,141,126
278,24,3,3,5,8,32,-65,3,1,173,61
278,25,3,4,8,5,35,41,8,2,208,102
278,26,3,4,7,6,-66,42,2,4,142,144
278,27,3,3,6,7,33,34,5,8,175,178
278,28,4,2,10,3,-54,21,1,9,121,199
278,29,4,2,7,6,43,-76,4,3,164,123
278,30,2,5,3,10,21,55,5,8,185,178
278,31,3,4,4,9,31,-55,6,3,216,123
278,32,3,4,3,10,30,46,6,9,246,169
278,33,4,2,6,7,42,-75,8,4,288,94
278,34,2,4,6,7,-76,43,2,7,212,137
278,35,4,3,6,7,42,-66,4,1,254,71
278,36,2,4,3,10,21,46,5,7,275,117
278,37,2,4,6,7,24,-57,9,0,299,60
278,38,3,3,5,8,-68,35,1,5,231,95
278,39,4,2,9,4,45,22,6,7,276,117
278,40,3,4,7,6,-66,42,0,9,210,159
278,41,3,3,6,7,33,-66,3,3,243,93
278,42,3,4,8,5,35,41,8,4,278,134
278,43,4,2,5,8,41,-74,9,0,319,60
278,44,4,3,8,5,-56,32,3,2,263,92
278,45,2,6,5,8,23,62,6,4,286,154
278,46,3,4,8,5,-65,41,1,5,221,195
278,47,2,4,6,7,24,43,5,8,245,238
278,48,2,5,5,8,23,-47,8,1,268,191
278,49,3,4,5,8,-68,44,0,5,200,235
278,50,3,4,5,8,32,44,2,9,232,279
278,51,6,2,10,3,64,-79,6,0,296,200
278,52,5,2,9,4,-46,22,0,2,250,222
278,53,3,3,5,8,32,35,2,7,282,257
278,54,3,4,4,9,31,-55,3,2,313,202
278,55,2,4,5,8,23,44,6,6,336,246
278,56,3,3,4,9,31,-64,7,2,367,182
278,57,3,4,6,7,-67,43,0,5,300,225
278,58,3,4,5,8,32,44,2,9,332,269
278,59,3,3,6,7,33,-66,5,3,365,203
278,60,3,4,8,5,-65,41,0,4,300,244
278,61,3,4,6,7,33,43,3,7,333,287
278,62,3,3,4,9,31,-64,4,3,364,223
278,63,2,4,5,8,23,44,7,7,387,267
278,64,5,2,10,3,-45,21,2,8,342,288
278,65,4,3,9,4,45,31,7,9,387,319
278,66,3,4,8,5,-65,-59,2,0,322,260
278,67,2,4,5,8,23,44,5,4,345,304
278,68,3,5,5,8,32,53,7,7,377,357
278,69,5,2,10,3,-45,21,2,8,332,378
278,70,2,4,9,4,27,40,9,8,359,418
278,71,4,3,7,6,-57,-67,2,1,302,351
278,72,2,4,5,8,23,44,5,5,325,395
278,73,3,3,7,6,34,33,9,8,359,428
278,74,4,2,6,7,-58,-75,1,3,301,353
278,75,4,3,9,4,45,31,6,4,346,384
278,76,4,3,5,8,41,35,7,9,387,419
278,77,3,3,8,5,-65,-68,2,1,322,351
278,78,4,2,7,6,43,24,5,5,365,375
278,79,4,3,5,8,41,-65,6,0,406,310
278,80,3,4,5,8,32,44,8,4,438,354
278,81,4,2,8,5,-56,23,2,7,382,377
278,82,3,4,5,8,32,-56,4,1,414,321
278,83,4,3,6,7,42,34,6,5,456,355
278,84,4,3,6,7,42,34,8,9,498,389
278,85,3,4,5,8,-68,-56,0,3,430,333
278,86,4,3,8,5,44,32,4,5,474,365
278,87,4,2,6,7,42,-75,6,0,516,290
279,1,2,5,4,9,22,54,2,4,22,54
279,2,2,4,4,9,22,45,4,9,44,99
279,3,2,5,7,6,25,-49,9,0,69,50
279,4,4,2,7,6,-57,24,2,4,12,74
279,5,3,3,9,4,36,31,8,5,48,105
279,6,2,6,4,9,-78,63,0,8,-30,168
279,7,4,2,7,6,43,-76,3,2,13,92
279,8,3,3,9,4,36,31,9,3,49,123
279,9,3,4,4,9,-69,45,0,8,-20,168
279,10,4,3,10,3,46,30,6,8,26,198
279,11,3,3,4,9,31,-64,7,4,57,134
279,12,2,4,6,7,-76,43,1,7,-19,177
279,13,2,4,4,9,22,-55,3,2,3,122
279,14,5,2,9,4,54,22,7,4,57,144
279,15,4,3,9,4,-55,31,2,5,2,175
279,16,3,3,5,8,32,-65,4,0,34,110
279,17,6,2,8,5,62,23,6,3,96,133
279,18,6,2,9,4,63,22,9,5,159,155
279,19,2,5,2,11,20,-44,9,1,179,111
279,20,2,4,8,5,-74,41,5,2,105,152
279,21,3,4,3,10,30,46,5,8,135,198
279,22,4,3,7,6,43,-67,8,1,178,131
279,23,2,4,2,11,20,47,8,8,198,178
279,24,4,2,8,5,-56,-77,2,1,142,101
279,25,6,2,10,3,64,21,6,2,206,122
279,26,3,3,7,6,-66,33,0,5,140,155
279,27,4,3,8,5,44,32,4,7,184,187
279,28,5,2,7,6,52,-76,6,1,236,111
279,29,3,4,9,4,-64,40,2,1,172,151
279,30,2,5,3,10,21,55,3,6,193,206
279,31,4,2,7,6,43,-76,6,0,236,130
279,32,4,3,5,8,41,35,7,5,277,165
279,33,4,2,6,7,42,-75,9,0,319,90
279,34,3,4,6,7,-67,43,2,3,252,133
279,35,2,4,4,9,22,45,4,8,274,178
279,36,3,4,6,7,33,-57,7,1,307,121
279,37,3,3,3,10,30,37,7,8,337,158
279,38,3,4,5,8,32,-56,9,2,369,102
279,39,2,6,2,11,20,65,9,7,389,167
279,40,4,3,8,5,-56,32,3,9,333,199
279,41,4,3,6,7,42,-66,5,3,375,133
279,42,4,3,6,7,42,34,7,7,417,167
279,43,5,2,10,3,-45,21,2,8,372,188
279,44,3,3,7,6,34,-67,6,1,406,121
279,45,4,2,8,5,-56,23,0,4,350,144
279,46,3,3,4,9,31,-64,1,0,381,80
279,47,4,2,8,5,44,23,5,3,425,103
279,48,3,3,8,5,-65,32,0,5,360,135
279,49,3,4,4,9,31,-55,1,0,391,80
279,50,3,4,5,8,32,44,3,4,423,124
279,51,3,3,9,4,36,31,9,5,459,155
279,52,3,4,5,8,-68,44,1,9,391,199
279,53,4,3,7,6,43,-67,4,2,434,132
279,54,3,4,6,7,33,43,7,5,467,175
279,55,3,4,7,6,-66,42,1,7,401,217
279,56,3,4,5,8,32,-56,3,1,433,161
279,57,6,2,11,2,65,20,8,1,498,181
279,58,2,4,6,7,-76,43,2,4,422,224
279,59,4,2,9,4,45,22,7,6,467,246
279,60,3,4,7,6,-66,42,1,8,401,288
279,61,2,4,4,9,22,-55,3,3,423,233
279,62,3,3,5,8,32,35,5,8,455,268
279,63,3,3,6,7,33,-66,8,2,488,202
279,64,4,2,8,5,-56,23,2,5,432,225
279,65,3,4,8,5,35,41,7,6,467,266
279,66,5,2,7,6,52,-76,9,0,519,190
280,1,2,5,4,9,22,54,2,4,22,54
280,2,3,4,4,9,31,45,3,9,53,99
280,3,3,3,5,8,32,-65,5,4,85,34
280,4,4,3,7,6,43,33,8,7,128,67
280,5,3,3,8,5,-65,32,3,9,63,99
280,6,4,3,9,4,45,-69,8,0,108,30
280,7,3,4,4,9,31,45,9,5,139,75
280,8,4,3,7,6,-57,33,2,8,82,108
280,9,5,2,7,6,52,-76,4,2,134,32
280,10,3,3,6,7,33,34,7,6,167,66
280,11,4,3,7,6,-57,33,0,9,110,99
280,12,2,5,4,9,22,-46,2,3,132,53
280,13,4,2,9,4,45,22,7,5,177,75
280,14,3,4,6,7,-67,43,0,8,110,118
280,15,3,3,6,7,33,-66,3,2,143,52
280,16,5,2,8,5,53,23,6,5,196,75
280,17,4,2,8,5,-56,23,0,8,140,98
280,18,4,2,8,5,44,-77,4,1,184,21
280,19,4,3,6,7,42,34,6,5,226,55
280,20,2,5,4,9,22,54,8,9,248,109
280,21,5,2,7,6,-48,-76,0,3,200,33
280,22,4,4,5,8,41,44,1,7,241,77
280,23,4,3,8,5,44,32,5,9,285,109
280,24,2,4,3,10,21,-54,6,5,306,55
280,25,3,3,9,4,-64,31,2,6,242,86
280,26,4,3,8,5,44,32,6,8,286,118
280,27,3,4,7,6,-66,-58,0,0,220,60
280,28,3,3,8,5,35,32,5,2,255,92
280,29,5,2,5,8,50,26,5,8,305,118
280,30,3,4,4,9,31,-55,6,3,336,63
280,31,2,5,5,8,23,53,9,6,359,116
280,32,3,3,10,3,-63,30,6,6,296,146
280,33,3,3,4,9,31,-64,7,2,327,82
280,34,3,4,5,8,32,44,9,6,359,126
280,35,3,4,8,5,-65,41,4,7,294,167
280,36,4,2,9,4,45,22,9,9,339,189
280,37,5,2,11,2,-44,20,5,9,295,209
280,38,3,3,5,8,32,-65,7,4,327,144
280,39,3,3,5,8,32,35,9,9,359,179
280,40,4,3,4,9,40,-64,9,5,399,115
280,41,3,4,9,4,-64,40,5,5,335,155
280,42,5,2,9,4,54,22,9,7,389,177
280,43,3,3,5,8,-68,-65,1,2,321,112
280,44,3,3,7,6,34,33,5,5,355,145
280,45,3,3,5,8,32,-65,7,0,387,80
280,46,5,2,9,4,-46,22,1,2,341,102
280,47,4,3,8,5,44,32,5,4,385,134
280,48,2,5,5,8,23,53,8,7,408,187
280,49,3,3,5,8,-68,-65,0,2,340,122
280,50,3,4,5,8,32,44,2,6,372,166
280,51,4,2,9,4,45,22,7,8,417,188
280,52,3,3,4,9,31,-64,8,4,448,124
280,53,2,4,4,9,-78,45,0,9,370,169
280,54,3,3,7,6,34,-67,4,2,404,102
280,55,3,3,6,7,33,34,7,6,437,136
280,56,4,3,5,8,41,-65,8,1,478,71
280,57,4,3,9,4,-55,31,3,2,423,102
280,58,2,4,5,8,23,44,6,6,446,146
280,59,4,3,6,7,42,-66,8,0,488,80
280,60,3,4,5,8,-68,44,0,4,420,124
280,61,3,4,7,6,34,42,4,6,454,166
280,62,5,2,10,3,55,21,9,7,509,187
281,1,4,2,7,6,43,24,3,4,43,24
281,2,4,3,8,5,44,32,7,6,87,56
281,3,4,2,7,6,-57,-76,0,0,30,-20
281,4,4,3,6,7,42,34,2,4,72,14
281,5,3,3,5,8,32,35,4,9,104,49
281,6,2,4,5,8,23,-56,7,3,127,-7
281,7,3,4,8,5,-65,41,2,4,62,34
281,8,2,6,4,9,22,63,4,7,84,97
281,9,3,3,9,4,-64,31,0,8,20,128
281,10,3,3,7,6,34,-67,4,1,54,61
281,11,5,2,9,4,54,22,8,3,108,83
281,12,2,4,4,9,-78,45,0,8,30,128
281,13,2,5,5,8,23,-47,3,1,53,81
281,14,4,3,5,8,41,35,4,6,94,116
281,15,4,2,6,7,42,-75,6,1,136,41
281,16,2,4,7,6,-75,42,1,3,61,83
281,17,3,3,9,4,36,31,7,4,97,114
281,18,4,4,7,6,-57,42,0,6,40,156
281,19,2,4,6,7,24,43,4,9,64,199
281,20,2,4,5,8,23,-56,7,3,87,143
281,21,3,4,6,7,-67,43,0,6,20,186
281,22,3,4,8,5,35,41,5,7,55,227
281,23,5,2,8,5,53,-77,8,0,108,150
281,24,3,3,4,9,31,36,9,6,139,186
281,25,2,4,4,9,-78,-55,1,1,61,131
281,26,3,4,6,7,33,43,4,4,94,174
281,27,4,2,9,4,45,22,9,6,139,196
281,28,2,5,5,8,-77,53,2,9,62,249
281,29,4,2,7,6,43,-76,5,3,105,173
281,30,3,4,9,4,-64,40,1,3,41,213
281,31,3,4,8,5,35,41,6,4,76,254
281,32,3,4,6,7,33,43,9,7,109,297
281,33,4,2,9,4,-55,22,4,9,54,319
281,34,2,5,3,10,21,-45,5,4,75,274
281,35,4,3,5,8,41,35,6,9,116,309
281,36,3,4,9,4,-64,40,2,9,52,349
281,37,4,2,7,6,43,-76,5,3,95,273
281,38,2,5,3,10,21,55,6,8,116,328
281,39,2,4,5,8,23,-56,9,2,139,272
281,40,3,3,8,5,-65,32,4,4,74,304
281,41,3,3,6,7,33,34,7,8,107,338
281,42,3,3,5,8,32,-65,9,3,139,273
281,43,4,2,11,2,-53,20,6,3,86,293
281,44,5,3,7,6,52,33,8,6,138,326
281,45,5,2,10,3,-45,21,3,7,93,347
281,46,5,2,8,5,53,-77,6,0,146,270
281,47,3,3,5,8,32,35,8,5,178,305
281,48,3,3,6,7,-67,34,1,9,111,339
281,49,3,3,7,6,34,-67,5,2,145,272
281,50,2,5,7,6,-75,51,0,3,70,323
281,51,3,3,3,10,30,-63,0,0,100,260
281,52,2,5,5,8,23,53,3,3,123,313
281,53,6,2,10,3,64,21,7,4,187,334
281,54,3,3,6,7,-67,34,0,8,120,368
281,55,2,4,5,8,23,-56,3,2,143,312
281,56,3,3,7,6,34,33,7,5,177,345
281,57,2,5,5,8,-77,53,0,8,100,398
281,58,3,3,6,7,33,-66,3,2,133,332
281,59,3,4,4,9,31,45,4,7,164,377
281,60,4,2,8,5,44,-77,8,0,208,300
281,61,3,4,8,5,-65,41,3,1,143,341
281,62,2,4,5,8,23,44,6,5,166,385
281,63,3,4,6,7,33,43,9,8,199,428
281,64,3,4,6,7,-67,-57,2,1,132,371
281,65,3,3,6,7,33,34,5,5,165,405
281,66,3,3,7,6,34,33,9,8,199,438
281,67,2,5,5,8,-77,-47,2,1,122,391
281,68,4,3,8,5,44,32,6,3,166,423
281,69,4,2,9,4,-55,22,1,5,111,445
281,70,3,4,5,8,32,44,3,9,143,489
281,71,2,4,8,5,26,-59,9,0,169,430
281,72,2,4,4,9,-78,45,1,5,91,475
281,73,2,5,7,6,25,51,6,6,116,526
282,1,2,5,2,11,20,56,0,6,20,56
282,2,3,4,4,9,31,-55,1,1,51,1
282,3,3,4,8,5,35,41,6,2,86,42
282,4,2,4,4,9,22,45,8,7,108,87
282,5,4,3,6,7,-58,-66,0,1,50,21
282,6,2,4,4,9,22,45,2,6,72,66
282,7,2,4,4,9,22,-55,4,1,94,11
282,8,4,2,6,7,42,25,6,6,136,36
282,9,5,2,6,7,51,-75,7,1,187,-39
282,10,4,3,7,6,-57,33,0,4,130,-6
282,11,4,2,6,7,42,25,2,9,172,19
282,12,4,3,7,6,43,-67,5,2,215,-48
282,13,3,4,4,9,31,45,6,7,246,-3
282,14,3,4,7,6,-66,42,0,9,180,39
282,15,3,3,9,4,36,-69,6,0,216,-30
282,16,2,4,6,7,-76,43,0,3,140,13
282,17,3,3,9,4,36,31,6,4,176,44
282,18,5,2,10,3,-45,21,1,5,131,65
282,19,3,3,6,7,33,34,4,9,164,99
282,20,2,4,4,9,22,-55,6,4,186,44
282,21,4,2,5,8,41,-74,7,0,227,-30
282,22,5,2,9,4,-46,22,1,2,181,-8
282,23,2,5,7,6,25,51,6,3,206,43
282,24,2,4,5,8,23,44,9,7,229,87
282,25,3,3,4,9,-69,-64,0,3,160,23
282,26,4,3,8,5,44,32,4,5,204,55
282,27,4,3,9,4,45,31,9,6,249,86
282,28,3,4,8,5,-65,41,4,7,184,127
282,29,2,5,4,9,22,-46,6,1,206,81
282,30,3,3,7,6,-66,33,0,4,140,114
282,31,2,5,7,6,25,51,5,5,165,165
282,32,3,4,5,8,32,44,7,9,197,209
282,33,3,3,3,10,30,-63,7,6,227,146
282,34,4,3,6,7,42,-66,9,0,269,80
282,35,4,2,8,5,-56,23,3,3,213,103
282,36,4,2,10,3,46,21,9,4,259,124
282,37,3,4,5,8,-68,44,1,8,191,168
282,38,3,4,5,8,32,-56,3,2,223,112
282,39,3,3,8,5,35,32,8,4,258,144
282,40,3,4,4,9,31,45,9,9,289,189
282,41,5,2,11,2,-44,20,5,9,245,209
282,42,2,4,4,9,22,-55,7,4,267,154
282,43,3,3,7,6,-66,33,1,7,201,187
282,44,3,3,8,5,35,32,6,9,236,219
282,45,4,3,7,6,43,-67,9,2,279,152
282,46,5,2,10,3,-45,21,4,3,234,173
282,47,2,5,3,10,21,55,5,8,255,228
282,48,5,2,11,2,-44,20,1,8,211,248
282,49,2,5,5,8,23,-47,4,1,234,201
282,50,3,3,8,5,35,32,9,3,269,233
282,51,5,2,11,2,-44,20,5,3,225,253
282,52,2,5,5,8,23,53,8,6,248,306
282,53,4,3,5,8,41,-65,9,1,289,241
282,54,3,4,5,8,-68,44,1,5,221,285
282,55,3,3,5,8,32,-65,3,0,253,220
282,56,5,2,10,3,55,21,8,1,308,241
282,57,4,3,8,5,-56,32,2,3,252,273
282,58,3,3,4,9,31,36,3,9,283,309
282,59,3,3,9,4,36,-69,9,0,319,240
282,60,4,3,8,5,-56,32,3,2,263,272
282,61,4,3,8,5,44,32,7,4,307,304
282,62,3,3,6,7,-67,34,0,8,240,338
282,63,4,2,9,4,45,-78,5,0,285,260
282,64,3,3,3,10,30,37,5,7,315,297
282,65,4,3,8,5,44,32,9,9,359,329
282,66,4,3,7,6,-57,-67,2,2,302,262
282,67,3,3,5,8,32,35,4,7,334,297
282,68,4,3,7,6,43,-67,7,0,377,230
282,69,3,4,7,6,-66,42,1,2,311,272
282,70,3,5,6,7,33,52,4,4,344,324
282,71,2,5,4,9,22,54,6,8,366,378
282,72,4,3,8,5,-56,-68,0,0,310,310
282,73,2,6,2,11,20,65,0,5,330,375
282,74,4,3,5,8,41,-65,1,0,371,310
282,75,2,5,4,9,22,54,3,4,393,364
282,76,2,5,4,9,22,54,5,8,415,418
282,77,3,4,7,6,34,-58,9,0,449,360
282,78,2,5,4,9,-78,54,1,4,371,414
282,79,2,5,3,10,21,55,2,9,392,469
282,80,3,4,4,9,31,-55,3,4,423,414
282,81,4,2,9,4,45,22,8,6,468,436
282,82,3,4,5,8,-68,-56,0,0,400,380
282,83,2,5,2,11,20,56,0,6,420,436
282,84,3,3,5,8,32,-65,2,1,452,371
282,85,4,3,8,5,44,32,6,3,496,403
282,86,3,3,7,6,-66,33,0,6,430,436
282,87,5,2,11,2,56,20,6,6,486,456
282,88,3,5,3,10,30,-45,6,1,516,411
283,1,4,2,7,6,43,24,3,4,43,24
283,2,3,4,6,7,33,43,6,7,76,67
283,3,3,3,8,5,-65,32,1,9,11,99
283,4,5,2,9,4,54,-78,5,1,65,21
283,5,3,3,5,8,32,35,7,6,97,56
283,6,4,2,5,8,41,-74,8,2,138,-18
283,7,3,4,6,7,-67,43,1,5,71,25
283,8,4,2,11,2,47,20,8,5,118,45
283,9,3,3,4,9,31,-64,9,1,149,-19
283,10,2,4,6,7,-76,43,3,4,73,24
283,11,3,3,7,6,34,33,7,7,107,57
283,12,4,3,8,5,-56,32,1,9,51,89
283,13,5,2,11,2,56,20,7,9,107,109
283,14,3,4,3,10,30,-54,7,5,137,55
283,15,3,4,5,8,32,44,9,9,169,99
283,16,3,4,4,9,-69,-55,0,4,100,44
283,17,3,4,9,4,36,40,6,4,136,84
283,18,5,2,9,4,-46,22,0,6,90,106
283,19,4,3,8,5,44,32,4,8,134,138
283,20,3,3,6,7,33,-66,7,2,167,72
283,21,5,2,9,4,-46,22,1,4,121,94
283,22,3,3,6,7,33,34,4,8,154,128
283,23,4,3,9,4,45,31,9,9,199,159
283,24,2,5,6,7,-76,-48,3,1,123,111
283,25,2,4,4,9,22,45,5,6,145,156
283,26,3,3,6,7,33,-66,8,0,178,90
283,27,5,3,6,7,51,34,9,4,229,124
283,28,4,3,7,6,-57,33,2,7,172,157
283,29,3,3,5,8,32,-65,4,2,204,92
283,30,2,4,3,10,21,46,5,8,225,138
283,31,4,3,9,4,-55,31,0,9,170,169
283,32,4,3,6,7,42,-66,2,3,212,103
283,33,4,2,8,5,44,23,6,6,256,126
283,34,3,4,5,8,32,-56,8,0,288,70
283,35,4,3,5,8,41,35,9,5,329,105
283,36,3,3,4,9,-69,-64,0,1,260,41
283,37,3,4,4,9,31,45,1,6,291,86
283,38,4,3,10,3,46,30,7,6,337,116
283,39,2,5,2,11,20,-44,7,2,357,72
283,40,3,3,6,7,-67,34,0,6,290,106
283,41,4,2,9,4,45,22,5,8,335,128
283,42,3,4,3,10,30,-54,5,4,365,74
283,43,3,4,7,6,34,42,9,6,399,116
283,44,3,4,3,10,30,-54,9,2,429,62
283,45,3,4,6,7,-67,43,2,5,362,105
283,46,5,2,10,3,55,21,7,6,417,126
283,47,5,2,9,4,-46,22,1,8,371,148
283,48,5,2,7,6,52,-76,3,2,423,72
283,49,3,4,7,6,34,42,7,4,457,114
283,50,5,2,8,5,-47,23,0,7,410,137
283,51,2,5,5,8,23,-47,3,0,433,90
283,52,3,3,7,6,34,33,7,3,467,123
283,53,4,2,8,5,-56,23,1,6,411,146
283,54,4,2,7,6,43,-76,4,0,454,70
283,55,2,5,3,10,21,55,5,5,475,125
283,56,4,2,8,5,44,23,9,8,519,148
284,1,3,3,4,9,31,36,1,6,31,36
284,2,4,2,9,4,45,22,6,8,76,58
284,3,3,3,7,6,-66,-67,0,1,10,-9
284,4,2,5,4,9,22,54,2,5,32,45
284,5,4,2,7,6,43,24,5,9,75,69
284,6,6,2,8,5,62,-77,7,2,137,-8
284,7,2,5,5,8,-77,53,0,5,60,45
284,8,2,4,6,7,24,43,4,8,84,88
284,9,3,3,6,7,33,-66,7,2,117,22
284,10,3,3,10,3,-63,30,4,2,54,52
284,11,4,2,6,7,42,25,6,7,96,77
284,12,4,3,7,6,43,-67,9,0,139,10
284,13,4,2,5,8,-59,26,0,6,80,36
284,14,4,3,9,4,45,31,5,7,125,67
284,15,4,3,8,5,44,32,9,9,169,99
284,16,2,4,4,9,-78,-55,1,4,91,44
284,17,4,3,7,6,43,33,4,7,134,77
284,18,4,2,10,3,-54,21,0,8,80,98
284,19,2,4,4,9,22,-55,2,3,102,43
284,20,4,3,9,4,45,31,7,4,147,74
284,21,3,3,9,4,-64,31,3,5,83,105
284,22,4,2,9,4,45,22,8,7,128,127
284,23,5,2,7,6,-48,-76,0,1,80,51
284,24,4,3,9,4,45,31,5,2,125,82
284,25,2,6,2,11,20,65,5,7,145,147
284,26,5,2,9,4,54,22,9,9,199,169
284,27,3,3,5,8,-68,-65,1,4,131,104
284,28,3,3,3,10,30,-63,1,1,161,41
284,29,2,5,3,10,21,55,2,6,182,96
284,30,4,3,8,5,44,32,6,8,226,128
284,31,3,4,6,7,33,-57,9,1,259,71
284,32,3,3,6,7,-67,34,2,5,192,105
284,33,3,4,6,7,33,43,5,8,225,148
284,34,4,3,9,4,-55,31,0,9,170,179
284,35,2,5,5,8,23,-47,3,2,193,132
284,36,3,3,4,9,31,36,4,8,224,168
284,37,4,2,8,5,44,-77,8,1,268,91
284,38,4,4,8,5,-56,41,2,2,212,132
284,39,3,3,8,5,35,32,7,4,247,164
284,40,2,5,5,8,-77,53,0,7,170,217
284,41,4,3,6,7,42,-66,2,1,212,151
284,42,3,3,7,6,34,33,6,4,246,184
284,43,2,4,6,7,-76,43,0,7,170,227
284,44,3,4,6,7,33,-57,3,0,203,170
284,45,2,6,3,10,21,64,4,4,224,234
284,46,3,3,8,5,35,32,9,6,259,266
284,47,3,4,6,7,-67,43,2,9,192,309
284,48,2,5,5,8,23,-47,5,2,215,262
284,49,4,3,8,5,44,32,9,4,259,294
284,50,3,3,9,4,-64,31,5,5,195,325
284,51,5,2,9,4,54,22,9,7,249,347
284,52,5,2,10,3,-45,21,4,8,204,368
284,53,2,4,6,7,24,-57,8,1,228,311
284,54,4,3,8,5,-56,32,2,3,172,343
284,55,3,4,4,9,31,45,3,8,203,388
284,56,3,3,8,5,35,-68,8,0,238,320
284,57,3,3,7,6,-66,33,2,3,172,353
284,58,4,3,7,6,43,33,5,6,215,386
284,59,3,3,8,5,-65,32,0,8,150,418
284,60,2,4,6,7,24,-57,4,1,174,361
284,61,3,3,6,7,33,34,7,5,207,395
284,62,3,4,7,6,-66,42,1,7,141,437
284,63,3,4,4,9,31,-55,2,2,172,382
284,64,3,4,7,6,34,42,6,4,206,424
284,65,2,5,5,8,23,53,9,7,229,477
284,66,3,3,8,5,-65,32,4,9,164,509
285,1,2,4,9,4,27,40,7,0,27,40
285,2,3,3,6,7,-67,34,0,4,-40,74
285,3,3,4,5,8,32,44,2,8,-8,118
285,4,3,3,6,7,33,-66,5,2,25,52
285,5,4,3,7,6,43,33,8,5,68,85
285,6,3,3,6,7,-67,34,1,9,1,119
285,7,2,4,7,6,25,-58,6,1,26,61
285,8,2,4,5,8,23,44,9,5,49,105
285,9,3,3,4,9,-69,-64,0,1,-20,41
285,10,3,3,6,7,33,34,3,5,13,75
285,11,4,4,9,4,45,40,8,5,58,115
285,12,4,3,7,6,-57,33,1,8,1,148
285,13,2,4,4,9,22,-55,3,3,23,93
285,14,5,2,7,6,52,24,5,7,75,117
285,15,3,3,6,7,33,-66,8,1,108,51
285,16,3,3,7,6,-66,33,2,4,42,84
285,17,3,4,8,5,35,41,7,5,77,125
285,18,2,6,3,10,21,64,8,9,98,189
285,19,3,5,4,9,31,-46,9,3,129,143
285,20,3,4,5,8,-68,44,1,7,61,187
285,21,5,2,6,7,51,-75,2,2,112,112
285,22,2,5,4,9,22,54,4,6,134,166
285,23,3,4,6,7,33,43,7,9,167,209
285,24,5,2,11,2,-44,20,3,9,123,229
285,25,4,3,8,5,44,-68,7,1,167,161
285,26,4,3,5,8,41,35,8,6,208,196
285,27,5,3,6,7,51,-66,9,0,259,130
285,28,5,3,9,4,-46,31,3,1,213,161
285,29,3,3,3,10,30,37,3,8,243,198
285,30,4,2,9,4,45,-78,8,0,288,120
285,31,5,2,8,5,-47,23,1,3,241,143
285,32,4,2,7,6,43,24,4,7,284,167
285,33,5,2,11,2,-44,20,0,7,240,187
285,34,2,4,4,9,22,-55,2,2,262,132
285,35,2,4,6,7,24,43,6,5,286,175
285,36,3,3,6,7,33,34,9,9,319,209
285,37,3,4,7,6,-66,-58,3,1,253,151
285,38,2,4,4,9,22,45,5,6,275,196
285,39,4,4,8,5,44,41,9,7,319,237
285,40,3,3,7,6,-66,-67,3,0,253,170
285,41,3,3,7,6,34,33,7,3,287,203
285,42,4,3,9,4,-55,31,2,4,232,234
285,43,2,5,5,8,23,53,5,7,255,287
285,44,5,3,7,6,52,-67,7,0,307,220
285,45,4,3,8,5,-56,32,1,2,251,252
285,46,4,3,5,8,41,35,2,7,292,287
285,47,4,3,8,5,44,32,6,9,336,319
285,48,4,3,8,5,-56,-68,0,1,280,251
285,49,2,4,7,6,25,42,5,3,305,293
285,50,4,3,8,5,44,32,9,5,349,325
285,51,4,3,5,8,-59,-65,0,0,290,260
285,52,4,3,10,3,46,30,6,0,336,290
285,53,3,4,4,9,31,45,7,5,367,335
285,54,4,3,7,6,-57,33,0,8,310,368
285,55,3,4,5,8,32,-56,2,2,342,312
285,56,3,3,6,7,33,34,5,6,375,346
285,57,4,3,9,4,-55,31,0,7,320,377
285,58,2,5,5,8,23,-47,3,0,343,330
285,59,2,4,3,10,21,46,4,6,364,376
285,60,3,3,5,8,32,-65,6,1,396,311
285,61,2,4,4,9,22,45,8,6,418,356
285,62,4,2,10,3,-54,21,4,7,364,377
285,63,3,3,7,6,34,-67,8,0,398,310
285,64,2,4,4,9,-78,45,0,5,320,355
285,65,4,3,5,8,41,-65,1,0,361,290
285,66,4,3,7,6,43,33,4,3,404,323
285,67,2,6,2,11,20,65,4,8,424,388
285,68,4,3,7,6,43,-67,7,1,467,321
285,69,2,4,4,9,22,45,9,6,489,366
285,70,3,3,5,8,-68,-65,1,1,421,301
285,71,2,6,4,9,22,63,3,4,443,364
285,72,4,3,9,4,45,31,8,5,488,395
285,73,4,2,8,5,-56,23,2,8,432,418
285,74,2,6,2,11,20,-35,2,3,452,383
285,75,3,3,8,5,35,32,7,5,487,415
285,76,3,3,10,3,-63,30,4,5,424,445
285,77,2,5,4,9,22,54,6,9,446,499
285,78,2,5,4,9,22,-46,8,3,468,453
285,79,2,4,2,11,20,-53,8,0,488,400
285,80,4,3,8,5,-56,32,2,2,432,432
285,81,2,6,6,7,24,61,6,3,456,493
285,82,2,4,5,8,23,44,9,7,479,537
286,1,3,4,7,6,34,42,4,2,34,42
286,2,4,3,7,6,43,33,7,5,77,75
286,3,2,4,4,9,22,-55,9,0,99,20
286,4,2,5,5,8,-77,53,2,3,22,73
286,5,3,4,7,6,34,42,6,5,56,115
286,6,3,4,7,6,-66,42,0,7,-10,157
286,7,2,4,5,8,23,-56,3,1,13,101
286,8,4,3,8,5,44,32,7,3,57,133
286,9,3,3,7,6,-66,33,1,6,-9,166
286,10,2,5,5,8,23,53,4,9,14,219
286,11,3,3,8,5,35,-68,9,1,49,151
286,12,4,2,7,6,-57,24,2,5,-8,175
286,13,3,3,4,9,31,-64,3,1,23,111
286,14,2,5,2,11,20,56,3,7,43,167
286,15,3,5,5,8,32,-47,5,0,75,120
286,16,4,4,9,4,-55,40,0,0,20,160
286,17,3,3,6,7,33,34,3,4,53,194
286,18,3,4,6,7,33,43,6,7,86,237
286,19,4,3,5,8,41,-65,7,2,127,172
286,20,2,5,4,9,22,54,9,6,149,226
286,21,5,2,10,3,-45,21,4,7,104,247
286,22,4,3,8,5,44,32,8,9,148,279
286,23,4,3,8,5,-56,-68,2,1,92,211
286,24,5,2,8,5,53,23,5,4,145,234
286,25,2,5,4,9,22,54,7,8,167,288
286,26,3,4,6,7,-67,-57,0,1,100,231
286,27,3,3,6,7,33,34,3,5,133,265
286,28,3,4,7,6,34,42,7,7,167,307
286,29,3,4,6,7,-67,-57,0,0,100,250
286,30,4,3,8,5,44,32,4,2,144,282
286,31,2,5,5,8,23,53,7,5,167,335
286,32,3,3,4,9,31,-64,8,1,198,271
286,33,4,3,7,6,-57,33,1,4,141,304
286,34,2,4,6,7,24,43,5,7,165,347
286,35,4,2,8,5,44,-77,9,0,209,270
286,36,4,2,8,5,-56,23,3,3,153,293
286,37,3,3,7,6,34,33,7,6,187,326
286,38,2,4,4,9,22,-55,9,1,209,271
286,39,4,2,7,6,-57,24,2,5,152,295
286,40,4,3,8,5,44,32,6,7,196,327
286,41,3,3,7,6,-66,-67,0,0,130,260
286,42,3,3,5,8,32,35,2,5,162,295
286,43,2,4,6,7,24,43,6,8,186,338
286,44,3,5,4,9,31,-46,7,2,217,292
286,45,4,4,6,7,42,43,9,5,259,335
286,46,2,4,5,8,-77,44,2,9,182,379
286,47,4,2,6,7,42,-75,4,4,224,304
286,48,2,5,4,9,22,54,6,8,246,358
286,49,2,4,4,9,22,-55,8,3,268,303
286,50,2,5,5,8,-77,53,1,6,191,356
286,51,3,3,7,6,34,33,5,9,225,389
286,52,4,3,6,7,42,-66,7,3,267,323
286,53,4,3,8,5,-56,32,1,5,211,355
286,54,4,3,5,8,41,-65,2,0,252,290
286,55,4,2,9,4,45,22,7,2,297,312
286,56,2,5,4,9,22,54,9,6,319,366
286,57,5,2,9,4,-46,22,3,8,273,388
286,58,3,3,6,7,33,-66,6,2,306,322
286,59,3,3,8,5,-65,32,1,4,241,354
286,60,3,4,6,7,33,43,4,7,274,397
286,61,4,2,7,6,43,-76,7,1,317,321
286,62,2,5,4,9,22,54,9,5,339,375
286,63,2,5,3,10,-79,-45,0,0,260,330
286,64,3,4,4,9,31,45,1,5,291,375
286,65,3,4,5,8,32,44,3,9,323,419
286,66,2,4,8,5,26,-59,9,0,349,360
286,67,4,3,9,4,-55,31,4,1,294,391
286,68,5,2,11,2,-44,20,0,1,250,411
286,69,4,3,7,6,43,33,3,4,293,444
286,70,3,4,6,7,33,43,6,7,326,487
286,71,3,3,7,6,-66,-67,0,0,260,420
286,72,5,2,9,4,54,22,4,2,314,442
286,73,4,2,10,3,-54,21,0,3,260,463
286,74,3,3,8,5,35,32,5,5,295,495
286,75,3,3,6,7,33,34,8,9,328,529
287,1,5,2,9,4,54,22,4,2,54,22
287,2,3,4,4,9,31,45,5,7,85,67
287,3,2,5,4,9,22,-46,7,1,107,21
287,4,3,4,5,8,32,44,9,5,139,65
287,5,4,2,9,4,-55,22,4,7,84,87
287,6,2,5,4,9,22,-46,6,1,106,41
287,7,3,4,7,6,-66,42,0,3,40,83
287,8,2,5,3,10,21,55,1,8,61,138
287,9,3,4,5,8,32,-56,3,2,93,82
287,10,4,3,6,7,42,34,5,6,135,116
287,11,3,4,5,8,32,-56,7,0,167,60
287,12,3,3,5,8,32,35,9,5,199,95
287,13,4,3,9,4,-55,31,4,6,144,126
287,14,4,2,9,4,45,22,9,8,189,148
287,15,3,3,6,7,-67,-66,2,2,122,82
287,16,5,2,9,4,54,22,6,4,176,104
287,17,3,4,6,7,33,43,9,7,209,147
287,18,2,5,4,9,-78,-46,1,1,131,101
287,19,3,3,7,6,34,33,5,4,165,134
287,20,4,2,6,7,42,25,7,9,207,159
287,21,3,3,7,6,-66,-67,1,2,141,92
287,22,2,5,5,8,23,53,4,5,164,145
287,23,4,3,5,8,41,-65,5,0,205,80
287,24,3,3,6,7,33,34,8,4,238,114
287,25,2,4,7,6,-75,42,3,6,163,156
287,26,3,3,7,6,34,33,7,9,197,189
287,27,2,5,4,9,22,-46,9,3,219,143
287,28,3,3,4,9,-69,36,0,9,150,179
287,29,3,3,7,6,34,-67,4,2,184,112
287,30,2,5,3,10,21,55,5,7,205,167
287,31,4,2,7,6,43,-76,8,1,248,91
287,32,3,3,8,5,-65,32,3,3,183,123
287,33,4,2,5,8,41,26,4,9,224,149
287,34,4,2,7,6,43,-76,7,3,267,73
287,35,3,4,7,6,-66,42,1,5,201,115
287,36,4,3,5,8,41,-65,2,0,242,50
287,37,4,2,6,7,42,25,4,5,284,75
287,38,4,3,9,4,45,31,9,6,329,106
287,39,3,4,6,7,-67,43,2,9,262,149
287,40,3,3,7,6,34,-67,6,2,296,82
287,41,2,4,2,11,20,47,6,9,316,129
287,42,3,3,6,7,33,-66,9,3,349,63
287,43,5,2,10,3,-45,21,4,4,304,84
287,44,4,3,5,8,41,35,5,9,345,119
287,45,3,4,6,7,33,-57,8,2,378,62
287,46,3,3,9,4,-64,31,4,3,314,93
287,47,4,2,9,4,45,22,9,5,359,115
287,48,5,2,6,7,-49,-75,0,0,310,40
287,49,3,4,4,9,31,45,1,5,341,85
287,50,3,3,7,6,34,33,5,8,375,118
287,51,2,5,4,9,22,-46,7,2,397,72
287,52,3,3,6,7,-67,34,0,6,330,106
287,53,5,2,9,4,54,22,4,8,384,128
287,54,3,5,5,8,32,-47,6,1,416,81
287,55,4,3,10,3,-54,30,2,1,362,111
287,56,4,3,7,6,43,33,5,4,405,144
287,57,3,4,5,8,32,44,7,8,437,188
287,58,3,3,8,5,-65,-68,2,0,372,120
287,59,3,3,6,7,33,34,5,4,405,154
287,60,3,3,7,6,34,33,9,7,439,187
287,61,2,5,4,9,-78,-46,1,1,361,141
287,62,4,3,6,7,42,34,3,5,403,175
287,63,2,4,8,5,26,41,9,6,429,216
287,64,3,3,5,8,-68,-65,1,1,361,151
287,65,4,3,7,6,43,33,4,4,404,184
287,66,3,4,6,7,33,43,7,7,437,227
287,67,5,2,10,3,-45,21,2,8,392,248
287,68,3,3,9,4,36,31,8,9,428,279
287,69,2,6,3,10,21,-36,9,3,449,243
287,70,4,3,6,7,-58,34,1,7,391,277
287,71,4,2,8,5,44,-77,5,0,435,200
287,72,2,6,4,9,22,63,7,3,457,263
287,73,4,2,10,3,-54,21,3,4,403,284
287,74,2,4,7,6,25,42,8,6,428,326
287,75,4,3,5,8,41,-65,9,1,469,261
287,76,4,3,5,8,-59,35,0,6,410,296
287,77,3,4,4,9,31,-55,1,1,441,241
287,78,3,3,5,8,32,35,3,6,473,276
287,79,3,4,7,6,34,42,7,8,507,318
288,1,3,4,6,7,33,43,3,3,33,43
288,2,2,5,4,9,22,54,5,7,55,97
288,3,3,4,5,8,32,-56,7,1,87,41
288,4,3,3,8,5,-65,32,2,3,22,73
288,5,3,3,6,7,33,34,5,7,55,107
288,6,5,2,11,2,-44,20,1,7,11,127
288,7,4,3,7,6,43,-67,4,0,54,60
288,8,3,3,8,5,35,32,9,2,89,92
288,9,5,2,8,5,-47,23,2,5,42,115
288,10,3,4,4,9,31,-55,3,0,73,60
288,11,3,4,5,8,32,44,5,4,105,104
288,12,4,2,8,5,44,23,9,7,149,127
288,13,3,3,5,8,-68,-65,1,2,81,62
288,14,3,5,5,8,32,53,3,5,113,115
288,15,2,4,6,7,24,43,7,8,137,158
288,16,4,3,7,6,-57,-67,0,1,80,91
288,17,4,4,8,5,44,41,4,2,124,132
288,18,2,4,4,9,22,45,6,7,146,177
288,19,4,3,7,6,43,-67,9,0,189,110
288,20,2,5,5,8,-77,53,2,3,112,163
288,21,3,3,8,5,35,32,7,5,147,195
288,22,3,3,5,8,32,-65,9,0,179,130
288,23,4,2,8,5,-56,23,3,3,123,153
288,24,2,4,6,7,24,43,7,6,147,196
288,25,4,4,8,5,-56,41,1,7,91,237
288,26,4,3,10,3,46,30,7,7,137,267
288,27,3,3,8,5,-65,32,2,9,72,299
288,28,4,3,5,8,41,-65,3,4,113,234
288,29,4,3,9,4,45,31,8,5,158,265
288,30,5,2,8,5,-47,23,1,8,111,288
288,31,3,4,6,7,33,-57,4,1,144,231
288,32,4,3,7,6,43,33,7,4,187,264
288,33,2,4,6,7,-76,43,1,7,111,307
288,34,4,3,8,5,44,32,5,9,155,339
288,35,2,4,6,7,24,-57,9,2,179,282
288,36,4,2,7,6,-57,24,2,6,122,306
288,37,3,4,6,7,33,43,5,9,155,349
288,38,2,5,5,8,23,-47,8,2,178,302
288,39,3,4,5,8,-68,44,0,6,110,346
288,40,4,3,7,6,43,33,3,9,153,379
288,41,4,3,8,5,44,-68,7,1,197,311
288,42,5,2,7,6,52,24,9,5,249,335
288,43,3,3,9,4,-64,31,5,6,185,366
288,44,4,4,7,6,43,42,8,8,228,408
288,45,3,4,8,5,-65,41,3,9,163,449
288,46,3,3,8,5,35,-68,8,1,198,381
288,47,3,3,5,8,-68,35,0,6,130,416
288,48,3,4,5,8,32,-56,2,0,162,360
288,49,6,2,10,3,64,21,6,1,226,381
288,50,3,4,6,7,33,43,9,4,259,424
288,51,3,4,3,10,30,-54,9,0,289,370
288,52,3,3,6,7,-67,34,2,4,222,404
288,53,3,3,7,6,34,33,6,7,256,437
288,54,4,2,9,4,-55,22,1,9,201,459
288,55,2,5,2,11,20,-44,1,5,221,415
288,56,4,3,8,5,44,32,5,7,265,447
288,57,3,3,9,4,-64,31,1,8,201,478
288,58,3,4,6,7,33,-57,4,1,234,421
288,59,2,4,5,8,23,44,7,5,257,465
288,60,5,2,9,4,-46,22,1,7,211,487
288,61,5,2,9,4,54,22,5,9,265,509
289,1,3,3,6,7,33,34,3,4,33,34
289,2,3,4,6,7,33,43,6,7,66,77
289,3,3,3,7,6,-66,-67,0,0,0,10
289,4,2,4,7,6,25,42,5,2,25,52
289,5,2,4,7,6,-75,42,0,4,-50,94
289,6,3,4,5,8,32,44,2,8,-18,138
289,7,4,3,7,6,43,-67,5,1,25,71
289,8,2,4,5,8,23,44,8,5,48,115
289,9,4,2,8,5,-56,23,2,8,-8,138
289,10,3,3,7,6,34,-67,6,1,26,71
289,11,4,3,4,9,40,36,6,7,66,107
289,12,4,3,9,4,-55,31,1,8,11,138
289,13,3,3,5,8,32,-65,3,3,43,73
289,14,5,2,8,5,53,23,6,6,96,96
289,15,3,4,7,6,-66,42,0,8,30,138
289,16,4,2,8,5,44,-77,4,1,74,61
289,17,2,4,7,6,25,42,9,3,99,103
289,18,3,4,6,7,-67,43,2,6,32,146
289,19,2,4,6,7,24,43,6,9,56,189
289,20,3,4,5,8,32,-56,8,3,88,133
289,21,4,3,7,6,-57,33,1,6,31,166
289,22,5,2,9,4,54,22,5,8,85,188
289,23,5,2,9,4,54,-78,9,0,139,110
289,24,5,2,6,7,-49,25,0,5,90,135
289,25,2,4,7,6,25,42,5,7,115,177
289,26,5,2,11,2,-44,20,1,7,71,197
289,27,2,4,7,6,25,42,6,9,96,239
289,28,2,4,6,7,-76,-57,0,2,20,182
289,29,4,2,6,7,42,25,2,7,62,207
289,30,3,3,8,5,35,32,7,9,97,239
289,31,5,2,6,7,51,-75,8,4,148,164
289,32,2,5,6,7,-76,52,2,6,72,216
289,33,4,2,9,4,45,22,7,8,117,238
289,34,2,4,3,10,21,-54,8,4,138,184
289,35,5,2,11,2,-44,20,4,4,94,204
289,36,2,5,5,8,23,53,7,7,117,257
289,37,5,2,11,2,-44,20,3,7,73,277
289,38,4,3,8,5,44,32,7,9,117,309
289,39,4,3,6,7,42,-66,9,3,159,243
289,40,5,2,9,4,-46,22,3,5,113,265
289,41,3,4,6,7,33,43,6,8,146,308
289,42,3,4,6,7,33,-57,9,1,179,251
289,43,2,5,4,9,-78,54,1,5,101,305
289,44,4,3,8,5,44,32,5,7,145,337
289,45,2,5,5,8,23,-47,8,0,168,290
289,46,5,2,9,4,-46,22,2,2,122,312
289,47,5,2,10,3,55,21,7,3,177,333
289,48,3,3,7,6,-66,33,1,6,111,366
289,49,3,3,9,4,36,31,7,7,147,397
289,50,4,3,8,5,-56,32,1,9,91,429
289,51,2,5,6,7,24,-48,5,1,115,381
289,52,3,3,9,4,-64,31,1,2,51,412
289,53,3,4,7,6,34,42,5,4,85,454
289,54,4,2,8,5,44,23,9,7,129,477
289,55,3,4,7,6,-66,42,3,9,63,519
290,1,5,2,7,6,52,24,2,4,52,24
290,2,4,3,9,4,45,31,7,5,97,55
290,3,4,3,8,5,-56,32,1,7,41,87
290,4,4,3,6,7,42,-66,3,1,83,21
290,5,3,3,6,7,33,34,6,5,116,55
290,6,2,6,3,10,21,64,7,9,137,119
290,7,2,4,5,8,-77,-56,0,3,60,63
290,8,2,4,4,9,22,45,2,8,82,108
290,9,2,5,6,7,24,-48,6,0,106,60
290,10,5,2,12,1,-43,-20,3,0,63,40
290,11,3,3,6,7,33,34,6,4,96,74
290,12,2,5,5,8,23,53,9,7,119,127
290,13,3,4,6,7,-67,-57,2,0,52,70
290,14,3,3,8,5,35,32,7,2,87,102
290,15,3,4,5,8,32,44,9,6,119,146
290,16,4,2,8,5,-56,23,3,9,63,169
290,17,4,3,7,6,43,-67,6,2,106,102
290,18,4,3,8,5,-56,32,0,4,50,134
290,19,3,4,6,7,33,43,3,7,83,177
290,20,4,3,9,4,45,31,8,8,128,208
290,21,3,4,7,6,-66,-58,2,0,62,150
290,22,3,4,5,8,32,44,4,4,94,194
290,23,3,3,6,7,33,34,7,8,127,228
290,24,2,6,2,11,20,-35,7,3,147,193
290,25,2,5,3,10,21,55,8,8,168,248
290,26,4,3,8,5,-56,-68,2,0,112,180
290,27,4,2,8,5,44,23,6,3,156,203
290,28,3,3,8,5,-65,32,1,5,91,235
290,29,3,5,5,8,32,53,3,8,123,288
290,30,3,4,6,7,33,-57,6,1,156,231
290,31,3,3,7,6,-66,33,0,4,90,264
290,32,4,2,10,3,46,21,6,5,136,285
290,33,3,3,8,5,-65,32,1,7,71,317
290,34,4,2,8,5,44,-77,5,0,115,240
290,35,2,4,6,7,24,43,9,3,139,283
290,36,4,2,9,4,-55,22,4,5,84,305
290,37,4,3,7,6,43,33,7,8,127,338
290,38,3,3,7,6,-66,-67,1,1,61,271
290,39,2,4,4,9,22,45,3,6,83,316
290,40,2,4,3,10,21,-54,4,2,104,262
290,41,3,3,5,8,32,35,6,7,136,297
290,42,2,4,4,9,22,-55,8,2,158,242
290,43,3,4,8,5,-65,41,3,3,93,283
290,44,4,3,7,6,43,33,6,6,136,316
290,45,4,2,6,7,42,-75,8,1,178,241
290,46,4,3,9,4,-55,31,3,2,123,272
290,47,5,2,11,2,56,20,9,2,179,292
290,48,3,4,8,5,-65,41,4,3,114,333
290,49,3,3,6,7,33,34,7,7,147,367
290,50,4,3,5,8,41,-65,8,2,188,302
290,51,3,4,6,7,-67,43,1,5,121,345
290,52,3,4,7,6,34,42,5,7,155,387
290,53,2,5,5,8,23,-47,8,0,178,340
290,54,6,2,11,2,-35,20,3,0,143,360
290,55,2,6,3,10,21,64,4,4,164,424
290,56,5,2,10,3,55,21,9,5,219,445
290,57,3,4,6,7,-67,43,2,8,152,488
290,58,4,3,9,4,45,31,7,9,197,519
291,1,4,3,6,7,42,34,2,4,42,34
291,2,3,3,7,6,34,33,6,7,76,67
291,3,5,2,8,5,53,-77,9,0,129,-10
291,4,4,4,7,6,-57,42,2,2,72,32
291,5,3,4,7,6,34,42,6,4,106,74
291,6,3,4,5,8,32,44,8,8,138,118
291,7,2,5,3,10,21,-45,9,3,159,73
291,8,3,4,4,9,-69,45,0,8,90,118
291,9,2,5,2,11,20,-44,0,4,110,74
291,10,2,5,3,10,21,55,1,9,131,129
291,11,4,2,7,6,43,-76,4,3,174,53
291,12,4,4,9,4,45,40,9,3,219,93
291,13,2,4,6,7,-76,43,3,6,143,136
291,14,4,2,10,3,46,21,9,7,189,157
291,15,4,3,10,3,-54,30,5,7,135,187
291,16,3,4,4,9,31,-55,6,2,166,132
291,17,2,4,5,8,23,44,9,6,189,176
291,18,2,5,7,6,-75,51,4,7,114,227
291,19,5,2,8,5,53,-77,7,0,167,150
291,20,4,2,5,8,41,26,8,6,208,176
291,21,3,4,4,9,31,-55,9,1,239,121
291,22,2,4,6,7,-76,43,3,4,163,164
291,23,5,2,8,5,53,23,6,7,216,187
291,24,3,3,5,8,32,-65,8,2,248,122
291,25,3,4,7,6,-66,42,2,4,182,164
291,26,3,4,4,9,31,45,3,9,213,209
291,27,3,3,8,5,35,-68,8,1,248,141
291,28,5,2,10,3,-45,21,3,2,203,162
291,29,4,3,6,7,42,34,5,6,245,196
291,30,2,4,6,7,24,43,9,9,269,239
291,31,3,4,4,9,-69,-55,0,4,200,184
291,32,3,3,5,8,32,35,2,9,232,219
291,33,4,2,8,5,44,-77,6,2,276,142
291,34,5,2,9,4,-46,22,0,4,230,164
291,35,4,3,7,6,43,33,3,7,273,197
291,36,2,4,5,8,23,-56,6,1,296,141
291,37,3,3,6,7,33,34,9,5,329,175
291,38,4,2,10,3,-54,21,5,6,275,196
291,39,3,4,4,9,31,-55,6,1,306,141
291,40,4,2,9,4,-55,22,1,3,251,163
291,41,4,2,8,5,44,23,5,6,295,186
291,42,2,5,5,8,23,53,8,9,318,239
291,43,3,4,7,6,-66,-58,2,1,252,181
291,44,4,2,8,5,44,23,6,4,296,204
291,45,3,3,7,6,-66,33,0,7,230,237
291,46,4,2,10,3,46,21,6,8,276,258
291,47,4,3,7,6,43,-67,9,1,319,191
291,48,4,2,6,7,-58,25,1,6,261,216
291,49,3,3,8,5,35,32,6,8,296,248
291,50,3,4,5,8,32,-56,8,2,328,192
291,51,3,3,7,6,-66,33,2,5,262,225
291,52,2,5,5,8,23,53,5,8,285,278
291,53,2,4,5,8,23,-56,8,2,308,222
291,54,4,2,8,5,-56,23,2,5,252,245
291,55,4,3,8,5,44,32,6,7,296,277
291,56,4,4,5,8,41,-56,7,1,337,221
291,57,4,2,7,6,-57,24,0,5,280,245
291,58,2,5,3,10,21,-45,1,0,301,200
291,59,2,4,5,8,23,44,4,4,324,244
291,60,3,3,8,5,35,32,9,6,359,276
291,61,4,2,9,4,-55,22,4,8,304,298
291,62,4,3,9,4,45,31,9,9,349,329
291,63,4,2,8,5,-56,-77,3,2,293,252
291,64,3,3,6,7,33,34,6,6,326,286
291,65,3,3,7,6,-66,33,0,9,260,319
291,66,2,5,2,11,20,-44,0,5,280,275
291,67,3,4,8,5,35,41,5,6,315,316
291,68,3,5,5,8,32,53,7,9,347,369
291,69,3,3,6,7,-67,-66,0,3,280,303
291,70,4,3,8,5,44,32,4,5,324,335
291,71,4,2,10,3,-54,21,0,6,270,356
291,72,6,2,10,3,64,21,4,7,334,377
291,73,2,4,6,7,24,-57,8,0,358,320
291,74,2,6,2,11,20,65,8,5,378,385
291,75,4,3,4,9,40,-64,8,1,418,321
291,76,4,3,10,3,-54,30,4,1,364,351
291,77,3,3,6,7,33,34,7,5,397,385
291,78,5,2,9,4,-46,22,1,7,351,407
291,79,4,2,10,3,46,21,7,8,397,428
291,80,3,3,5,8,32,-65,9,3,429,363
291,81,4,3,5,8,-59,35,0,8,370,398
291,82,5,2,6,7,51,-75,1,3,421,323
291,83,5,2,7,6,52,24,3,7,473,347
291,84,4,2,8,5,44,-77,7,0,517,270
292,1,5,2,7,6,52,24,2,4,52,24
292,2,4,3,8,5,44,32,6,6,96,56
292,3,2,4,5,8,23,-56,9,0,119,0
292,4,4,2,9,4,-55,22,4,2,64,22
292,5,4,3,7,6,43,33,7,5,107,55
292,6,4,3,8,5,-56,32,1,7,51,87
292,7,4,3,7,6,43,-67,4,0,94,20
292,8,3,4,5,8,32,44,6,4,126,64
292,9,5,2,8,5,53,23,9,7,179,87
292,10,3,3,5,8,-68,-65,1,2,111,22
292,11,5,2,9,4,54,22,5,4,165,44
292,12,2,5,3,10,21,55,6,9,186,99
292,13,4,3,5,8,41,-65,7,4,227,34
292,14,4,4,7,6,-57,42,0,6,170,76
292,15,3,4,5,8,32,-56,2,0,202,20
292,16,5,2,7,6,52,24,4,4,254,44
292,17,6,2,10,3,64,21,8,5,318,65
292,18,3,3,6,7,-67,34,1,9,251,99
292,19,4,3,7,6,43,-67,4,2,294,32
292,20,3,4,6,7,33,43,7,5,327,75
292,21,5,2,10,3,-45,21,2,6,282,96
292,22,3,4,5,8,32,-56,4,0,314,40
292,23,4,2,7,6,43,24,7,4,357,64
292,24,3,4,4,9,31,45,8,9,388,109
292,25,2,5,4,9,-78,-46,0,3,310,63
292,26,3,3,6,7,33,34,3,7,343,97
292,27,4,3,6,7,42,-66,5,1,385,31
292,28,3,4,5,8,32,44,7,5,417,75
292,29,5,2,10,3,-45,21,2,6,372,96
292,30,2,4,2,11,20,-53,2,3,392,43
292,31,2,4,7,6,25,42,7,5,417,85
292,32,2,4,4,9,22,-55,9,0,439,30
292,33,3,3,11,2,-62,-30,7,0,377,0
292,34,2,4,2,11,20,47,7,7,397,47
292,35,4,3,8,5,-56,32,1,9,341,79
292,36,4,3,7,6,43,-67,4,2,384,12
292,37,4,3,6,7,42,34,6,6,426,46
292,38,2,5,7,6,-75,51,1,7,351,97
292,39,3,4,8,5,35,41,6,8,386,138
292,40,5,2,10,3,-45,21,1,9,341,159
292,41,4,3,8,5,44,-68,5,1,385,91
292,42,3,4,4,9,31,45,6,6,416,136
292,43,5,2,8,5,53,23,9,9,469,159
292,44,3,4,5,8,-68,-56,1,3,401,103
292,45,4,3,8,5,44,32,5,5,445,135
292,46,4,4,9,4,-55,40,0,5,390,175
292,47,4,2,7,6,43,24,3,9,433,199
292,48,2,5,7,6,25,-49,8,0,458,150
292,49,4,2,6,7,-58,25,0,5,400,175
292,50,2,4,6,7,24,43,4,8,424,218
292,51,4,4,8,5,44,41,8,9,468,259
292,52,3,3,8,5,-65,-68,3,1,403,191
292,53,3,4,7,6,34,42,7,3,437,233
292,54,4,2,7,6,-57,24,0,7,380,257
292,55,3,3,7,6,34,-67,4,0,414,190
292,56,3,4,8,5,35,41,9,1,449,231
292,57,4,2,9,4,-55,22,4,3,394,253
292,58,4,3,8,5,44,32,8,5,438,285
292,59,4,3,7,6,-57,33,1,8,381,318
292,60,3,4,7,6,34,-58,5,0,415,260
292,61,4,3,7,6,43,33,8,3,458,293
292,62,3,4,5,8,-68,44,0,7,390,337
292,63,3,3,7,6,34,-67,4,0,424,270
292,64,2,4,5,8,23,44,7,4,447,314
292,65,5,2,9,4,-46,22,1,6,401,336
292,66,4,3,8,5,44,32,5,8,445,368
292,67,2,4,4,9,22,-55,7,3,467,313
292,68,5,2,7,6,52,24,9,7,519,337
293,1,2,4,7,6,25,42,5,2,25,42
293,2,2,6,2,11,20,65,5,7,45,107
293,3,2,4,7,6,-75,42,0,9,-30,149
293,4,2,5,5,8,23,-47,3,2,-7,102
293,5,3,3,8,5,35,32,8,4,28,134
293,6,4,2,7,6,-57,24,1,8,-29,158
293,7,4,2,8,5,44,-77,5,1,15,81
293,8,2,4,8,5,-74,41,1,2,-59,122
293,9,4,2,5,8,41,26,2,8,-18,148
293,10,4,2,6,7,42,-75,4,3,24,73
293,11,3,5,5,8,32,53,6,6,56,126
293,12,2,5,4,9,22,-46,8,0,78,80
293,13,3,4,5,8,-68,44,0,4,10,124
293,14,3,3,7,6,34,33,4,7,44,157
293,15,3,3,7,6,34,-67,8,0,78,90
293,16,3,4,5,8,-68,44,0,4,10,134
293,17,3,4,6,7,33,43,3,7,43,177
293,18,2,4,7,6,25,42,8,9,68,219
293,19,2,4,6,7,-76,-57,2,2,-8,162
293,20,3,4,5,8,32,44,4,6,24,206
293,21,4,3,8,5,44,32,8,8,68,238
293,22,4,3,8,5,-56,-68,2,0,12,170
293,23,4,2,11,2,47,20,9,0,59,190
293,24,3,3,5,8,-68,35,1,5,-9,225
293,25,3,3,8,5,35,32,6,7,26,257
293,26,4,3,5,8,41,-65,7,2,67,192
293,27,3,5,7,6,-66,51,1,3,1,243
293,28,3,3,6,7,33,34,4,7,34,277
293,29,2,5,4,9,22,-46,6,1,56,231
293,30,5,3,8,5,53,32,9,3,109,263
293,31,4,2,8,5,-56,23,3,6,53,286
293,32,4,2,8,5,44,23,7,9,97,309
293,33,3,4,4,9,31,-55,8,4,128,254
293,34,5,2,8,5,-47,23,1,7,81,277
293,35,4,2,10,3,46,21,7,8,127,298
293,36,3,4,5,8,32,-56,9,2,159,242
293,37,5,2,10,3,-45,21,4,3,114,263
293,38,2,5,3,10,21,55,5,8,135,318
293,39,2,4,3,10,21,-54,6,4,156,264
293,40,4,3,9,4,-55,31,1,5,101,295
293,41,3,5,5,8,32,53,3,8,133,348
293,42,4,3,7,6,43,-67,6,1,176,281
293,43,3,4,5,8,32,44,8,5,208,325
293,44,2,5,6,7,-76,52,2,7,132,377
293,45,3,4,7,6,34,42,6,9,166,419
293,46,4,2,7,6,43,-76,9,3,209,343
293,47,3,3,4,9,-69,36,0,9,140,379
293,48,4,3,4,9,40,-64,0,5,180,315
293,49,3,3,5,8,32,-65,2,0,212,250
293,50,4,3,8,5,44,32,6,2,256,282
293,51,3,3,7,6,-66,33,0,5,190,315
293,52,3,4,3,10,30,-54,0,1,220,261
293,53,2,4,4,9,22,45,2,6,242,306
293,54,4,3,7,6,43,33,5,9,285,339
293,55,2,5,3,10,21,-45,6,4,306,294
293,56,4,3,8,5,-56,32,0,6,250,326
293,57,2,4,4,9,22,-55,2,1,272,271
293,58,5,2,8,5,53,23,5,4,325,294
293,59,3,3,6,7,33,34,8,8,358,328
293,60,4,3,8,5,-56,-68,2,0,302,260
293,61,5,2,6,7,51,25,3,5,353,285
293,62,4,4,5,8,41,44,4,9,394,329
293,63,4,3,7,6,43,-67,7,2,437,262
293,64,3,4,6,7,-67,43,0,5,370,305
293,65,3,3,4,9,31,-64,1,1,401,241
293,66,3,3,6,7,33,34,4,5,434,275
293,67,4,3,6,7,42,34,6,9,476,309
293,68,3,4,6,7,33,-57,9,2,509,252
294,1,5,2,9,4,54,22,4,2,54,22
294,2,3,4,5,8,32,44,6,6,86,66
294,3,3,3,8,5,-65,32,1,8,21,98
294,4,3,3,7,6,34,-67,5,1,55,31
294,5,3,4,8,5,-65,41,0,2,-10,72
294,6,4,2,7,6,43,24,3,6,33,96
294,7,3,3,7,6,34,33,7,9,67,129
294,8,4,2,5,8,41,-74,8,5,108,55
294,9,3,3,5,8,-68,-65,0,0,40,-10
294,10,2,4,7,6,25,42,5,2,65,32
294,11,4,2,8,5,44,23,9,5,109,55
294,12,2,4,4,9,-78,-55,1,0,31,0
294,13,4,2,6,7,42,25,3,5,73,25
294,14,5,2,9,4,54,22,7,7,127,47
294,15,3,3,4,9,31,-64,8,3,158,-17
294,16,5,2,8,5,-47,23,1,6,111,6
294,17,4,3,7,6,43,33,4,9,154,39
294,18,4,2,8,5,44,-77,8,2,198,-38
294,19,3,5,7,6,-66,51,2,3,132,13
294,20,3,4,8,5,35,41,7,4,167,54
294,21,4,2,5,8,41,-74,8,0,208,-20
294,22,4,3,9,4,-55,31,3,1,153,11
294,23,3,4,3,10,30,46,3,7,183,57
294,24,2,4,7,6,25,42,8,9,208,99
294,25,2,4,4,9,-78,-55,0,4,130,44
294,26,3,4,6,7,33,43,3,7,163,87
294,27,4,3,9,4,45,31,8,8,208,118
294,28,2,4,6,7,-76,-57,2,1,132,61
294,29,2,4,8,5,26,41,8,2,158,102
294,30,3,3,6,7,-67,34,1,6,91,136
294,31,3,3,8,5,35,32,6,8,126,168
294,32,4,2,9,4,-55,-78,1,0,71,90
294,33,4,3,7,6,43,33,4,3,114,123
294,34,3,3,6,7,33,34,7,7,147,157
294,35,4,4,8,5,-56,41,1,8,91,198
294,36,4,2,7,6,43,-76,4,2,134,122
294,37,4,3,9,4,45,31,9,3,179,153
294,38,2,4,7,6,-75,42,4,5,104,195
294,39,2,4,5,8,23,44,7,9,127,239
294,40,3,4,5,8,32,-56,9,3,159,183
294,41,4,3,7,6,-57,33,2,6,102,216
294,42,4,3,5,8,41,-65,3,1,143,151
294,43,5,2,7,6,52,24,5,5,195,175
294,44,3,3,6,7,33,34,8,9,228,209
294,45,3,4,3,10,30,-54,8,5,258,155
294,46,2,4,7,6,-75,42,3,7,183,197
294,47,3,3,5,8,32,-65,5,2,215,132
294,48,5,2,11,2,-44,20,1,2,171,152
294,49,2,5,6,7,24,52,5,4,195,204
294,50,5,2,8,5,53,23,8,7,248,227
294,51,2,4,5,8,-77,-56,1,1,171,171
294,52,5,3,10,3,55,30,6,1,226,201
294,53,3,4,6,7,33,43,9,4,259,244
294,54,3,3,7,6,-66,33,3,7,193,277
294,55,3,5,4,9,31,-46,4,1,224,231
294,56,3,3,6,7,33,34,7,5,257,265
294,57,2,5,5,8,-77,53,0,8,180,318
294,58,4,3,5,8,41,-65,1,3,221,253
294,59,3,4,4,9,31,45,2,8,252,298
294,60,5,2,11,2,56,20,8,8,308,318
294,61,2,4,5,8,-77,-56,1,2,231,262
294,62,2,5,5,8,23,53,4,5,254,315
294,63,3,4,5,8,32,44,6,9,286,359
294,64,5,2,7,6,52,-76,8,3,338,283
294,65,4,2,8,5,-56,23,2,6,282,306
294,66,4,3,10,3,46,30,8,6,328,336
294,67,2,4,4,9,-78,-55,0,1,250,281
294,68,3,3,7,6,34,33,4,4,284,314
294,69,4,3,8,5,44,32,8,6,328,346
294,70,5,2,10,3,-45,21,3,7,283,367
294,71,3,4,7,6,34,42,7,9,317,409
294,72,5,2,9,4,-46,-78,1,1,271,331
294,73,3,4,5,8,32,44,3,5,303,375
294,74,2,5,7,6,25,51,8,6,328,426
294,75,3,3,4,9,31,-64,9,2,359,362
294,76,2,5,3,10,-79,55,0,7,280,417
294,77,4,3,10,3,46,30,6,7,326,447
294,78,3,4,4,9,31,-55,7,2,357,392
294,79,4,2,10,3,-54,21,3,3,303,413
294,80,3,3,8,5,35,32,8,5,338,445
294,81,3,5,4,9,31,54,9,9,369,499
294,82,5,2,9,4,-46,-78,3,1,323,421
294,83,3,3,6,7,33,34,6,5,356,455
294,84,3,4,6,7,33,43,9,8,389,498
294,85,4,2,6,7,-58,-75,1,3,331,423
294,86,3,4,7,6,34,42,5,5,365,465
294,87,2,4,4,9,22,-55,7,0,387,410
294,88,5,2,9,4,-46,22,1,2,341,432
294,89,3,3,5,8,32,35,3,7,373,467
294,90,2,4,5,8,23,-56,6,1,396,411
294,91,3,4,4,9,31,45,7,6,427,456
294,92,4,3,9,4,-55,31,2,7,372,487
294,93,3,4,8,5,35,41,7,8,407,528
295,1,4,2,9,4,45,22,5,2,45,22
295,2,4,3,10,3,-54,30,1,2,-9,52
295,3,2,4,4,9,22,45,3,7,13,97
295,4,2,6,3,10,21,-36,4,1,34,61
295,5,2,4,3,10,21,46,5,7,55,107
295,6,3,3,6,7,33,-66,8,1,88,41
295,7,4,2,10,3,-54,21,4,2,34,62
295,8,3,4,7,6,34,42,8,4,68,104
295,9,2,5,6,7,-76,52,2,6,-8,156
295,10,3,3,6,7,33,-66,5,0,25,90
295,11,2,5,3,10,21,55,6,5,46,145
295,12,3,4,7,6,-66,42,0,7,-20,187
295,13,2,5,5,8,23,-47,3,0,3,140
295,14,5,2,10,3,55,21,8,1,58,161
295,15,4,3,7,6,-57,33,1,4,1,194
295,16,2,4,3,10,21,-54,2,0,22,140
295,17,2,4,8,5,26,41,8,1,48,181
295,18,3,3,9,4,-64,31,4,2,-16,212
295,19,3,3,9,4,-64,31,0,3,-80,243
295,20,2,4,6,7,24,43,4,6,-56,286
295,21,3,3,8,5,35,32,9,8,-21,318
295,22,3,3,7,6,-66,-67,3,1,-87,251
295,23,4,2,8,5,44,23,7,4,-43,274
295,24,5,2,9,4,-46,22,1,6,-89,296
295,25,4,3,7,6,43,33,4,9,-46,329
295,26,4,3,4,9,40,-64,4,5,-6,265
295,27,3,3,8,5,35,32,9,7,29,297
295,28,4,2,9,4,-55,22,4,9,-26,319
295,29,4,4,4,9,40,-55,4,4,14,264
295,30,4,2,8,5,44,23,8,7,58,287
295,31,4,3,8,5,-56,32,2,9,2,319
295,32,4,2,9,4,45,-78,7,1,47,241
295,33,3,4,8,5,-65,41,2,2,-18,282
295,34,3,4,3,10,30,46,2,8,12,328
295,35,4,2,9,4,45,-78,7,0,57,250
295,36,4,2,7,6,-57,24,0,4,0,274
295,37,3,3,8,5,35,32,5,6,35,306
295,38,4,3,7,6,43,33,8,9,78,339
295,39,4,2,7,6,-57,-76,1,3,21,263
295,40,3,3,9,4,36,31,7,4,57,294
295,41,4,3,9,4,-55,31,2,5,2,325
295,42,4,3,4,9,40,-64,2,1,42,261
295,43,2,4,5,8,23,44,5,5,65,305
295,44,3,3,9,4,-64,31,1,6,1,336
295,45,2,5,3,10,21,-45,2,1,22,291
295,46,4,2,8,5,44,23,6,4,66,314
295,47,3,4,6,7,33,43,9,7,99,357
295,48,3,4,4,9,-69,-55,0,2,30,302
295,49,2,5,4,9,22,54,2,6,52,356
295,50,3,4,7,6,34,42,6,8,86,398
295,51,4,3,8,5,-56,-68,0,0,30,330
295,52,4,4,5,8,41,44,1,4,71,374
295,53,5,2,10,3,55,21,6,5,126,395
295,54,4,3,6,7,42,34,8,9,168,429
295,55,3,4,7,6,-66,-58,2,1,102,371
295,56,4,2,10,3,46,21,8,2,148,392
295,57,3,3,6,7,-67,34,1,6,81,426
295,58,2,5,6,7,24,52,5,8,105,478
295,59,3,3,7,6,34,-67,9,1,139,411
295,60,4,3,4,9,40,36,9,7,179,447
295,61,4,2,11,2,-53,20,6,7,126,467
295,62,5,2,6,7,51,-75,7,2,177,392
295,63,5,2,10,3,-45,21,2,3,132,413
295,64,5,2,8,5,53,23,5,6,185,436
295,65,3,3,7,6,34,33,9,9,219,469
295,66,4,3,6,7,-58,-66,1,3,161,403
295,67,4,3,7,6,43,33,4,6,204,436
295,68,3,4,8,5,35,41,9,7,239,477
295,69,5,2,9,4,-46,22,3,9,193,499
295,70,2,5,4,9,22,-46,5,3,215,453
295,71,3,4,9,4,-64,40,1,3,151,493
295,72,5,2,9,4,54,22,5,5,205,515
296,1,3,3,4,9,31,36,1,6,31,36
296,2,2,5,6,7,24,52,5,8,55,88
296,3,4,2,8,5,44,-77,9,1,99,11
296,4,2,5,5,8,-77,53,2,4,22,64
296,5,5,2,8,5,53,23,5,7,75,87
296,6,2,5,6,7,24,52,9,9,99,139
296,7,2,5,4,9,-78,-46,1,3,21,93
296,8,3,4,4,9,31,45,2,8,52,138
296,9,3,4,6,7,33,-57,5,1,85,81
296,10,3,4,8,5,-65,41,0,2,20,122
296,11,3,4,7,6,34,42,4,4,54,164
296,12,3,3,5,8,32,35,6,9,86,199
296,13,4,3,9,4,-55,-69,1,0,31,130
296,14,4,4,7,6,43,42,4,2,74,172
296,15,3,4,8,5,35,41,9,3,109,213
296,16,4,4,7,6,-57,42,2,5,52,255
296,17,3,4,5,8,32,44,4,9,84,299
296,18,4,3,7,6,43,-67,7,2,127,232
296,19,4,4,7,6,-57,42,0,4,70,274
296,20,5,3,7,6,52,33,2,7,122,307
296,21,5,2,9,4,54,22,6,9,176,329
296,22,3,3,9,4,-64,-69,2,0,112,260
296,23,4,2,8,5,44,23,6,3,156,283
296,24,3,4,5,8,32,44,8,7,188,327
296,25,4,2,8,5,-56,-77,2,0,132,250
296,26,3,4,4,9,31,45,3,5,163,295
296,27,2,5,4,9,22,54,5,9,185,349
296,28,3,3,5,8,32,-65,7,4,217,284
296,29,3,3,6,7,-67,34,0,8,150,318
296,30,3,3,5,8,32,-65,2,3,182,253
296,31,5,2,10,3,55,21,7,4,237,274
296,32,4,3,6,7,42,34,9,8,279,308
296,33,4,3,9,4,-55,31,4,9,224,339
296,34,4,3,8,5,44,-68,8,1,268,271
296,35,3,3,6,7,-67,34,1,5,201,305
296,36,4,2,9,4,45,22,6,7,246,327
296,37,3,3,7,6,-66,-67,0,0,180,260
296,38,3,3,8,5,35,32,5,2,215,292
296,39,3,4,6,7,33,43,8,5,248,335
296,40,2,4,8,5,-74,41,4,6,174,376
296,41,4,2,7,6,43,-76,7,0,217,300
296,42,4,2,7,6,-57,24,0,4,160,324
296,43,3,3,8,5,35,32,5,6,195,356
296,44,4,2,10,3,-54,21,1,7,141,377
296,45,4,3,8,5,44,32,5,9,185,409
296,46,5,2,9,4,54,-78,9,1,239,331
296,47,2,5,3,10,-79,55,0,6,160,386
296,48,3,3,7,6,34,33,4,9,194,419
296,49,4,3,7,6,43,-67,7,2,237,352
296,50,4,3,8,5,-56,32,1,4,181,384
296,51,2,5,3,10,21,55,2,9,202,439
296,52,2,4,5,8,23,-56,5,3,225,383
296,53,3,3,7,6,34,33,9,6,259,416
296,54,3,3,8,5,-65,32,4,8,194,448
296,55,5,2,9,4,54,-78,8,0,248,370
296,56,4,3,5,8,41,35,9,5,289,405
296,57,5,2,10,3,-45,21,4,6,244,426
296,58,4,3,8,5,44,32,8,8,288,458
296,59,4,2,6,7,-58,-75,0,3,230,383
296,60,3,3,6,7,33,34,3,7,263,417
296,61,3,3,6,7,33,-66,6,1,296,351
296,62,3,3,5,8,32,35,8,6,328,386
296,63,3,4,7,6,-66,42,2,8,262,428
296,64,3,4,4,9,31,-55,3,3,293,373
296,65,3,3,8,5,35,32,8,5,328,405
296,66,2,5,4,9,-78,54,0,9,250,459
296,67,5,2,10,3,55,-79,5,0,305,380
296,68,5,3,9,4,54,31,9,1,359,411
296,69,4,4,9,4,-55,40,4,1,304,451
296,70,4,3,7,6,43,33,7,4,347,484
296,71,2,5,3,10,21,55,8,9,368,539
297,1,4,3,9,4,45,31,5,1,45,31
297,2,3,3,5,8,32,35,7,6,77,66
297,3,3,3,6,7,-67,-66,0,0,10,0
297,4,2,4,3,10,21,46,1,6,31,46
297,5,4,3,8,5,44,32,5,8,75,78
297,6,3,3,8,5,-65,-68,0,0,10,10
297,7,4,2,10,3,46,21,6,1,56,31
297,8,2,6,3,10,21,64,7,5,77,95
297,9,4,3,5,8,41,-65,8,0,118,30
297,10,3,3,5,8,-68,35,0,5,50,65
297,11,2,4,5,8,23,44,3,9,73,109
297,12,4,3,8,5,44,-68,7,1,117,41
297,13,2,4,5,8,-77,44,0,5,40,85
297,14,5,2,8,5,53,23,3,8,93,108
297,15,3,4,7,6,34,-58,7,0,127,50
297,16,5,2,10,3,-45,21,2,1,82,71
297,17,3,4,6,7,33,43,5,4,115,114
297,18,4,2,6,7,42,25,7,9,157,139
297,19,4,3,5,8,41,-65,8,4,198,74
297,20,3,3,6,7,-67,34,1,8,131,108
297,21,2,5,4,9,22,-46,3,2,153,62
297,22,2,5,4,9,22,54,5,6,175,116
297,23,3,4,7,6,34,42,9,8,209,158
297,24,5,2,10,3,-45,21,4,9,164,179
297,25,2,4,5,8,23,-56,7,3,187,123
297,26,3,4,3,10,30,46,7,9,217,169
297,27,4,3,8,5,-56,-68,1,1,161,101
297,28,5,2,11,2,56,20,7,1,217,121
297,29,2,4,4,9,22,45,9,6,239,166
297,30,5,2,9,4,-46,22,3,8,193,188
297,31,3,3,9,4,36,31,9,9,229,219
297,32,4,3,8,5,-56,-68,3,1,173,151
297,33,2,4,6,7,24,43,7,4,197,194
297,34,3,4,5,8,32,44,9,8,229,238
297,35,3,3,7,6,-66,-67,3,1,163,171
297,36,3,4,7,6,34,42,7,3,197,213
297,37,5,2,8,5,-47,23,0,6,150,236
297,38,4,3,6,7,42,-66,2,0,192,170
297,39,2,4,4,9,22,45,4,5,214,215
297,40,4,3,5,8,41,-65,5,0,255,150
297,41,3,4,5,8,32,44,7,4,287,194
297,42,2,5,3,10,21,55,8,9,308,249
297,43,5,2,10,3,-45,-79,3,0,263,170
297,44,2,4,6,7,24,43,7,3,287,213
297,45,3,4,5,8,32,44,9,7,319,257
297,46,4,3,5,8,-59,-65,0,2,260,192
297,47,4,3,7,6,43,33,3,5,303,225
297,48,5,2,10,3,55,21,8,6,358,246
297,49,3,3,8,5,-65,32,3,8,293,278
297,50,2,5,6,7,24,-48,7,0,317,230
297,51,4,3,7,6,-57,33,0,3,260,263
297,52,4,2,7,6,43,24,3,7,303,287
297,53,3,3,6,7,33,-66,6,1,336,221
297,54,3,3,8,5,-65,32,1,3,271,253
297,55,3,4,8,5,35,41,6,4,306,294
297,56,5,2,8,5,53,23,9,7,359,317
297,57,4,2,9,4,-55,22,4,9,304,339
297,58,4,3,7,6,43,-67,7,2,347,272
297,59,4,3,6,7,42,34,9,6,389,306
297,60,4,2,7,6,-57,-76,2,0,332,230
297,61,4,3,6,7,42,34,4,4,374,264
297,62,2,4,6,7,24,43,8,7,398,307
297,63,4,3,5,8,41,-65,9,2,439,242
297,64,2,4,4,9,-78,45,1,7,361,287
297,65,3,4,5,8,32,-56,3,1,393,231
297,66,4,2,8,5,44,23,7,4,437,254
297,67,2,5,3,10,21,55,8,9,458,309
297,68,4,3,6,7,-58,-66,0,3,400,243
297,69,2,5,3,10,21,55,1,8,421,298
297,70,3,3,4,9,31,-64,2,4,452,234
297,71,4,3,7,6,43,33,5,7,495,267
297,72,4,3,9,4,-55,31,0,8,440,298
297,73,3,4,7,6,34,-58,4,0,474,240
297,74,3,4,5,8,32,44,6,4,506,284
298,1,2,4,6,7,24,43,4,3,24,43
298,2,3,3,6,7,33,34,7,7,57,77
298,3,2,5,3,10,21,-45,8,2,78,32
298,4,3,3,8,5,-65,32,3,4,13,64
298,5,3,3,6,7,33,34,6,8,46,98
298,6,4,3,8,5,-56,-68,0,0,-10,30
298,7,3,5,4,9,31,54,1,4,21,84
298,8,4,2,5,8,41,-74,2,0,62,10
298,9,2,6,2,11,20,65,2,5,82,75
298,10,2,4,2,11,20,-53,2,2,102,22
298,11,4,2,11,2,47,20,9,2,149,42
298,12,2,5,6,7,-76,52,3,4,73,94
298,13,4,2,10,3,46,21,9,5,119,115
298,14,3,3,5,8,-68,-65,1,0,51,50
298,15,4,2,8,5,44,23,5,3,95,73
298,16,3,3,7,6,34,33,9,6,129,106
298,17,3,3,6,7,-67,-66,2,0,62,40
298,18,3,3,6,7,33,34,5,4,95,74
298,19,2,5,2,11,20,-44,5,0,115,30
298,20,4,2,11,2,-53,20,2,0,62,50
298,21,4,3,8,5,44,32,6,2,106,82
298,22,2,5,4,9,22,54,8,6,128,136
298,23,4,2,6,7,-58,-75,0,1,70,61
298,24,5,2,9,4,54,22,4,3,124,83
298,25,2,5,5,8,23,53,7,6,147,136
298,26,4,3,5,8,41,-65,8,1,188,71
298,27,2,5,3,10,21,55,9,6,209,126
298,28,6,2,10,3,-36,21,3,7,173,147
298,29,4,2,8,5,44,-77,7,0,217,70
298,30,2,6,4,9,22,63,9,3,239,133
298,31,2,4,5,8,-77,44,2,7,162,177
298,32,3,4,8,5,35,41,7,8,197,218
298,33,4,2,7,6,-57,-76,0,2,140,142
298,34,3,4,5,8,32,44,2,6,172,186
298,35,3,3,8,5,35,32,7,8,207,218
298,36,6,2,11,2,-35,20,2,8,172,238
298,37,2,5,6,7,24,-48,6,0,196,190
298,38,3,4,4,9,31,45,7,5,227,235
298,39,3,4,4,9,31,-55,8,0,258,180
298,40,3,4,8,5,-65,41,3,1,193,221
298,41,3,4,6,7,33,43,6,4,226,264
298,42,3,4,7,6,-66,42,0,6,160,306
298,43,4,3,5,8,41,-65,1,1,201,241
298,44,6,2,10,3,64,21,5,2,265,262
298,45,2,4,4,9,22,45,7,7,287,307
298,46,2,4,3,10,21,-54,8,3,308,253
298,47,4,3,7,6,-57,33,1,6,251,286
298,48,4,2,7,6,43,-76,4,0,294,210
298,49,2,4,5,8,23,44,7,4,317,254
298,50,2,5,5,8,-77,53,0,7,240,307
298,51,4,3,8,5,44,32,4,9,284,339
298,52,2,5,2,11,20,-44,4,5,304,295
298,53,4,2,7,6,43,24,7,9,347,319
298,54,4,2,7,6,-57,-76,0,3,290,243
298,55,3,3,5,8,32,35,2,8,322,278
298,56,2,5,4,9,22,-46,4,2,344,232
298,57,6,2,10,3,64,21,8,3,408,253
298,58,4,3,9,4,-55,31,3,4,353,284
298,59,2,4,5,8,23,44,6,8,376,328
298,60,4,2,7,6,43,-76,9,2,419,252
298,61,4,3,8,5,-56,32,3,4,363,284
298,62,2,4,5,8,23,44,6,8,386,328
298,63,3,4,8,5,-65,41,1,9,321,369
298,64,3,3,8,5,35,-68,6,1,356,301
298,65,4,2,8,5,-56,23,0,4,300,324
298,66,4,2,8,5,44,23,4,7,344,347
298,67,2,5,4,9,22,-46,6,1,366,301
298,68,3,3,7,6,-66,33,0,4,300,334
298,69,4,3,8,5,44,32,4,6,344,366
298,70,5,2,9,4,54,22,8,8,398,388
298,71,4,3,8,5,-56,-68,2,0,342,320
298,72,4,2,8,5,44,23,6,3,386,343
298,73,3,5,4,9,31,54,7,7,417,397
298,74,3,4,6,7,-67,-57,0,0,350,340
298,75,4,3,6,7,42,34,2,4,392,374
298,76,3,4,5,8,32,44,4,8,424,418
298,77,3,3,6,7,33,-66,7,2,457,352
298,78,4,2,8,5,-56,23,1,5,401,375
298,79,3,4,7,6,34,42,5,7,435,417
298,80,2,4,5,8,23,-56,8,1,458,361
298,81,4,2,10,3,-54,21,4,2,404,382
298,82,4,2,9,4,45,22,9,4,449,404
298,83,4,3,7,6,-57,33,2,7,392,437
298,84,2,5,5,8,23,-47,5,0,415,390
298,85,3,3,6,7,33,34,8,4,448,424
298,86,4,3,6,7,-58,34,0,8,390,458
298,87,3,4,5,8,32,-56,2,2,422,402
298,88,6,2,10,3,64,21,6,3,486,423
298,89,3,4,4,9,31,45,7,8,517,468
299,1,2,5,4,9,22,54,2,4,22,54
299,2,5,2,8,5,53,23,5,7,75,77
299,3,4,3,10,3,-54,30,1,7,21,107
299,4,3,4,5,8,32,-56,3,1,53,51
299,5,3,4,6,7,33,43,6,4,86,94
299,6,2,4,4,9,22,45,8,9,108,139
299,7,3,3,6,7,-67,-66,1,3,41,73
299,8,3,3,5,8,32,35,3,8,73,108
299,9,4,3,8,5,44,-68,7,0,117,40
299,10,4,2,9,4,-55,22,2,2,62,62
299,11,4,2,8,5,44,23,6,5,106,85
299,12,3,4,6,7,33,43,9,8,139,128
299,13,2,4,5,8,-77,-56,2,2,62,72
299,14,3,3,6,7,33,34,5,6,95,106
299,15,3,4,7,6,34,42,9,8,129,148
299,16,4,3,7,6,-57,-67,2,1,72,81
299,17,4,3,8,5,44,32,6,3,116,113
299,18,2,5,7,6,-75,51,1,4,41,164
299,19,3,4,5,8,32,44,3,8,73,208
299,20,2,5,3,10,21,-45,4,3,94,163
299,21,5,2,9,4,54,22,8,5,148,185
299,22,2,4,6,7,-76,43,2,8,72,228
299,23,3,3,6,7,33,-66,5,2,105,162
299,24,5,2,7,6,52,24,7,6,157,186
299,25,5,2,11,2,-44,20,3,6,113,206
299,26,4,2,10,3,46,21,9,7,159,227
299,27,2,5,4,9,-78,-46,1,1,81,181
299,28,2,5,6,7,24,52,5,3,105,233
299,29,4,3,8,5,44,32,9,5,149,265
299,30,4,2,9,4,-55,22,4,7,94,287
299,31,4,3,7,6,43,-67,7,0,137,220
299,32,3,3,8,5,-65,32,2,2,72,252
299,33,4,3,10,3,46,30,8,2,118,282
299,34,3,3,7,6,-66,33,2,5,52,315
299,35,3,4,3,10,30,-54,2,1,82,261
299,36,3,3,7,6,34,33,6,4,116,294
299,37,2,4,4,9,22,45,8,9,138,339
299,38,2,4,4,9,-78,-55,0,4,60,284
299,39,3,4,5,8,32,44,2,8,92,328
299,40,3,3,7,6,34,-67,6,1,126,261
299,41,2,4,4,9,22,45,8,6,148,306
299,42,2,4,6,7,-76,43,2,9,72,349
299,43,3,4,7,6,34,-58,6,1,106,291
299,44,4,3,6,7,42,34,8,5,148,325
299,45,4,2,10,3,-54,21,4,6,94,346
299,46,3,3,5,8,32,-65,6,1,126,281
299,47,3,3,7,6,-66,33,0,4,60,314
299,48,4,4,6,7,42,43,2,7,102,357
299,49,3,3,5,8,32,-65,4,2,134,292
299,50,4,2,8,5,44,23,8,5,178,315
299,51,3,5,5,8,-68,53,0,8,110,368
299,52,3,3,6,7,33,-66,3,2,143,302
299,53,3,3,4,9,31,36,4,8,174,338
299,54,2,5,5,8,23,-47,7,1,197,291
299,55,3,4,6,7,-67,43,0,4,130,334
299,56,3,3,7,6,34,33,4,7,164,367
299,57,4,3,6,7,42,-66,6,1,206,301
299,58,2,5,6,7,-76,52,0,3,130,353
299,59,3,4,6,7,33,43,3,6,163,396
299,60,5,3,5,8,50,-65,3,1,213,331
299,61,3,3,8,5,35,32,8,3,248,363
299,62,4,2,7,6,-57,24,1,7,191,387
299,63,2,4,9,4,27,40,8,7,218,427
299,64,2,4,5,8,-77,-56,1,1,141,371
299,65,4,3,10,3,46,30,7,1,187,401
299,66,3,3,9,4,-64,31,3,2,123,432
299,67,3,3,6,7,33,34,6,6,156,466
299,68,4,2,10,3,-54,21,2,7,102,487
299,69,4,3,7,6,43,-67,5,0,145,420
299,70,3,3,9,4,-64,31,1,1,81,451
299,71,4,2,7,6,43,24,4,5,124,475
299,72,5,2,8,5,53,23,7,8,177,498
299,73,5,3,6,7,51,-66,8,2,228,432
299,74,3,4,6,7,-67,43,1,5,161,475
299,75,3,3,9,4,36,31,7,6,197,506
300,1,4,2,9,4,45,22,5,2,45,22
300,2,2,5,3,10,21,55,6,7,66,77
300,3,3,4,5,8,32,-56,8,1,98,21
300,4,3,3,6,7,-67,34,1,5,31,55
300,5,4,3,7,6,43,33,4,8,74,88
300,6,2,4,4,9,22,-55,6,3,96,33
300,7,5,2,10,3,-45,21,1,4,51,54
300,8,4,3,9,4,45,31,6,5,96,85
300,9,3,3,7,6,-66,33,0,8,30,118
300,10,4,3,9,4,45,31,5,9,75,149
300,11,4,3,8,5,44,-68,9,1,119,81
300,12,3,3,7,6,-66,33,3,4,53,114
300,13,3,4,7,6,34,42,7,6,87,156
300,14,4,3,8,5,-56,32,1,8,31,188
300,15,6,2,8,5,62,-77,3,1,93,111
300,16,2,5,5,8,23,53,6,4,116,164
300,17,4,3,7,6,43,33,9,7,159,197
300,18,3,3,6,7,-67,-66,2,1,92,131
300,19,3,4,6,7,33,43,5,4,125,174
300,20,5,2,7,6,52,24,7,8,177,198
300,21,2,5,4,9,22,-46,9,2,199,152
300,22,4,2,7,6,-57,24,2,6,142,176
300,23,3,4,5,8,32,-56,4,0,174,120
300,24,2,5,5,8,23,53,7,3,197,173
300,25,4,3,4,9,40,36,7,9,237,209
300,26,4,3,6,7,42,-66,9,3,279,143
300,27,3,4,3,10,30,46,9,9,309,189
300,28,4,2,9,4,-55,-78,4,1,254,111
300,29,4,3,7,6,43,33,7,4,297,144
300,30,3,3,5,8,32,35,9,9,329,179
300,31,2,4,5,8,-77,-56,2,3,252,123
300,32,3,5,7,6,34,51,6,4,286,174
300,33,3,3,7,6,-66,33,0,7,220,207
300,34,3,4,5,8,32,-56,2,1,252,151
300,35,4,2,8,5,44,23,6,4,296,174
300,36,3,4,7,6,-66,42,0,6,230,216
300,37,2,4,4,9,22,-55,2,1,252,161
300,38,3,3,5,8,32,35,4,6,284,196
300,39,2,4,8,5,-74,41,0,7,210,237
300,40,5,2,10,3,55,21,5,8,265,258
300,41,2,5,6,7,24,-48,9,0,289,210
300,42,3,4,4,9,-69,45,0,5,220,255
300,43,3,4,4,9,31,-55,1,0,251,200
300,44,2,5,6,7,24,52,5,2,275,252
300,45,5,2,8,5,53,23,8,5,328,275
300,46,2,5,3,10,21,-45,9,0,349,230
300,47,3,3,6,7,-67,34,2,4,282,264
300,48,5,2,9,4,54,22,6,6,336,286
300,49,4,3,9,4,-55,31,1,7,281,317
300,50,4,2,9,4,45,22,6,9,326,339
300,51,4,3,7,6,43,-67,9,2,369,272
300,52,2,4,6,7,-76,43,3,5,293,315
300,53,3,3,8,5,35,32,8,7,328,347
300,54,3,3,7,6,-66,-67,2,0,262,280
300,55,2,4,7,6,25,42,7,2,287,322
300,56,2,5,4,9,22,54,9,6,309,376
300,57,4,3,9,4,-55,31,4,7,254,407
300,58,3,3,5,8,32,-65,6,2,286,342
300,59,3,3,6,7,33,34,9,6,319,376
300,60,3,3,4,9,-69,-64,0,2,250,312
300,61,3,3,8,5,35,32,5,4,285,344
300,62,4,2,10,3,-54,21,1,5,231,365
300,63,3,4,8,5,35,41,6,6,266,406
300,64,4,3,8,5,-56,32,0,8,210,438
300,65,5,2,11,2,56,20,6,8,266,458
300,66,4,2,8,5,-56,-77,0,1,210,381
300,67,4,3,6,7,42,34,2,5,252,415
300,68,3,3,6,7,33,34,5,9,285,449
300,69,4,3,6,7,42,-66,7,3,327,383
300,70,2,5,5,8,-77,53,0,6,250,436
300,71,4,2,5,8,41,-74,1,2,291,362
300,72,4,3,9,4,45,31,6,3,336,393
300,73,4,2,9,4,-55,22,1,5,281,415
300,74,3,4,7,6,34,42,5,7,315,457
300,75,5,3,8,5,53,32,8,9,368,489
300,76,5,2,10,3,-45,-79,3,0,323,410
300,77,4,2,7,6,43,24,6,4,366,434
300,78,2,5,2,11,20,-44,6,0,386,390
300,79,5,2,9,4,-46,22,0,2,340,412
300,80,5,2,6,7,51,25,1,7,391,437
300,81,3,4,7,6,34,42,5,9,425,479
300,82,3,3,8,5,-65,-68,0,1,360,411
300,83,3,4,5,8,32,44,2,5,392,455
300,84,4,3,7,6,43,33,5,8,435,488
300,85,3,4,5,8,32,-56,7,2,467,432
300,86,4,2,8,5,-56,23,1,5,411,455
300,87,4,3,9,4,45,31,6,6,456,486
300,88,4,3,8,5,-56,32,0,8,400,518
301,1,3,4,8,5,35,41,5,1,35,41
301,2,3,3,6,7,33,34,8,5,68,75
301,3,2,5,4,9,-78,54,0,9,-10,129
301,4,3,4,6,7,33,-57,3,2,23,72
301,5,2,4,4,9,22,45,5,7,45,117
301,6,4,2,9,4,-55,22,0,9,-10,139
301,7,3,4,7,6,34,-58,4,1,24,81
301,8,3,3,7,6,34,33,8,4,58,114
301,9,5,2,11,2,-44,20,4,4,14,134
301,10,4,2,7,6,43,24,7,8,57,158
301,11,2,4,3,10,21,-54,8,4,78,104
301,12,3,3,4,9,31,-64,9,0,109,40
301,13,4,2,6,7,-58,25,1,5,51,65
301,14,2,4,5,8,23,44,4,9,74,109
301,15,4,2,7,6,43,-76,7,3,117,33
301,16,5,2,8,5,-47,23,0,6,70,56
301,17,3,3,6,7,33,-66,3,0,103,-10
301,18,3,3,6,7,33,34,6,4,136,24
301,19,4,2,9,4,-55,22,1,6,81,46
301,20,2,4,4,9,22,-55,3,1,103,-9
301,21,3,4,8,5,35,41,8,2,138,32
301,22,4,3,4,9,40,36,8,8,178,68
301,23,3,4,6,7,-67,-57,1,1,111,11
301,24,3,3,7,6,34,33,5,4,145,44
301,25,4,2,6,7,42,25,7,9,187,69
301,26,3,3,4,9,31,-64,8,5,218,5
301,27,2,4,4,9,-78,-55,0,0,140,-50
301,28,3,4,4,9,31,45,1,5,171,-5
301,29,2,5,4,9,22,54,3,9,193,49
301,30,3,4,7,6,34,-58,7,1,227,-9
301,31,3,4,9,4,-64,40,3,1,163,31
301,32,3,4,5,8,32,44,5,5,195,75
301,33,2,5,5,8,23,53,8,8,218,128
301,34,5,2,9,4,-46,-78,2,0,172,50
301,35,4,2,8,5,44,23,6,3,216,73
301,36,5,2,10,3,-45,21,1,4,171,94
301,37,3,3,8,5,35,32,6,6,206,126
301,38,3,3,6,7,33,-66,9,0,239,60
301,39,3,4,3,10,30,46,9,6,269,106
301,40,2,5,5,8,-77,53,2,9,192,159
301,41,3,4,8,5,35,-59,7,0,227,100
301,42,2,6,4,9,22,63,9,3,249,163
301,43,6,2,11,2,-35,20,4,3,214,183
301,44,3,3,6,7,33,34,7,7,247,217
301,45,2,4,8,5,-74,41,3,8,173,258
301,46,3,4,7,6,34,-58,7,0,207,200
301,47,3,3,8,5,-65,32,2,2,142,232
301,48,3,4,4,9,31,45,3,7,173,277
301,49,2,5,7,6,25,51,8,8,198,328
301,50,4,3,10,3,-54,30,4,8,144,358
301,51,2,4,6,7,24,-57,8,1,168,301
301,52,3,3,5,8,-68,35,0,6,100,336
301,53,3,4,5,8,32,-56,2,0,132,280
301,54,5,2,8,5,53,23,5,3,185,303
301,55,5,2,8,5,53,23,8,6,238,326
301,56,4,2,7,6,-57,-76,1,0,181,250
301,57,3,4,4,9,31,45,2,5,212,295
301,58,4,3,8,5,44,32,6,7,256,327
301,59,4,3,8,5,-56,32,0,9,200,359
301,60,2,4,3,10,21,-54,1,5,221,305
301,61,4,3,6,7,42,34,3,9,263,339
301,62,4,2,9,4,45,-78,8,1,308,261
301,63,4,3,9,4,-55,31,3,2,253,292
301,64,2,5,5,8,23,53,6,5,276,345
301,65,2,5,6,7,-76,52,0,7,200,397
301,66,2,4,3,10,21,-54,1,3,221,343
301,67,4,2,7,6,43,24,4,7,264,367
301,68,3,3,8,5,35,32,9,9,299,399
301,69,3,4,6,7,-67,-57,2,2,232,342
301,70,3,4,8,5,35,41,7,3,267,383
301,71,3,4,6,7,-67,43,0,6,200,426
301,72,3,3,7,6,34,33,4,9,234,459
301,73,4,3,7,6,43,-67,7,2,277,392
301,74,4,2,7,6,-57,24,0,6,220,416
301,75,5,2,6,7,51,-75,1,1,271,341
301,76,2,4,6,7,24,43,5,4,295,384
301,77,5,2,11,2,-44,20,1,4,251,404
301,78,4,3,8,5,44,32,5,6,295,436
301,79,3,4,6,7,33,43,8,9,328,479
301,80,4,2,10,3,-54,-79,4,0,274,400
301,81,2,5,4,9,22,54,6,4,296,454
301,82,4,3,10,3,-54,30,2,4,242,484
301,83,3,3,4,9,31,-64,3,0,273,420
301,84,2,5,5,8,23,53,6,3,296,473
301,85,3,4,5,8,32,44,8,7,328,517
302,1,3,4,5,8,32,44,2,4,32,44
302,2,2,5,2,11,20,-44,2,0,52,0
302,3,6,2,9,4,63,22,5,2,115,22
302,4,4,2,7,6,43,24,8,6,158,46
302,5,3,3,8,5,-65,32,3,8,93,78
302,6,3,3,5,8,32,-65,5,3,125,13
302,7,3,4,4,9,31,45,6,8,156,58
302,8,2,5,5,8,23,-47,9,1,179,11
302,9,2,4,6,7,-76,43,3,4,103,54
302,10,3,4,8,5,35,41,8,5,138,95
302,11,2,5,3,10,21,-45,9,0,159,50
302,12,4,2,7,6,-57,24,2,4,102,74
302,13,3,4,6,7,33,43,5,7,135,117
302,14,3,3,6,7,33,-66,8,1,168,51
302,15,3,4,6,7,-67,43,1,4,101,94
302,16,3,4,8,5,35,41,6,5,136,135
302,17,2,5,5,8,23,53,9,8,159,188
302,18,3,4,6,7,-67,-57,2,1,92,131
302,19,4,3,7,6,43,33,5,4,135,164
302,20,2,5,4,9,22,54,7,8,157,218
302,21,5,2,10,3,-45,21,2,9,112,239
302,22,3,3,7,6,34,-67,6,2,146,172
302,23,5,2,11,2,-44,20,2,2,102,192
302,24,2,5,5,8,23,53,5,5,125,245
302,25,3,3,8,5,-65,32,0,7,60,277
302,26,4,3,8,5,44,32,4,9,104,309
302,27,3,4,4,9,31,-55,5,4,135,254
302,28,3,3,7,6,34,33,9,7,169,287
302,29,4,2,7,6,-57,-76,2,1,112,211
302,30,3,4,5,8,32,44,4,5,144,255
302,31,2,5,3,10,21,-45,5,0,165,210
302,32,3,4,6,7,33,43,8,3,198,253
302,33,4,3,4,9,40,36,8,9,238,289
302,34,3,4,6,7,-67,-57,1,2,171,232
302,35,4,4,7,6,43,42,4,4,214,274
302,36,4,3,8,5,44,32,8,6,258,306
302,37,2,6,3,10,21,-36,9,0,279,270
302,38,3,4,5,8,-68,44,1,4,211,314
302,39,3,3,7,6,34,33,5,7,245,347
302,40,3,3,7,6,34,-67,9,0,279,280
302,41,2,7,2,11,20,74,9,4,299,354
302,42,4,3,8,5,-56,32,3,6,243,386
302,43,3,4,7,6,34,42,7,8,277,428
302,44,2,5,3,10,21,-45,8,3,298,383
302,45,4,3,7,6,-57,33,1,6,241,416
302,46,2,4,4,9,22,-55,3,1,263,361
302,47,3,3,6,7,33,34,6,5,296,395
302,48,3,3,5,8,32,-65,8,0,328,330
302,49,3,4,7,6,-66,42,2,2,262,372
302,50,3,4,6,7,33,43,5,5,295,415
302,51,4,3,6,7,42,34,7,9,337,449
302,52,3,3,5,8,32,-65,9,4,369,384
302,53,5,3,9,4,-46,31,3,5,323,415
302,54,4,4,6,7,42,43,5,8,365,458
302,55,3,4,3,10,30,-54,5,4,395,404
302,56,4,3,7,6,43,33,8,7,438,437
302,57,2,4,3,10,21,-54,9,3,459,383
302,58,2,5,2,11,20,56,9,9,479,439
302,59,4,2,9,4,-55,-78,4,1,424,361
302,60,3,3,5,8,32,35,6,6,456,396
302,61,3,4,5,8,32,-56,8,0,488,340
302,62,2,6,5,8,-77,62,1,2,411,402
302,63,5,2,9,4,54,22,5,4,465,424
302,64,4,3,6,7,42,34,7,8,507,458
303,1,2,5,5,8,23,53,3,3,23,53
303,2,4,2,5,8,41,26,4,9,64,79
303,3,3,4,7,6,34,-58,8,1,98,21
303,4,6,2,10,3,-36,21,2,2,62,42
303,5,2,5,5,8,23,53,5,5,85,95
303,6,3,4,8,5,-65,41,0,6,20,136
303,7,4,2,9,4,45,22,5,8,65,158
303,8,2,4,5,8,23,-56,8,2,88,102
303,9,3,4,7,6,-66,42,2,4,22,144
303,10,4,3,8,5,44,32,6,6,66,176
303,11,3,3,8,5,-65,32,1,8,1,208
303,12,4,2,6,7,42,-75,3,3,43,133
303,13,2,5,3,10,21,55,4,8,64,188
303,14,2,5,5,8,23,-47,7,1,87,141
303,15,4,3,8,5,-56,32,1,3,31,173
303,16,4,3,7,6,43,33,4,6,74,206
303,17,3,3,9,4,-64,31,0,7,10,237
303,18,4,3,7,6,43,-67,3,0,53,170
303,19,3,4,5,8,32,44,5,4,85,214
303,20,3,4,7,6,34,42,9,6,119,256
303,21,5,2,9,4,-46,22,3,8,73,278
303,22,3,3,8,5,35,-68,8,0,108,210
303,23,2,4,5,8,-77,44,1,4,31,254
303,24,3,3,8,5,35,32,6,6,66,286
303,25,5,3,8,5,53,32,9,8,119,318
303,26,2,6,4,9,-78,-37,1,1,41,281
303,27,3,3,4,9,31,36,2,7,72,317
303,28,4,2,8,5,44,-77,6,0,116,240
303,29,4,3,9,4,-55,31,1,1,61,271
303,30,5,2,8,5,53,23,4,4,114,294
303,31,2,4,5,8,23,44,7,8,137,338
303,32,5,2,8,5,-47,-77,0,1,90,261
303,33,2,5,7,6,25,51,5,2,115,312
303,34,4,2,9,4,-55,22,0,4,60,334
303,35,4,3,7,6,43,33,3,7,103,367
303,36,3,4,5,8,32,-56,5,1,135,311
303,37,4,2,7,6,43,24,8,5,178,335
303,38,4,2,6,7,-58,-75,0,0,120,260
303,39,2,6,3,10,21,64,1,4,141,324
303,40,3,3,6,7,33,34,4,8,174,358
303,41,3,3,9,4,-64,31,0,9,110,389
303,42,3,4,3,10,30,-54,0,5,140,335
303,43,5,2,8,5,53,23,3,8,193,358
303,44,3,4,7,6,34,-58,7,0,227,300
303,45,2,4,7,6,-75,42,2,2,152,342
303,46,5,3,8,5,53,32,5,4,205,374
303,47,4,2,8,5,44,23,9,7,249,397
303,48,3,3,5,8,-68,-65,1,2,181,332
303,49,2,4,4,9,22,45,3,7,203,377
303,50,5,2,10,3,55,21,8,8,258,398
303,51,4,2,9,4,-55,-78,3,0,203,320
303,52,5,3,8,5,53,32,6,2,256,352
303,53,3,4,3,10,30,46,6,8,286,398
303,54,4,3,5,8,41,-65,7,3,327,333
303,55,4,2,10,3,-54,21,3,4,273,354
303,56,4,3,5,8,41,35,4,9,314,389
303,57,6,2,9,4,63,-78,7,1,377,311
303,58,2,5,5,8,-77,53,0,4,300,364
303,59,4,3,4,9,40,-64,0,0,340,300
303,60,3,3,5,8,32,35,2,5,372,335
303,61,3,4,3,10,30,-54,2,1,402,281
303,62,5,3,7,6,52,33,4,4,454,314
303,63,2,5,3,10,21,55,5,9,475,369
303,64,3,4,8,5,-65,-59,0,0,410,310
303,65,3,4,6,7,33,43,3,3,443,353
303,66,4,2,7,6,43,24,6,7,486,377
303,67,3,3,5,8,32,-65,8,2,518,312
304,1,4,3,7,6,43,33,3,3,43,33
304,2,3,4,6,7,33,43,6,6,76,76
304,3,3,4,6,7,33,43,9,9,109,119
304,4,2,5,4,9,-78,-46,1,3,31,73
304,5,3,4,7,6,34,42,5,5,65,115
304,6,5,2,8,5,53,23,8,8,118,138
304,7,3,4,6,7,-67,-57,1,1,51,81
304,8,4,3,7,6,43,33,4,4,94,114
304,9,3,4,5,8,32,44,6,8,126,158
304,10,4,2,9,4,-55,-78,1,0,71,80
304,11,3,3,9,4,36,31,7,1,107,111
304,12,5,2,11,2,-44,20,3,1,63,131
304,13,3,4,3,10,30,46,3,7,93,177
304,14,2,5,3,10,21,-45,4,2,114,132
304,15,3,3,7,6,34,33,8,5,148,165
304,16,4,3,5,8,41,-65,9,0,189,100
304,17,2,5,6,7,-76,52,3,2,113,152
304,18,5,2,10,3,55,21,8,3,168,173
304,19,4,3,7,6,-57,33,1,6,111,206
304,20,3,3,6,7,33,-66,4,0,144,140
304,21,4,4,7,6,43,42,7,2,187,182
304,22,5,2,10,3,-45,21,2,3,142,203
304,23,4,2,5,8,41,26,3,9,183,229
304,24,3,3,7,6,34,-67,7,2,217,162
304,25,4,3,6,7,42,34,9,6,259,196
304,26,2,4,6,7,-76,43,3,9,183,239
304,27,6,2,10,3,64,-79,7,0,247,160
304,28,2,4,4,9,22,45,9,5,269,205
304,29,4,4,7,6,-57,42,2,7,212,247
304,30,3,3,4,9,31,-64,3,3,243,183
304,31,4,3,7,6,43,33,6,6,286,216
304,32,3,3,8,5,-65,32,1,8,221,248
304,33,3,3,6,7,33,-66,4,2,254,182
304,34,5,2,9,4,54,22,8,4,308,204
304,35,2,5,4,9,-78,54,0,8,230,258
304,36,3,4,6,7,33,-57,3,1,263,201
304,37,4,2,7,6,43,24,6,5,306,225
304,38,4,2,8,5,-56,23,0,8,250,248
304,39,4,3,6,7,42,-66,2,2,292,182
304,40,5,2,8,5,53,23,5,5,345,205
304,41,6,2,11,2,-35,20,0,5,310,225
304,42,3,3,6,7,33,34,3,9,343,259
304,43,4,3,4,9,40,-64,3,5,383,195
304,44,2,4,6,7,24,43,7,8,407,238
304,45,2,4,3,10,21,-54,8,4,428,184
304,46,2,4,6,7,-76,43,2,7,352,227
304,47,4,2,8,5,44,-77,6,0,396,150
304,48,4,3,9,4,-55,31,1,1,341,181
304,49,2,4,7,6,25,42,6,3,366,223
304,50,5,2,10,3,-45,21,1,4,321,244
304,51,3,4,5,8,32,44,3,8,353,288
304,52,3,3,6,7,33,-66,6,2,386,222
304,53,4,3,9,4,-55,31,1,3,331,253
304,54,2,4,5,8,23,44,4,7,354,297
304,55,2,4,3,10,21,-54,5,3,375,243
304,56,5,3,6,7,51,34,6,7,426,277
304,57,5,2,9,4,-46,22,0,9,380,299
304,58,5,2,7,6,52,-76,2,3,432,223
304,59,3,3,5,8,32,35,4,8,464,258
304,60,4,4,8,5,44,41,8,9,508,299
305,1,4,2,8,5,44,23,4,3,44,23
305,2,3,3,9,4,-64,31,0,4,-20,54
305,3,3,3,6,7,33,34,3,8,13,88
305,4,2,4,6,7,24,-57,7,1,37,31
305,5,4,3,7,6,-57,33,0,4,-20,64
305,6,5,2,7,6,52,24,2,8,32,88
305,7,3,5,7,6,34,51,6,9,66,139
305,8,4,3,8,5,-56,-68,0,1,10,71
305,9,4,3,8,5,44,32,4,3,54,103
305,10,3,4,5,8,32,44,6,7,86,147
305,11,3,3,9,4,-64,31,2,8,22,178
305,12,3,3,4,9,31,-64,3,4,53,114
305,13,2,5,3,10,21,55,4,9,74,169
305,14,3,3,8,5,35,-68,9,1,109,101
305,15,4,3,5,8,-59,35,0,6,50,136
305,16,5,2,9,4,54,22,4,8,104,158
305,17,2,5,6,7,24,-48,8,0,128,110
305,18,2,4,7,6,-75,42,3,2,53,152
305,19,3,3,5,8,32,35,5,7,85,187
305,20,3,3,8,5,-65,32,0,9,20,219
305,21,2,5,3,10,21,-45,1,4,41,174
305,22,5,2,10,3,55,21,6,5,96,195
305,23,4,2,7,6,43,24,9,9,139,219
305,24,2,4,3,10,-79,-54,0,5,60,165
305,25,2,6,3,10,21,64,1,9,81,229
305,26,3,4,6,7,33,-57,4,2,114,172
305,27,4,2,11,2,-53,20,1,2,61,192
305,28,2,5,3,10,21,55,2,7,82,247
305,29,2,5,3,10,21,-45,3,2,103,202
305,30,4,3,9,4,45,31,8,3,148,233
305,31,3,3,8,5,-65,32,3,5,83,265
305,32,4,3,7,6,43,33,6,8,126,298
305,33,3,3,7,6,-66,-67,0,1,60,231
305,34,4,3,8,5,44,32,4,3,104,263
305,35,3,4,5,8,32,44,6,7,136,307
305,36,3,3,8,5,-65,32,1,9,71,339
305,37,3,3,7,6,34,-67,5,2,105,272
305,38,3,3,6,7,33,34,8,6,138,306
305,39,5,2,8,5,-47,23,1,9,91,329
305,40,5,2,11,2,56,20,7,9,147,349
305,41,5,3,9,4,-46,-69,1,0,101,280
305,42,4,2,7,6,43,24,4,4,144,304
305,43,3,4,7,6,34,42,8,6,178,346
305,44,3,3,9,4,-64,31,4,7,114,377
305,45,4,2,9,4,45,22,9,9,159,399
305,46,4,3,8,5,-56,-68,3,1,103,331
305,47,2,4,4,9,22,45,5,6,125,376
305,48,3,4,7,6,34,42,9,8,159,418
305,49,3,3,5,8,-68,-65,1,3,91,353
305,50,2,5,6,7,24,52,5,5,115,405
305,51,2,5,3,10,21,-45,6,0,136,360
305,52,4,2,9,4,-55,22,1,2,81,382
305,53,2,4,6,7,24,43,5,5,105,425
305,54,2,4,4,9,22,-55,7,0,127,370
305,55,3,4,6,7,-67,43,0,3,60,413
305,56,3,3,8,5,35,32,5,5,95,445
305,57,3,3,4,9,31,-64,6,1,126,381
305,58,2,4,5,8,23,44,9,5,149,425
305,59,2,4,3,10,-79,-54,0,1,70,371
305,60,3,4,4,9,31,45,1,6,101,416
305,61,5,2,7,6,52,-76,3,0,153,340
305,62,3,3,5,8,32,35,5,5,185,375
305,63,3,4,6,7,33,43,8,8,218,418
305,64,2,6,6,7,-76,61,2,9,142,479
305,65,2,4,6,7,24,-57,6,2,166,422
305,66,4,3,10,3,-54,30,2,2,112,452
305,67,4,3,6,7,42,34,4,6,154,486
305,68,3,4,8,5,35,41,9,7,189,527
306,1,3,4,4,9,31,45,1,5,31,45
306,2,5,2,9,4,54,22,5,7,85,67
306,3,2,4,4,9,22,-55,7,2,107,12
306,4,4,3,6,7,42,34,9,6,149,46
306,5,3,4,7,6,-66,42,3,8,83,88
306,6,4,4,9,4,45,40,8,8,128,128
306,7,3,3,3,10,30,-63,8,5,158,65
306,8,3,3,6,7,-67,34,1,9,91,99
306,9,4,3,8,5,44,-68,5,1,135,31
306,10,5,2,8,5,53,23,8,4,188,54
306,11,5,2,8,5,-47,23,1,7,141,77
306,12,2,6,5,8,23,62,4,9,164,139
306,13,3,3,7,6,34,-67,8,2,198,72
306,14,4,2,6,7,-58,25,0,7,140,97
306,15,2,5,3,10,21,-45,1,2,161,52
306,16,2,5,6,7,24,52,5,4,185,104
306,17,4,2,8,5,44,23,9,7,229,127
306,18,4,2,7,6,-57,-76,2,1,172,51
306,19,2,4,4,9,22,45,4,6,194,96
306,20,4,3,7,6,43,33,7,9,237,129
306,21,3,4,5,8,32,-56,9,3,269,73
306,22,3,3,5,8,-68,35,1,8,201,108
306,23,3,4,7,6,34,-58,5,0,235,50
306,24,2,4,6,7,24,43,9,3,259,93
306,25,3,4,6,7,-67,43,2,6,192,136
306,26,4,3,8,5,44,32,6,8,236,168
306,27,3,3,5,8,32,-65,8,3,268,103
306,28,4,2,9,4,-55,22,3,5,213,125
306,29,3,3,8,5,35,32,8,7,248,157
306,30,4,4,5,8,41,-56,9,1,289,101
306,31,2,4,3,10,-79,46,0,7,210,147
306,32,3,3,8,5,35,32,5,9,245,179
306,33,4,2,11,2,-53,20,2,9,192,199
306,34,2,6,4,9,22,-37,4,2,214,162
306,35,3,4,4,9,31,45,5,7,245,207
306,36,3,3,6,7,33,-66,8,1,278,141
306,37,4,3,7,6,-57,33,1,4,221,174
306,38,4,2,6,7,42,25,3,9,263,199
306,39,3,3,8,5,35,-68,8,1,298,131
306,40,3,4,5,8,-68,44,0,5,230,175
306,41,4,2,8,5,44,23,4,8,274,198
306,42,3,3,6,7,33,-66,7,2,307,132
306,43,2,5,4,9,22,54,9,6,329,186
306,44,4,2,6,7,-58,-75,1,1,271,111
306,45,3,3,6,7,33,34,4,5,304,145
306,46,3,3,7,6,34,33,8,8,338,178
306,47,3,4,8,5,-65,41,3,9,273,219
306,48,4,3,6,7,42,-66,5,3,315,153
306,49,3,4,6,7,33,43,8,6,348,196
306,50,3,4,5,8,-68,-56,0,0,280,140
306,51,4,2,5,8,41,26,1,6,321,166
306,52,4,3,7,6,43,33,4,9,364,199
306,53,3,3,6,7,33,-66,7,3,397,133
306,54,2,4,5,8,-77,44,0,7,320,177
306,55,4,3,8,5,44,32,4,9,364,209
306,56,3,4,6,7,33,-57,7,2,397,152
306,57,2,4,4,9,22,45,9,7,419,197
306,58,4,2,9,4,-55,22,4,9,364,219
306,59,5,2,9,4,54,-78,8,1,418,141
306,60,5,3,9,4,-46,31,2,2,372,172
306,61,3,4,6,7,33,43,5,5,405,215
306,62,2,4,7,6,-75,42,0,7,330,257
306,63,3,3,4,9,31,-64,1,3,361,193
306,64,6,2,10,3,64,21,5,4,425,214
306,65,3,3,7,6,34,33,9,7,459,247
306,66,3,4,6,7,-67,-57,2,0,392,190
306,67,4,3,8,5,44,32,6,2,436,222
306,68,3,3,9,4,-64,31,2,3,372,253
306,69,3,4,7,6,34,42,6,5,406,295
306,70,5,3,8,5,53,32,9,7,459,327
306,71,3,4,6,7,-67,-57,2,0,392,270
306,72,3,3,7,6,34,33,6,3,426,303
306,73,2,5,4,9,22,54,8,7,448,357
306,74,3,3,5,8,-68,-65,0,2,380,292
306,75,3,3,7,6,34,33,4,5,414,325
306,76,2,4,5,8,23,44,7,9,437,369
306,77,4,4,8,5,-56,-59,1,0,381,310
306,78,4,3,8,5,44,32,5,2,425,342
306,79,4,3,6,7,42,34,7,6,467,376
306,80,4,2,6,7,42,-75,9,1,509,301
307,1,4,3,5,8,41,35,1,5,41,35
307,2,4,2,9,4,45,22,6,7,86,57
307,3,3,3,7,6,-66,-67,0,0,20,-10
307,4,4,3,8,5,44,32,4,2,64,22
307,5,3,4,6,7,33,43,7,5,97,65
307,6,3,4,5,8,32,44,9,9,129,109
307,7,2,4,6,7,-76,-57,3,2,53,52
307,8,3,4,6,7,33,43,6,5,86,95
307,9,3,3,6,7,33,34,9,9,119,129
307,10,3,3,8,5,-65,-68,4,1,54,61
307,11,4,2,8,5,44,23,8,4,98,84
307,12,2,5,5,8,-77,53,1,7,21,137
307,13,2,4,3,10,21,-54,2,3,42,83
307,14,3,3,6,7,33,34,5,7,75,117
307,15,3,3,4,9,31,-64,6,3,106,53
307,16,3,3,8,5,-65,32,1,5,41,85
307,17,3,4,5,8,32,44,3,9,73,129
307,18,3,4,4,9,31,-55,4,4,104,74
307,19,3,4,5,8,32,44,6,8,136,118
307,20,4,4,8,5,-56,41,0,9,80,159
307,21,3,3,7,6,34,-67,4,2,114,92
307,22,3,4,7,6,34,42,8,4,148,134
307,23,4,3,10,3,-54,30,4,4,94,164
307,24,3,3,7,6,34,33,8,7,128,197
307,25,4,2,9,4,-55,22,3,9,73,219
307,26,5,2,9,4,54,-78,7,1,127,141
307,27,3,3,5,8,32,35,9,6,159,176
307,28,2,4,5,8,-77,-56,2,0,82,120
307,29,3,3,7,6,34,33,6,3,116,153
307,30,3,4,8,5,-65,41,1,4,51,194
307,31,3,4,5,8,32,44,3,8,83,238
307,32,4,2,9,4,45,-78,8,0,128,160
307,33,3,4,3,10,30,46,8,6,158,206
307,34,4,3,6,7,-58,-66,0,0,100,140
307,35,3,4,7,6,34,42,4,2,134,182
307,36,3,4,6,7,33,43,7,5,167,225
307,37,4,3,9,4,-55,31,2,6,112,256
307,38,4,2,8,5,44,23,6,9,156,279
307,39,4,3,10,3,-54,30,2,9,102,309
307,40,3,3,8,5,35,-68,7,1,137,241
307,41,2,4,5,8,-77,44,0,5,60,285
307,42,3,3,4,9,31,-64,1,1,91,221
307,43,4,2,7,6,43,24,4,5,134,245
307,44,3,3,7,6,34,33,8,8,168,278
307,45,4,3,9,4,-55,31,3,9,113,309
307,46,5,2,9,4,54,-78,7,1,167,231
307,47,3,3,3,10,30,37,7,8,197,268
307,48,2,4,9,4,-73,40,4,8,124,308
307,49,2,4,6,7,24,-57,8,1,148,251
307,50,2,5,7,6,-75,51,3,2,73,302
307,51,3,3,5,8,32,35,5,7,105,337
307,52,3,4,5,8,32,-56,7,1,137,281
307,53,2,6,3,10,21,64,8,5,158,345
307,54,4,2,10,3,-54,21,4,6,104,366
307,55,4,3,9,4,45,31,9,7,149,397
307,56,3,3,4,9,-69,-64,0,3,80,333
307,57,4,2,9,4,45,22,5,5,125,355
307,58,3,3,6,7,33,34,8,9,158,389
307,59,2,4,6,7,-76,-57,2,2,82,332
307,60,4,2,5,8,41,26,3,8,123,358
307,61,3,3,8,5,35,-68,8,0,158,290
307,62,4,2,6,7,-58,25,0,5,100,315
307,63,3,4,6,7,33,43,3,8,133,358
307,64,3,3,4,9,31,-64,4,4,164,294
307,65,4,2,7,6,43,24,7,8,207,318
307,66,2,5,4,9,22,-46,9,2,229,272
307,67,3,3,9,4,-64,31,5,3,165,303
307,68,3,3,8,5,-65,32,0,5,100,335
307,69,2,4,6,7,24,43,4,8,124,378
307,70,3,3,6,7,33,-66,7,2,157,312
307,71,4,3,7,6,-57,33,0,5,100,345
307,72,2,4,4,9,22,-55,2,0,122,290
307,73,2,5,5,8,23,53,5,3,145,343
307,74,3,4,7,6,34,42,9,5,179,385
307,75,4,4,7,6,-57,42,2,7,122,427
307,76,2,4,4,9,22,-55,4,2,144,372
307,77,2,4,6,7,24,43,8,5,168,415
307,78,3,3,8,5,-65,32,3,7,103,447
307,79,3,3,6,7,33,-66,6,1,136,381
307,80,2,4,4,9,22,45,8,6,158,426
307,81,3,3,8,5,-65,32,3,8,93,458
307,82,5,2,9,4,54,-78,7,0,147,380
307,83,2,5,8,5,-74,50,3,0,73,430
307,84,3,3,8,5,35,32,8,2,108,462
307,85,3,4,8,5,-65,41,3,3,43,503
308,1,4,2,5,8,41,26,1,6,41,26
308,2,3,4,7,6,34,42,5,8,75,68
308,3,3,4,7,6,34,-58,9,0,109,10
308,4,5,2,8,5,-47,23,2,3,62,33
308,5,2,4,5,8,23,44,5,7,85,77
308,6,4,3,6,7,42,-66,7,1,127,11
308,7,4,3,7,6,-57,33,0,4,70,44
308,8,2,5,5,8,23,53,3,7,93,97
308,9,3,4,5,8,32,-56,5,1,125,41
308,10,4,2,9,4,-55,22,0,3,70,63
308,11,4,2,10,3,46,21,6,4,116,84
308,12,3,4,8,5,-65,41,1,5,51,125
308,13,3,5,5,8,32,53,3,8,83,178
308,14,5,2,8,5,53,-77,6,1,136,101
308,15,2,5,4,9,22,54,8,5,158,155
308,16,2,5,6,7,-76,52,2,7,82,207
308,17,3,3,8,5,35,32,7,9,117,239
308,18,4,2,6,7,42,-75,9,4,159,164
308,19,5,2,11,2,-44,20,5,4,115,184
308,20,3,3,7,6,34,33,9,7,149,217
308,21,3,3,4,9,-69,-64,0,3,80,153
308,22,2,4,4,9,22,45,2,8,102,198
308,23,3,3,6,7,33,-66,5,2,135,132
308,24,2,5,2,11,20,56,5,8,155,188
308,25,2,4,4,9,22,-55,7,3,177,133
308,26,4,3,6,7,42,34,9,7,219,167
308,27,3,4,3,10,30,-54,9,3,249,113
308,28,2,5,3,10,-79,55,0,8,170,168
308,29,3,3,6,7,33,-66,3,2,203,102
308,30,3,4,3,10,30,46,3,8,233,148
308,31,3,4,6,7,33,-57,6,1,266,91
308,32,3,4,5,8,32,44,8,5,298,135
308,33,4,3,7,6,-57,33,1,8,241,168
308,34,2,6,4,9,22,-37,3,1,263,131
308,35,2,4,3,10,21,46,4,7,284,177
308,36,4,3,5,8,41,-65,5,2,325,112
308,37,2,5,6,7,24,52,9,4,349,164
308,38,3,4,7,6,-66,42,3,6,283,206
308,39,4,2,8,5,44,23,7,9,327,229
308,40,4,4,7,6,-57,-58,0,1,270,171
308,41,5,3,9,4,54,31,4,2,324,202
308,42,3,4,4,9,31,45,5,7,355,247
308,43,4,2,8,5,44,-77,9,0,399,170
308,44,3,3,8,5,-65,32,4,2,334,202
308,45,4,3,9,4,45,31,9,3,379,233
308,46,3,3,8,5,-65,32,4,5,314,265
308,47,4,3,7,6,43,33,7,8,357,298
308,48,3,4,3,10,30,-54,7,4,387,244
308,49,4,2,8,5,-56,23,1,7,331,267
308,50,3,3,7,6,34,-67,5,0,365,200
308,51,2,4,4,9,22,45,7,5,387,245
308,52,3,3,6,7,-67,34,0,9,320,279
308,53,5,2,11,2,56,20,6,9,376,299
308,54,2,5,6,7,-76,-48,0,1,300,251
308,55,4,3,7,6,43,33,3,4,343,284
308,56,4,3,9,4,45,31,8,5,388,315
308,57,3,3,4,9,31,-64,9,1,419,251
308,58,2,4,5,8,-77,44,2,5,342,295
308,59,4,3,6,7,42,34,4,9,384,329
308,60,4,2,9,4,45,-78,9,1,429,251
308,61,5,2,10,3,-45,21,4,2,384,272
308,62,3,4,5,8,32,44,6,6,416,316
308,63,3,4,5,8,32,-56,8,0,448,260
308,64,4,2,8,5,-56,23,2,3,392,283
308,65,3,3,5,8,32,35,4,8,424,318
308,66,2,4,4,9,22,-55,6,3,446,263
308,67,4,2,8,5,-56,23,0,6,390,286
308,68,3,3,6,7,33,-66,3,0,423,220
308,69,5,2,8,5,53,23,6,3,476,243
308,70,4,3,9,4,-55,31,1,4,421,274
308,71,4,4,8,5,44,41,5,5,465,315
308,72,3,3,8,5,-65,32,0,7,400,347
308,73,3,4,5,8,32,-56,2,1,432,291
308,74,4,3,6,7,42,34,4,5,474,325
308,75,4,2,8,5,44,23,8,8,518,348
309,1,3,3,6,7,33,34,3,4,33,34
309,2,4,3,7,6,43,33,6,7,76,67
309,3,3,3,5,8,32,-65,8,2,108,2
309,4,5,2,10,3,-45,21,3,3,63,23
309,5,2,4,5,8,23,44,6,7,86,67
309,6,4,4,5,8,41,-56,7,1,127,11
309,7,2,4,5,8,-77,44,0,5,50,55
309,8,3,3,8,5,35,32,5,7,85,87
309,9,2,4,6,7,24,-57,9,0,109,30
309,10,2,4,4,9,-78,45,1,5,31,75
309,11,3,3,4,9,31,-64,2,1,62,11
309,12,4,2,6,7,42,25,4,6,104,36
309,13,4,2,8,5,44,23,8,9,148,59
309,14,4,2,10,3,-54,-79,4,0,94,-20
309,15,5,2,9,4,54,22,8,2,148,2
309,16,3,4,6,7,-67,43,1,5,81,45
309,17,4,2,9,4,45,22,6,7,126,67
309,18,4,2,8,5,-56,-77,0,0,70,-10
309,19,2,5,4,9,22,54,2,4,92,44
309,20,3,3,5,8,32,35,4,9,124,79
309,21,2,5,4,9,22,-46,6,3,146,33
309,22,4,2,9,4,-55,22,1,5,91,55
309,23,2,5,6,7,24,52,5,7,115,107
309,24,5,2,6,7,51,-75,6,2,166,32
309,25,5,2,11,2,-44,20,2,2,122,52
309,26,2,4,5,8,23,44,5,6,145,96
309,27,3,3,8,5,-65,32,0,8,80,128
309,28,2,5,3,10,21,-45,1,3,101,83
309,29,3,3,6,7,33,34,4,7,134,117
309,30,2,6,5,8,23,62,7,9,157,179
309,31,2,5,4,9,22,-46,9,3,179,133
309,32,3,3,4,9,-69,36,0,9,110,169
309,33,5,2,9,4,54,-78,4,1,164,91
309,34,4,2,8,5,44,23,8,4,208,114
309,35,3,3,5,8,-68,35,0,9,140,149
309,36,3,4,6,7,33,-57,3,2,173,92
309,37,3,3,7,6,34,33,7,5,207,125
309,38,4,3,6,7,42,34,9,9,249,159
309,39,2,4,4,9,-78,-55,1,4,171,104
309,40,3,5,5,8,32,53,3,7,203,157
309,41,5,2,6,7,51,-75,4,2,254,82
309,42,5,2,8,5,53,23,7,5,307,105
309,43,3,4,5,8,32,44,9,9,339,149
309,44,4,4,7,6,-57,-58,2,1,282,91
309,45,2,5,4,9,22,54,4,5,304,145
309,46,2,5,7,6,25,51,9,6,329,196
309,47,3,3,8,5,-65,32,4,8,264,228
309,48,4,2,6,7,42,-75,6,3,306,153
309,49,4,2,5,8,41,26,7,9,347,179
309,50,4,3,5,8,41,-65,8,4,388,114
309,51,3,3,7,6,-66,33,2,7,322,147
309,52,3,3,7,6,34,-67,6,0,356,80
309,53,2,5,2,11,20,56,6,6,376,136
309,54,4,3,7,6,43,33,9,9,419,169
309,55,2,5,5,8,-77,-47,2,2,342,122
309,56,2,6,2,11,20,65,2,7,362,187
309,57,4,2,7,6,43,-76,5,1,405,111
309,58,2,4,5,8,23,44,8,5,428,155
309,59,3,3,7,6,-66,33,2,8,362,188
309,60,3,4,4,9,31,-55,3,3,393,133
309,61,3,4,4,9,31,45,4,8,424,178
309,62,4,3,7,6,43,-67,7,1,467,111
309,63,3,4,4,9,31,45,8,6,498,156
309,64,4,3,7,6,-57,33,1,9,441,189
309,65,2,4,3,10,21,-54,2,5,462,135
309,66,3,3,7,6,34,33,6,8,496,168
309,67,3,4,6,7,33,-57,9,1,529,111
310,1,3,3,8,5,35,32,5,2,35,32
310,2,2,5,4,9,22,54,7,6,57,86
310,3,3,3,4,9,31,-64,8,2,88,22
310,4,4,3,7,6,-57,33,1,5,31,55
310,5,3,4,5,8,32,44,3,9,63,99
310,6,4,3,7,6,43,-67,6,2,106,32
310,7,3,3,9,4,-64,31,2,3,42,63
310,8,5,2,8,5,53,23,5,6,95,86
310,9,4,2,8,5,44,23,9,9,139,109
310,10,4,2,8,5,-56,-77,3,2,83,32
310,11,4,3,7,6,43,33,6,5,126,65
310,12,4,3,6,7,42,34,8,9,168,99
310,13,4,3,9,4,-55,-69,3,0,113,30
310,14,5,2,6,7,51,25,4,5,164,55
310,15,2,4,6,7,24,43,8,8,188,98
310,16,5,3,10,3,-45,30,3,8,143,128
310,17,3,3,8,5,35,-68,8,0,178,60
310,18,4,3,9,4,-55,31,3,1,123,91
310,19,3,4,3,10,30,46,3,7,153,137
310,20,3,4,7,6,34,42,7,9,187,179
310,21,4,3,7,6,-57,-67,0,2,130,112
310,22,3,4,4,9,31,45,1,7,161,157
310,23,4,3,7,6,43,-67,4,0,204,90
310,24,3,4,8,5,35,41,9,1,239,131
310,25,3,4,8,5,-65,41,4,2,174,172
310,26,4,2,8,5,44,23,8,5,218,195
310,27,3,4,7,6,-66,42,2,7,152,237
310,28,2,5,4,9,22,-46,4,1,174,191
310,29,4,2,6,7,42,25,6,6,216,216
310,30,4,3,7,6,43,33,9,9,259,249
310,31,3,3,5,8,-68,-65,1,4,191,184
310,32,5,2,11,2,56,20,7,4,247,204
310,33,3,3,5,8,32,35,9,9,279,239
310,34,2,4,5,8,-77,-56,2,3,202,183
310,35,3,4,4,9,31,45,3,8,233,228
310,36,5,2,10,3,55,21,8,9,288,249
310,37,4,3,10,3,-54,30,4,9,234,279
310,38,2,6,3,10,21,-36,5,3,255,243
310,39,3,3,7,6,34,33,9,6,289,276
310,40,4,3,9,4,-55,31,4,7,234,307
310,41,2,5,5,8,23,-47,7,0,257,260
310,42,3,3,7,6,-66,33,1,3,191,293
310,43,4,3,5,8,41,35,2,8,232,328
310,44,4,2,6,7,42,-75,4,3,274,253
310,45,2,4,4,9,22,45,6,8,296,298
310,46,3,3,6,7,33,-66,9,2,329,232
310,47,4,3,6,7,-58,34,1,6,271,266
310,48,2,4,3,10,21,-54,2,2,292,212
310,49,3,5,4,9,31,54,3,6,323,266
310,50,4,2,7,6,43,-76,6,0,366,190
310,51,3,3,7,6,-66,33,0,3,300,223
310,52,2,4,5,8,23,44,3,7,323,267
310,53,3,4,5,8,32,-56,5,1,355,211
310,54,3,4,7,6,34,42,9,3,389,253
310,55,4,3,7,6,-57,33,2,6,332,286
310,56,3,4,5,8,32,-56,4,0,364,230
310,57,5,2,9,4,54,22,8,2,418,252
310,58,3,3,6,7,-67,34,1,6,351,286
310,59,3,3,7,6,34,33,5,9,385,319
310,60,3,3,6,7,33,-66,8,3,418,253
310,61,3,4,5,8,-68,44,0,7,350,297
310,62,3,4,5,8,32,-56,2,1,382,241
310,63,3,3,6,7,33,34,5,5,415,275
310,64,2,4,4,9,22,-55,7,0,437,220
310,65,3,3,7,6,-66,33,1,3,371,253
310,66,3,3,4,9,31,36,2,9,402,289
310,67,3,3,5,8,32,-65,4,4,434,224
310,68,4,3,6,7,42,34,6,8,476,258
310,69,3,3,5,8,32,-65,8,3,508,193
311,1,4,3,6,7,42,34,2,4,42,34
311,2,3,3,6,7,33,34,5,8,75,68
311,3,3,3,4,9,31,-64,6,4,106,4
311,4,4,3,7,6,43,33,9,7,149,37
311,5,3,3,5,8,-68,-65,1,2,81,-28
311,6,2,4,6,7,24,43,5,5,105,15
311,7,2,5,4,9,22,54,7,9,127,69
311,8,6,2,11,2,-35,20,2,9,92,89
311,9,3,4,6,7,33,-57,5,2,125,32
311,10,5,2,8,5,53,23,8,5,178,55
311,11,5,2,11,2,-44,20,4,5,134,75
311,12,2,5,5,8,23,53,7,8,157,128
311,13,2,5,2,11,20,-44,7,4,177,84
311,14,5,2,10,3,-45,21,2,5,132,105
311,15,4,3,9,4,45,31,7,6,177,136
311,16,3,4,3,10,30,-54,7,2,207,82
311,17,4,2,8,5,-56,23,1,5,151,105
311,18,3,4,5,8,32,44,3,9,183,149
311,19,4,3,7,6,43,-67,6,2,226,82
311,20,2,6,3,10,21,64,7,6,247,146
311,21,4,2,9,4,-55,22,2,8,192,168
311,22,5,2,7,6,52,-76,4,2,244,92
311,23,2,5,6,7,24,52,8,4,268,144
311,24,3,4,5,8,-68,44,0,8,200,188
311,25,3,3,6,7,33,-66,3,2,233,122
311,26,2,4,6,7,24,43,7,5,257,165
311,27,6,2,8,5,62,23,9,8,319,188
311,28,5,2,8,5,-47,-77,2,1,272,111
311,29,4,3,7,6,43,33,5,4,315,144
311,30,2,5,3,10,21,55,6,9,336,199
311,31,3,4,6,7,33,-57,9,2,369,142
311,32,3,4,6,7,-67,43,2,5,302,185
311,33,5,2,8,5,53,23,5,8,355,208
311,34,4,2,8,5,44,-77,9,1,399,131
311,35,4,2,6,7,-58,25,1,6,341,156
311,36,3,4,5,8,32,-56,3,0,373,100
311,37,3,3,4,9,31,36,4,6,404,136
311,38,3,4,5,8,32,-56,6,0,436,80
311,39,4,3,6,7,42,34,8,4,478,114
311,40,4,3,6,7,-58,34,0,8,420,148
311,41,2,4,8,5,26,41,6,9,446,189
311,42,3,3,8,5,-65,-68,1,1,381,121
311,43,2,4,4,9,22,45,3,6,403,166
311,44,3,5,7,6,34,51,7,7,437,217
311,45,4,3,8,5,-56,32,1,9,381,249
311,46,5,2,8,5,53,-77,4,2,434,172
311,47,4,3,5,8,41,35,5,7,475,207
311,48,4,2,7,6,43,-76,8,1,518,131
312,1,2,4,3,10,21,46,1,6,21,46
312,2,4,3,5,8,41,-65,2,1,62,-19
312,3,3,4,6,7,33,43,5,4,95,24
312,4,3,3,7,6,34,33,9,7,129,57
312,5,2,5,3,10,-79,-45,0,2,50,12
312,6,2,4,5,8,23,44,3,6,73,56
312,7,4,2,10,3,46,21,9,7,119,77
312,8,3,4,4,9,-69,-55,0,2,50,22
312,9,4,4,6,7,42,43,2,5,92,65
312,10,3,3,9,4,36,31,8,6,128,96
312,11,2,4,3,10,21,-54,9,2,149,42
312,12,4,2,6,7,-58,25,1,7,91,67
312,13,3,4,6,7,33,-57,4,0,124,10
312,14,4,3,6,7,42,34,6,4,166,44
312,15,4,2,10,3,-54,21,2,5,112,65
312,16,2,4,5,8,23,44,5,9,135,109
312,17,4,2,7,6,43,-76,8,3,178,33
312,18,5,2,7,6,-48,24,0,7,130,57
312,19,4,3,9,4,45,31,5,8,175,88
312,20,3,3,8,5,-65,-68,0,0,110,20
312,21,2,5,4,9,22,54,2,4,132,74
312,22,4,3,7,6,43,33,5,7,175,107
312,23,3,3,5,8,32,-65,7,2,207,42
312,24,2,4,7,6,-75,42,2,4,132,84
312,25,3,3,9,4,36,31,8,5,168,115
312,26,4,3,8,5,-56,32,2,7,112,147
312,27,3,3,5,8,32,-65,4,2,144,82
312,28,4,2,6,7,42,25,6,7,186,107
312,29,4,3,8,5,-56,32,0,9,130,139
312,30,3,3,7,6,34,-67,4,2,164,72
312,31,4,2,8,5,44,23,8,5,208,95
312,32,3,4,6,7,-67,43,1,8,141,138
312,33,3,3,3,10,30,-63,1,5,171,75
312,34,2,5,3,10,21,-45,2,0,192,30
312,35,4,3,7,6,43,33,5,3,235,63
312,36,3,4,5,8,32,44,7,7,267,107
312,37,2,4,7,6,-75,42,2,9,192,149
312,38,3,4,4,9,31,-55,3,4,223,94
312,39,3,3,7,6,34,33,7,7,257,127
312,40,4,2,8,5,-56,-77,1,0,201,50
312,41,2,4,3,10,21,46,2,6,222,96
312,42,2,5,4,9,22,-46,4,0,244,50
312,43,5,2,8,5,53,23,7,3,297,73
312,44,4,3,9,4,-55,31,2,4,242,104
312,45,2,4,5,8,23,44,5,8,265,148
312,46,2,5,5,8,23,-47,8,1,288,101
312,47,2,4,6,7,-76,43,2,4,212,144
312,48,4,3,7,6,43,33,5,7,255,177
312,49,3,3,4,9,31,-64,6,3,286,113
312,50,2,4,2,11,20,-53,6,0,306,60
312,51,4,3,8,5,-56,32,0,2,250,92
312,52,3,4,4,9,31,45,1,7,281,137
312,53,4,3,7,6,43,-67,4,0,324,70
312,54,2,5,4,9,22,54,6,4,346,124
312,55,4,2,9,4,-55,22,1,6,291,146
312,56,4,3,8,5,44,32,5,8,335,178
312,57,4,2,5,8,41,-74,6,4,376,104
312,58,5,2,8,5,53,23,9,7,429,127
312,59,2,4,5,8,-77,-56,2,1,352,71
312,60,3,3,6,7,33,34,5,5,385,105
312,61,3,3,8,5,-65,32,0,7,320,137
312,62,2,5,2,11,20,-44,0,3,340,93
312,63,3,3,7,6,34,33,4,6,374,126
312,64,5,2,10,3,55,21,9,7,429,147
312,65,3,4,6,7,-67,-57,2,0,362,90
312,66,5,2,11,2,56,20,8,0,418,110
312,67,2,5,5,8,-77,53,1,3,341,163
312,68,3,4,9,4,36,40,7,3,377,203
312,69,4,2,8,5,-56,23,1,6,321,226
312,70,4,2,8,5,44,23,5,9,365,249
312,71,4,2,8,5,44,-77,9,2,409,172
312,72,2,4,8,5,-74,41,5,3,335,213
312,73,5,3,9,4,54,31,9,4,389,244
312,74,3,3,8,5,-65,32,4,6,324,276
312,75,3,4,7,6,34,42,8,8,358,318
312,76,2,5,4,9,-78,-46,0,2,280,272
312,77,2,5,7,6,25,51,5,3,305,323
312,78,4,4,7,6,43,42,8,5,348,365
312,79,4,2,10,3,-54,21,4,6,294,386
312,80,2,4,7,6,25,42,9,8,319,428
312,81,3,3,4,9,-69,-64,0,4,250,364
312,82,4,3,7,6,43,33,3,7,293,397
312,83,5,2,8,5,53,-77,6,0,346,320
312,84,3,4,7,6,-66,42,0,2,280,362
312,85,2,4,5,8,23,44,3,6,303,406
312,86,2,4,5,8,23,-56,6,0,326,350
312,87,3,3,7,6,-66,33,0,3,260,383
312,88,2,4,5,8,23,44,3,7,283,427
312,89,3,5,5,8,32,-47,5,0,315,380
312,90,4,2,10,3,-54,21,1,1,261,401
312,91,4,2,6,7,42,25,3,6,303,426
312,92,2,5,5,8,23,53,6,9,326,479
312,93,3,4,8,5,-65,-59,1,0,261,420
312,94,2,4,5,8,23,44,4,4,284,464
312,95,4,2,8,5,44,23,8,7,328,487
312,96,3,3,5,8,-68,-65,0,2,260,422
312,97,5,2,9,4,54,22,4,4,314,444
312,98,2,4,4,9,22,45,6,9,336,489
312,99,3,4,6,7,33,-57,9,2,369,432
312,100,2,4,7,6,-75,42,4,4,294,474
312,101,5,2,9,4,54,22,8,6,348,496
312,102,4,2,10,3,-54,21,4,7,294,517
313,1,2,4,7,6,25,42,5,2,25,42
313,2,3,3,8,5,-65,32,0,4,-40,74
313,3,2,4,7,6,25,42,5,6,-15,116
313,4,3,4,6,7,33,43,8,9,18,159
313,5,3,3,6,7,-67,-66,1,3,-49,93
313,6,3,4,6,7,33,43,4,6,-16,136
313,7,4,3,7,6,43,33,7,9,27,169
313,8,5,2,7,6,52,-76,9,3,79,93
313,9,3,4,5,8,-68,44,1,7,11,137
313,10,4,3,7,6,43,-67,4,0,54,70
313,11,2,4,5,8,23,44,7,4,77,114
313,12,4,3,6,7,42,34,9,8,119,148
313,13,2,5,4,9,-78,-46,1,2,41,102
313,14,5,2,9,4,54,22,5,4,95,124
313,15,3,4,8,5,-65,41,0,5,30,165
313,16,4,3,8,5,44,32,4,7,74,197
313,17,3,4,7,6,34,42,8,9,108,239
313,18,3,3,8,5,-65,-68,3,1,43,171
313,19,3,3,8,5,35,32,8,3,78,203
313,20,4,3,7,6,-57,33,1,6,21,236
313,21,5,2,10,3,55,21,6,7,76,257
313,22,2,5,4,9,22,-46,8,1,98,211
313,23,3,4,6,7,-67,43,1,4,31,254
313,24,2,4,5,8,23,44,4,8,54,298
313,25,4,2,7,6,43,-76,7,2,97,222
313,26,6,2,10,3,-36,21,1,3,61,243
313,27,2,4,8,5,26,41,7,4,87,284
313,28,4,3,8,5,-56,32,1,6,31,316
313,29,4,2,8,5,44,23,5,9,75,339
313,30,3,4,7,6,34,-58,9,1,109,281
313,31,3,4,5,8,-68,44,1,5,41,325
313,32,3,3,9,4,36,31,7,6,77,356
313,33,3,3,8,5,-65,32,2,8,12,388
313,34,2,6,4,9,22,-37,4,1,34,351
313,35,4,3,9,4,45,31,9,2,79,382
313,36,4,3,5,8,-59,35,0,7,20,417
313,37,3,3,8,5,35,32,5,9,55,449
313,38,4,3,10,3,-54,30,1,9,1,479
313,39,3,4,8,5,35,-59,6,0,36,420
313,40,4,4,6,7,42,43,8,3,78,463
313,41,6,2,9,4,-37,22,1,5,41,485
313,42,3,3,8,5,35,32,6,7,76,517
314,1,4,4,6,7,42,43,2,3,42,43
314,2,3,5,4,9,31,54,3,7,73,97
314,3,5,3,8,5,53,32,6,9,126,129
314,4,3,3,6,7,33,-66,9,3,159,63
314,5,2,5,5,8,-77,53,2,6,82,116
314,6,3,4,4,9,31,-55,3,1,113,61
314,7,2,6,3,10,21,64,4,5,134,125
314,8,4,3,6,7,42,34,6,9,176,159
314,9,3,4,6,7,33,-57,9,2,209,102
314,10,2,5,4,9,-78,54,1,6,131,156
314,11,3,3,4,9,31,-64,2,2,162,92
314,12,2,5,3,10,21,55,3,7,183,147
314,13,3,3,9,4,36,31,9,8,219,178
314,14,6,2,10,3,-36,21,3,9,183,199
314,15,3,3,4,9,31,-64,4,5,214,135
314,16,3,4,6,7,33,43,7,8,247,178
314,17,3,4,5,8,32,-56,9,2,279,122
314,18,5,2,8,5,-47,23,2,5,232,145
314,19,3,3,8,5,35,32,7,7,267,177
314,20,4,2,10,3,-54,21,3,8,213,198
314,21,2,4,7,6,25,-58,8,0,238,140
314,22,4,3,5,8,41,35,9,5,279,175
314,23,2,4,4,9,-78,-55,1,0,201,120
314,24,4,3,9,4,45,31,6,1,246,151
314,25,2,4,6,7,-76,43,0,4,170,194
314,26,4,2,7,6,43,24,3,8,213,218
314,27,4,3,7,6,43,-67,6,1,256,151
314,28,2,6,4,9,22,63,8,4,278,214
314,29,3,4,4,9,31,45,9,9,309,259
314,30,3,3,6,7,-67,-66,2,3,242,193
314,31,3,4,7,6,34,42,6,5,276,235
314,32,3,3,8,5,-65,32,1,7,211,267
314,33,4,3,4,9,40,-64,1,3,251,203
314,34,4,2,8,5,44,23,5,6,295,226
314,35,4,3,7,6,43,33,8,9,338,259
314,36,3,3,8,5,-65,-68,3,1,273,191
314,37,3,4,4,9,31,45,4,6,304,236
314,38,3,3,5,8,32,-65,6,1,336,171
314,39,3,3,5,8,32,35,8,6,368,206
314,40,3,4,8,5,-65,41,3,7,303,247
314,41,3,3,7,6,34,-67,7,0,337,180
314,42,2,5,6,7,-76,52,1,2,261,232
314,43,3,3,4,9,31,36,2,8,292,268
314,44,2,4,6,7,24,-57,6,1,316,211
314,45,4,3,5,8,41,35,7,6,357,246
314,46,4,3,8,5,-56,32,1,8,301,278
314,47,5,2,9,4,54,-78,5,0,355,200
314,48,3,3,5,8,32,35,7,5,387,235
314,49,2,4,7,6,-75,42,2,7,312,277
314,50,3,3,4,9,31,-64,3,3,343,213
314,51,3,3,4,9,31,36,4,9,374,249
314,52,5,2,9,4,54,-78,8,1,428,171
314,53,4,2,8,5,-56,23,2,4,372,194
314,54,4,3,6,7,42,34,4,8,414,228
314,55,6,2,10,3,64,21,8,9,478,249
314,56,2,5,4,9,-78,-46,0,3,400,203
314,57,4,3,10,3,46,30,6,3,446,233
314,58,2,4,6,7,-76,43,0,6,370,276
314,59,2,5,2,11,20,-44,0,2,390,232
314,60,4,3,7,6,43,33,3,5,433,265
314,61,4,3,9,4,45,31,8,6,478,296
314,62,2,4,4,9,-78,-55,0,1,400,241
314,63,2,5,3,10,21,55,1,6,421,296
314,64,5,2,10,3,55,21,6,7,476,317
314,65,4,3,8,5,-56,32,0,9,420,349
314,66,5,2,10,3,55,-79,5,0,475,270
314,67,3,4,7,6,34,42,9,2,509,312
315,1,5,2,7,6,52,24,2,4,52,24
315,2,5,2,8,5,53,23,5,7,105,47
315,3,5,2,9,4,54,22,9,9,159,69
315,4,5,3,7,6,-48,-67,1,2,111,2
315,5,4,3,8,5,44,32,5,4,155,34
315,6,3,4,6,7,33,43,8,7,188,77
315,7,4,3,7,6,-57,-67,1,0,131,10
315,8,2,5,4,9,22,54,3,4,153,64
315,9,3,3,7,6,34,33,7,7,187,97
315,10,6,2,10,3,-36,21,1,8,151,118
315,11,4,2,9,4,45,-78,6,0,196,40
315,12,4,3,7,6,43,33,9,3,239,73
315,13,4,3,7,6,-57,33,2,6,182,106
315,14,2,6,6,7,24,61,6,7,206,167
315,15,5,2,8,5,53,-77,9,0,259,90
315,16,5,3,9,4,-46,31,3,1,213,121
315,17,4,2,9,4,45,22,8,3,258,143
315,18,3,3,7,6,-66,33,2,6,192,176
315,19,2,4,6,7,24,43,6,9,216,219
315,20,3,3,5,8,32,-65,8,4,248,154
315,21,2,4,6,7,-76,43,2,7,172,197
315,22,4,3,9,4,45,31,7,8,217,228
315,23,2,5,3,10,21,-45,8,3,238,183
315,24,3,4,5,8,-68,44,0,7,170,227
315,25,4,2,6,7,42,-75,2,2,212,152
315,26,4,2,9,4,45,22,7,4,257,174
315,27,3,3,7,6,-66,33,1,7,191,207
315,28,3,4,7,6,34,42,5,9,225,249
315,29,3,3,9,4,-64,-69,1,0,161,180
315,30,2,5,4,9,22,54,3,4,183,234
315,31,3,3,5,8,32,35,5,9,215,269
315,32,3,3,6,7,33,-66,8,3,248,203
315,33,4,2,9,4,-55,22,3,5,193,225
315,34,3,4,7,6,34,42,7,7,227,267
315,35,3,3,5,8,32,-65,9,2,259,202
315,36,3,4,5,8,-68,44,1,6,191,246
315,37,3,3,7,6,34,33,5,9,225,279
315,38,3,4,3,10,30,-54,5,5,255,225
315,39,3,3,8,5,-65,32,0,7,190,257
315,40,3,3,7,6,34,-67,4,0,224,190
315,41,3,4,7,6,34,42,8,2,258,232
315,42,4,2,8,5,-56,23,2,5,202,255
315,43,4,3,7,6,43,33,5,8,245,288
315,44,2,5,3,10,21,-45,6,3,266,243
315,45,2,4,5,8,23,44,9,7,289,287
315,46,4,3,6,7,-58,-66,1,1,231,221
315,47,2,4,7,6,25,42,6,3,256,263
315,48,2,4,6,7,-76,43,0,6,180,306
315,49,4,4,7,6,43,42,3,8,223,348
315,50,3,3,8,5,35,-68,8,0,258,280
315,51,2,4,3,10,21,46,9,6,279,326
315,52,2,4,6,7,-76,43,3,9,203,369
315,53,4,3,9,4,45,-69,8,0,248,300
315,54,2,4,3,10,21,46,9,6,269,346
315,55,3,3,6,7,-67,-66,2,0,202,280
315,56,3,4,4,9,31,45,3,5,233,325
315,57,3,4,6,7,33,43,6,8,266,368
315,58,4,2,10,3,-54,21,2,9,212,389
315,59,2,5,4,9,22,-46,4,3,234,343
315,60,2,5,6,7,24,52,8,5,258,395
315,61,4,3,6,7,-58,34,0,9,200,429
315,62,2,4,4,9,22,-55,2,4,222,374
315,63,3,3,6,7,33,34,5,8,255,408
315,64,4,3,8,5,44,-68,9,0,299,340
315,65,5,3,10,3,-45,30,4,0,254,370
315,66,4,3,9,4,45,31,9,1,299,401
315,67,3,3,8,5,-65,32,4,3,234,433
315,68,5,2,9,4,54,22,8,5,288,455
315,69,3,3,8,5,-65,32,3,7,223,487
315,70,5,2,10,3,55,21,8,8,278,508
316,1,5,2,11,2,56,20,6,0,56,20
316,2,5,2,8,5,53,23,9,3,109,43
316,3,3,4,7,6,-66,42,3,5,43,85
316,4,3,3,7,6,34,33,7,8,77,118
316,5,4,3,5,8,41,-65,8,3,118,53
316,6,2,5,2,11,20,56,8,9,138,109
316,7,5,2,9,4,-46,-78,2,1,92,31
316,8,4,4,4,9,40,45,2,6,132,76
316,9,4,2,8,5,44,23,6,9,176,99
316,10,4,3,10,3,-54,30,2,9,122,129
316,11,5,2,8,5,53,-77,5,2,175,52
316,12,2,5,2,11,20,56,5,8,195,108
316,13,2,5,3,10,21,-45,6,3,216,63
316,14,4,3,6,7,42,34,8,7,258,97
316,15,4,3,10,3,-54,30,4,7,204,127
316,16,4,3,8,5,44,32,8,9,248,159
316,17,4,3,9,4,-55,-69,3,0,193,90
316,18,4,2,10,3,46,21,9,1,239,111
316,19,4,3,5,8,-59,35,0,6,180,146
316,20,3,3,8,5,35,32,5,8,215,178
316,21,3,4,8,5,-65,41,0,9,150,219
316,22,3,3,6,7,33,-66,3,3,183,153
316,23,3,3,6,7,33,34,6,7,216,187
316,24,2,5,2,11,20,-44,6,3,236,143
316,25,5,2,9,4,-46,22,0,5,190,165
316,26,2,4,6,7,24,43,4,8,214,208
316,27,3,3,4,9,31,-64,5,4,245,144
316,28,2,5,3,10,21,55,6,9,266,199
316,29,3,4,5,8,32,-56,8,3,298,143
316,30,4,3,8,5,-56,32,2,5,242,175
316,31,2,4,7,6,25,42,7,7,267,217
316,32,5,2,11,2,-44,20,3,7,223,237
316,33,3,3,7,6,34,-67,7,0,257,170
316,34,5,2,7,6,52,24,9,4,309,194
316,35,4,3,10,3,-54,30,5,4,255,224
316,36,2,4,7,6,-75,42,0,6,180,266
316,37,4,3,8,5,44,32,4,8,224,298
316,38,4,3,9,4,45,31,9,9,269,329
316,39,4,2,7,6,-57,-76,2,3,212,253
316,40,3,4,4,9,31,45,3,8,243,298
316,41,2,4,5,8,23,-56,6,2,266,242
316,42,3,5,6,7,33,52,9,4,299,294
316,43,3,3,8,5,-65,32,4,6,234,326
316,44,2,4,5,8,23,-56,7,0,257,270
316,45,4,3,6,7,42,34,9,4,299,304
316,46,4,3,8,5,-56,32,3,6,243,336
316,47,3,4,4,9,31,-55,4,1,274,281
316,48,2,5,6,7,24,52,8,3,298,333
316,49,3,4,7,6,-66,42,2,5,232,375
316,50,3,4,7,6,34,42,6,7,266,417
316,51,3,3,8,5,-65,32,1,9,201,449
316,52,4,2,9,4,45,-78,6,1,246,371
316,53,2,4,6,7,-76,43,0,4,170,414
316,54,2,5,4,9,22,54,2,8,192,468
316,55,3,3,7,6,34,-67,6,1,226,401
316,56,3,3,6,7,33,34,9,5,259,435
316,57,3,3,7,6,-66,33,3,8,193,468
316,58,4,3,7,6,43,-67,6,1,236,401
316,59,3,4,6,7,33,43,9,4,269,444
316,60,3,3,7,6,-66,33,3,7,203,477
316,61,3,3,8,5,35,32,8,9,238,509
317,1,4,3,5,8,41,35,1,5,41,35
317,2,3,3,5,8,32,-65,3,0,73,-30
317,3,4,3,9,4,45,31,8,1,118,1
317,4,2,5,3,10,21,55,9,6,139,56
317,5,6,2,11,2,-35,20,4,6,104,76
317,6,4,3,7,6,43,33,7,9,147,109
317,7,4,3,7,6,-57,-67,0,2,90,42
317,8,3,3,5,8,32,35,2,7,122,77
317,9,4,2,6,7,42,-75,4,2,164,2
317,10,3,4,6,7,33,43,7,5,197,45
317,11,3,3,5,8,32,-65,9,0,229,-20
317,12,4,3,7,6,-57,33,2,3,172,13
317,13,2,6,3,10,21,64,3,7,193,77
317,14,2,5,6,7,24,52,7,9,217,129
317,15,4,2,11,2,-53,20,4,9,164,149
317,16,2,5,3,10,21,-45,5,4,185,104
317,17,2,5,6,7,24,52,9,6,209,156
317,18,4,3,5,8,-59,-65,0,1,150,91
317,19,3,3,5,8,32,35,2,6,182,126
317,20,2,5,4,9,22,-46,4,0,204,80
317,21,5,3,9,4,54,31,8,1,258,111
317,22,2,4,6,7,-76,43,2,4,182,154
317,23,2,4,5,8,23,44,5,8,205,198
317,24,3,4,6,7,33,-57,8,1,238,141
317,25,3,3,5,8,-68,35,0,6,170,176
317,26,5,2,7,6,52,-76,2,0,222,100
317,27,3,3,7,6,34,33,6,3,256,133
317,28,2,5,6,7,-76,52,0,5,180,185
317,29,4,3,6,7,42,34,2,9,222,219
317,30,4,2,9,4,45,-78,7,1,267,141
317,31,4,3,9,4,-55,31,2,2,212,172
317,32,3,3,6,7,33,34,5,6,245,206
317,33,2,4,5,8,23,-56,8,0,268,150
317,34,2,5,5,8,-77,53,1,3,191,203
317,35,4,3,7,6,43,33,4,6,234,236
317,36,3,3,4,9,31,-64,5,2,265,172
317,37,3,3,8,5,-65,32,0,4,200,204
317,38,3,3,4,9,31,-64,1,0,231,140
317,39,2,5,3,10,21,55,2,5,252,195
317,40,5,2,10,3,55,21,7,6,307,216
317,41,2,4,5,8,-77,-56,0,0,230,160
317,42,4,4,5,8,41,44,1,4,271,204
317,43,4,2,7,6,43,24,4,8,314,228
317,44,4,2,9,4,45,-78,9,0,359,150
317,45,2,4,6,7,-76,43,3,3,283,193
317,46,3,4,7,6,34,42,7,5,317,235
317,47,3,4,5,8,32,44,9,9,349,279
317,48,4,3,7,6,-57,-67,2,2,292,212
317,49,3,3,8,5,35,32,7,4,327,244
317,50,4,3,6,7,42,34,9,8,369,278
317,51,3,4,8,5,-65,41,4,9,304,319
317,52,5,2,8,5,53,-77,7,2,357,242
317,53,2,4,4,9,22,45,9,7,379,287
317,54,2,4,5,8,-77,-56,2,1,302,231
317,55,2,4,9,4,27,40,9,1,329,271
317,56,3,3,8,5,-65,32,4,3,264,303
317,57,3,3,7,6,34,33,8,6,298,336
317,58,2,5,5,8,-77,53,1,9,221,389
317,59,4,3,5,8,41,-65,2,4,262,324
317,60,3,4,6,7,33,43,5,7,295,367
317,61,3,3,7,6,34,-67,9,0,329,300
317,62,5,2,9,4,-46,22,3,2,283,322
317,63,5,2,9,4,54,22,7,4,337,344
317,64,3,4,5,8,32,44,9,8,369,388
317,65,4,2,10,3,-54,21,5,9,315,409
317,66,5,2,9,4,54,-78,9,1,369,331
317,67,2,4,5,8,-77,44,2,5,292,375
317,68,4,2,8,5,44,23,6,8,336,398
317,69,2,5,3,10,21,-45,7,3,357,353
317,70,3,3,7,6,-66,33,1,6,291,386
317,71,3,3,5,8,32,-65,3,1,323,321
317,72,3,4,7,6,34,42,7,3,357,363
317,73,3,3,10,3,-63,30,4,3,294,393
317,74,3,4,9,4,-64,40,0,3,230,433
317,75,2,4,4,9,22,45,2,8,252,478
317,76,4,3,9,4,45,31,7,9,297,509
318,1,5,3,7,6,52,33,2,3,52,33
318,2,4,2,5,8,41,26,3,9,93,59
318,3,3,3,8,5,35,-68,8,1,128,-9
318,4,2,5,4,9,-78,54,0,5,50,45
318,5,4,2,9,4,45,22,5,7,95,67
318,6,2,5,5,8,23,-47,8,0,118,20
318,7,3,4,6,7,-67,43,1,3,51,63
318,8,2,5,4,9,22,54,3,7,73,117
318,9,3,3,7,6,34,-67,7,0,107,50
318,10,3,4,5,8,32,44,9,4,139,94
318,11,3,4,6,7,-67,43,2,7,72,137
318,12,2,5,4,9,22,-46,4,1,94,91
318,13,6,2,8,5,62,23,6,4,156,114
318,14,4,3,8,5,-56,32,0,6,100,146
318,15,3,3,4,9,31,-64,1,2,131,82
318,16,3,4,5,8,32,44,3,6,163,126
318,17,3,3,6,7,33,-66,6,0,196,60
318,18,2,5,4,9,22,54,8,4,218,114
318,19,3,3,5,8,-68,35,0,9,150,149
318,20,3,4,4,9,31,-55,1,4,181,94
318,21,4,3,5,8,41,35,2,9,222,129
318,22,4,3,9,4,45,-69,7,0,267,60
318,23,2,4,5,8,-77,44,0,4,190,104
318,24,3,4,7,6,34,42,4,6,224,146
318,25,4,3,5,8,41,-65,5,1,265,81
318,26,4,2,8,5,44,23,9,4,309,104
318,27,2,4,3,10,-79,-54,0,0,230,50
318,28,2,4,3,10,21,46,1,6,251,96
318,29,4,2,8,5,44,23,5,9,295,119
318,30,2,5,4,9,22,-46,7,3,317,73
318,31,4,3,4,9,40,36,7,9,357,109
318,32,4,4,4,9,40,-55,7,4,397,54
318,33,2,5,4,9,22,54,9,8,419,108
318,34,3,3,7,6,-66,-67,3,1,353,41
318,35,3,4,5,8,32,44,5,5,385,85
318,36,5,2,8,5,53,23,8,8,438,108
318,37,2,5,4,9,-78,-46,0,2,360,62
318,38,4,3,8,5,44,32,4,4,404,94
318,39,5,2,7,6,52,24,6,8,456,118
318,40,3,4,8,5,-65,41,1,9,391,159
318,41,3,5,7,6,34,-49,5,0,425,110
318,42,4,4,7,6,43,42,8,2,468,152
318,43,4,3,9,4,-55,31,3,3,413,183
318,44,4,3,5,8,41,35,4,8,454,218
318,45,2,4,7,6,25,-58,9,0,479,160
318,46,3,4,5,8,-68,44,1,4,411,204
318,47,4,3,7,6,43,33,4,7,454,237
318,48,3,4,5,8,32,-56,6,1,486,181
318,49,5,3,9,4,-46,31,0,2,440,212
318,50,2,5,3,10,21,55,1,7,461,267
318,51,4,3,8,5,44,32,5,9,505,299
319,1,5,2,11,2,56,20,6,0,56,20
319,2,3,3,5,8,32,35,8,5,88,55
319,3,3,3,7,6,-66,33,2,8,22,88
319,4,4,2,10,3,46,21,8,9,68,109
319,5,3,4,6,7,-67,-57,1,2,1,52
319,6,2,6,4,9,22,63,3,5,23,115
319,7,2,4,5,8,23,44,6,9,46,159
319,8,3,3,4,9,31,-64,7,5,77,95
319,9,4,2,10,3,-54,21,3,6,23,116
319,10,4,3,7,6,43,33,6,9,66,149
319,11,3,3,8,5,-65,-68,1,1,1,81
319,12,3,3,10,3,37,30,8,1,38,111
319,13,2,5,3,10,21,55,9,6,59,166
319,14,2,4,5,8,-77,-56,2,0,-18,110
319,15,3,4,5,8,32,44,4,4,14,154
319,16,3,4,5,8,32,44,6,8,46,198
319,17,5,2,10,3,-45,21,1,9,1,219
319,18,2,4,8,5,26,-59,7,0,27,160
319,19,3,3,6,7,-67,34,0,4,-40,194
319,20,2,5,3,10,21,55,1,9,-19,249
319,21,3,3,7,6,34,-67,5,2,15,182
319,22,4,3,9,4,-55,31,0,3,-40,213
319,23,2,4,6,7,24,43,4,6,-16,256
319,24,2,4,5,8,23,-56,7,0,7,200
319,25,4,3,7,6,-57,33,0,3,-50,233
319,26,2,4,5,8,23,44,3,7,-27,277
319,27,5,2,9,4,54,22,7,9,27,299
319,28,2,5,4,9,22,-46,9,3,49,253
319,29,3,3,8,5,-65,32,4,5,-16,285
319,30,2,4,2,11,20,-53,4,2,4,232
319,31,3,4,6,7,33,43,7,5,37,275
319,32,4,2,10,3,-54,21,3,6,-17,296
319,33,5,2,8,5,53,23,6,9,36,319
319,34,3,3,5,8,32,-65,8,4,68,254
319,35,3,3,7,6,-66,33,2,7,2,287
319,36,3,3,6,7,33,-66,5,1,35,221
319,37,3,4,4,9,31,45,6,6,66,266
319,38,2,4,4,9,22,-55,8,1,88,211
319,39,2,4,4,9,-78,45,0,6,10,256
319,40,4,3,8,5,44,32,4,8,54,288
319,41,3,4,8,5,35,41,9,9,89,329
319,42,4,3,7,6,-57,-67,2,2,32,262
319,43,3,3,9,4,36,31,8,3,68,293
319,44,4,3,8,5,-56,32,2,5,12,325
319,45,3,3,9,4,36,31,8,6,48,356
319,46,3,3,9,4,-64,31,4,7,-16,387
319,47,3,3,9,4,-64,31,0,8,-80,418
319,48,4,3,7,6,43,-67,3,1,-37,351
319,49,3,4,6,7,33,43,6,4,-4,394
319,50,3,3,9,4,-64,31,2,5,-68,425
319,51,6,2,11,2,65,20,7,5,-3,445
319,52,4,3,6,7,42,34,9,9,39,479
319,53,5,2,10,3,-45,-79,4,0,-6,400
319,54,2,5,6,7,24,52,8,2,18,452
319,55,3,4,4,9,31,45,9,7,49,497
319,56,2,5,6,7,-76,52,3,9,-27,549
320,1,3,4,5,8,32,44,2,4,32,44
320,2,4,3,9,4,45,31,7,5,77,75
320,3,3,3,6,7,-67,34,0,9,10,109
320,4,3,3,6,7,33,-66,3,3,43,43
320,5,2,5,4,9,22,54,5,7,65,97
320,6,4,4,9,4,-55,40,0,7,10,137
320,7,2,4,3,10,21,-54,1,3,31,83
320,8,4,3,7,6,43,33,4,6,74,116
320,9,3,4,5,8,32,-56,6,0,106,60
320,10,4,3,7,6,43,33,9,3,149,93
320,11,2,4,4,9,-78,45,1,8,71,138
320,12,4,3,6,7,42,-66,3,2,113,72
320,13,2,4,7,6,25,42,8,4,138,114
320,14,2,5,5,8,-77,53,1,7,61,167
320,15,3,3,7,6,34,-67,5,0,95,100
320,16,4,2,8,5,44,23,9,3,139,123
320,17,3,3,8,5,-65,32,4,5,74,155
320,18,5,2,9,4,54,22,8,7,128,177
320,19,3,3,9,4,-64,31,4,8,64,208
320,20,5,3,6,7,51,-66,5,2,115,142
320,21,5,2,11,2,-44,20,1,2,71,162
320,22,3,3,3,10,30,37,1,9,101,199
320,23,3,5,5,8,32,-47,3,2,133,152
320,24,2,4,5,8,23,44,6,6,156,196
320,25,4,2,5,8,41,-74,7,2,197,122
320,26,3,3,8,5,-65,32,2,4,132,154
320,27,2,4,5,8,23,44,5,8,155,198
320,28,4,3,8,5,44,-68,9,0,199,130
320,29,4,2,9,4,-55,22,4,2,144,152
320,30,3,4,7,6,34,42,8,4,178,194
320,31,4,4,4,9,40,45,8,9,218,239
320,32,2,4,6,7,-76,-57,2,2,142,182
320,33,3,3,7,6,34,33,6,5,176,215
320,34,4,2,10,3,-54,21,2,6,122,236
320,35,2,4,5,8,23,-56,5,0,145,180
320,36,3,4,4,9,31,45,6,5,176,225
320,37,4,3,7,6,43,33,9,8,219,258
320,38,4,2,8,5,-56,-77,3,1,163,181
320,39,3,3,5,8,32,35,5,6,195,216
320,40,2,5,6,7,24,52,9,8,219,268
320,41,4,3,9,4,-55,31,4,9,164,299
320,42,4,3,5,8,41,-65,5,4,205,234
320,43,4,3,9,4,-55,31,0,5,150,265
320,44,4,3,7,6,43,33,3,8,193,298
320,45,4,3,10,3,46,30,9,8,239,328
320,46,2,4,6,7,-76,-57,3,1,163,271
320,47,3,3,7,6,34,33,7,4,197,304
320,48,3,3,5,8,32,35,9,9,229,339
320,49,2,5,6,7,-76,-48,3,1,153,291
320,50,3,3,8,5,35,32,8,3,188,323
320,51,2,4,6,7,-76,43,2,6,112,366
320,52,2,5,5,8,23,53,5,9,135,419
320,53,3,3,5,8,32,-65,7,4,167,354
320,54,2,5,3,10,21,55,8,9,188,409
320,55,5,2,9,4,-46,-78,2,1,142,331
320,56,3,4,6,7,33,43,5,4,175,374
320,57,2,5,4,9,22,54,7,8,197,428
320,58,2,4,5,8,-77,-56,0,2,120,372
320,59,4,2,9,4,45,22,5,4,165,394
320,60,4,2,9,4,-55,22,0,6,110,416
320,61,4,3,6,7,42,-66,2,0,152,350
320,62,3,4,6,7,33,43,5,3,185,393
320,63,4,2,5,8,41,26,6,9,226,419
320,64,3,4,6,7,33,-57,9,2,259,362
320,65,3,3,7,6,-66,33,3,5,193,395
320,66,5,2,9,4,54,22,7,7,247,417
320,67,2,6,4,9,22,-37,9,0,269,380
320,68,2,4,5,8,-77,44,2,4,192,424
320,69,4,3,8,5,44,32,6,6,236,456
320,70,4,2,9,4,-55,22,1,8,181,478
320,71,5,2,11,2,56,20,7,8,237,498
320,72,3,5,5,8,32,-47,9,1,269,451
320,73,3,3,7,6,-66,33,3,4,203,484
320,74,2,5,2,11,20,-44,3,0,223,440
320,75,4,3,4,9,40,36,3,6,263,476
320,76,4,3,5,8,41,-65,4,1,304,411
320,77,3,3,8,5,35,32,9,3,339,443
320,78,3,4,7,6,-66,42,3,5,273,485
320,79,4,3,7,6,43,33,6,8,316,518
321,1,4,3,5,8,41,35,1,5,41,35
321,2,2,4,4,9,22,-55,3,0,63,-20
321,3,4,2,6,7,42,25,5,5,105,5
321,4,5,2,6,7,51,-75,6,0,156,-70
321,5,3,3,6,7,33,34,9,4,189,-36
321,6,3,4,5,8,-68,44,1,8,121,8
321,7,3,4,5,8,32,-56,3,2,153,-48
321,8,2,4,5,8,23,44,6,6,176,-4
321,9,4,3,6,7,42,-66,8,0,218,-70
321,10,3,3,5,8,-68,35,0,5,150,-35
321,11,2,4,7,6,25,42,5,7,175,7
321,12,3,4,6,7,33,-57,8,0,208,-50
321,13,4,2,8,5,-56,23,2,3,152,-27
321,14,4,2,9,4,45,22,7,5,197,-5
321,15,4,3,6,7,42,34,9,9,239,29
321,16,3,4,5,8,-68,-56,1,3,171,-27
321,17,2,4,5,8,23,44,4,7,194,17
321,18,3,4,5,8,32,-56,6,1,226,-39
321,19,4,2,8,5,-56,23,0,4,170,-16
321,20,3,3,8,5,35,32,5,6,205,16
321,21,3,5,7,6,34,51,9,7,239,67
321,22,2,4,7,6,-75,42,4,9,164,109
321,23,4,2,10,3,-54,-79,0,0,110,30
321,24,4,3,8,5,44,32,4,2,154,62
321,25,3,4,6,7,33,43,7,5,187,105
321,26,4,3,8,5,-56,32,1,7,131,137
321,27,3,4,6,7,33,-57,4,0,164,80
321,28,3,3,7,6,34,33,8,3,198,113
321,29,4,2,5,8,41,26,9,9,239,139
321,30,4,3,10,3,-54,30,5,9,185,169
321,31,2,4,8,5,-74,-59,1,0,111,110
321,32,2,5,3,10,21,55,2,5,132,165
321,33,4,2,10,3,46,21,8,6,178,186
321,34,4,3,7,6,-57,33,1,9,121,219
321,35,4,3,7,6,43,-67,4,2,164,152
321,36,3,3,7,6,34,33,8,5,198,185
321,37,3,4,5,8,-68,44,0,9,130,229
321,38,4,3,8,5,44,-68,4,1,174,161
321,39,3,4,6,7,33,43,7,4,207,204
321,40,3,3,8,5,-65,32,2,6,142,236
321,41,2,4,4,9,22,-55,4,1,164,181
321,42,2,5,5,8,23,53,7,4,187,234
321,43,5,2,9,4,-46,22,1,6,141,256
321,44,3,3,9,4,36,31,7,7,177,287
321,45,3,4,8,5,-65,41,2,8,112,328
321,46,2,5,4,9,22,-46,4,2,134,282
321,47,3,3,5,8,32,35,6,7,166,317
321,48,2,5,3,10,21,-45,7,2,187,272
321,49,5,2,10,3,-45,21,2,3,142,293
321,50,4,2,9,4,45,22,7,5,187,315
321,51,3,4,3,10,30,-54,7,1,217,261
321,52,4,3,9,4,-55,31,2,2,162,292
321,53,2,4,4,9,22,45,4,7,184,337
321,54,5,2,10,3,55,21,9,8,239,358
321,55,2,5,3,10,-79,-45,0,3,160,313
321,56,4,3,9,4,45,31,5,4,205,344
321,57,3,3,6,7,33,34,8,8,238,378
321,58,4,3,8,5,-56,-68,2,0,182,310
321,59,4,3,7,6,43,33,5,3,225,343
321,60,5,3,8,5,53,32,8,5,278,375
321,61,3,3,4,9,31,-64,9,1,309,311
321,62,2,4,3,10,-79,46,0,7,230,357
321,63,2,4,3,10,21,-54,1,3,251,303
321,64,2,6,3,10,21,64,2,7,272,367
321,65,5,2,8,5,53,-77,5,0,325,290
321,66,2,4,6,7,24,43,9,3,349,333
321,67,4,4,6,7,-58,43,1,6,291,376
321,68,3,3,9,4,36,31,7,7,327,407
321,69,4,3,6,7,42,-66,9,1,369,341
321,70,4,2,7,6,-57,24,2,5,312,365
321,71,2,6,3,10,21,64,3,9,333,429
321,72,4,3,9,4,45,-69,8,0,378,360
321,73,4,2,6,7,-58,25,0,5,320,385
321,74,2,5,2,11,20,-44,0,1,340,341
321,75,3,3,7,6,34,33,4,4,374,374
321,76,3,3,6,7,33,34,7,8,407,408
321,77,6,2,10,3,-36,21,1,9,371,429
321,78,3,4,7,6,34,-58,5,1,405,371
321,79,2,5,4,9,22,54,7,5,427,425
321,80,4,3,9,4,-55,31,2,6,372,456
321,81,4,3,7,6,43,33,5,9,415,489
321,82,2,5,4,9,22,-46,7,3,437,443
321,83,3,4,6,7,-67,43,0,6,370,486
321,84,3,3,5,8,32,-65,2,1,402,421
321,85,4,2,6,7,42,25,4,6,444,446
321,86,3,4,7,6,34,42,8,8,478,488
321,87,2,4,5,8,-77,-56,1,2,401,432
321,88,3,4,5,8,32,44,3,6,433,476
321,89,3,3,7,6,34,33,7,9,467,509
322,1,3,4,6,7,33,43,3,3,33,43
322,2,4,2,8,5,44,23,7,6,77,66
322,3,3,3,4,9,31,-64,8,2,108,2
322,4,2,4,5,8,-77,44,1,6,31,46
322,5,3,4,6,7,33,43,4,9,64,89
322,6,3,4,8,5,35,-59,9,0,99,30
322,7,5,2,10,3,-45,21,4,1,54,51
322,8,4,3,10,3,-54,30,0,1,0,81
322,9,4,2,9,4,45,22,5,3,45,103
322,10,3,4,6,7,33,43,8,6,78,146
322,11,3,4,7,6,-66,42,2,8,12,188
322,12,4,4,5,8,41,-56,3,2,53,132
322,13,5,2,9,4,54,22,7,4,107,154
322,14,4,3,6,7,42,34,9,8,149,188
322,15,5,3,9,4,-46,31,3,9,103,219
322,16,4,3,9,4,45,-69,8,0,148,150
322,17,3,4,5,8,-68,44,0,4,80,194
322,18,3,3,9,4,36,31,6,5,116,225
322,19,4,3,7,6,43,33,9,8,159,258
322,20,2,4,5,8,-77,-56,2,2,82,202
322,21,3,5,3,10,30,55,2,7,112,257
322,22,5,2,10,3,55,21,7,8,167,278
322,23,3,3,5,8,32,-65,9,3,199,213
322,24,5,2,9,4,-46,22,3,5,153,235
322,25,5,2,9,4,54,22,7,7,207,257
322,26,2,4,3,10,21,-54,8,3,228,203
322,27,3,4,6,7,-67,43,1,6,161,246
322,28,3,3,8,5,35,32,6,8,196,278
322,29,4,3,8,5,-56,-68,0,0,140,210
322,30,2,5,6,7,24,52,4,2,164,262
322,31,3,3,7,6,34,33,8,5,198,295
322,32,3,3,9,4,-64,31,4,6,134,326
322,33,2,4,4,9,22,-55,6,1,156,271
322,34,4,4,6,7,42,43,8,4,198,314
322,35,2,4,4,9,-78,45,0,9,120,359
322,36,3,3,7,6,34,-67,4,2,154,292
322,37,3,3,6,7,33,34,7,6,187,326
322,38,3,3,8,5,-65,32,2,8,122,358
322,39,3,4,6,7,33,-57,5,1,155,301
322,40,4,3,7,6,43,33,8,4,198,334
322,41,4,2,9,4,-55,22,3,6,143,356
322,42,3,3,9,4,36,31,9,7,179,387
322,43,2,5,5,8,-77,-47,2,0,102,340
322,44,3,4,4,9,31,45,3,5,133,385
322,45,5,2,9,4,54,22,7,7,187,407
322,46,2,4,7,6,-75,42,2,9,112,449
322,47,5,2,11,2,56,20,8,9,168,469
322,48,4,3,9,4,-55,-69,3,0,113,400
322,49,3,4,5,8,32,44,5,4,145,444
322,50,3,3,6,7,33,34,8,8,178,478
322,51,3,4,4,9,31,-55,9,3,209,423
322,52,4,3,5,8,-59,35,0,8,150,458
322,53,3,3,5,8,32,-65,2,3,182,393
322,54,4,2,7,6,43,24,5,7,225,417
322,55,5,3,6,7,51,-66,6,1,276,351
322,56,2,4,4,9,22,45,8,6,298,396
322,57,4,2,8,5,-56,23,2,9,242,419
322,58,4,4,6,7,42,-57,4,2,284,362
322,59,3,3,6,7,33,34,7,6,317,396
322,60,3,3,5,8,32,-65,9,1,349,331
322,61,2,4,3,10,-79,46,0,7,270,377
322,62,2,5,6,7,24,52,4,9,294,429
322,63,2,5,7,6,25,-49,9,0,319,380
322,64,4,3,8,5,-56,32,3,2,263,412
322,65,4,3,5,8,41,35,4,7,304,447
322,66,2,4,4,9,22,-55,6,2,326,392
322,67,4,3,7,6,43,33,9,5,369,425
322,68,2,5,2,11,20,-44,9,1,389,381
322,69,4,2,8,5,-56,23,3,4,333,404
322,70,3,3,7,6,34,33,7,7,367,437
322,71,4,3,7,6,-57,-67,0,0,310,370
322,72,4,2,7,6,43,24,3,4,353,394
322,73,3,4,6,7,33,43,6,7,386,437
322,74,3,4,6,7,33,-57,9,0,419,380
322,75,4,2,7,6,-57,24,2,4,362,404
322,76,4,3,9,4,45,31,7,5,407,435
322,77,5,2,9,4,-46,22,1,7,361,457
322,78,3,4,4,9,31,-55,2,2,392,402
322,79,4,3,9,4,45,31,7,3,437,433
322,80,2,5,5,8,-77,53,0,6,360,486
322,81,3,3,7,6,34,33,4,9,394,519
323,1,2,4,4,9,22,45,2,5,22,45
323,2,4,3,6,7,42,34,4,9,64,79
323,3,3,4,5,8,32,-56,6,3,96,23
323,4,2,4,6,7,-76,43,0,6,20,66
323,5,3,3,6,7,33,-66,3,0,53,0
323,6,3,3,9,4,36,31,9,1,89,31
323,7,3,4,5,8,-68,44,1,5,21,75
323,8,3,4,7,6,34,42,5,7,55,117
323,9,5,2,9,4,54,22,9,9,109,139
323,10,2,5,7,6,-75,-49,4,0,34,90
323,11,3,3,6,7,33,34,7,4,67,124
323,12,3,4,8,5,-65,41,2,5,2,165
323,13,4,2,8,5,44,23,6,8,46,188
323,14,4,3,7,6,43,-67,9,1,89,121
323,15,3,3,5,8,-68,35,1,6,21,156
323,16,4,3,9,4,45,31,6,7,66,187
323,17,5,3,9,4,-46,31,0,8,20,218
323,18,5,2,8,5,53,-77,3,1,73,141
323,19,3,3,6,7,33,34,6,5,106,175
323,20,2,4,5,8,23,44,9,9,129,219
323,21,5,2,7,6,-48,-76,1,3,81,143
323,22,3,3,7,6,34,33,5,6,115,176
323,23,3,3,9,4,-64,31,1,7,51,207
323,24,4,3,8,5,44,32,5,9,95,239
323,25,3,5,4,9,31,-46,6,3,126,193
323,26,4,3,6,7,42,34,8,7,168,227
323,27,2,5,2,11,20,-44,8,3,188,183
323,28,4,2,9,4,-55,22,3,5,133,205
323,29,4,4,7,6,43,42,6,7,176,247
323,30,3,5,6,7,33,52,9,9,209,299
323,31,4,3,6,7,-58,-66,1,3,151,233
323,32,4,2,7,6,43,24,4,7,194,257
323,33,3,3,9,4,-64,31,0,8,130,288
323,34,4,3,10,3,46,30,6,8,176,318
323,35,4,3,7,6,43,-67,9,1,219,251
323,36,4,3,5,8,-59,35,0,6,160,286
323,37,2,6,3,10,21,-36,1,0,181,250
323,38,4,3,5,8,41,35,2,5,222,285
323,39,5,2,10,3,55,21,7,6,277,306
323,40,3,3,8,5,-65,32,2,8,212,338
323,41,4,2,8,5,44,-77,6,1,256,261
323,42,3,3,7,6,-66,33,0,4,190,294
323,43,3,3,5,8,32,35,2,9,222,329
323,44,3,3,6,7,33,-66,5,3,255,263
323,45,3,3,9,4,-64,31,1,4,191,294
323,46,2,4,6,7,24,43,5,7,215,337
323,47,3,3,8,5,-65,32,0,9,150,369
323,48,3,3,6,7,33,-66,3,3,183,303
323,49,4,3,5,8,41,35,4,8,224,338
323,50,2,4,4,9,22,-55,6,3,246,283
323,51,2,4,5,8,23,44,9,7,269,327
323,52,3,4,4,9,-69,-55,0,2,200,272
323,53,2,4,4,9,22,45,2,7,222,317
323,54,2,4,6,7,24,-57,6,0,246,260
323,55,2,6,4,9,22,63,8,3,268,323
323,56,4,2,9,4,-55,22,3,5,213,345
323,57,3,3,9,4,36,31,9,6,249,376
323,58,4,2,9,4,-55,22,4,8,194,398
323,59,3,3,4,9,31,-64,5,4,225,334
323,60,3,3,9,4,-64,31,1,5,161,365
323,61,4,3,6,7,42,34,3,9,203,399
323,62,2,6,3,10,21,-36,4,3,224,363
323,63,4,3,6,7,42,34,6,7,266,397
323,64,3,3,5,8,32,-65,8,2,298,332
323,65,4,2,10,3,-54,21,4,3,244,353
323,66,2,5,5,8,23,53,7,6,267,406
323,67,4,3,7,6,-57,33,0,9,210,439
323,68,6,2,11,2,65,20,5,9,275,459
323,69,4,3,6,7,42,-66,7,3,317,393
323,70,4,4,8,5,-56,41,1,4,261,434
323,71,2,4,7,6,25,42,6,6,286,476
323,72,4,2,8,5,-56,23,0,9,230,499
323,73,4,2,5,8,41,-74,1,5,271,425
323,74,2,5,3,10,21,-45,2,0,292,380
323,75,3,3,6,7,33,34,5,4,325,414
323,76,3,3,6,7,33,34,8,8,358,448
323,77,3,3,6,7,-67,-66,1,2,291,382
323,78,3,4,4,9,31,45,2,7,322,427
323,79,4,2,8,5,44,-77,6,0,366,350
323,80,2,5,4,9,22,54,8,4,388,404
323,81,4,2,6,7,-58,25,0,9,330,429
323,82,2,5,5,8,23,-47,3,2,353,382
323,83,4,3,8,5,44,32,7,4,397,414
323,84,4,3,5,8,41,35,8,9,438,449
323,85,3,4,7,6,-66,-58,2,1,372,391
323,86,3,3,8,5,35,32,7,3,407,423
323,87,4,2,7,6,-57,24,0,7,350,447
323,88,2,5,5,8,23,-47,3,0,373,400
323,89,4,2,7,6,43,24,6,4,416,424
323,90,3,4,4,9,31,45,7,9,447,469
323,91,3,3,7,6,-66,-67,1,2,381,402
323,92,2,6,3,10,21,64,2,6,402,466
323,93,5,2,10,3,55,21,7,7,457,487
323,94,3,3,7,6,-66,-67,1,0,391,420
323,95,5,2,8,5,53,23,4,3,444,443
323,96,2,4,7,6,25,42,9,5,469,485
323,97,3,3,7,6,-66,33,3,8,403,518
324,1,2,5,4,9,22,54,2,4,22,54
324,2,3,4,5,8,32,44,4,8,54,98
324,3,5,2,9,4,54,-78,8,0,108,20
324,4,2,5,6,7,-76,52,2,2,32,72
324,5,4,2,10,3,46,21,8,3,78,93
324,6,3,4,5,8,-68,44,0,7,10,137
324,7,4,2,8,5,44,-77,4,0,54,60
324,8,3,3,9,4,-64,31,0,1,-10,91
324,9,3,3,5,8,32,35,2,6,22,126
324,10,4,2,7,6,43,-76,5,0,65,50
324,11,4,3,7,6,43,33,8,3,108,83
324,12,3,3,7,6,-66,33,2,6,42,116
324,13,2,5,2,11,20,-44,2,2,62,72
324,14,4,2,9,4,45,22,7,4,107,94
324,15,3,4,6,7,-67,43,0,7,40,137
324,16,3,4,9,4,36,40,6,7,76,177
324,17,5,2,7,6,52,-76,8,1,128,101
324,18,3,4,6,7,-67,43,1,4,61,144
324,19,5,2,9,4,54,22,5,6,115,166
324,20,4,2,10,3,-54,21,1,7,61,187
324,21,3,4,7,6,34,42,5,9,95,229
324,22,2,5,5,8,23,-47,8,2,118,182
324,23,5,2,8,5,-47,23,1,5,71,205
324,24,2,5,5,8,23,53,4,8,94,258
324,25,4,3,5,8,41,-65,5,3,135,193
324,26,5,2,11,2,-44,20,1,3,91,213
324,27,4,2,9,4,45,22,6,5,136,235
324,28,3,4,7,6,-66,42,0,7,70,277
324,29,2,5,3,10,21,-45,1,2,91,232
324,30,3,3,7,6,34,33,5,5,125,265
324,31,4,3,5,8,41,-65,6,0,166,200
324,32,3,3,6,7,33,34,9,4,199,234
324,33,4,2,9,4,-55,22,4,6,144,256
324,34,2,5,3,10,21,-45,5,1,165,211
324,35,3,3,5,8,32,35,7,6,197,246
324,36,4,3,6,7,42,-66,9,0,239,180
324,37,2,5,3,10,-79,55,0,5,160,235
324,38,2,5,7,6,25,51,5,6,185,286
324,39,5,3,8,5,53,32,8,8,238,318
324,40,3,3,6,7,-67,-66,1,2,171,252
324,41,3,4,5,8,32,44,3,6,203,296
324,42,2,4,6,7,24,43,7,9,227,339
324,43,4,3,6,7,42,-66,9,3,269,273
324,44,3,3,6,7,-67,34,2,7,202,307
324,45,2,5,3,10,21,-45,3,2,223,262
324,46,4,2,7,6,43,24,6,6,266,286
324,47,3,4,5,8,32,-56,8,0,298,230
324,48,5,2,11,2,-44,20,4,0,254,250
324,49,3,3,5,8,32,35,6,5,286,285
324,50,2,4,4,9,22,-55,8,0,308,230
324,51,5,2,10,3,-45,21,3,1,263,251
324,52,4,3,8,5,44,32,7,3,307,283
324,53,3,3,6,7,-67,34,0,7,240,317
324,54,5,2,9,4,54,22,4,9,294,339
324,55,4,2,9,4,45,-78,9,1,339,261
324,56,5,3,9,4,-46,31,3,2,293,292
324,57,3,4,4,9,31,45,4,7,324,337
324,58,4,3,6,7,42,-66,6,1,366,271
324,59,4,2,10,3,-54,21,2,2,312,292
324,60,4,3,10,3,46,30,8,2,358,322
324,61,4,2,8,5,-56,23,2,5,302,345
324,62,4,3,9,4,45,31,7,6,347,376
324,63,5,2,9,4,-46,22,1,8,301,398
324,64,5,2,8,5,53,-77,4,1,354,321
324,65,3,3,4,9,31,36,5,7,385,357
324,66,4,2,8,5,44,-77,9,0,429,280
324,67,4,3,9,4,-55,31,4,1,374,311
324,68,4,2,7,6,43,24,7,5,417,335
324,69,5,2,10,3,-45,21,2,6,372,356
324,70,3,4,7,6,34,42,6,8,406,398
324,71,3,4,3,10,30,-54,6,4,436,344
324,72,3,4,5,8,32,44,8,8,468,388
324,73,2,5,4,9,-78,-46,0,2,390,342
324,74,6,2,10,3,64,21,4,3,454,363
324,75,2,4,7,6,25,42,9,5,479,405
324,76,5,2,10,3,-45,21,4,6,434,426
324,77,2,4,6,7,24,43,8,9,458,469
324,78,3,3,7,6,-66,-67,2,2,392,402
324,79,3,3,6,7,33,34,5,6,425,436
324,80,3,4,5,8,32,-56,7,0,457,380
324,81,3,4,8,5,-65,41,2,1,392,421
324,82,2,4,7,6,25,42,7,3,417,463
324,83,3,3,8,5,-65,32,2,5,352,495
324,84,4,2,10,3,46,21,8,6,398,516
325,1,5,2,8,5,53,23,3,3,53,23
325,2,3,5,6,7,33,52,6,5,86,75
325,3,5,2,7,6,52,24,8,9,138,99
325,4,4,2,9,4,-55,-78,3,1,83,21
325,5,3,4,4,9,31,45,4,6,114,66
325,6,4,2,9,4,45,22,9,8,159,88
325,7,3,4,6,7,-67,-57,2,1,92,31
325,8,2,5,3,10,21,55,3,6,113,86
325,9,5,2,8,5,53,23,6,9,166,109
325,10,3,3,5,8,32,-65,8,4,198,44
325,11,4,3,6,7,-58,34,0,8,140,78
325,12,3,3,5,8,32,-65,2,3,172,13
325,13,4,2,7,6,43,24,5,7,215,37
325,14,5,2,10,3,-45,21,0,8,170,58
325,15,3,4,6,7,33,-57,3,1,203,1
325,16,3,4,3,10,30,46,3,7,233,47
325,17,3,3,8,5,35,32,8,9,268,79
325,18,3,4,5,8,-68,-56,0,3,200,23
325,19,2,5,2,11,20,56,0,9,220,79
325,20,3,3,7,6,34,-67,4,2,254,12
325,21,3,3,8,5,35,32,9,4,289,44
325,22,2,4,4,9,-78,45,1,9,211,89
325,23,4,2,9,4,45,-78,6,1,256,11
325,24,4,2,6,7,42,25,8,6,298,36
325,25,2,5,5,8,-77,53,1,9,221,89
325,26,4,3,5,8,41,-65,2,4,262,24
325,27,4,3,6,7,42,34,4,8,304,58
325,28,4,2,9,4,45,-78,9,0,349,-20
325,29,3,3,5,8,-68,35,1,5,281,15
325,30,4,4,8,5,44,41,5,6,325,56
325,31,3,3,5,8,32,-65,7,1,357,-9
325,32,5,2,9,4,-46,22,1,3,311,13
325,33,3,3,7,6,34,33,5,6,345,46
325,34,5,2,9,4,54,22,9,8,399,68
325,35,3,4,4,9,-69,-55,0,3,330,13
325,36,2,4,7,6,25,42,5,5,355,55
325,37,4,3,9,4,-55,31,0,6,300,86
325,38,5,2,10,3,55,21,5,7,355,107
325,39,4,3,6,7,42,-66,7,1,397,41
325,40,4,2,9,4,-55,22,2,3,342,63
325,41,4,2,10,3,46,21,8,4,388,84
325,42,4,3,9,4,-55,31,3,5,333,115
325,43,4,3,9,4,45,31,8,6,378,146
325,44,5,2,7,6,-48,-76,0,0,330,70
325,45,4,3,8,5,44,32,4,2,374,102
325,46,3,3,7,6,34,33,8,5,408,135
325,47,2,5,5,8,-77,53,1,8,331,188
325,48,2,5,4,9,22,-46,3,2,353,142
325,49,3,4,6,7,33,43,6,5,386,185
325,50,2,5,5,8,23,53,9,8,409,238
325,51,4,2,7,6,-57,-76,2,2,352,162
325,52,3,3,4,9,31,36,3,8,383,198
325,53,4,2,7,6,43,-76,6,2,426,122
325,54,2,4,4,9,22,45,8,7,448,167
325,55,2,5,6,7,-76,52,2,9,372,219
325,56,3,3,10,3,37,30,9,9,409,249
325,57,3,5,5,8,-68,-47,1,2,341,202
325,58,3,4,5,8,32,44,3,6,373,246
325,59,4,3,6,7,42,-66,5,0,415,180
325,60,4,3,7,6,43,33,8,3,458,213
325,61,3,3,4,9,31,36,9,9,489,249
325,62,3,4,6,7,-67,-57,2,2,422,192
325,63,4,3,8,5,44,32,6,4,466,224
325,64,3,4,5,8,32,44,8,8,498,268
325,65,3,3,7,6,-66,-67,2,1,432,201
325,66,3,4,6,7,33,43,5,4,465,244
325,67,4,4,7,6,43,42,8,6,508,286
326,1,3,3,5,8,32,35,2,5,32,35
326,2,4,2,5,8,41,-74,3,1,73,-39
326,3,2,4,5,8,23,44,6,5,96,5
326,4,4,3,10,3,-54,30,2,5,42,35
326,5,3,4,5,8,32,44,4,9,74,79
326,6,4,3,6,7,42,-66,6,3,116,13
326,7,2,5,5,8,23,53,9,6,139,66
326,8,3,3,6,7,-67,-66,2,0,72,0
326,9,3,3,5,8,32,35,4,5,104,35
326,10,5,2,8,5,53,23,7,8,157,58
326,11,3,3,5,8,32,-65,9,3,189,-7
326,12,5,2,8,5,-47,23,2,6,142,16
326,13,5,2,10,3,55,21,7,7,197,37
326,14,4,3,5,8,41,-65,8,2,238,-28
326,15,3,4,5,8,-68,44,0,6,170,16
326,16,4,2,8,5,44,23,4,9,214,39
326,17,2,4,4,9,22,-55,6,4,236,-16
326,18,4,3,8,5,-56,32,0,6,180,16
326,19,2,5,5,8,23,53,3,9,203,69
326,20,4,3,8,5,44,-68,7,1,247,1
326,21,3,5,4,9,31,54,8,5,278,55
326,22,4,2,9,4,-55,22,3,7,223,77
326,23,3,4,8,5,35,41,8,8,258,118
326,24,3,4,5,8,-68,-56,0,2,190,62
326,25,4,2,7,6,43,24,3,6,233,86
326,26,3,3,7,6,34,33,7,9,267,119
326,27,2,5,1,12,-20,-43,7,6,247,76
326,28,4,2,8,5,-56,23,1,9,191,99
326,29,4,2,8,5,44,-77,5,2,235,22
326,30,2,5,5,8,23,53,8,5,258,75
326,31,3,4,6,7,-67,43,1,8,191,118
326,32,3,4,7,6,34,-58,5,0,225,60
326,33,2,4,6,7,24,43,9,3,249,103
326,34,2,4,6,7,-76,43,3,6,173,146
326,35,3,3,4,9,31,-64,4,2,204,82
326,36,4,3,10,3,-54,30,0,2,150,112
326,37,4,3,8,5,44,32,4,4,194,144
326,38,2,5,3,10,21,55,5,9,215,199
326,39,4,3,6,7,42,-66,7,3,257,133
326,40,4,3,6,7,42,34,9,7,299,167
326,41,3,4,6,7,-67,-57,2,0,232,110
326,42,5,2,8,5,53,23,5,3,285,133
326,43,4,3,5,8,41,35,6,8,326,168
326,44,4,3,7,6,43,-67,9,1,369,101
326,45,4,2,7,6,-57,24,2,5,312,125
326,46,5,3,9,4,54,31,6,6,366,156
326,47,5,2,8,5,53,23,9,9,419,179
326,48,5,2,8,5,-47,-77,2,2,372,102
326,49,3,4,6,7,33,43,5,5,405,145
326,50,4,3,10,3,-54,30,1,5,351,175
326,51,4,2,9,4,45,22,6,7,396,197
326,52,4,2,10,3,-54,21,2,8,342,218
326,53,3,3,10,3,37,30,9,8,379,248
326,54,3,4,6,7,-67,-57,2,1,312,191
326,55,3,3,9,4,36,31,8,2,348,222
326,56,3,4,6,7,-67,43,1,5,281,265
326,57,5,2,9,4,54,22,5,7,335,287
326,58,2,5,5,8,23,-47,8,0,358,240
326,59,4,3,4,9,40,36,8,6,398,276
326,60,2,5,5,8,-77,53,1,9,321,329
326,61,4,3,9,4,45,-69,6,0,366,260
326,62,4,2,5,8,41,26,7,6,407,286
326,63,2,4,5,8,-77,-56,0,0,330,230
326,64,3,4,8,5,35,41,5,1,365,271
326,65,3,4,7,6,34,42,9,3,399,313
326,66,3,3,5,8,-68,35,1,8,331,348
326,67,3,3,4,9,31,-64,2,4,362,284
326,68,3,4,4,9,31,45,3,9,393,329
326,69,4,2,7,6,43,-76,6,3,436,253
326,70,3,3,4,9,31,36,7,9,467,289
326,71,5,2,9,4,-46,-78,1,1,421,211
326,72,5,2,8,5,53,23,4,4,474,234
326,73,2,4,7,6,25,42,9,6,499,276
326,74,4,3,9,4,-55,31,4,7,444,307
326,75,4,2,7,6,43,-76,7,1,487,231
326,76,3,4,6,7,-67,43,0,4,420,274
326,77,4,3,6,7,42,34,2,8,462,308
326,78,3,4,7,6,34,-58,6,0,496,250
326,79,2,4,4,9,22,45,8,5,518,295
327,1,3,4,9,4,36,40,6,0,36,40
327,2,2,5,5,8,23,53,9,3,59,93
327,3,2,4,7,6,-75,42,4,5,-16,135
327,4,3,4,4,9,31,-55,5,0,15,80
327,5,3,4,7,6,34,42,9,2,49,122
327,6,4,2,10,3,-54,21,5,3,-5,143
327,7,3,4,7,6,34,42,9,5,29,185
327,8,3,4,3,10,30,-54,9,1,59,131
327,9,3,4,8,5,-65,41,4,2,-6,172
327,10,2,5,4,9,22,54,6,6,16,226
327,11,3,3,6,7,33,-66,9,0,49,160
327,12,3,5,7,6,-66,51,3,1,-17,211
327,13,3,4,5,8,32,44,5,5,15,255
327,14,2,4,6,7,24,43,9,8,39,298
327,15,3,4,4,9,-69,-55,0,3,-30,243
327,16,3,3,6,7,33,34,3,7,3,277
327,17,2,5,5,8,23,-47,6,0,26,230
327,18,5,2,9,4,-46,22,0,2,-20,252
327,19,3,5,5,8,32,53,2,5,12,305
327,20,3,3,8,5,35,32,7,7,47,337
327,21,3,3,5,8,32,-65,9,2,79,272
327,22,2,4,2,11,20,47,9,9,99,319
327,23,3,3,9,4,-64,-69,5,0,35,250
327,24,3,4,7,6,34,42,9,2,69,292
327,25,2,4,6,7,-76,43,3,5,-7,335
327,26,5,2,11,2,56,20,9,5,49,355
327,27,4,3,9,4,-55,31,4,6,-6,386
327,28,2,5,4,9,22,-46,6,0,16,340
327,29,4,2,7,6,43,24,9,4,59,364
327,30,2,4,4,9,-78,45,1,9,-19,409
327,31,5,2,10,3,55,-79,6,0,36,330
327,32,3,3,7,6,-66,33,0,3,-30,363
327,33,2,5,7,6,25,51,5,4,-5,414
327,34,3,3,9,4,-64,31,1,5,-69,445
327,35,4,2,7,6,43,24,4,9,-26,469
327,36,3,3,6,7,33,-66,7,3,7,403
327,37,4,2,8,5,-56,23,1,6,-49,426
327,38,3,4,6,7,33,43,4,9,-16,469
327,39,4,3,6,7,42,-66,6,3,26,403
327,40,3,3,8,5,-65,32,1,5,-39,435
327,41,4,3,6,7,42,34,3,9,3,469
327,42,3,3,5,8,32,-65,5,4,35,404
327,43,4,2,5,8,41,-74,6,0,76,330
327,44,3,3,9,4,-64,31,2,1,12,361
327,45,2,4,6,7,24,43,6,4,36,404
327,46,3,3,7,6,-66,33,0,7,-30,437
327,47,3,4,6,7,33,-57,3,0,3,380
327,48,5,2,9,4,54,22,7,2,57,402
327,49,3,3,6,7,-67,34,0,6,-10,436
327,50,4,2,10,3,46,21,6,7,36,457
327,51,5,3,7,6,52,-67,8,0,88,390
327,52,4,2,7,6,-57,24,1,4,31,414
327,53,5,3,9,4,54,31,5,5,85,445
327,54,4,3,8,5,44,32,9,7,129,477
327,55,3,3,10,3,-63,30,6,7,66,507
328,1,5,2,8,5,53,23,3,3,53,23
328,2,2,5,5,8,23,53,6,6,76,76
328,3,4,4,5,8,41,-56,7,0,117,20
328,4,3,4,9,4,-64,40,3,0,53,60
328,5,4,2,7,6,43,24,6,4,96,84
328,6,4,3,8,5,-56,32,0,6,40,116
328,7,3,4,5,8,32,-56,2,0,72,60
328,8,3,4,6,7,33,43,5,3,105,103
328,9,4,2,9,4,-55,22,0,5,50,125
328,10,3,3,8,5,35,32,5,7,85,157
328,11,2,4,6,7,24,-57,9,0,109,100
328,12,4,3,9,4,-55,31,4,1,54,131
328,13,5,2,11,2,-44,20,0,1,10,151
328,14,2,4,6,7,24,43,4,4,34,194
328,15,4,3,4,9,40,-64,4,0,74,130
328,16,4,3,7,6,43,33,7,3,117,163
328,17,6,2,10,3,-36,21,1,4,81,184
328,18,3,3,8,5,35,32,6,6,116,216
328,19,2,4,6,7,-76,43,0,9,40,259
328,20,3,3,5,8,32,-65,2,4,72,194
328,21,6,2,7,6,61,24,3,8,133,218
328,22,2,5,3,10,21,-45,4,3,154,173
328,23,4,3,9,4,45,31,9,4,199,204
328,24,3,3,8,5,-65,32,4,6,134,236
328,25,2,4,5,8,23,-56,7,0,157,180
328,26,5,2,10,3,-45,21,2,1,112,201
328,27,5,2,9,4,54,22,6,3,166,223
328,28,4,2,9,4,-55,22,1,5,111,245
328,29,2,6,3,10,21,64,2,9,132,309
328,30,3,4,6,7,33,-57,5,2,165,252
328,31,3,3,6,7,33,34,8,6,198,286
328,32,2,4,3,10,21,-54,9,2,219,232
328,33,3,4,8,5,-65,41,4,3,154,273
328,34,2,5,4,9,22,54,6,7,176,327
328,35,3,3,6,7,33,-66,9,1,209,261
328,36,3,3,6,7,-67,34,2,5,142,295
328,37,5,2,6,7,51,-75,3,0,193,220
328,38,5,2,10,3,55,21,8,1,248,241
328,39,3,4,5,8,-68,44,0,5,180,285
328,40,5,2,9,4,54,22,4,7,234,307
328,41,2,4,5,8,23,-56,7,1,257,251
328,42,4,2,8,5,-56,23,1,4,201,274
328,43,3,3,8,5,35,32,6,6,236,306
328,44,4,2,8,5,-56,23,0,9,180,329
328,45,2,4,4,9,22,-55,2,4,202,274
328,46,4,3,7,6,43,33,5,7,245,307
328,47,4,2,7,6,43,-76,8,1,288,231
328,48,4,2,8,5,-56,23,2,4,232,254
328,49,2,4,8,5,26,41,8,5,258,295
328,50,3,4,4,9,31,-55,9,0,289,240
328,51,3,4,5,8,-68,44,1,4,221,284
328,52,3,4,6,7,33,43,4,7,254,327
328,53,3,4,7,6,34,42,8,9,288,369
328,54,2,5,3,10,21,-45,9,4,309,324
328,55,4,3,9,4,-55,31,4,5,254,355
328,56,3,4,4,9,31,-55,5,0,285,300
328,57,2,5,3,10,21,55,6,5,306,355
328,58,2,4,7,6,-75,42,1,7,231,397
328,59,5,3,6,7,51,-66,2,1,282,331
328,60,2,5,3,10,21,55,3,6,303,386
328,61,4,4,5,8,41,-56,4,0,344,330
328,62,4,2,5,8,41,26,5,6,385,356
328,63,4,3,9,4,-55,31,0,7,330,387
328,64,5,2,7,6,52,-76,2,1,382,311
328,65,4,2,9,4,45,22,7,3,427,333
328,66,3,4,4,9,31,45,8,8,458,378
328,67,2,4,6,7,-76,-57,2,1,382,321
328,68,3,3,9,4,36,31,8,2,418,352
328,69,3,3,6,7,-67,34,1,6,351,386
328,70,3,3,4,9,31,-64,2,2,382,322
328,71,3,4,5,8,32,44,4,6,414,366
328,72,3,3,8,5,35,32,9,8,449,398
328,73,4,3,6,7,-58,-66,1,2,391,332
328,74,2,4,2,11,20,47,1,9,411,379
328,75,4,2,9,4,45,-78,6,1,456,301
328,76,3,4,3,10,30,46,6,7,486,347
328,77,3,4,5,8,32,-56,8,1,518,291
329,1,3,3,6,7,33,34,3,4,33,34
329,2,4,3,4,9,40,-64,3,0,73,-30
329,3,3,4,5,8,32,44,5,4,105,14
329,4,4,3,5,8,41,35,6,9,146,49
329,5,3,3,6,7,33,-66,9,3,179,-17
329,6,3,4,6,7,-67,43,2,6,112,26
329,7,3,4,4,9,31,-55,3,1,143,-29
329,8,2,5,4,9,22,54,5,5,165,25
329,9,3,3,9,4,-64,31,1,6,101,56
329,10,3,4,6,7,33,43,4,9,134,99
329,11,4,3,9,4,45,-69,9,0,179,30
329,12,4,2,8,5,-56,23,3,3,123,53
329,13,5,2,8,5,53,23,6,6,176,76
329,14,2,5,4,9,22,-46,8,0,198,30
329,15,3,4,5,8,-68,44,0,4,130,74
329,16,4,2,9,4,45,22,5,6,175,96
329,17,2,4,2,11,20,-53,5,3,195,43
329,18,3,3,7,6,34,33,9,6,229,76
329,19,3,4,5,8,-68,-56,1,0,161,20
329,20,4,3,9,4,45,31,6,1,206,51
329,21,4,2,8,5,-56,23,0,4,150,74
329,22,3,4,5,8,32,44,2,8,182,118
329,23,5,3,10,3,55,30,7,8,237,148
329,24,4,3,6,7,42,-66,9,2,279,82
329,25,4,3,8,5,-56,32,3,4,223,114
329,26,3,3,7,6,34,33,7,7,257,147
329,27,2,6,2,11,20,-35,7,2,277,112
329,28,3,4,5,8,32,44,9,6,309,156
329,29,6,2,10,3,-36,21,3,7,273,177
329,30,2,5,4,9,22,-46,5,1,295,131
329,31,3,3,8,5,-65,32,0,3,230,163
329,32,4,2,7,6,43,24,3,7,273,187
329,33,2,5,6,7,24,52,7,9,297,239
329,34,3,3,6,7,-67,-66,0,3,230,173
329,35,3,3,5,8,32,35,2,8,262,208
329,36,4,2,9,4,45,-78,7,0,307,130
329,37,3,3,5,8,32,35,9,5,339,165
329,38,3,3,7,6,-66,33,3,8,273,198
329,39,3,4,7,6,34,-58,7,0,307,140
329,40,3,3,6,7,-67,34,0,4,240,174
329,41,2,4,5,8,23,44,3,8,263,218
329,42,2,4,6,7,24,-57,7,1,287,161
329,43,3,3,9,4,-64,31,3,2,223,192
329,44,4,3,6,7,42,34,5,6,265,226
329,45,3,4,4,9,31,-55,6,1,296,171
329,46,2,4,6,7,-76,43,0,4,220,214
329,47,4,3,6,7,42,34,2,8,262,248
329,48,3,4,4,9,31,-55,3,3,293,193
329,49,3,4,5,8,32,44,5,7,325,237
329,50,3,4,4,9,31,-55,6,2,356,182
329,51,3,4,7,6,-66,42,0,4,290,224
329,52,4,2,5,8,41,-74,1,0,331,150
329,53,3,3,8,5,35,32,6,2,366,182
329,54,3,3,4,9,31,36,7,8,397,218
329,55,3,4,4,9,31,-55,8,3,428,163
329,56,2,5,6,7,-76,52,2,5,352,215
329,57,3,3,6,7,33,34,5,9,385,249
329,58,2,5,3,10,21,-45,6,4,406,204
329,59,3,4,6,7,33,43,9,7,439,247
329,60,2,5,3,10,-79,-45,0,2,360,202
329,61,3,4,5,8,32,44,2,6,392,246
329,62,3,4,4,9,31,-55,3,1,423,191
329,63,3,3,8,5,35,32,8,3,458,223
329,64,3,3,7,6,-66,33,2,6,392,256
329,65,5,2,10,3,55,21,7,7,447,277
329,66,3,4,5,8,32,-56,9,1,479,221
329,67,2,4,4,9,-78,45,1,6,401,266
329,68,3,4,8,5,35,41,6,7,436,307
329,69,3,4,5,8,32,-56,8,1,468,251
329,70,2,6,3,10,21,64,9,5,489,315
329,71,3,4,6,7,-67,43,2,8,422,358
329,72,5,2,10,3,55,21,7,9,477,379
329,73,3,3,6,7,-67,-66,0,3,410,313
329,74,3,3,6,7,33,34,3,7,443,347
329,75,5,2,11,2,56,20,9,7,499,367
329,76,3,4,5,8,-68,-56,1,1,431,311
329,77,3,4,8,5,35,41,6,2,466,352
329,78,3,4,7,6,-66,42,0,4,400,394
329,79,2,6,3,10,21,64,1,8,421,458
329,80,4,2,10,3,46,21,7,9,467,479
329,81,3,4,4,9,31,-55,8,4,498,424
329,82,6,2,10,3,-36,21,2,5,462,445
329,83,3,4,6,7,33,43,5,8,495,488
329,84,4,2,8,5,44,-77,9,1,539,411
330,1,4,2,8,5,44,23,4,3,44,23
330,2,4,3,9,4,45,31,9,4,89,54
330,3,2,4,3,10,-79,-54,0,0,10,0
330,4,4,3,9,4,45,31,5,1,55,31
330,5,4,3,9,4,-55,31,0,2,0,62
330,6,4,2,10,3,46,21,6,3,46,83
330,7,3,3,6,7,33,34,9,7,79,117
330,8,5,2,8,5,-47,-77,2,0,32,40
330,9,5,2,8,5,53,23,5,3,85,63
330,10,5,2,8,5,53,23,8,6,138,86
330,11,4,3,6,7,-58,-66,0,0,80,20
330,12,2,4,5,8,23,44,3,4,103,64
330,13,3,4,7,6,34,42,7,6,137,106
330,14,2,5,3,10,21,-45,8,1,158,61
330,15,3,4,8,5,-65,41,3,2,93,102
330,16,3,4,5,8,32,44,5,6,125,146
330,17,4,2,9,4,-55,22,0,8,70,168
330,18,3,3,8,5,35,-68,5,0,105,100
330,19,4,2,8,5,44,23,9,3,149,123
330,20,3,4,8,5,-65,41,4,4,84,164
330,21,2,5,5,8,23,53,7,7,107,217
330,22,2,4,6,7,-76,-57,1,0,31,160
330,23,2,5,5,8,23,53,4,3,54,213
330,24,5,2,6,7,51,25,5,8,105,238
330,25,4,2,6,7,42,-75,7,3,147,163
330,26,3,3,7,6,-66,33,1,6,81,196
330,27,4,3,8,5,44,32,5,8,125,228
330,28,2,4,7,6,-75,-58,0,0,50,170
330,29,3,4,7,6,34,42,4,2,84,212
330,30,3,3,6,7,33,34,7,6,117,246
330,31,3,3,9,4,-64,31,3,7,53,277
330,32,3,3,7,6,34,-67,7,0,87,210
330,33,4,3,4,9,40,36,7,6,127,246
330,34,4,3,7,6,-57,33,0,9,70,279
330,35,4,3,7,6,43,-67,3,2,113,212
330,36,3,3,7,6,34,33,7,5,147,245
330,37,6,2,8,5,62,23,9,8,209,268
330,38,3,3,7,6,-66,-67,3,1,143,201
330,39,3,3,5,8,32,35,5,6,175,236
330,40,4,3,6,7,42,-66,7,0,217,170
330,41,3,4,8,5,-65,41,2,1,152,211
330,42,4,2,9,4,45,22,7,3,197,233
330,43,3,4,5,8,32,44,9,7,229,277
330,44,3,3,10,3,-63,30,6,7,166,307
330,45,3,4,5,8,32,-56,8,1,198,251
330,46,4,3,8,5,-56,32,2,3,142,283
330,47,4,3,8,5,44,32,6,5,186,315
330,48,2,5,7,6,-75,51,1,6,111,366
330,49,4,3,8,5,44,32,5,8,155,398
330,50,4,2,7,6,43,-76,8,2,198,322
330,51,3,4,9,4,-64,40,4,2,134,362
330,52,3,3,7,6,34,33,8,5,168,395
330,53,3,4,9,4,-64,40,4,5,104,435
330,54,3,4,6,7,33,43,7,8,137,478
330,55,4,2,8,5,-56,-77,1,1,81,401
330,56,2,4,4,9,22,45,3,6,103,446
330,57,5,2,7,6,52,-76,5,0,155,370
330,58,4,2,8,5,44,23,9,3,199,393
330,59,3,4,6,7,-67,43,2,6,132,436
330,60,3,4,4,9,31,-55,3,1,163,381
330,61,3,3,8,5,35,32,8,3,198,413
330,62,4,2,8,5,-56,23,2,6,142,436
330,63,4,3,10,3,46,30,8,6,188,466
330,64,4,3,7,6,-57,33,1,9,131,499
330,65,4,3,8,5,44,-68,5,1,175,431
330,66,2,4,6,7,24,43,9,4,199,474
330,67,3,3,6,7,-67,34,2,8,132,508
331,1,5,2,9,4,54,22,4,2,54,22
331,2,3,4,6,7,33,43,7,5,87,65
331,3,4,3,6,7,42,34,9,9,129,99
331,4,3,3,8,5,-65,-68,4,1,64,31
331,5,4,2,7,6,43,24,7,5,107,55
331,6,2,4,3,10,21,-54,8,1,128,1
331,7,3,3,6,7,-67,34,1,5,61,35
331,8,4,3,6,7,42,34,3,9,103,69
331,9,3,3,6,7,33,-66,6,3,136,3
331,10,3,4,6,7,33,43,9,6,169,46
331,11,6,2,10,3,-36,21,3,7,133,67
331,12,5,2,9,4,54,22,7,9,187,89
331,13,3,4,6,7,-67,-57,0,2,120,32
331,14,3,3,6,7,33,34,3,6,153,66
331,15,4,3,6,7,42,-66,5,0,195,0
331,16,3,5,7,6,34,51,9,1,229,51
331,17,4,3,5,8,-59,35,0,6,170,86
331,18,4,3,7,6,43,33,3,9,213,119
331,19,3,3,5,8,32,-65,5,4,245,54
331,20,3,3,8,5,-65,32,0,6,180,86
331,21,3,3,7,6,34,33,4,9,214,119
331,22,3,3,6,7,33,-66,7,3,247,53
331,23,3,3,5,8,32,35,9,8,279,88
331,24,3,4,4,9,-69,-55,0,3,210,33
331,25,3,3,6,7,33,34,3,7,243,67
331,26,3,3,6,7,33,-66,6,1,276,1
331,27,3,3,5,8,32,35,8,6,308,36
331,28,4,2,6,7,-58,-75,0,1,250,-39
331,29,6,2,8,5,62,23,2,4,312,-16
331,30,4,2,8,5,44,23,6,7,356,7
331,31,4,2,9,4,-55,22,1,9,301,29
331,32,2,4,5,8,23,-56,4,3,324,-27
331,33,2,4,5,8,23,44,7,7,347,17
331,34,3,3,8,5,-65,32,2,9,282,49
331,35,5,2,10,3,55,-79,7,0,337,-30
331,36,3,3,8,5,-65,32,2,2,272,2
331,37,3,3,8,5,35,32,7,4,307,34
331,38,2,4,6,7,-76,43,1,7,231,77
331,39,3,3,6,7,33,-66,4,1,264,11
331,40,5,2,9,4,54,22,8,3,318,33
331,41,2,4,8,5,-74,41,4,4,244,74
331,42,2,5,4,9,22,54,6,8,266,128
331,43,2,4,4,9,22,-55,8,3,288,73
331,44,5,2,9,4,-46,22,2,5,242,95
331,45,2,5,3,10,21,-45,3,0,263,50
331,46,4,2,7,6,43,24,6,4,306,74
331,47,5,2,7,6,52,24,8,8,358,98
331,48,4,3,10,3,-54,30,4,8,304,128
331,49,2,4,7,6,25,-58,9,0,329,70
331,50,4,3,6,7,-58,34,1,4,271,104
331,51,2,5,4,9,22,54,3,8,293,158
331,52,6,2,9,4,63,-78,6,0,356,80
331,53,3,5,6,7,33,52,9,2,389,132
331,54,4,2,11,2,-53,20,6,2,336,152
331,55,4,3,8,5,-56,32,0,4,280,184
331,56,2,4,7,6,25,42,5,6,305,226
331,57,2,4,6,7,24,43,9,9,329,269
331,58,3,3,4,9,-69,-64,0,5,260,205
331,59,2,4,5,8,23,44,3,9,283,249
331,60,3,3,5,8,32,-65,5,4,315,184
331,61,2,5,2,11,20,-44,5,0,335,140
331,62,3,3,6,7,33,34,8,4,368,174
331,63,2,4,5,8,-77,44,1,8,291,218
331,64,3,4,4,9,31,-55,2,3,322,163
331,65,4,2,9,4,45,22,7,5,367,185
331,66,2,5,4,9,22,54,9,9,389,239
331,67,3,3,4,9,-69,-64,0,5,320,175
331,68,4,2,7,6,43,24,3,9,363,199
331,69,4,3,8,5,44,-68,7,1,407,131
331,70,3,3,7,6,-66,33,1,4,341,164
331,71,3,4,7,6,34,42,5,6,375,206
331,72,2,4,5,8,23,-56,8,0,398,150
331,73,2,4,6,7,-76,43,2,3,322,193
331,74,4,3,8,5,44,32,6,5,366,225
331,75,3,4,7,6,-66,42,0,7,300,267
331,76,2,5,4,9,22,-46,2,1,322,221
331,77,4,2,9,4,45,22,7,3,367,243
331,78,3,3,6,7,-67,34,0,7,300,277
331,79,2,5,4,9,22,-46,2,1,322,231
331,80,2,6,3,10,21,64,3,5,343,295
331,81,2,4,5,8,23,44,6,9,366,339
331,82,3,3,6,7,33,-66,9,3,399,273
331,83,4,3,5,8,-59,35,0,8,340,308
331,84,4,3,8,5,44,-68,4,0,384,240
331,85,4,3,8,5,44,32,8,2,428,272
331,86,3,4,6,7,-67,43,1,5,361,315
331,87,5,2,8,5,53,23,4,8,414,338
331,88,3,3,6,7,33,-66,7,2,447,272
331,89,2,4,8,5,-74,41,3,3,373,313
331,90,2,4,7,6,25,42,8,5,398,355
331,91,5,2,7,6,-48,24,0,9,350,379
331,92,5,2,6,7,51,-75,1,4,401,304
331,93,2,5,3,10,21,55,2,9,422,359
331,94,4,3,8,5,44,-68,6,1,466,291
331,95,4,3,7,6,43,33,9,4,509,324
332,1,4,3,8,5,44,32,4,2,44,32
332,2,5,2,8,5,53,23,7,5,97,55
332,3,2,4,5,8,-77,44,0,9,20,99
332,4,4,3,7,6,43,-67,3,2,63,32
332,5,3,4,7,6,34,42,7,4,97,74
332,6,4,3,7,6,-57,33,0,7,40,107
332,7,4,2,6,7,42,-75,2,2,82,32
332,8,4,3,6,7,42,34,4,6,124,66
332,9,4,2,4,9,40,-73,4,3,164,-7
332,10,4,3,8,5,44,32,8,5,208,25
332,11,2,4,8,5,-74,41,4,6,134,66
332,12,2,5,6,7,24,52,8,8,158,118
332,13,5,2,11,2,-44,20,4,8,114,138
332,14,3,3,9,4,-64,31,0,9,50,169
332,15,5,2,7,6,52,-76,2,3,102,93
332,16,3,4,4,9,31,45,3,8,133,138
332,17,2,4,4,9,22,-55,5,3,155,83
332,18,2,5,6,7,24,52,9,5,179,135
332,19,4,3,4,9,40,-64,9,1,219,71
332,20,3,3,7,6,-66,33,3,4,153,104
332,21,4,2,5,8,41,-74,4,0,194,30
332,22,4,2,10,3,-54,21,0,1,140,51
332,23,4,3,7,6,43,33,3,4,183,84
332,24,3,4,5,8,32,44,5,8,215,128
332,25,4,3,5,8,41,-65,6,3,256,63
332,26,3,3,7,6,-66,33,0,6,190,96
332,27,3,3,5,8,32,-65,2,1,222,31
332,28,3,3,7,6,34,33,6,4,256,64
332,29,3,4,6,7,33,43,9,7,289,107
332,30,2,5,6,7,-76,52,3,9,213,159
332,31,2,4,5,8,23,-56,6,3,236,103
332,32,3,3,4,9,31,36,7,9,267,139
332,33,3,4,7,6,-66,-58,1,1,201,81
332,34,3,4,5,8,32,44,3,5,233,125
332,35,5,2,8,5,53,23,6,8,286,148
332,36,3,3,6,7,33,-66,9,2,319,82
332,37,3,4,5,8,-68,44,1,6,251,126
332,38,3,3,6,7,33,-66,4,0,284,60
332,39,4,2,10,3,-54,21,0,1,230,81
332,40,3,4,4,9,31,45,1,6,261,126
332,41,3,4,5,8,32,-56,3,0,293,70
332,42,3,4,5,8,32,44,5,4,325,114
332,43,2,4,4,9,22,45,7,9,347,159
332,44,3,4,7,6,-66,-58,1,1,281,101
332,45,3,4,3,10,30,46,1,7,311,147
332,46,2,5,4,9,22,-46,3,1,333,101
332,47,4,3,6,7,42,34,5,5,375,135
332,48,3,3,8,5,-65,32,0,7,310,167
332,49,4,2,6,7,42,-75,2,2,352,92
332,50,4,3,6,7,42,34,4,6,394,126
332,51,3,3,9,4,-64,31,0,7,330,157
332,52,2,5,5,8,23,-47,3,0,353,110
332,53,3,3,4,9,31,36,4,6,384,146
332,54,2,4,9,4,-73,40,1,6,311,186
332,55,2,4,6,7,24,43,5,9,335,229
332,56,3,4,9,4,-64,40,1,9,271,269
332,57,4,3,9,4,45,-69,6,0,316,200
332,58,3,3,8,5,-65,32,1,2,251,232
332,59,3,3,6,7,33,34,4,6,284,266
332,60,4,3,8,5,44,32,8,8,328,298
332,61,2,6,4,9,-78,-37,0,1,250,261
332,62,4,3,9,4,45,31,5,2,295,292
332,63,3,4,5,8,32,44,7,6,327,336
332,64,2,6,4,9,22,63,9,9,349,399
332,65,2,5,4,9,-78,-46,1,3,271,353
332,66,3,3,5,8,32,35,3,8,303,388
332,67,3,4,7,6,34,-58,7,0,337,330
332,68,4,2,7,6,-57,24,0,4,280,354
332,69,2,4,6,7,24,43,4,7,304,397
332,70,4,3,9,4,45,31,9,8,349,428
332,71,3,3,7,6,-66,-67,3,1,283,361
332,72,4,4,8,5,44,41,7,2,327,402
332,73,3,4,5,8,32,44,9,6,359,446
332,74,3,3,8,5,-65,32,4,8,294,478
332,75,2,5,3,10,21,-45,5,3,315,433
332,76,2,5,4,9,22,54,7,7,337,487
332,77,2,5,4,9,22,-46,9,1,359,441
332,78,4,3,8,5,-56,32,3,3,303,473
332,79,3,4,6,7,33,43,6,6,336,516
333,1,2,4,6,7,24,43,4,3,24,43
333,2,3,3,7,6,34,33,8,6,58,76
333,3,3,3,7,6,-66,33,2,9,-8,109
333,4,3,4,5,8,32,-56,4,3,24,53
333,5,3,3,8,5,35,32,9,5,59,85
333,6,5,3,8,5,-47,32,2,7,12,117
333,7,3,3,6,7,33,-66,5,1,45,51
333,8,3,4,5,8,32,44,7,5,77,95
333,9,5,2,11,2,-44,20,3,5,33,115
333,10,4,3,7,6,43,33,6,8,76,148
333,11,3,4,5,8,32,-56,8,2,108,92
333,12,3,3,4,9,31,36,9,8,139,128
333,13,3,3,6,7,-67,-66,2,2,72,62
333,14,5,2,9,4,54,22,6,4,126,84
333,15,3,3,5,8,32,35,8,9,158,119
333,16,2,5,5,8,-77,-47,1,2,81,72
333,17,3,3,8,5,35,32,6,4,116,104
333,18,4,4,5,8,41,44,7,8,157,148
333,19,4,3,10,3,-54,30,3,8,103,178
333,20,5,2,9,4,54,-78,7,0,157,100
333,21,4,3,6,7,42,34,9,4,199,134
333,22,3,4,5,8,-68,44,1,8,131,178
333,23,3,4,6,7,33,-57,4,1,164,121
333,24,2,5,4,9,22,54,6,5,186,175
333,25,4,4,9,4,-55,40,1,5,131,215
333,26,3,3,9,4,36,31,7,6,167,246
333,27,2,6,4,9,22,63,9,9,189,309
333,28,5,2,10,3,-45,-79,4,0,144,230
333,29,4,4,6,7,42,43,6,3,186,273
333,30,5,2,6,7,51,25,7,8,237,298
333,31,3,3,8,5,-65,-68,2,0,172,230
333,32,4,3,7,6,43,33,5,3,215,263
333,33,3,3,7,6,34,33,9,6,249,296
333,34,4,3,5,8,-59,-65,0,1,190,231
333,35,4,3,7,6,43,33,3,4,233,264
333,36,3,4,5,8,32,44,5,8,265,308
333,37,2,5,3,10,21,-45,6,3,286,263
333,38,4,3,7,6,43,33,9,6,329,296
333,39,2,5,6,7,-76,52,3,8,253,348
333,40,2,5,5,8,23,-47,6,1,276,301
333,41,3,3,5,8,32,35,8,6,308,336
333,42,4,3,6,7,-58,-66,0,0,250,270
333,43,2,4,7,6,25,42,5,2,275,312
333,44,3,3,6,7,33,34,8,6,308,346
333,45,4,2,7,6,-57,-76,1,0,251,270
333,46,3,4,5,8,32,44,3,4,283,314
333,47,2,4,6,7,24,43,7,7,307,357
333,48,3,3,6,7,-67,-66,0,1,240,291
333,49,6,2,10,3,64,21,4,2,304,312
333,50,3,4,8,5,35,41,9,3,339,353
333,51,5,2,9,4,-46,22,3,5,293,375
333,52,3,4,6,7,33,43,6,8,326,418
333,53,4,4,7,6,43,-58,9,0,369,360
333,54,3,3,7,6,-66,33,3,3,303,393
333,55,4,2,8,5,44,23,7,6,347,416
333,56,3,3,7,6,-66,33,1,9,281,449
333,57,4,3,7,6,43,-67,4,2,324,382
333,58,4,3,4,9,40,36,4,8,364,418
333,59,4,3,8,5,44,-68,8,0,408,350
333,60,5,2,10,3,-45,21,3,1,363,371
333,61,4,3,7,6,43,33,6,4,406,404
333,62,4,2,8,5,-56,23,0,7,350,427
333,63,4,2,6,7,42,-75,2,2,392,352
333,64,3,3,6,7,33,34,5,6,425,386
333,65,2,4,8,5,-74,41,1,7,351,427
333,66,4,2,8,5,44,-77,5,0,395,350
333,67,3,3,8,5,-65,32,0,2,330,382
333,68,2,5,2,11,20,56,0,8,350,438
333,69,3,3,4,9,31,-64,1,4,381,374
333,70,4,3,10,3,46,30,7,4,427,404
333,71,2,5,4,9,22,54,9,8,449,458
333,72,4,3,6,7,-58,-66,1,2,391,392
333,73,4,3,9,4,45,31,6,3,436,423
333,74,2,4,5,8,23,44,9,7,459,467
333,75,2,4,5,8,-77,-56,2,1,382,411
333,76,3,3,5,8,32,35,4,6,414,446
333,77,3,4,8,5,35,41,9,7,449,487
333,78,2,4,4,9,-78,-55,1,2,371,432
333,79,4,2,9,4,45,22,6,4,416,454
333,80,3,4,5,8,32,44,8,8,448,498
333,81,4,2,8,5,-56,-77,2,1,392,421
333,82,3,3,8,5,35,32,7,3,427,453
333,83,3,3,7,6,-66,33,1,6,361,486
333,84,4,3,8,5,44,32,5,8,405,518
334,1,3,3,4,9,31,36,1,6,31,36
334,2,3,4,6,7,33,43,4,9,64,79
334,3,4,3,5,8,41,-65,5,4,105,14
334,4,3,4,7,6,34,42,9,6,139,56
334,5,2,4,5,8,-77,-56,2,0,62,0
334,6,5,2,9,4,54,22,6,2,116,22
334,7,2,5,4,9,22,54,8,6,138,76
334,8,4,2,8,5,-56,23,2,9,82,99
334,9,4,2,9,4,45,-78,7,1,127,21
334,10,3,5,5,8,32,53,9,4,159,74
334,11,4,3,8,5,-56,32,3,6,103,106
334,12,3,3,4,9,31,-64,4,2,134,42
334,13,3,3,4,9,31,36,5,8,165,78
334,14,4,2,11,2,-53,20,2,8,112,98
334,15,5,2,11,2,56,20,8,8,168,118
334,16,5,2,9,4,-46,-78,2,0,122,40
334,17,4,4,7,6,43,42,5,2,165,82
334,18,2,5,4,9,22,54,7,6,187,136
334,19,2,4,4,9,22,-55,9,1,209,81
334,20,2,4,8,5,-74,41,5,2,135,122
334,21,2,5,6,7,24,52,9,4,159,174
334,22,3,5,5,8,-68,53,1,7,91,227
334,23,3,4,4,9,31,-55,2,2,122,172
334,24,3,3,6,7,33,34,5,6,155,206
334,25,4,3,10,3,-54,30,1,6,101,236
334,26,3,3,7,6,34,33,5,9,135,269
334,27,4,4,5,8,41,-56,6,3,176,213
334,28,3,4,5,8,32,44,8,7,208,257
334,29,4,2,8,5,-56,-77,2,0,152,180
334,30,3,3,7,6,34,33,6,3,186,213
334,31,2,5,5,8,23,53,9,6,209,266
334,32,3,4,4,9,-69,-55,0,1,140,211
334,33,3,4,6,7,33,43,3,4,173,254
334,34,2,5,4,9,22,54,5,8,195,308
334,35,4,3,9,4,-55,31,0,9,140,339
334,36,3,3,5,8,32,-65,2,4,172,274
334,37,5,2,7,6,52,24,4,8,224,298
334,38,4,3,7,6,43,-67,7,1,267,231
334,39,4,2,8,5,-56,23,1,4,211,254
334,40,2,5,5,8,23,53,4,7,234,307
334,41,4,3,8,5,44,32,8,9,278,339
334,42,2,5,5,8,-77,-47,1,2,201,292
334,43,2,5,2,11,20,56,1,8,221,348
334,44,3,4,3,10,30,-54,1,4,251,294
334,45,4,2,7,6,43,24,4,8,294,318
334,46,5,2,10,3,55,21,9,9,349,339
334,47,5,2,9,4,-46,-78,3,1,303,261
334,48,2,4,5,8,23,44,6,5,326,305
334,49,6,2,9,4,63,22,9,7,389,327
334,50,3,3,5,8,-68,-65,1,2,321,262
334,51,4,3,9,4,45,31,6,3,366,293
334,52,4,2,10,3,-54,21,2,4,312,314
334,53,3,3,4,9,31,-64,3,0,343,250
334,54,3,3,8,5,35,32,8,2,378,282
334,55,3,4,7,6,-66,42,2,4,312,324
334,56,3,3,6,7,33,34,5,8,345,358
334,57,2,4,3,10,21,-54,6,4,366,304
334,58,4,3,9,4,-55,31,1,5,311,335
334,59,3,3,7,6,34,33,5,8,345,368
334,60,4,3,8,5,44,-68,9,0,389,300
334,61,3,4,9,4,-64,40,5,0,325,340
334,62,4,3,7,6,43,33,8,3,368,373
334,63,2,5,2,11,20,56,8,9,388,429
334,64,3,4,4,9,31,-55,9,4,419,374
334,65,5,2,10,3,-45,21,4,5,374,395
334,66,5,2,11,2,-44,20,0,5,330,415
334,67,2,4,5,8,23,44,3,9,353,459
334,68,5,3,9,4,54,-69,7,0,407,390
334,69,3,3,7,6,-66,33,1,3,341,423
334,70,3,4,6,7,33,43,4,6,374,466
334,71,3,4,6,7,33,43,7,9,407,509
335,1,2,5,4,9,22,54,2,4,22,54
335,2,2,5,6,7,24,52,6,6,46,106
335,3,2,5,5,8,23,53,9,9,69,159
335,4,3,4,4,9,-69,-55,0,4,0,104
335,5,3,4,4,9,31,45,1,9,31,149
335,6,4,3,7,6,43,-67,4,2,74,82
335,7,4,3,6,7,42,34,6,6,116,116
335,8,4,3,7,6,43,33,9,9,159,149
335,9,4,2,6,7,-58,-75,1,4,101,74
335,10,4,3,10,3,46,30,7,4,147,104
335,11,4,2,8,5,-56,23,1,7,91,127
335,12,3,4,7,6,34,42,5,9,125,169
335,13,5,2,10,3,-45,-79,0,0,80,90
335,14,2,4,5,8,23,44,3,4,103,134
335,15,5,2,10,3,55,21,8,5,158,155
335,16,2,4,4,9,-78,-55,0,0,80,100
335,17,3,3,9,4,36,31,6,1,116,131
335,18,3,4,7,6,-66,42,0,3,50,173
335,19,3,3,4,9,31,36,1,9,81,209
335,20,3,4,4,9,31,-55,2,4,112,154
335,21,2,4,5,8,23,44,5,8,135,198
335,22,3,4,5,8,32,-56,7,2,167,142
335,23,3,3,5,8,32,35,9,7,199,177
335,24,4,2,6,7,-58,-75,1,2,141,102
335,25,2,5,4,9,22,54,3,6,163,156
335,26,3,4,3,10,30,-54,3,2,193,102
335,27,3,4,4,9,31,45,4,7,224,147
335,28,3,5,4,9,31,-46,5,1,255,101
335,29,3,4,6,7,33,43,8,4,288,144
335,30,4,2,9,4,-55,22,3,6,233,166
335,31,3,3,5,8,32,-65,5,1,265,101
335,32,4,3,8,5,44,32,9,3,309,133
335,33,2,5,2,11,20,56,9,9,329,189
335,34,4,3,7,6,-57,-67,2,2,272,122
335,35,4,2,7,6,43,24,5,6,315,146
335,36,4,3,8,5,44,32,9,8,359,178
335,37,4,2,6,7,-58,-75,1,3,301,103
335,38,3,4,6,7,33,43,4,6,334,146
335,39,2,5,2,11,20,-44,4,2,354,102
335,40,3,4,6,7,33,43,7,5,387,145
335,41,6,2,10,3,-36,21,1,6,351,166
335,42,4,3,6,7,42,-66,3,0,393,100
335,43,5,2,7,6,52,24,5,4,445,124
335,44,4,3,9,4,-55,31,0,5,390,155
335,45,4,2,10,3,46,21,6,6,436,176
335,46,4,4,6,7,42,43,8,9,478,219
335,47,2,4,7,6,-75,-58,3,1,403,161
335,48,3,3,5,8,32,35,5,6,435,196
335,49,4,2,10,3,-54,21,1,7,381,217
335,50,5,2,10,3,55,21,6,8,436,238
335,51,5,2,7,6,52,-76,8,2,488,162
335,52,4,2,5,8,41,26,9,8,529,188
336,1,5,2,11,2,56,20,6,0,56,20
336,2,2,4,6,7,-76,43,0,3,-20,63
336,3,2,5,6,7,24,52,4,5,4,115
336,4,4,2,6,7,42,-75,6,0,46,40
336,5,3,4,5,8,32,44,8,4,78,84
336,6,4,3,7,6,-57,33,1,7,21,117
336,7,5,2,10,3,55,21,6,8,76,138
336,8,4,2,9,4,-55,-78,1,0,21,60
336,9,3,3,4,9,31,36,2,6,52,96
336,10,2,4,4,9,22,-55,4,1,74,41
336,11,4,3,5,8,41,35,5,6,115,76
336,12,2,4,6,7,24,43,9,9,139,119
336,13,4,3,6,7,-58,-66,1,3,81,53
336,14,4,3,7,6,43,33,4,6,124,86
336,15,3,4,8,5,35,41,9,7,159,127
336,16,2,4,3,10,-79,-54,0,3,80,73
336,17,3,4,3,10,30,46,0,9,110,119
336,18,3,3,9,4,36,-69,6,0,146,50
336,19,3,3,5,8,32,35,8,5,178,85
336,20,4,3,9,4,-55,31,3,6,123,116
336,21,2,4,6,7,24,43,7,9,147,159
336,22,3,4,7,6,-66,-58,1,1,81,101
336,23,3,3,7,6,34,33,5,4,115,134
336,24,5,2,10,3,-45,21,0,5,70,155
336,25,3,3,7,6,34,33,4,8,104,188
336,26,3,3,4,9,31,-64,5,4,135,124
336,27,3,4,5,8,32,44,7,8,167,168
336,28,3,3,7,6,-66,-67,1,1,101,101
336,29,4,3,9,4,45,31,6,2,146,132
336,30,5,2,9,4,-46,22,0,4,100,154
336,31,4,2,8,5,44,23,4,7,144,177
336,32,2,5,5,8,23,-47,7,0,167,130
336,33,4,4,4,9,40,45,7,5,207,175
336,34,4,3,5,8,41,-65,8,0,248,110
336,35,2,5,3,10,21,55,9,5,269,165
336,36,3,3,6,7,-67,34,2,9,202,199
336,37,3,4,3,10,30,-54,2,5,232,145
336,38,4,3,9,4,45,31,7,6,277,176
336,39,4,3,6,7,42,-66,9,0,319,110
336,40,4,3,8,5,-56,32,3,2,263,142
336,41,4,2,9,4,45,22,8,4,308,164
336,42,2,6,4,9,-78,63,0,7,230,227
336,43,3,4,6,7,33,-57,3,0,263,170
336,44,4,2,9,4,45,22,8,2,308,192
336,45,3,3,9,4,-64,31,4,3,244,223
336,46,3,3,7,6,34,33,8,6,278,256
336,47,4,2,7,6,-57,-76,1,0,221,180
336,48,3,4,3,10,30,46,1,6,251,226
336,49,3,3,9,4,36,31,7,7,287,257
336,50,2,5,2,11,20,-44,7,3,307,213
336,51,3,3,8,5,-65,32,2,5,242,245
336,52,3,3,3,10,30,-63,2,2,272,182
336,53,2,5,3,10,21,55,3,7,293,237
336,54,3,4,4,9,31,-55,4,2,324,182
336,55,4,3,7,6,43,33,7,5,367,215
336,56,2,4,7,6,-75,42,2,7,292,257
336,57,4,2,8,5,44,-77,6,0,336,180
336,58,3,3,4,9,31,36,7,6,367,216
336,59,2,4,4,9,22,-55,9,1,389,161
336,60,2,5,5,8,-77,53,2,4,312,214
336,61,4,2,8,5,44,23,6,7,356,237
336,62,3,3,7,6,-66,-67,0,0,290,170
336,63,4,2,10,3,46,21,6,1,336,191
336,64,4,4,7,6,43,42,9,3,379,233
336,65,4,4,6,7,-58,43,1,6,321,276
336,66,2,4,4,9,22,-55,3,1,343,221
336,67,4,3,10,3,46,30,9,1,389,251
336,68,2,5,4,9,-78,54,1,5,311,305
336,69,3,5,5,8,32,53,3,8,343,358
336,70,3,5,4,9,31,-46,4,2,374,312
336,71,3,3,9,4,-64,31,0,3,310,343
336,72,2,4,3,10,21,46,1,9,331,389
336,73,4,2,9,4,45,-78,6,1,376,311
336,74,4,3,7,6,43,33,9,4,419,344
336,75,4,2,7,6,-57,24,2,8,362,368
336,76,3,4,4,9,31,-55,3,3,393,313
336,77,4,2,10,3,46,21,9,4,439,334
336,78,4,3,7,6,-57,33,2,7,382,367
336,79,2,4,3,10,21,-54,3,3,403,313
336,80,3,3,7,6,34,33,7,6,437,346
336,81,2,4,3,10,21,-54,8,2,458,292
336,82,5,2,10,3,-45,21,3,3,413,313
336,83,4,3,9,4,45,31,8,4,458,344
336,84,3,3,7,6,-66,33,2,7,392,377
336,85,4,3,7,6,43,-67,5,0,435,310
336,86,4,3,5,8,41,35,6,5,476,345
336,87,3,4,8,5,-65,41,1,6,411,386
336,88,3,4,6,7,33,43,4,9,444,429
336,89,2,4,3,10,21,-54,5,5,465,375
336,90,3,3,4,9,31,-64,6,1,496,311
336,91,4,3,8,5,-56,32,0,3,440,343
336,92,3,4,8,5,35,41,5,4,475,384
336,93,4,3,9,4,-55,31,0,5,420,415
336,94,3,3,5,8,32,-65,2,0,452,350
336,95,3,3,8,5,35,32,7,2,487,382
336,96,3,4,6,7,-67,43,0,5,420,425
336,97,2,5,6,7,24,52,4,7,444,477
336,98,3,4,5,8,32,-56,6,1,476,421
336,99,3,4,6,7,33,43,9,4,509,464
337,1,4,2,8,5,44,23,4,3,44,23
337,2,2,5,4,9,22,54,6,7,66,77
337,3,3,4,6,7,33,-57,9,0,99,20
337,4,3,4,5,8,-68,44,1,4,31,64
337,5,3,4,5,8,32,44,3,8,63,108
337,6,3,4,5,8,32,-56,5,2,95,52
337,7,3,3,7,6,34,33,9,5,129,85
337,8,3,3,9,4,-64,31,5,6,65,116
337,9,4,3,9,4,-55,31,0,7,10,147
337,10,2,4,7,6,25,42,5,9,35,189
337,11,4,2,11,2,-53,20,2,9,-18,209
337,12,5,2,6,7,51,-75,3,4,33,134
337,13,5,2,9,4,54,22,7,6,87,156
337,14,3,3,6,7,-67,-66,0,0,20,90
337,15,3,4,4,9,31,45,1,5,51,135
337,16,3,3,7,6,34,33,5,8,85,168
337,17,2,6,2,11,20,-35,5,3,105,133
337,18,4,2,8,5,44,23,9,6,149,156
337,19,4,2,8,5,-56,23,3,9,93,179
337,20,3,4,6,7,33,-57,6,2,126,122
337,21,2,4,4,9,22,45,8,7,148,167
337,22,3,4,4,9,31,-55,9,2,179,112
337,23,2,5,3,10,-79,55,0,7,100,167
337,24,3,3,7,6,34,-67,4,0,134,100
337,25,4,3,10,3,-54,30,0,0,80,130
337,26,3,3,6,7,33,34,3,4,113,164
337,27,3,4,5,8,32,44,5,8,145,208
337,28,4,2,8,5,44,-77,9,1,189,131
337,29,3,3,9,4,-64,31,5,2,125,162
337,30,6,2,10,3,64,21,9,3,189,183
337,31,3,3,8,5,-65,32,4,5,124,215
337,32,4,3,7,6,43,33,7,8,167,248
337,33,3,3,4,9,31,-64,8,4,198,184
337,34,3,4,4,9,31,45,9,9,229,229
337,35,5,2,10,3,-45,-79,4,0,184,150
337,36,3,3,5,8,32,35,6,5,216,185
337,37,2,5,2,11,20,-44,6,1,236,141
337,38,2,4,2,11,20,47,6,8,256,188
337,39,3,3,7,6,-66,-67,0,1,190,121
337,40,3,4,7,6,34,42,4,3,224,163
337,41,3,4,6,7,33,43,7,6,257,206
337,42,4,3,7,6,-57,33,0,9,200,239
337,43,3,3,4,9,31,-64,1,5,231,175
337,44,5,2,7,6,52,24,3,9,283,199
337,45,3,3,5,8,32,-65,5,4,315,134
337,46,3,3,5,8,32,35,7,9,347,169
337,47,5,2,10,3,-45,-79,2,0,302,90
337,48,2,5,3,10,21,55,3,5,323,145
337,49,2,5,5,8,23,53,6,8,346,198
337,50,4,3,7,6,43,-67,9,1,389,131
337,51,4,2,7,6,-57,24,2,5,332,155
337,52,3,4,6,7,33,43,5,8,365,198
337,53,2,4,4,9,22,-55,7,3,387,143
337,54,3,4,5,8,32,44,9,7,419,187
337,55,2,5,4,9,-78,-46,1,1,341,141
337,56,4,3,9,4,45,31,6,2,386,172
337,57,4,2,9,4,-55,22,1,4,331,194
337,58,4,3,9,4,45,31,6,5,376,225
337,59,2,4,6,7,-76,43,0,8,300,268
337,60,3,4,4,9,31,-55,1,3,331,213
337,61,3,4,8,5,35,41,6,4,366,254
337,62,4,2,7,6,43,24,9,8,409,278
337,63,3,3,5,8,-68,-65,1,3,341,213
337,64,2,4,5,8,23,44,4,7,364,257
337,65,3,4,7,6,34,42,8,9,398,299
337,66,3,4,6,7,-67,-57,1,2,331,242
337,67,4,2,6,7,42,25,3,7,373,267
337,68,3,3,9,4,36,31,9,8,409,298
337,69,3,3,5,8,-68,-65,1,3,341,233
337,70,3,3,6,7,33,34,4,7,374,267
337,71,5,2,11,2,-44,20,0,7,330,287
337,72,4,2,8,5,44,-77,4,0,374,210
337,73,4,2,5,8,41,26,5,6,415,236
337,74,2,4,5,8,23,-56,8,0,438,180
337,75,4,3,8,5,-56,32,2,2,382,212
337,76,4,3,9,4,45,31,7,3,427,243
337,77,6,2,8,5,62,23,9,6,489,266
337,78,3,3,8,5,-65,32,4,8,424,298
337,79,3,3,6,7,33,-66,7,2,457,232
337,80,4,3,8,5,-56,32,1,4,401,264
337,81,3,4,5,8,32,44,3,8,433,308
337,82,5,2,11,2,56,20,9,8,489,328
337,83,4,2,8,5,-56,-77,3,1,433,251
337,84,5,2,10,3,55,21,8,2,488,272
337,85,5,2,7,6,-48,24,0,6,440,296
337,86,4,2,7,6,43,-76,3,0,483,220
337,87,3,3,6,7,33,34,6,4,516,254
338,1,4,4,5,8,41,44,1,4,41,44
338,2,5,2,10,3,55,21,6,5,96,65
338,3,3,3,6,7,33,34,9,9,129,99
338,4,3,3,6,7,-67,-66,2,3,62,33
338,5,3,3,6,7,33,34,5,7,95,67
338,6,2,5,3,10,21,-45,6,2,116,22
338,7,2,5,3,10,21,55,7,7,137,77
338,8,3,4,4,9,31,-55,8,2,168,22
338,9,2,4,4,9,-78,45,0,7,90,67
338,10,5,2,9,4,54,22,4,9,144,89
338,11,2,4,5,8,23,-56,7,3,167,33
338,12,2,5,5,8,-77,53,0,6,90,86
338,13,2,6,4,9,22,63,2,9,112,149
338,14,4,2,9,4,45,-78,7,1,157,71
338,15,4,2,8,5,-56,23,1,4,101,94
338,16,5,2,9,4,54,22,5,6,155,116
338,17,4,4,4,9,40,-55,5,1,195,61
338,18,4,2,9,4,-55,22,0,3,140,83
338,19,2,4,5,8,23,44,3,7,163,127
338,20,3,4,6,7,33,-57,6,0,196,70
338,21,3,3,7,6,-66,33,0,3,130,103
338,22,2,4,3,10,21,46,1,9,151,149
338,23,4,3,10,3,46,30,7,9,197,179
338,24,3,4,7,6,-66,-58,1,1,131,121
338,25,5,2,9,4,54,22,5,3,185,143
338,26,3,3,7,6,34,33,9,6,219,176
338,27,4,3,6,7,-58,-66,1,0,161,110
338,28,5,2,8,5,53,23,4,3,214,133
338,29,4,2,7,6,43,24,7,7,257,157
338,30,3,4,7,6,-66,42,1,9,191,199
338,31,4,2,6,7,42,-75,3,4,233,124
338,32,4,2,5,8,41,-74,4,0,274,50
338,33,3,4,6,7,33,43,7,3,307,93
338,34,3,4,7,6,-66,42,1,5,241,135
338,35,4,3,6,7,42,34,3,9,283,169
338,36,2,4,4,9,22,-55,5,4,305,114
338,37,2,4,5,8,23,44,8,8,328,158
338,38,3,3,7,6,-66,-67,2,1,262,91
338,39,4,2,8,5,44,23,6,4,306,114
338,40,3,3,6,7,33,34,9,8,339,148
338,41,5,2,9,4,-46,-78,3,0,293,70
338,42,2,4,6,7,24,43,7,3,317,113
338,43,4,3,8,5,-56,32,1,5,261,145
338,44,4,2,6,7,42,-75,3,0,303,70
338,45,3,4,5,8,32,44,5,4,335,114
338,46,4,3,7,6,43,33,8,7,378,147
338,47,2,4,7,6,-75,42,3,9,303,189
338,48,2,4,5,8,23,-56,6,3,326,133
338,49,3,3,4,9,31,36,7,9,357,169
338,50,2,5,4,9,22,-46,9,3,379,123
338,51,4,2,9,4,-55,22,4,5,324,145
338,52,2,5,4,9,22,54,6,9,346,199
338,53,3,3,5,8,32,-65,8,4,378,134
338,54,3,5,7,6,-66,51,2,5,312,185
338,55,2,5,4,9,22,54,4,9,334,239
338,56,3,3,7,6,34,-67,8,2,368,172
338,57,3,4,4,9,31,45,9,7,399,217
338,58,4,4,8,5,-56,41,3,8,343,258
338,59,3,3,6,7,33,-66,6,2,376,192
338,60,2,5,8,5,-74,50,2,2,302,242
338,61,2,5,3,10,21,55,3,7,323,297
338,62,5,2,9,4,54,22,7,9,377,319
338,63,3,3,7,6,-66,-67,1,2,311,252
338,64,3,3,5,8,32,35,3,7,343,287
338,65,2,4,4,9,22,-55,5,2,365,232
338,66,3,3,7,6,34,33,9,5,399,265
338,67,4,3,6,7,-58,34,1,9,341,299
338,68,5,2,11,2,56,20,7,9,397,319
338,69,2,5,3,10,21,-45,8,4,418,274
338,70,3,5,6,7,-67,52,1,6,351,326
338,71,2,5,2,11,20,-44,1,2,371,282
338,72,2,5,5,8,23,53,4,5,394,335
338,73,3,4,4,9,31,-55,5,0,425,280
338,74,2,5,6,7,24,52,9,2,449,332
338,75,3,4,8,5,-65,41,4,3,384,373
338,76,3,4,7,6,34,42,8,5,418,415
338,77,3,4,6,7,-67,43,1,8,351,458
338,78,2,5,2,11,20,-44,1,4,371,414
338,79,4,2,6,7,42,25,3,9,413,439
338,80,3,3,8,5,35,-68,8,1,448,371
338,81,2,4,8,5,-74,41,4,2,374,412
338,82,2,4,3,10,21,46,5,8,395,458
338,83,3,4,6,7,33,-57,8,1,428,401
338,84,2,6,2,11,20,65,8,6,448,466
338,85,3,4,7,6,-66,42,2,8,382,508
339,1,3,3,6,7,33,34,3,4,33,34
339,2,4,2,9,4,45,22,8,6,78,56
339,3,3,3,8,5,-65,32,3,8,13,88
339,4,2,5,3,10,21,-45,4,3,34,43
339,5,3,3,6,7,33,34,7,7,67,77
339,6,2,4,6,7,-76,-57,1,0,-9,20
339,7,2,5,5,8,23,53,4,3,14,73
339,8,3,3,8,5,35,32,9,5,49,105
339,9,3,4,7,6,-66,42,3,7,-17,147
339,10,4,2,7,6,43,-76,6,1,26,71
339,11,3,3,3,10,30,37,6,8,56,108
339,12,3,4,4,9,31,-55,7,3,87,53
339,13,3,4,4,9,31,45,8,8,118,98
339,14,4,2,7,6,-57,-76,1,2,61,22
339,15,3,3,8,5,35,32,6,4,96,54
339,16,3,3,8,5,-65,32,1,6,31,86
339,17,3,4,5,8,32,-56,3,0,63,30
339,18,3,3,8,5,35,32,8,2,98,62
339,19,3,3,6,7,-67,34,1,6,31,96
339,20,3,3,6,7,33,-66,4,0,64,30
339,21,4,3,7,6,43,33,7,3,107,63
339,22,3,3,6,7,-67,34,0,7,40,97
339,23,3,3,10,3,37,30,7,7,77,127
339,24,3,3,7,6,-66,-67,1,0,11,60
339,25,4,2,9,4,45,22,6,2,56,82
339,26,5,2,9,4,-46,22,0,4,10,104
339,27,4,2,7,6,43,24,3,8,53,128
339,28,3,3,4,9,31,-64,4,4,84,64
339,29,4,3,9,4,45,31,9,5,129,95
339,30,3,3,10,3,-63,30,6,5,66,125
339,31,3,3,8,5,-65,32,1,7,1,157
339,32,2,5,6,7,24,52,5,9,25,209
339,33,3,4,5,8,32,-56,7,3,57,153
339,34,2,5,3,10,21,55,8,8,78,208
339,35,3,4,5,8,-68,-56,0,2,10,152
339,36,3,4,7,6,34,42,4,4,44,194
339,37,2,6,3,10,21,64,5,8,65,258
339,38,3,4,6,7,33,-57,8,1,98,201
339,39,5,2,10,3,-45,21,3,2,53,222
339,40,4,2,9,4,45,22,8,4,98,244
339,41,3,3,6,7,-67,34,1,8,31,278
339,42,4,2,7,6,43,-76,4,2,74,202
339,43,4,3,5,8,41,35,5,7,115,237
339,44,3,4,5,8,32,-56,7,1,147,181
339,45,3,3,5,8,32,35,9,6,179,216
339,46,2,4,5,8,-77,-56,2,0,102,160
339,47,2,4,4,9,22,45,4,5,124,205
339,48,3,4,6,7,33,43,7,8,157,248
339,49,4,3,6,7,42,-66,9,2,199,182
339,50,4,3,6,7,-58,34,1,6,141,216
339,51,3,4,6,7,33,43,4,9,174,259
339,52,3,3,8,5,35,-68,9,1,209,191
339,53,3,3,5,8,-68,35,1,6,141,226
339,54,3,4,7,6,34,42,5,8,175,268
339,55,3,4,6,7,33,-57,8,1,208,211
339,56,2,4,6,7,-76,43,2,4,132,254
339,57,3,4,6,7,33,43,5,7,165,297
339,58,2,5,6,7,24,52,9,9,189,349
339,59,3,3,4,9,-69,-64,0,5,120,285
339,60,4,3,7,6,43,33,3,8,163,318
339,61,3,4,5,8,32,-56,5,2,195,262
339,62,4,2,9,4,-55,22,0,4,140,284
339,63,2,4,5,8,23,44,3,8,163,328
339,64,5,2,9,4,54,-78,7,0,217,250
339,65,3,3,7,6,-66,33,1,3,151,283
339,66,4,3,10,3,46,30,7,3,197,313
339,67,5,2,8,5,-47,23,0,6,150,336
339,68,3,4,9,4,36,40,6,6,186,376
339,69,5,2,7,6,52,-76,8,0,238,300
339,70,5,2,10,3,-45,21,3,1,193,321
339,71,3,4,4,9,31,45,4,6,224,366
339,72,4,3,9,4,45,31,9,7,269,397
339,73,4,2,10,3,-54,21,5,8,215,418
339,74,4,3,6,7,42,-66,7,2,257,352
339,75,4,3,8,5,-56,32,1,4,201,384
339,76,3,4,6,7,33,43,4,7,234,427
339,77,2,5,3,10,21,-45,5,2,255,382
339,78,2,4,4,9,22,45,7,7,277,427
339,79,4,2,7,6,-57,-76,0,1,220,351
339,80,6,2,8,5,62,23,2,4,282,374
339,81,2,5,4,9,22,54,4,8,304,428
339,82,2,4,4,9,22,-55,6,3,326,373
339,83,2,4,8,5,-74,41,2,4,252,414
339,84,2,4,8,5,26,41,8,5,278,455
339,85,4,3,9,4,-55,31,3,6,223,486
339,86,4,3,5,8,41,-65,4,1,264,421
339,87,3,4,5,8,32,44,6,5,296,465
339,88,3,4,4,9,31,-55,7,0,327,410
339,89,3,3,8,5,-65,32,2,2,262,442
339,90,3,4,8,5,35,41,7,3,297,483
339,91,2,4,5,8,-77,44,0,7,220,527
340,1,4,2,9,4,45,22,5,2,45,22
340,2,3,3,3,10,30,37,5,9,75,59
340,3,2,4,5,8,23,-56,8,3,98,3
340,4,4,3,8,5,-56,32,2,5,42,35
340,5,3,4,5,8,32,44,4,9,74,79
340,6,5,2,8,5,53,-77,7,2,127,2
340,7,3,4,6,7,-67,43,0,5,60,45
340,8,3,3,6,7,33,34,3,9,93,79
340,9,4,3,9,4,45,-69,8,0,138,10
340,10,3,4,7,6,-66,42,2,2,72,52
340,11,4,3,5,8,41,35,3,7,113,87
340,12,3,4,7,6,34,42,7,9,147,129
340,13,5,2,8,5,-47,-77,0,2,100,52
340,14,3,4,8,5,35,41,5,3,135,93
340,15,4,2,7,6,43,24,8,7,178,117
340,16,3,5,7,6,-66,51,2,8,112,168
340,17,3,3,8,5,35,-68,7,0,147,100
340,18,4,3,8,5,-56,32,1,2,91,132
340,19,4,2,7,6,43,24,4,6,134,156
340,20,5,2,9,4,54,22,8,8,188,178
340,21,4,2,8,5,-56,-77,2,1,132,101
340,22,4,2,5,8,41,26,3,7,173,127
340,23,2,5,4,9,22,-46,5,1,195,81
340,24,2,4,7,6,-75,42,0,3,120,123
340,25,3,3,4,9,31,36,1,9,151,159
340,26,3,3,9,4,36,-69,7,0,187,90
340,27,3,3,7,6,-66,33,1,3,121,123
340,28,3,4,6,7,33,43,4,6,154,166
340,29,4,2,8,5,44,23,8,9,198,189
340,30,5,2,9,4,-46,-78,2,1,152,111
340,31,4,3,9,4,45,31,7,2,197,142
340,32,3,3,9,4,-64,31,3,3,133,173
340,33,3,4,4,9,31,45,4,8,164,218
340,34,3,4,5,8,32,-56,6,2,196,162
340,35,2,6,2,11,20,65,6,7,216,227
340,36,4,2,10,3,-54,21,2,8,162,248
340,37,3,4,6,7,33,-57,5,1,195,191
340,38,5,2,7,6,52,24,7,5,247,215
340,39,3,3,5,8,32,-65,9,0,279,150
340,40,2,4,7,6,-75,42,4,2,204,192
340,41,2,5,5,8,23,53,7,5,227,245
340,42,3,4,4,9,31,-55,8,0,258,190
340,43,3,4,7,6,-66,42,2,2,192,232
340,44,2,4,8,5,26,41,8,3,218,273
340,45,3,3,6,7,-67,34,1,7,151,307
340,46,3,3,5,8,32,-65,3,2,183,242
340,47,3,4,8,5,35,41,8,3,218,283
340,48,3,4,9,4,-64,40,4,3,154,323
340,49,3,4,6,7,33,43,7,6,187,366
340,50,2,6,2,11,20,-35,7,1,207,331
340,51,3,3,7,6,-66,33,1,4,141,364
340,52,3,3,6,7,33,34,4,8,174,398
340,53,2,5,3,10,21,-45,5,3,195,353
340,54,2,4,6,7,24,43,9,6,219,396
340,55,2,4,4,9,-78,-55,1,1,141,341
340,56,4,2,9,4,45,22,6,3,186,363
340,57,4,3,8,5,-56,32,0,5,130,395
340,58,2,4,7,6,25,42,5,7,155,437
340,59,2,5,4,9,22,-46,7,1,177,391
340,60,3,3,7,6,-66,33,1,4,111,424
340,61,4,3,5,8,41,35,2,9,152,459
340,62,4,3,5,8,41,-65,3,4,193,394
340,63,3,4,8,5,35,41,8,5,228,435
340,64,3,3,5,8,-68,-65,0,0,160,370
340,65,4,3,5,8,41,35,1,5,201,405
340,66,3,4,7,6,34,42,5,7,235,447
340,67,2,4,4,9,22,-55,7,2,257,392
340,68,4,2,5,8,41,26,8,8,298,418
340,69,3,3,7,6,-66,-67,2,1,232,351
340,70,3,3,5,8,32,35,4,6,264,386
340,71,4,3,9,4,45,31,9,7,309,417
340,72,4,3,10,3,-54,30,5,7,255,447
340,73,3,3,5,8,32,-65,7,2,287,382
340,74,2,6,3,10,21,64,8,6,308,446
340,75,3,3,5,8,-68,-65,0,1,240,381
340,76,4,3,7,6,43,33,3,4,283,414
340,77,5,3,8,5,53,32,6,6,336,446
340,78,3,3,8,5,-65,32,1,8,271,478
340,79,4,2,8,5,44,-77,5,1,315,401
340,80,4,3,7,6,43,33,8,4,358,434
340,81,2,5,3,10,21,55,9,9,379,489
340,82,4,2,10,3,-54,-79,5,0,325,410
340,83,3,3,5,8,32,35,7,5,357,445
340,84,2,5,2,11,20,-44,7,1,377,401
340,85,2,5,4,9,22,54,9,5,399,455
340,86,4,2,9,4,-55,22,4,7,344,477
340,87,4,3,8,5,44,32,8,9,388,509
341,1,4,3,7,6,43,33,3,3,43,33
341,2,3,3,7,6,34,33,7,6,77,66
341,3,2,5,4,9,22,-46,9,0,99,20
341,4,3,3,8,5,-65,32,4,2,34,52
341,5,4,3,5,8,41,35,5,7,75,87
341,6,2,4,5,8,23,-56,8,1,98,31
341,7,2,5,5,8,-77,53,1,4,21,84
341,8,2,5,6,7,24,52,5,6,45,136
341,9,2,5,7,6,-75,51,0,7,-30,187
341,10,3,3,7,6,34,-67,4,0,4,120
341,11,2,5,5,8,23,53,7,3,27,173
341,12,3,3,6,7,-67,34,0,7,-40,207
341,13,2,4,6,7,24,-57,4,0,-16,150
341,14,3,3,8,5,35,32,9,2,19,182
341,15,3,3,8,5,-65,32,4,4,-46,214
341,16,6,2,9,4,63,22,7,6,17,236
341,17,4,3,9,4,-55,31,2,7,-38,267
341,18,3,4,5,8,32,-56,4,1,-6,211
341,19,5,3,6,7,51,34,5,5,45,245
341,20,2,4,6,7,24,43,9,8,69,288
341,21,4,3,6,7,-58,-66,1,2,11,222
341,22,3,4,6,7,33,43,4,5,44,265
341,23,4,3,9,4,45,31,9,6,89,296
341,24,4,3,8,5,-56,32,3,8,33,328
341,25,2,5,2,11,20,-44,3,4,53,284
341,26,6,2,10,3,64,21,7,5,117,305
341,27,3,3,7,6,-66,33,1,8,51,338
341,28,3,3,6,7,33,-66,4,2,84,272
341,29,3,3,6,7,33,34,7,6,117,306
341,30,2,4,4,9,22,-55,9,1,139,251
341,31,2,4,6,7,-76,43,3,4,63,294
341,32,4,4,8,5,44,41,7,5,107,335
341,33,3,4,4,9,31,-55,8,0,138,280
341,34,3,3,8,5,-65,32,3,2,73,312
341,35,4,3,9,4,45,31,8,3,118,343
341,36,2,4,4,9,-78,45,0,8,40,388
341,37,3,3,3,10,30,-63,0,5,70,325
341,38,2,4,5,8,23,44,3,9,93,369
341,39,5,2,10,3,55,-79,8,0,148,290
341,40,4,4,7,6,-57,42,1,2,91,332
341,41,2,4,5,8,23,44,4,6,114,376
341,42,3,3,4,9,31,-64,5,2,145,312
341,43,5,2,7,6,52,24,7,6,197,336
341,44,5,3,7,6,52,33,9,9,249,369
341,45,4,2,7,6,-57,-76,2,3,192,293
341,46,2,5,6,7,24,52,6,5,216,345
341,47,3,4,8,5,-65,41,1,6,151,386
341,48,5,2,7,6,52,-76,3,0,203,310
341,49,5,2,9,4,54,22,7,2,257,332
341,50,3,3,6,7,-67,34,0,6,190,366
341,51,2,4,3,10,21,-54,1,2,211,312
341,52,3,4,4,9,31,45,2,7,242,357
341,53,3,5,5,8,32,-47,4,0,274,310
341,54,3,4,5,8,32,44,6,4,306,354
341,55,3,4,5,8,32,44,8,8,338,398
341,56,4,3,7,6,-57,-67,1,1,281,331
341,57,4,3,8,5,44,32,5,3,325,363
341,58,5,2,8,5,53,23,8,6,378,386
341,59,2,5,3,10,21,-45,9,1,399,341
341,60,3,3,5,8,-68,35,1,6,331,376
341,61,5,2,9,4,54,22,5,8,385,398
341,62,5,2,8,5,53,-77,8,1,438,321
341,63,6,2,8,5,-38,23,0,4,400,344
341,64,3,3,7,6,34,33,4,7,434,377
341,65,4,2,6,7,42,-75,6,2,476,302
341,66,3,4,8,5,-65,41,1,3,411,343
341,67,5,2,10,3,55,21,6,4,466,364
341,68,3,4,6,7,33,43,9,7,499,407
341,69,3,3,6,7,-67,-66,2,1,432,341
341,70,4,2,9,4,45,22,7,3,477,363
341,71,5,2,9,4,-46,22,1,5,431,385
341,72,5,2,9,4,54,22,5,7,485,407
341,73,5,2,6,7,51,-75,6,2,536,332
342,1,3,4,3,10,30,46,0,6,30,46
342,2,3,3,7,6,34,33,4,9,64,79
342,3,4,3,6,7,42,-66,6,3,106,13
342,4,3,4,7,6,-66,42,0,5,40,55
342,5,4,2,8,5,44,23,4,8,84,78
342,6,4,2,9,4,45,-78,9,0,129,0
342,7,4,3,6,7,-58,34,1,4,71,34
342,8,3,4,5,8,32,44,3,8,103,78
342,9,4,2,8,5,44,-77,7,1,147,1
342,10,5,2,8,5,-47,23,0,4,100,24
342,11,2,4,5,8,23,44,3,8,123,68
342,12,4,4,6,7,42,-57,5,1,165,11
342,13,3,3,7,6,34,33,9,4,199,44
342,14,2,4,5,8,-77,44,2,8,122,88
342,15,3,3,5,8,32,-65,4,3,154,23
342,16,3,3,9,4,-64,31,0,4,90,54
342,17,3,4,5,8,32,44,2,8,122,98
342,18,4,3,5,8,41,-65,3,3,163,33
342,19,2,5,3,10,21,55,4,8,184,88
342,20,2,5,3,10,21,-45,5,3,205,43
342,21,3,3,10,3,-63,30,2,3,142,73
342,22,4,3,4,9,40,36,2,9,182,109
342,23,5,2,11,2,56,20,8,9,238,129
342,24,4,3,7,6,-57,-67,1,2,181,62
342,25,2,5,5,8,23,53,4,5,204,115
342,26,3,3,7,6,34,33,8,8,238,148
342,27,4,3,6,7,-58,-66,0,2,180,82
342,28,2,4,4,9,22,45,2,7,202,127
342,29,3,4,4,9,31,-55,3,2,233,72
342,30,6,2,10,3,64,21,7,3,297,93
342,31,2,4,5,8,-77,44,0,7,220,137
342,32,2,4,4,9,22,-55,2,2,242,82
342,33,4,3,9,4,45,31,7,3,287,113
342,34,2,5,6,7,-76,52,1,5,211,165
342,35,4,3,8,5,44,32,5,7,255,197
342,36,3,4,8,5,-65,41,0,8,190,238
342,37,2,6,3,10,21,-36,1,2,211,202
342,38,3,3,7,6,34,33,5,5,245,235
342,39,3,3,6,7,33,34,8,9,278,269
342,40,4,3,8,5,-56,-68,2,1,222,201
342,41,3,3,7,6,34,33,6,4,256,234
342,42,3,3,5,8,32,35,8,9,288,269
342,43,2,5,3,10,21,-45,9,4,309,224
342,44,3,4,6,7,-67,43,2,7,242,267
342,45,6,2,10,3,64,21,6,8,306,288
342,46,2,4,4,9,22,-55,8,3,328,233
342,47,2,4,3,10,21,46,9,9,349,279
342,48,5,2,7,6,-48,-76,1,3,301,203
342,49,2,5,5,8,23,53,4,6,324,256
342,50,3,5,6,7,33,52,7,8,357,308
342,51,4,4,7,6,-57,-58,0,0,300,250
342,52,3,3,6,7,33,34,3,4,333,284
342,53,3,4,7,6,34,42,7,6,367,326
342,54,3,3,7,6,-66,33,1,9,301,359
342,55,2,4,4,9,22,-55,3,4,323,304
342,56,3,3,8,5,35,32,8,6,358,336
342,57,4,3,8,5,-56,32,2,8,302,368
342,58,3,3,6,7,33,-66,5,2,335,302
342,59,2,5,2,11,20,56,5,8,355,358
342,60,4,2,6,7,42,-75,7,3,397,283
342,61,3,3,8,5,-65,32,2,5,332,315
342,62,4,3,6,7,42,34,4,9,374,349
342,63,4,2,7,6,43,-76,7,3,417,273
342,64,4,4,4,9,40,45,7,8,457,318
342,65,2,5,5,8,-77,-47,0,1,380,271
342,66,5,2,8,5,53,23,3,4,433,294
342,67,4,3,6,7,42,34,5,8,475,328
342,68,4,3,5,8,41,-65,6,3,516,263
343,1,2,5,3,10,21,55,1,5,21,55
343,2,4,2,5,8,41,-74,2,1,62,-19
343,3,2,4,7,6,25,42,7,3,87,23
343,4,4,3,9,4,-55,31,2,4,32,54
343,5,4,3,9,4,45,31,7,5,77,85
343,6,5,2,10,3,-45,21,2,6,32,106
343,7,4,2,9,4,45,22,7,8,77,128
343,8,4,4,5,8,41,-56,8,2,118,72
343,9,2,5,6,7,-76,52,2,4,42,124
343,10,2,5,5,8,23,53,5,7,65,177
343,11,4,2,7,6,43,-76,8,1,108,101
343,12,3,4,8,5,-65,41,3,2,43,142
343,13,2,5,3,10,21,55,4,7,64,197
343,14,5,2,8,5,53,-77,7,0,117,120
343,15,3,3,5,8,32,35,9,5,149,155
343,16,4,3,8,5,-56,32,3,7,93,187
343,17,4,3,7,6,43,-67,6,0,136,120
343,18,5,2,9,4,-46,22,0,2,90,142
343,19,3,3,7,6,34,33,4,5,124,175
343,20,4,3,9,4,45,31,9,6,169,206
343,21,2,4,4,9,-78,-55,1,1,91,151
343,22,2,5,2,11,20,56,1,7,111,207
343,23,2,4,7,6,25,42,6,9,136,249
343,24,4,3,7,6,43,-67,9,2,179,182
343,25,2,4,7,6,-75,42,4,4,104,224
343,26,2,4,7,6,25,42,9,6,129,266
343,27,4,2,4,9,40,-73,9,3,169,193
343,28,4,3,6,7,-58,34,1,7,111,227
343,29,3,4,6,7,33,-57,4,0,144,170
343,30,3,4,7,6,34,42,8,2,178,212
343,31,3,3,6,7,-67,34,1,6,111,246
343,32,4,2,9,4,45,22,6,8,156,268
343,33,3,4,9,4,-64,40,2,8,92,308
343,34,5,3,7,6,52,-67,4,1,144,241
343,35,3,3,4,9,31,36,5,7,175,277
343,36,2,5,3,10,21,-45,6,2,196,232
343,37,3,4,8,5,-65,41,1,3,131,273
343,38,3,3,5,8,32,35,3,8,163,308
343,39,3,4,7,6,34,-58,7,0,197,250
343,40,3,4,7,6,-66,42,1,2,131,292
343,41,4,2,7,6,43,24,4,6,174,316
343,42,4,2,8,5,44,23,8,9,218,339
343,43,5,2,10,3,-45,-79,3,0,173,260
343,44,3,3,6,7,33,34,6,4,206,294
343,45,3,3,5,8,32,35,8,9,238,329
343,46,4,2,6,7,-58,-75,0,4,180,254
343,47,3,4,4,9,31,45,1,9,211,299
343,48,4,3,7,6,43,-67,4,2,254,232
343,49,4,3,9,4,45,31,9,3,299,263
343,50,2,5,3,10,-79,55,0,8,220,318
343,51,2,4,4,9,22,-55,2,3,242,263
343,52,2,5,4,9,22,54,4,7,264,317
343,53,2,4,5,8,23,-56,7,1,287,261
343,54,4,3,8,5,-56,32,1,3,231,293
343,55,3,4,5,8,32,44,3,7,263,337
343,56,3,4,4,9,31,-55,4,2,294,282
343,57,3,3,8,5,35,32,9,4,329,314
343,58,2,6,4,9,-78,63,1,7,251,377
343,59,4,2,9,4,45,22,6,9,296,399
343,60,3,4,5,8,32,-56,8,3,328,343
343,61,3,4,9,4,-64,40,4,3,264,383
343,62,3,3,7,6,34,33,8,6,298,416
343,63,6,2,10,3,-36,21,2,7,262,437
343,64,3,4,7,6,34,42,6,9,296,479
343,65,3,3,6,7,33,-66,9,3,329,413
343,66,2,5,6,7,-76,52,3,5,253,465
343,67,6,2,8,5,62,23,5,8,315,488
343,68,4,3,8,5,44,-68,9,0,359,420
343,69,3,3,8,5,-65,32,4,2,294,452
343,70,3,4,5,8,32,44,6,6,326,496
343,71,4,2,10,3,-54,21,2,7,272,517
344,1,3,3,3,10,30,37,0,7,30,37
344,2,2,4,6,7,24,-57,4,0,54,-20
344,3,3,3,8,5,35,32,9,2,89,12
344,4,4,3,8,5,-56,32,3,4,33,44
344,5,3,3,7,6,34,33,7,7,67,77
344,6,4,3,5,8,41,-65,8,2,108,12
344,7,4,2,8,5,-56,23,2,5,52,35
344,8,3,3,8,5,35,32,7,7,87,67
344,9,5,2,9,4,-46,22,1,9,41,89
344,10,3,4,5,8,32,-56,3,3,73,33
344,11,2,4,4,9,22,45,5,8,95,78
344,12,3,4,8,5,-65,41,0,9,30,119
344,13,2,4,6,7,24,-57,4,2,54,62
344,14,2,4,6,7,24,43,8,5,78,105
344,15,2,5,6,7,-76,52,2,7,2,157
344,16,3,4,5,8,32,-56,4,1,34,101
344,17,5,3,9,4,54,31,8,2,88,132
344,18,2,4,3,10,21,46,9,8,109,178
344,19,3,5,4,9,-69,-46,0,2,40,132
344,20,3,4,4,9,31,45,1,7,71,177
344,21,2,5,4,9,22,-46,3,1,93,131
344,22,3,4,5,8,32,44,5,5,125,175
344,23,4,3,8,5,44,32,9,7,169,207
344,24,3,4,4,9,-69,-55,0,2,100,152
344,25,2,4,4,9,22,45,2,7,122,197
344,26,5,2,6,7,51,-75,3,2,173,122
344,27,3,3,6,7,33,34,6,6,206,156
344,28,4,3,7,6,43,33,9,9,249,189
344,29,3,4,5,8,-68,-56,1,3,181,133
344,30,2,5,5,8,23,53,4,6,204,186
344,31,2,4,3,10,21,-54,5,2,225,132
344,32,3,4,6,7,33,43,8,5,258,175
344,33,3,4,5,8,-68,44,0,9,190,219
344,34,3,3,6,7,33,-66,3,3,223,153
344,35,3,3,8,5,35,32,8,5,258,185
344,36,2,6,2,11,20,-35,8,0,278,150
344,37,2,4,3,10,21,46,9,6,299,196
344,38,2,5,6,7,-76,52,3,8,223,248
344,39,2,5,3,10,21,-45,4,3,244,203
344,40,3,3,6,7,33,34,7,7,277,237
344,41,4,2,10,3,-54,21,3,8,223,258
344,42,3,4,6,7,33,-57,6,1,256,201
344,43,3,4,6,7,33,43,9,4,289,244
344,44,4,2,10,3,-54,21,5,5,235,265
344,45,2,6,3,10,21,64,6,9,256,329
344,46,4,3,7,6,43,-67,9,2,299,262
344,47,3,3,5,8,-68,35,1,7,231,297
344,48,4,2,7,6,43,-76,4,1,274,221
344,49,4,2,7,6,43,24,7,5,317,245
344,50,3,3,8,5,-65,32,2,7,252,277
344,51,4,3,9,4,45,31,7,8,297,308
344,52,3,4,7,6,-66,-58,1,0,231,250
344,53,5,2,7,6,52,24,3,4,283,274
344,54,3,4,8,5,35,41,8,5,318,315
344,55,3,3,10,3,-63,30,5,5,255,345
344,56,4,3,6,7,42,34,7,9,297,379
344,57,3,4,6,7,-67,-57,0,2,230,322
344,58,4,3,8,5,44,32,4,4,274,354
344,59,2,4,5,8,23,44,7,8,297,398
344,60,3,3,5,8,32,-65,9,3,329,333
344,61,2,4,5,8,-77,44,2,7,252,377
344,62,2,4,5,8,23,-56,5,1,275,321
344,63,3,4,3,10,30,46,5,7,305,367
344,64,3,3,5,8,32,-65,7,2,337,302
344,65,3,3,5,8,32,35,9,7,369,337
344,66,4,3,7,6,-57,-67,2,0,312,270
344,67,3,4,7,6,34,42,6,2,346,312
344,68,4,2,7,6,43,24,9,6,389,336
344,69,4,4,6,7,-58,43,1,9,331,379
344,70,2,4,6,7,24,-57,5,2,355,322
344,71,3,4,4,9,31,45,6,7,386,367
344,72,3,4,7,6,-66,42,0,9,320,409
344,73,3,3,7,6,34,-67,4,2,354,342
344,74,5,2,9,4,54,22,8,4,408,364
344,75,4,3,5,8,41,35,9,9,449,399
344,76,4,3,8,5,-56,-68,3,1,393,331
344,77,3,3,4,9,31,36,4,7,424,367
344,78,2,5,3,10,21,-45,5,2,445,322
344,79,3,3,7,6,34,33,9,5,479,355
344,80,6,2,10,3,-36,21,3,6,443,376
344,81,3,4,5,8,32,-56,5,0,475,320
344,82,3,3,5,8,32,35,7,5,507,355
345,1,4,3,6,7,42,34,2,4,42,34
345,2,2,5,4,9,22,54,4,8,64,88
345,3,5,2,10,3,55,21,9,9,119,109
345,4,6,2,10,3,-36,-79,3,0,83,30
345,5,3,3,7,6,34,33,7,3,117,63
345,6,3,4,3,10,30,46,7,9,147,109
345,7,5,2,9,4,-46,-78,1,1,101,31
345,8,4,2,8,5,44,23,5,4,145,54
345,9,4,3,7,6,43,33,8,7,188,87
345,10,3,3,8,5,-65,32,3,9,123,119
345,11,4,2,7,6,43,-76,6,3,166,43
345,12,5,3,9,4,-46,31,0,4,120,74
345,13,3,4,6,7,33,43,3,7,153,117
345,14,3,4,6,7,33,-57,6,0,186,60
345,15,3,3,5,8,32,35,8,5,218,95
345,16,2,5,5,8,-77,53,1,8,141,148
345,17,2,4,3,10,21,-54,2,4,162,94
345,18,4,3,6,7,42,34,4,8,204,128
345,19,3,3,8,5,35,-68,9,0,239,60
345,20,3,3,7,6,-66,33,3,3,173,93
345,21,3,4,5,8,32,44,5,7,205,137
345,22,4,3,8,5,44,32,9,9,249,169
345,23,2,4,3,10,-79,-54,0,5,170,115
345,24,2,5,3,10,21,-45,1,0,191,70
345,25,2,4,6,7,24,43,5,3,215,113
345,26,4,2,6,7,42,25,7,8,257,138
345,27,3,4,6,7,-67,-57,0,1,190,81
345,28,4,3,10,3,46,30,6,1,236,111
345,29,5,2,11,2,-44,20,2,1,192,131
345,30,3,5,7,6,34,51,6,2,226,182
345,31,2,5,3,10,21,55,7,7,247,237
345,32,4,3,7,6,-57,-67,0,0,190,170
345,33,3,4,8,5,35,41,5,1,225,211
345,34,2,5,3,10,21,55,6,6,246,266
345,35,2,5,4,9,22,-46,8,0,268,220
345,36,4,2,9,4,-55,22,3,2,213,242
345,37,2,5,4,9,22,54,5,6,235,296
345,38,5,2,9,4,54,22,9,8,289,318
345,39,4,2,8,5,-56,-77,3,1,233,241
345,40,3,3,7,6,34,33,7,4,267,274
345,41,4,2,10,3,-54,21,3,5,213,295
345,42,4,2,11,2,-53,20,0,5,160,315
345,43,4,2,10,3,46,21,6,6,206,336
345,44,3,3,7,6,-66,33,0,9,140,369
345,45,3,3,4,9,31,-64,1,5,171,305
345,46,4,3,7,6,43,33,4,8,214,338
345,47,3,3,5,8,32,-65,6,3,246,273
345,48,2,4,5,8,23,44,9,7,269,317
345,49,2,4,8,5,-74,41,5,8,195,358
345,50,4,3,6,7,42,-66,7,2,237,292
345,51,3,4,6,7,-67,43,0,5,170,335
345,52,4,2,6,7,42,-75,2,0,212,260
345,53,2,4,5,8,23,44,5,4,235,304
345,54,3,4,7,6,34,42,9,6,269,346
345,55,3,4,5,8,-68,-56,1,0,201,290
345,56,2,5,4,9,22,54,3,4,223,344
345,57,2,6,5,8,23,62,6,6,246,406
345,58,3,4,6,7,33,43,9,9,279,449
345,59,6,2,11,2,-35,20,4,9,244,469
345,60,2,5,5,8,23,-47,7,2,267,422
345,61,2,4,7,6,-75,42,2,4,192,464
345,62,4,3,6,7,42,34,4,8,234,498
345,63,2,5,7,6,25,51,9,9,259,549
346,1,2,4,4,9,22,45,2,5,22,45
346,2,3,3,7,6,34,33,6,8,56,78
346,3,4,2,10,3,-54,21,2,9,2,99
346,4,4,3,8,5,44,-68,6,1,46,31
346,5,3,4,6,7,33,43,9,4,79,74
346,6,5,2,10,3,-45,21,4,5,34,95
346,7,2,5,4,9,22,54,6,9,56,149
346,8,4,2,9,4,-55,-78,1,1,1,71
346,9,3,4,4,9,31,45,2,6,32,116
346,10,3,3,6,7,33,-66,5,0,65,50
346,11,2,5,5,8,23,53,8,3,88,103
346,12,2,4,5,8,-77,44,1,7,11,147
346,13,4,3,7,6,43,-67,4,0,54,80
346,14,4,3,7,6,43,33,7,3,97,113
346,15,4,3,7,6,-57,33,0,6,40,146
346,16,2,4,2,11,20,-53,0,3,60,93
346,17,2,5,6,7,24,52,4,5,84,145
346,18,5,2,5,8,50,-74,4,1,134,71
346,19,2,4,8,5,-74,41,0,2,60,112
346,20,5,2,10,3,55,21,5,3,115,133
346,21,4,3,9,4,-55,31,0,4,60,164
346,22,3,4,7,6,34,42,4,6,94,206
346,23,4,3,7,6,43,33,7,9,137,239
346,24,3,3,9,4,-64,-69,3,0,73,170
346,25,2,5,4,9,22,54,5,4,95,224
346,26,2,5,2,11,20,-44,5,0,115,180
346,27,4,3,8,5,44,32,9,2,159,212
346,28,2,5,6,7,-76,52,3,4,83,264
346,29,5,2,8,5,53,23,6,7,136,287
346,30,3,3,5,8,32,-65,8,2,168,222
346,31,4,2,6,7,-58,25,0,7,110,247
346,32,5,2,10,3,55,21,5,8,165,268
346,33,4,2,9,4,-55,-78,0,0,110,190
346,34,4,2,8,5,44,23,4,3,154,213
346,35,4,4,7,6,43,42,7,5,197,255
346,36,3,3,5,8,32,-65,9,0,229,190
346,37,2,5,3,10,-79,55,0,5,150,245
346,38,3,3,5,8,32,-65,2,0,182,180
346,39,3,4,5,8,32,44,4,4,214,224
346,40,5,2,11,2,-44,20,0,4,170,244
346,41,6,2,10,3,64,21,4,5,234,265
346,42,4,3,9,4,45,31,9,6,279,296
346,43,3,3,9,4,-64,31,5,7,215,327
346,44,3,3,7,6,34,-67,9,0,249,260
346,45,3,3,6,7,-67,34,2,4,182,294
346,46,2,4,5,8,23,44,5,8,205,338
346,47,5,2,9,4,54,-78,9,0,259,260
346,48,4,2,9,4,-55,22,4,2,204,282
346,49,4,3,10,3,-54,30,0,2,150,312
346,50,3,4,7,6,34,42,4,4,184,354
346,51,3,4,8,5,35,41,9,5,219,395
346,52,5,2,7,6,-48,24,1,9,171,419
346,53,3,4,7,6,34,-58,5,1,205,361
346,54,3,4,5,8,32,44,7,5,237,405
346,55,3,3,6,7,-67,34,0,9,170,439
346,56,3,4,3,10,30,-54,0,5,200,385
346,57,5,2,6,7,51,-75,1,0,251,310
346,58,3,3,7,6,34,33,5,3,285,343
346,59,3,3,6,7,33,34,8,7,318,377
346,60,3,4,7,6,-66,42,2,9,252,419
346,61,4,3,4,9,40,-64,2,5,292,355
346,62,2,5,5,8,23,53,5,8,315,408
346,63,4,3,8,5,44,-68,9,0,359,340
346,64,4,3,9,4,-55,31,4,1,304,371
346,65,3,5,7,6,34,51,8,2,338,422
346,66,4,3,7,6,-57,33,1,5,281,455
346,67,4,2,10,3,46,21,7,6,327,476
346,68,5,2,11,2,-44,20,3,6,283,496
346,69,5,2,8,5,53,23,6,9,336,519
347,1,5,3,8,5,53,32,3,2,53,32
347,2,5,2,8,5,53,23,6,5,106,55
347,3,5,3,8,5,53,32,9,7,159,87
347,4,3,3,6,7,-67,-66,2,1,92,21
347,5,2,4,4,9,22,45,4,6,114,66
347,6,3,3,5,8,32,-65,6,1,146,1
347,7,3,3,6,7,33,34,9,5,179,35
347,8,4,3,8,5,-56,32,3,7,123,67
347,9,3,3,6,7,33,-66,6,1,156,1
347,10,4,2,8,5,-56,23,0,4,100,24
347,11,4,3,7,6,43,33,3,7,143,57
347,12,3,3,9,4,36,31,9,8,179,88
347,13,3,3,6,7,-67,-66,2,2,112,22
347,14,3,4,5,8,32,44,4,6,144,66
347,15,4,3,7,6,43,33,7,9,187,99
347,16,3,3,8,5,-65,-68,2,1,122,31
347,17,2,4,6,7,24,43,6,4,146,74
347,18,4,2,9,4,-55,22,1,6,91,96
347,19,3,3,9,4,36,31,7,7,127,127
347,20,3,3,5,8,32,-65,9,2,159,62
347,21,2,5,4,9,-78,54,1,6,81,116
347,22,2,5,4,9,22,-46,3,0,103,70
347,23,3,4,5,8,32,44,5,4,135,114
347,24,6,2,9,4,63,22,8,6,198,136
347,25,4,4,5,8,41,-56,9,0,239,80
347,26,3,3,7,6,-66,33,3,3,173,113
347,27,3,3,10,3,-63,30,0,3,110,143
347,28,3,4,5,8,32,44,2,7,142,187
347,29,5,2,8,5,53,-77,5,0,195,110
347,30,2,4,2,11,20,47,5,7,215,157
347,31,3,4,8,5,-65,41,0,8,150,198
347,32,4,3,7,6,43,-67,3,1,193,131
347,33,3,3,7,6,34,33,7,4,227,164
347,34,3,4,5,8,32,44,9,8,259,208
347,35,4,3,10,3,-54,30,5,8,205,238
347,36,3,3,7,6,34,-67,9,1,239,171
347,37,2,4,6,7,-76,43,3,4,163,214
347,38,3,4,6,7,33,43,6,7,196,257
347,39,3,3,7,6,-66,-67,0,0,130,190
347,40,4,2,7,6,43,24,3,4,173,214
347,41,4,3,8,5,44,32,7,6,217,246
347,42,4,3,4,9,40,-64,7,2,257,182
347,43,3,4,8,5,-65,41,2,3,192,223
347,44,4,2,8,5,44,23,6,6,236,246
347,45,3,3,9,4,-64,31,2,7,172,277
347,46,3,3,4,9,31,-64,3,3,203,213
347,47,3,3,8,5,35,32,8,5,238,245
347,48,5,2,10,3,-45,21,3,6,193,266
347,49,3,3,5,8,32,-65,5,1,225,201
347,50,2,4,6,7,24,43,9,4,249,244
347,51,3,3,6,7,-67,34,2,8,182,278
347,52,3,3,6,7,33,-66,5,2,215,212
347,53,4,2,11,2,-53,20,2,2,162,232
347,54,4,3,6,7,42,34,4,6,204,266
347,55,3,4,7,6,34,42,8,8,238,308
347,56,4,2,7,6,-57,-76,1,2,181,232
347,57,3,4,5,8,32,44,3,6,213,276
347,58,3,4,7,6,34,42,7,8,247,318
347,59,3,5,5,8,32,-47,9,1,279,271
347,60,2,4,5,8,-77,44,2,5,202,315
347,61,3,3,6,7,33,34,5,9,235,349
347,62,4,3,8,5,44,-68,9,1,279,281
347,63,3,4,7,6,-66,42,3,3,213,323
347,64,5,2,9,4,54,22,7,5,267,345
347,65,3,3,9,4,-64,31,3,6,203,376
347,66,4,3,8,5,44,32,7,8,247,408
347,67,6,2,11,2,-35,20,2,8,212,428
347,68,4,2,6,7,42,-75,4,3,254,353
347,69,5,2,9,4,54,22,8,5,308,375
347,70,4,2,8,5,-56,23,2,8,252,398
347,71,3,3,10,3,37,30,9,8,289,428
347,72,4,3,9,4,-55,31,4,9,234,459
347,73,4,2,7,6,43,-76,7,3,277,383
347,74,4,4,7,6,-57,42,0,5,220,425
347,75,4,3,10,3,46,30,6,5,266,455
347,76,3,3,6,7,33,34,9,9,299,489
347,77,5,2,12,1,-43,-20,6,9,256,469
347,78,2,5,3,10,21,-45,7,4,277,424
347,79,5,3,10,3,-45,30,2,4,232,454
347,80,2,5,5,8,23,53,5,7,255,507
348,1,4,2,9,4,45,22,5,2,45,22
348,2,3,3,5,8,32,35,7,7,77,57
348,3,2,5,5,8,-77,-47,0,0,0,10
348,4,2,5,5,8,23,53,3,3,23,63
348,5,3,4,3,10,30,46,3,9,53,109
348,6,4,3,7,6,43,-67,6,2,96,42
348,7,2,4,5,8,23,44,9,6,119,86
348,8,3,3,7,6,-66,33,3,9,53,119
348,9,4,4,7,6,43,-58,6,1,96,61
348,10,5,2,9,4,-46,22,0,3,50,83
348,11,2,6,3,10,21,64,1,7,71,147
348,12,5,2,10,3,55,21,6,8,126,168
348,13,2,4,5,8,23,-56,9,2,149,112
348,14,4,3,9,4,-55,31,4,3,94,143
348,15,2,5,3,10,21,55,5,8,115,198
348,16,2,4,7,6,-75,-58,0,0,40,140
348,17,3,3,7,6,34,33,4,3,74,173
348,18,3,3,9,4,-64,31,0,4,10,204
348,19,5,2,7,6,52,24,2,8,62,228
348,20,4,3,9,4,45,31,7,9,107,259
348,21,3,3,8,5,-65,-68,2,1,42,191
348,22,4,3,6,7,42,34,4,5,84,225
348,23,4,3,7,6,43,33,7,8,127,258
348,24,2,4,3,10,21,-54,8,4,148,204
348,25,5,2,9,4,-46,22,2,6,102,226
348,26,2,5,4,9,22,-46,4,0,124,180
348,27,6,2,10,3,64,21,8,1,188,201
348,28,3,3,9,4,-64,31,4,2,124,232
348,29,3,4,7,6,34,42,8,4,158,274
348,30,3,3,6,7,-67,34,1,8,91,308
348,31,4,2,8,5,44,-77,5,1,135,231
348,32,4,2,7,6,43,24,8,5,178,255
348,33,2,5,3,10,21,-45,9,0,199,210
348,34,4,2,9,4,-55,22,4,2,144,232
348,35,4,2,7,6,43,24,7,6,187,256
348,36,4,3,8,5,-56,32,1,8,131,288
348,37,5,2,8,5,53,-77,4,1,184,211
348,38,4,4,7,6,43,42,7,3,227,253
348,39,4,3,9,4,-55,31,2,4,172,284
348,40,3,3,6,7,33,34,5,8,205,318
348,41,2,5,5,8,23,-47,8,1,228,271
348,42,4,3,8,5,-56,32,2,3,172,303
348,43,4,2,7,6,43,24,5,7,215,327
348,44,4,2,6,7,42,-75,7,2,257,252
348,45,2,5,3,10,21,55,8,7,278,307
348,46,3,3,5,8,-68,-65,0,2,210,242
348,47,4,3,8,5,44,32,4,4,254,274
348,48,3,3,7,6,34,33,8,7,288,307
348,49,3,4,5,8,-68,-56,0,1,220,251
348,50,6,2,9,4,63,22,3,3,283,273
348,51,4,3,5,8,41,35,4,8,324,308
348,52,2,4,6,7,24,-57,8,1,348,251
348,53,5,2,9,4,-46,22,2,3,302,273
348,54,3,4,8,5,35,41,7,4,337,314
348,55,5,2,9,4,-46,22,1,6,291,336
348,56,2,5,6,7,24,52,5,8,315,388
348,57,4,3,6,7,42,-66,7,2,357,322
348,58,4,2,9,4,-55,22,2,4,302,344
348,59,4,3,8,5,44,32,6,6,346,376
348,60,4,2,7,6,43,-76,9,0,389,300
348,61,3,4,5,8,-68,44,1,4,321,344
348,62,2,4,6,7,24,43,5,7,345,387
348,63,2,4,7,6,-75,42,0,9,270,429
348,64,4,2,9,4,45,-78,5,1,315,351
348,65,2,4,6,7,24,43,9,4,339,394
348,66,2,4,5,8,-77,44,2,8,262,438
348,67,3,3,6,7,33,-66,5,2,295,372
348,68,3,3,7,6,34,33,9,5,329,405
348,69,3,4,8,5,-65,41,4,6,264,446
348,70,2,4,6,7,24,43,8,9,288,489
348,71,5,2,10,3,-45,-79,3,0,243,410
348,72,3,3,6,7,33,34,6,4,276,444
348,73,4,2,6,7,42,25,8,9,318,469
348,74,2,5,3,10,21,-45,9,4,339,424
348,75,5,2,10,3,-45,21,4,5,294,445
348,76,5,2,10,3,55,21,9,6,349,466
348,77,3,4,9,4,-64,40,5,6,285,506
349,1,3,3,5,8,32,35,2,5,32,35
349,2,4,2,8,5,44,23,6,8,76,58
349,3,4,2,8,5,-56,-77,0,1,20,-19
349,4,3,3,5,8,32,35,2,6,52,16
349,5,3,3,8,5,35,32,7,8,87,48
349,6,3,4,6,7,-67,-57,0,1,20,-9
349,7,2,5,7,6,25,51,5,2,45,42
349,8,3,4,7,6,34,42,9,4,79,84
349,9,4,4,7,6,-57,42,2,6,22,126
349,10,4,2,8,5,44,23,6,9,66,149
349,11,2,4,5,8,23,-56,9,3,89,93
349,12,4,2,5,8,-59,26,0,9,30,119
349,13,4,2,10,3,46,-79,6,0,76,40
349,14,3,4,6,7,33,43,9,3,109,83
349,15,3,3,6,7,-67,34,2,7,42,117
349,16,2,4,6,7,24,-57,6,0,66,60
349,17,3,3,4,9,31,36,7,6,97,96
349,18,4,2,5,8,41,-74,8,2,138,22
349,19,3,3,7,6,-66,33,2,5,72,55
349,20,4,4,6,7,42,43,4,8,114,98
349,21,3,3,6,7,33,-66,7,2,147,32
349,22,2,4,5,8,-77,44,0,6,70,76
349,23,4,4,9,4,45,40,5,6,115,116
349,24,4,3,9,4,-55,31,0,7,60,147
349,25,3,5,4,9,31,-46,1,1,91,101
349,26,4,3,10,3,46,30,7,1,137,131
349,27,2,4,4,9,22,45,9,6,159,176
349,28,3,3,5,8,-68,-65,1,1,91,111
349,29,3,3,9,4,36,31,7,2,127,142
349,30,4,2,10,3,-54,21,3,3,73,163
349,31,2,4,7,6,25,42,8,5,98,205
349,32,5,2,9,4,-46,22,2,7,52,227
349,33,2,5,3,10,21,-45,3,2,73,182
349,34,4,2,8,5,44,23,7,5,117,205
349,35,3,4,4,9,31,-55,8,0,148,150
349,36,2,5,4,9,-78,54,0,4,70,204
349,37,3,4,3,10,30,-54,0,0,100,150
349,38,3,3,8,5,35,32,5,2,135,182
349,39,3,4,5,8,32,44,7,6,167,226
349,40,2,6,3,10,21,-36,8,0,188,190
349,41,3,4,5,8,-68,44,0,4,120,234
349,42,4,3,7,6,43,33,3,7,163,267
349,43,5,2,9,4,54,22,7,9,217,289
349,44,2,5,5,8,-77,-47,0,2,140,242
349,45,2,4,5,8,23,44,3,6,163,286
349,46,4,3,6,7,42,-66,5,0,205,220
349,47,6,2,11,2,-35,20,0,0,170,240
349,48,4,2,8,5,44,23,4,3,214,263
349,49,3,4,6,7,33,43,7,6,247,306
349,50,3,3,8,5,-65,32,2,8,182,338
349,51,3,3,5,8,32,-65,4,3,214,273
349,52,5,3,6,7,51,34,5,7,265,307
349,53,4,3,5,8,41,-65,6,2,306,242
349,54,3,3,7,6,-66,33,0,5,240,275
349,55,2,5,5,8,23,53,3,8,263,328
349,56,3,3,6,7,33,-66,6,2,296,262
349,57,4,2,8,5,-56,23,0,5,240,285
349,58,4,3,9,4,45,31,5,6,285,316
349,59,3,3,5,8,32,-65,7,1,317,251
349,60,3,3,5,8,32,35,9,6,349,286
349,61,3,3,6,7,-67,-66,2,0,282,220
349,62,3,3,7,6,34,33,6,3,316,253
349,63,4,3,7,6,43,33,9,6,359,286
349,64,2,4,3,10,-79,-54,0,2,280,232
349,65,4,3,8,5,44,32,4,4,324,264
349,66,3,3,7,6,34,33,8,7,358,297
349,67,5,2,10,3,-45,21,3,8,313,318
349,68,3,3,6,7,33,-66,6,2,346,252
349,69,4,3,5,8,41,35,7,7,387,287
349,70,3,3,6,7,-67,-66,0,1,320,221
349,71,2,5,8,5,26,50,6,1,346,271
349,72,5,2,9,4,-46,22,0,3,300,293
349,73,4,2,8,5,44,23,4,6,344,316
349,74,4,3,7,6,43,33,7,9,387,349
349,75,2,4,5,8,-77,-56,0,3,310,293
349,76,4,3,8,5,44,32,4,5,354,325
349,77,4,3,5,8,41,-65,5,0,395,260
349,78,4,3,9,4,-55,31,0,1,340,291
349,79,3,4,6,7,33,43,3,4,373,334
349,80,2,5,3,10,21,55,4,9,394,389
349,81,2,4,4,9,22,-55,6,4,416,334
349,82,4,4,8,5,-56,41,0,5,360,375
349,83,5,2,10,3,55,21,5,6,415,396
349,84,4,2,8,5,44,23,9,9,459,419
349,85,6,2,11,2,-35,20,4,9,424,439
349,86,3,4,7,6,34,-58,8,1,458,381
349,87,3,3,7,6,-66,33,2,4,392,414
349,88,3,3,7,6,34,33,6,7,426,447
349,89,3,3,8,5,-65,32,1,9,361,479
349,90,2,4,3,10,21,-54,2,5,382,425
349,91,5,2,7,6,52,24,4,9,434,449
349,92,4,2,6,7,42,-75,6,4,476,374
349,93,4,2,8,5,-56,23,0,7,420,397
349,94,5,2,8,5,53,-77,3,0,473,320
349,95,3,3,8,5,35,32,8,2,508,352
350,1,3,3,6,7,33,34,3,4,33,34
350,2,3,3,5,8,32,35,5,9,65,69
350,3,4,3,10,3,-54,30,1,9,11,99
350,4,3,3,4,9,31,-64,2,5,42,35
350,5,4,2,8,5,44,23,6,8,86,58
350,6,2,4,6,7,-76,-57,0,1,10,1
350,7,3,3,10,3,37,30,7,1,47,31
350,8,5,2,9,4,-46,22,1,3,1,53
350,9,2,4,2,11,20,-53,1,0,21,0
350,10,3,3,5,8,32,35,3,5,53,35
350,11,5,2,11,2,56,20,9,5,109,55
350,12,5,2,10,3,-45,21,4,6,64,76
350,13,5,2,8,5,53,23,7,9,117,99
350,14,2,4,7,6,-75,-58,2,1,42,41
350,15,4,2,7,6,43,24,5,5,85,65
350,16,4,3,9,4,-55,31,0,6,30,96
350,17,2,4,6,7,24,43,4,9,54,139
350,18,4,3,6,7,42,-66,6,3,96,73
350,19,3,4,5,8,32,44,8,7,128,117
350,20,4,2,8,5,-56,-77,2,0,72,40
350,21,3,3,9,4,36,31,8,1,108,71
350,22,3,4,7,6,-66,42,2,3,42,113
350,23,4,2,9,4,45,22,7,5,87,135
350,24,4,2,9,4,-55,22,2,7,32,157
350,25,4,4,5,8,41,-56,3,1,73,101
350,26,6,2,10,3,64,21,7,2,137,122
350,27,2,5,6,7,-76,52,1,4,61,174
350,28,5,2,9,4,54,22,5,6,115,196
350,29,4,3,5,8,41,-65,6,1,156,131
350,30,3,3,6,7,33,34,9,5,189,165
350,31,3,3,6,7,-67,34,2,9,122,199
350,32,2,6,3,10,21,-36,3,3,143,163
350,33,4,3,6,7,42,34,5,7,185,197
350,34,2,5,6,7,24,52,9,9,209,249
350,35,5,2,9,4,-46,-78,3,1,163,171
350,36,4,3,10,3,46,30,9,1,209,201
350,37,4,2,7,6,-57,24,2,5,152,225
350,38,4,2,7,6,43,24,5,9,195,249
350,39,4,3,8,5,44,-68,9,1,239,181
350,40,4,3,8,5,-56,32,3,3,183,213
350,41,3,4,6,7,33,43,6,6,216,256
350,42,4,3,8,5,-56,32,0,8,160,288
350,43,4,2,9,4,45,-78,5,0,205,210
350,44,4,3,6,7,42,34,7,4,247,244
350,45,2,4,6,7,-76,43,1,7,171,287
350,46,3,3,4,9,31,-64,2,3,202,223
350,47,2,4,4,9,22,45,4,8,224,268
350,48,2,4,2,11,20,-53,4,5,244,215
350,49,2,5,5,8,23,53,7,8,267,268
350,50,3,4,7,6,-66,-58,1,0,201,210
350,51,3,4,4,9,31,45,2,5,232,255
350,52,5,2,9,4,54,22,6,7,286,277
350,53,2,4,7,6,-75,42,1,9,211,319
350,54,3,3,9,4,36,-69,7,0,247,250
350,55,7,2,12,1,-25,-20,2,0,222,230
350,56,2,4,5,8,23,44,5,4,245,274
350,57,2,5,5,8,23,53,8,7,268,327
350,58,5,2,10,3,-45,21,3,8,223,348
350,59,3,4,5,8,32,-56,5,2,255,292
350,60,4,3,7,6,43,33,8,5,298,325
350,61,4,3,9,4,-55,31,3,6,243,356
350,62,4,2,7,6,43,-76,6,0,286,280
350,63,4,3,9,4,-55,31,1,1,231,311
350,64,6,2,8,5,62,23,3,4,293,334
350,65,3,3,7,6,34,33,7,7,327,367
350,66,3,4,5,8,32,-56,9,1,359,311
350,67,3,4,6,7,-67,43,2,4,292,354
350,68,4,3,9,4,45,31,7,5,337,385
350,69,2,4,4,9,22,-55,9,0,359,330
350,70,3,4,5,8,-68,44,1,4,291,374
350,71,4,2,7,6,43,24,4,8,334,398
350,72,3,3,6,7,33,-66,7,2,367,332
350,73,5,2,9,4,-46,22,1,4,321,354
350,74,3,4,4,9,31,45,2,9,352,399
350,75,4,3,7,6,43,-67,5,2,395,332
350,76,4,2,6,7,42,25,7,7,437,357
350,77,4,4,7,6,-57,42,0,9,380,399
350,78,2,4,7,6,25,-58,5,1,405,341
350,79,5,2,10,3,-45,21,0,2,360,362
350,80,3,4,7,6,34,42,4,4,394,404
350,81,5,2,9,4,54,22,8,6,448,426
350,82,5,2,11,2,-44,20,4,6,404,446
350,83,3,4,7,6,34,42,8,8,438,488
350,84,4,2,9,4,-55,-78,3,0,383,410
350,85,4,2,9,4,45,22,8,2,428,432
350,86,2,5,5,8,-77,53,1,5,351,485
350,87,3,4,3,10,30,-54,1,1,381,431
350,88,3,3,5,8,32,35,3,6,413,466
350,89,3,3,5,8,32,-65,5,1,445,401
350,90,4,3,6,7,42,34,7,5,487,435
350,91,3,3,7,6,-66,33,1,8,421,468
350,92,6,2,8,5,62,-77,3,1,483,391
350,93,2,5,3,10,21,55,4,6,504,446
351,1,2,5,6,7,24,52,4,2,24,52
351,2,3,3,8,5,35,32,9,4,59,84
351,3,3,3,8,5,-65,32,4,6,-6,116
351,4,3,3,8,5,35,32,9,8,29,148
351,5,3,4,4,9,-69,-55,0,3,-40,93
351,6,3,3,3,10,30,-63,0,0,-10,30
351,7,3,3,6,7,33,34,3,4,23,64
351,8,2,4,4,9,22,45,5,9,45,109
351,9,2,5,4,9,22,-46,7,3,67,63
351,10,3,3,9,4,-64,31,3,4,3,94
351,11,3,4,6,7,33,43,6,7,36,137
351,12,3,4,6,7,33,-57,9,0,69,80
351,13,4,2,8,5,-56,23,3,3,13,103
351,14,2,6,6,7,24,61,7,4,37,164
351,15,5,2,10,3,-45,21,2,5,-8,185
351,16,4,2,6,7,42,-75,4,0,34,110
351,17,3,4,6,7,33,43,7,3,67,153
351,18,3,3,7,6,-66,33,1,6,1,186
351,19,5,2,10,3,55,21,6,7,56,207
351,20,5,2,9,4,-46,22,0,9,10,229
351,21,2,4,4,9,22,-55,2,4,32,174
351,22,2,5,5,8,23,53,5,7,55,227
351,23,3,3,5,8,32,-65,7,2,87,162
351,24,4,3,7,6,-57,33,0,5,30,195
351,25,3,4,6,7,33,43,3,8,63,238
351,26,3,3,4,9,31,-64,4,4,94,174
351,27,4,3,6,7,42,34,6,8,136,208
351,28,5,2,8,5,53,-77,9,1,189,131
351,29,3,3,6,7,-67,34,2,5,122,165
351,30,3,4,7,6,34,42,6,7,156,207
351,31,3,4,6,7,33,-57,9,0,189,150
351,32,4,3,7,6,-57,33,2,3,132,183
351,33,3,3,7,6,34,33,6,6,166,216
351,34,4,2,8,5,-56,23,0,9,110,239
351,35,3,3,9,4,36,-69,6,0,146,170
351,36,2,4,4,9,22,45,8,5,168,215
351,37,4,4,5,8,41,44,9,9,209,259
351,38,3,4,6,7,-67,-57,2,2,142,202
351,39,3,4,7,6,34,42,6,4,176,244
351,40,6,2,10,3,-36,21,0,5,140,265
351,41,3,3,6,7,33,34,3,9,173,299
351,42,4,3,7,6,43,-67,6,2,216,232
351,43,5,2,9,4,-46,22,0,4,170,254
351,44,3,3,7,6,34,33,4,7,204,287
351,45,3,4,7,6,34,42,8,9,238,329
351,46,3,3,7,6,-66,-67,2,2,172,262
351,47,2,6,3,10,21,64,3,6,193,326
351,48,5,2,9,4,54,22,7,8,247,348
351,49,3,3,5,8,32,-65,9,3,279,283
351,50,3,3,5,8,-68,35,1,8,211,318
351,51,5,2,9,4,54,-78,5,0,265,240
351,52,3,4,6,7,33,43,8,3,298,283
351,53,3,4,6,7,-67,43,1,6,231,326
351,54,3,4,6,7,33,43,4,9,264,369
351,55,3,3,5,8,32,-65,6,4,296,304
351,56,2,5,6,7,-76,52,0,6,220,356
351,57,2,4,3,10,21,-54,1,2,241,302
351,58,5,3,7,6,52,33,3,5,293,335
351,59,3,4,4,9,31,-55,4,0,324,280
351,60,3,3,7,6,34,33,8,3,358,313
351,61,2,5,6,7,-76,52,2,5,282,365
351,62,3,4,7,6,34,42,6,7,316,407
351,63,2,6,3,10,21,-36,7,1,337,371
351,64,4,3,7,6,-57,33,0,4,280,404
351,65,3,3,4,9,31,-64,1,0,311,340
351,66,3,3,8,5,35,32,6,2,346,372
351,67,2,5,5,8,23,53,9,5,369,425
351,68,3,3,6,7,-67,34,2,9,302,459
351,69,5,2,8,5,53,-77,5,2,355,382
351,70,4,3,8,5,44,32,9,4,399,414
351,71,4,3,8,5,-56,32,3,6,343,446
351,72,2,4,5,8,23,-56,6,0,366,390
351,73,4,3,7,6,43,33,9,3,409,423
351,74,2,4,6,7,-76,43,3,6,333,466
351,75,3,4,8,5,35,41,8,7,368,507
352,1,2,5,6,7,24,52,4,2,24,52
352,2,4,2,8,5,44,23,8,5,68,75
352,3,3,3,6,7,-67,34,1,9,1,109
352,4,3,3,7,6,34,-67,5,2,35,42
352,5,3,3,6,7,33,34,8,6,68,76
352,6,4,2,5,8,41,-74,9,2,109,2
352,7,2,4,4,9,-78,45,1,7,31,47
352,8,3,3,6,7,33,-66,4,1,64,-19
352,9,4,3,7,6,43,33,7,4,107,14
352,10,2,4,3,10,21,-54,8,0,128,-40
352,11,2,4,6,7,-76,43,2,3,52,3
352,12,4,2,9,4,45,22,7,5,97,25
352,13,3,3,7,6,-66,33,1,8,31,58
352,14,3,3,5,8,32,-65,3,3,63,-7
352,15,2,4,7,6,25,42,8,5,88,35
352,16,3,3,8,5,-65,32,3,7,23,67
352,17,3,4,5,8,32,-56,5,1,55,11
352,18,4,3,7,6,43,33,8,4,98,44
352,19,3,4,7,6,-66,42,2,6,32,86
352,20,2,4,6,7,24,43,6,9,56,129
352,21,3,3,9,4,-64,-69,2,0,-8,60
352,22,5,2,11,2,56,20,8,0,48,80
352,23,3,3,4,9,31,36,9,6,79,116
352,24,4,3,8,5,-56,32,3,8,23,148
352,25,3,3,5,8,32,-65,5,3,55,83
352,26,3,3,5,8,32,35,7,8,87,118
352,27,5,2,8,5,-47,-77,0,1,40,41
352,28,3,3,9,4,36,31,6,2,76,72
352,29,3,3,6,7,33,34,9,6,109,106
352,30,4,2,9,4,-55,22,4,8,54,128
352,31,2,5,3,10,21,-45,5,3,75,83
352,32,3,4,5,8,32,44,7,7,107,127
352,33,2,4,6,7,-76,-57,1,0,31,70
352,34,5,2,11,2,56,20,7,0,87,90
352,35,4,3,9,4,-55,31,2,1,32,121
352,36,4,2,9,4,45,22,7,3,77,143
352,37,3,3,7,6,-66,33,1,6,11,176
352,38,5,2,7,6,52,-76,3,0,63,100
352,39,3,4,7,6,34,42,7,2,97,142
352,40,3,4,3,10,30,46,7,8,127,188
352,41,3,4,9,4,-64,40,3,8,63,228
352,42,4,2,7,6,43,-76,6,2,106,152
352,43,4,2,9,4,-55,22,1,4,51,174
352,44,2,4,7,6,25,42,6,6,76,216
352,45,4,3,6,7,42,-66,8,0,118,150
352,46,4,2,9,4,-55,22,3,2,63,172
352,47,3,4,4,9,31,45,4,7,94,217
352,48,2,4,7,6,25,42,9,9,119,259
352,49,5,2,8,5,-47,-77,2,2,72,182
352,50,3,4,9,4,36,40,8,2,108,222
352,51,4,3,8,5,-56,32,2,4,52,254
352,52,5,3,8,5,53,32,5,6,105,286
352,53,3,3,8,5,-65,32,0,8,40,318
352,54,3,4,5,8,32,-56,2,2,72,262
352,55,5,2,10,3,55,21,7,3,127,283
352,56,4,2,7,6,-57,24,0,7,70,307
352,57,4,2,8,5,44,-77,4,0,114,230
352,58,4,3,6,7,42,34,6,4,156,264
352,59,3,4,4,9,31,45,7,9,187,309
352,60,5,2,8,5,-47,-77,0,2,140,232
352,61,3,4,5,8,32,44,2,6,172,276
352,62,3,4,5,8,32,-56,4,0,204,220
352,63,2,4,4,9,22,45,6,5,226,265
352,64,3,4,6,7,33,43,9,8,259,308
352,65,4,3,7,6,-57,-67,2,1,202,241
352,66,4,2,6,7,42,25,4,6,244,266
352,67,3,4,5,8,32,-56,6,0,276,210
352,68,6,2,11,2,-35,20,1,0,241,230
352,69,3,4,7,6,34,42,5,2,275,272
352,70,3,3,6,7,33,34,8,6,308,306
352,71,3,3,6,7,-67,-66,1,0,241,240
352,72,4,2,8,5,44,23,5,3,285,263
352,73,5,2,8,5,53,23,8,6,338,286
352,74,4,3,5,8,41,-65,9,1,379,221
352,75,2,5,5,8,-77,53,2,4,302,274
352,76,4,3,6,7,42,34,4,8,344,308
352,77,3,3,9,4,-64,31,0,9,280,339
352,78,4,3,6,7,42,-66,2,3,322,273
352,79,5,2,8,5,53,23,5,6,375,296
352,80,2,5,5,8,23,53,8,9,398,349
352,81,4,2,6,7,-58,-75,0,4,340,274
352,82,2,4,5,8,23,44,3,8,363,318
352,83,3,4,8,5,35,41,8,9,398,359
352,84,4,3,7,6,-57,-67,1,2,341,292
352,85,5,2,9,4,54,22,5,4,395,314
352,86,4,2,10,3,-54,21,1,5,341,335
352,87,5,2,7,6,52,24,3,9,393,359
352,88,3,3,7,6,34,-67,7,2,427,292
352,89,5,2,9,4,-46,22,1,4,381,314
352,90,4,3,8,5,44,32,5,6,425,346
352,91,3,4,3,10,30,-54,5,2,455,292
352,92,3,3,7,6,34,33,9,5,489,325
352,93,3,3,5,8,-68,-65,1,0,421,260
352,94,2,4,4,9,22,45,3,5,443,305
352,95,4,3,7,6,43,33,6,8,486,338
352,96,3,3,9,4,-64,31,2,9,422,369
352,97,2,4,5,8,23,-56,5,3,445,313
352,98,4,3,6,7,42,34,7,7,487,347
352,99,3,5,5,8,32,-47,9,0,519,300
353,1,3,3,7,6,34,33,4,3,34,33
353,2,3,3,8,5,35,32,9,5,69,65
353,3,5,2,8,5,-47,23,2,8,22,88
353,4,5,2,9,4,54,-78,6,0,76,10
353,5,4,2,7,6,43,24,9,4,119,34
353,6,3,3,7,6,-66,33,3,7,53,67
353,7,3,5,5,8,32,-47,5,0,85,20
353,8,2,5,4,9,22,54,7,4,107,74
353,9,2,6,2,11,20,65,7,9,127,139
353,10,3,3,7,6,-66,-67,1,2,61,72
353,11,3,3,5,8,32,35,3,7,93,107
353,12,4,3,6,7,42,-66,5,1,135,41
353,13,3,3,3,10,30,37,5,8,165,78
353,14,3,5,5,8,32,-47,7,1,197,31
353,15,3,3,8,5,-65,32,2,3,132,63
353,16,3,4,7,6,34,42,6,5,166,105
353,17,5,2,8,5,53,23,9,8,219,128
353,18,2,5,5,8,-77,-47,2,1,142,81
353,19,2,6,5,8,23,62,5,3,165,143
353,20,2,5,7,6,-75,51,0,4,90,194
353,21,5,2,11,2,56,20,6,4,146,214
353,22,4,3,6,7,42,34,8,8,188,248
353,23,3,3,7,6,-66,-67,2,1,122,181
353,24,3,3,5,8,32,35,4,6,154,216
353,25,4,3,8,5,44,32,8,8,198,248
353,26,3,4,8,5,-65,41,3,9,133,289
353,27,4,2,10,3,46,-79,9,0,179,210
353,28,4,3,6,7,-58,34,1,4,121,244
353,29,3,4,6,7,33,43,4,7,154,287
353,30,2,4,5,8,23,-56,7,1,177,231
353,31,4,3,7,6,-57,33,0,4,120,264
353,32,3,5,4,9,31,54,1,8,151,318
353,33,3,4,5,8,32,-56,3,2,183,262
353,34,3,4,5,8,32,44,5,6,215,306
353,35,2,5,3,10,21,-45,6,1,236,261
353,36,4,2,10,3,-54,21,2,2,182,282
353,37,3,3,7,6,34,33,6,5,216,315
353,38,4,2,10,3,-54,21,2,6,162,336
353,39,3,3,8,5,35,32,7,8,197,368
353,40,4,3,5,8,41,-65,8,3,238,303
353,41,4,3,7,6,-57,33,1,6,181,336
353,42,3,4,6,7,33,43,4,9,214,379
353,43,3,4,4,9,31,-55,5,4,245,324
353,44,4,3,9,4,-55,31,0,5,190,355
353,45,5,2,11,2,56,20,6,5,246,375
353,46,3,3,4,9,31,-64,7,1,277,311
353,47,2,4,6,7,-76,43,1,4,201,354
353,48,3,4,6,7,33,43,4,7,234,397
353,49,4,3,7,6,43,-67,7,0,277,330
353,50,2,4,4,9,22,45,9,5,299,375
353,51,4,3,5,8,-59,-65,0,0,240,310
353,52,4,3,8,5,44,32,4,2,284,342
353,53,5,2,6,7,51,25,5,7,335,367
353,54,5,2,7,6,52,-76,7,1,387,291
353,55,2,6,2,11,20,65,7,6,407,356
353,56,3,4,5,8,32,-56,9,0,439,300
353,57,4,3,9,4,-55,31,4,1,384,331
353,58,3,4,6,7,33,43,7,4,417,374
353,59,3,4,6,7,-67,43,0,7,350,417
353,60,3,4,7,6,34,42,4,9,384,459
353,61,3,3,6,7,33,-66,7,3,417,393
353,62,4,3,7,6,-57,33,0,6,360,426
353,63,4,2,10,3,46,21,6,7,406,447
353,64,3,4,5,8,32,-56,8,1,438,391
353,65,3,3,9,4,-64,31,4,2,374,422
353,66,4,3,8,5,44,32,8,4,418,454
353,67,3,3,6,7,-67,34,1,8,351,488
353,68,3,4,6,7,33,-57,4,1,384,431
353,69,3,4,5,8,32,44,6,5,416,475
353,70,4,3,7,6,43,33,9,8,459,508
354,1,2,5,6,7,24,52,4,2,24,52
354,2,4,2,7,6,43,24,7,6,67,76
354,3,2,5,4,9,22,-46,9,0,89,30
354,4,5,2,9,4,-46,22,3,2,43,52
354,5,5,2,9,4,54,22,7,4,97,74
354,6,2,4,6,7,-76,43,1,7,21,117
354,7,5,2,7,6,52,-76,3,1,73,41
354,8,2,5,3,10,21,55,4,6,94,96
354,9,3,3,5,8,32,-65,6,1,126,31
354,10,4,3,6,7,42,34,8,5,168,65
354,11,4,3,8,5,-56,32,2,7,112,97
354,12,5,2,8,5,53,-77,5,0,165,20
354,13,3,3,7,6,34,33,9,3,199,53
354,14,3,3,5,8,-68,35,1,8,131,88
354,15,4,3,9,4,45,31,6,9,176,119
354,16,2,5,3,10,21,-45,7,4,197,74
354,17,4,3,4,9,40,-64,7,0,237,10
354,18,4,3,9,4,-55,31,2,1,182,41
354,19,4,3,4,9,40,36,2,7,222,77
354,20,4,3,7,6,43,-67,5,0,265,10
354,21,4,3,10,3,-54,30,1,0,211,40
354,22,3,3,10,3,37,30,8,0,248,70
354,23,3,4,5,8,-68,44,0,4,180,114
354,24,2,4,3,10,21,-54,1,0,201,60
354,25,4,3,8,5,44,32,5,2,245,92
354,26,4,2,6,7,42,25,7,7,287,117
354,27,5,2,9,4,-46,22,1,9,241,139
354,28,3,4,7,6,34,-58,5,1,275,81
354,29,3,4,3,10,30,46,5,7,305,127
354,30,4,3,7,6,43,-67,8,0,348,60
354,31,2,4,3,10,21,46,9,6,369,106
354,32,3,3,8,5,-65,32,4,8,304,138
354,33,4,3,8,5,44,-68,8,0,348,70
354,34,4,2,9,4,-55,22,3,2,293,92
354,35,3,4,6,7,33,43,6,5,326,135
354,36,3,4,6,7,33,43,9,8,359,178
354,37,5,2,8,5,-47,-77,2,1,312,101
354,38,2,4,5,8,23,44,5,5,335,145
354,39,6,2,10,3,64,21,9,6,399,166
354,40,2,5,5,8,-77,53,2,9,322,219
354,41,3,3,6,7,33,-66,5,3,355,153
354,42,3,4,6,7,33,43,8,6,388,196
354,43,2,5,3,10,21,-45,9,1,409,151
354,44,4,4,7,6,-57,42,2,3,352,193
354,45,3,3,7,6,34,33,6,6,386,226
354,46,3,3,7,6,-66,33,0,9,320,259
354,47,5,2,8,5,53,-77,3,2,373,182
354,48,5,2,8,5,53,23,6,5,426,205
354,49,5,2,10,3,-45,21,1,6,381,226
354,50,2,6,2,11,20,-35,1,1,401,191
354,51,2,5,2,11,20,56,1,7,421,247
354,52,2,5,2,11,20,-44,1,3,441,203
354,53,3,3,8,5,35,32,6,5,476,235
354,54,2,5,5,8,23,53,9,8,499,288
354,55,3,3,6,7,-67,-66,2,2,432,222
354,56,2,5,5,8,23,53,5,5,455,275
354,57,3,3,7,6,34,33,9,8,489,308
354,58,3,4,5,8,-68,-56,1,2,421,252
354,59,2,4,6,7,24,43,5,5,445,295
354,60,4,3,7,6,43,33,8,8,488,328
354,61,3,4,6,7,-67,-57,1,1,421,271
354,62,2,5,4,9,22,54,3,5,443,325
354,63,3,4,7,6,34,42,7,7,477,367
354,64,4,3,5,8,41,-65,8,2,518,302
355,1,5,2,9,4,54,22,4,2,54,22
355,2,3,3,3,10,30,37,4,9,84,59
355,3,2,4,4,9,22,-55,6,4,106,4
355,4,4,2,8,5,-56,23,0,7,50,27
355,5,2,4,4,9,22,-55,2,2,72,-28
355,6,2,4,5,8,23,44,5,6,95,16
355,7,2,5,5,8,23,53,8,9,118,69
355,8,3,4,7,6,-66,-58,2,1,52,11
355,9,3,4,5,8,32,44,4,5,84,55
355,10,2,5,5,8,23,53,7,8,107,108
355,11,4,2,10,3,-54,21,3,9,53,129
355,12,4,3,7,6,43,-67,6,2,96,62
355,13,5,2,8,5,53,23,9,5,149,85
355,14,3,4,4,9,-69,-55,0,0,80,30
355,15,3,4,7,6,34,42,4,2,114,72
355,16,4,3,5,8,41,35,5,7,155,107
355,17,5,2,7,6,52,-76,7,1,207,31
355,18,2,4,3,10,21,46,8,7,228,77
355,19,3,3,4,9,31,-64,9,3,259,13
355,20,3,4,7,6,-66,42,3,5,193,55
355,21,4,3,10,3,46,30,9,5,239,85
355,22,3,4,5,8,-68,44,1,9,171,129
355,23,3,4,8,5,35,-59,6,0,206,70
355,24,3,3,8,5,-65,32,1,2,141,102
355,25,4,3,5,8,41,35,2,7,182,137
355,26,4,3,5,8,41,-65,3,2,223,72
355,27,3,3,5,8,32,35,5,7,255,107
355,28,4,2,8,5,44,-77,9,0,299,30
355,29,4,3,6,7,-58,34,1,4,241,64
355,30,2,4,6,7,24,43,5,7,265,107
355,31,3,3,5,8,32,-65,7,2,297,42
355,32,5,2,6,7,51,25,8,7,348,67
355,33,4,2,9,4,-55,22,3,9,293,89
355,34,4,3,9,4,45,-69,8,0,338,20
355,35,4,3,5,8,41,35,9,5,379,55
355,36,3,4,7,6,-66,42,3,7,313,97
355,37,4,2,8,5,44,-77,7,0,357,20
355,38,3,4,8,5,-65,41,2,1,292,61
355,39,3,5,6,7,33,52,5,3,325,113
355,40,3,4,7,6,34,42,9,5,359,155
355,41,3,3,6,7,-67,34,2,9,292,189
355,42,2,4,6,7,24,-57,6,2,316,132
355,43,3,4,4,9,31,45,7,7,347,177
355,44,3,4,4,9,31,-55,8,2,378,122
355,45,3,3,4,9,31,36,9,8,409,158
355,46,2,5,2,11,20,-44,9,4,429,114
355,47,3,5,7,6,-66,51,3,5,363,165
355,48,4,3,7,6,43,33,6,8,406,198
355,49,3,3,7,6,-66,-67,0,1,340,131
355,50,6,2,7,6,61,24,1,5,401,155
355,51,2,5,3,10,21,-45,2,0,422,110
355,52,3,4,3,10,30,46,2,6,452,156
355,53,4,3,6,7,42,-66,4,0,494,90
355,54,4,4,7,6,43,42,7,2,537,132
356,1,3,4,6,7,33,43,3,3,33,43
356,2,2,5,5,8,23,53,6,6,56,96
356,3,3,4,8,5,-65,41,1,7,-9,137
356,4,3,4,6,7,33,-57,4,0,24,80
356,5,2,4,5,8,23,44,7,4,47,124
356,6,2,6,3,10,21,64,8,8,68,188
356,7,2,4,6,7,-76,-57,2,1,-8,131
356,8,4,3,9,4,45,31,7,2,37,162
356,9,3,4,5,8,32,44,9,6,69,206
356,10,2,5,6,7,-76,52,3,8,-7,258
356,11,3,4,7,6,34,-58,7,0,27,200
356,12,4,3,7,6,-57,33,0,3,-30,233
356,13,4,2,9,4,45,22,5,5,15,255
356,14,3,3,9,4,-64,31,1,6,-49,286
356,15,5,2,7,6,52,-76,3,0,3,210
356,16,2,5,4,9,22,54,5,4,25,264
356,17,4,2,7,6,43,24,8,8,68,288
356,18,3,3,6,7,-67,-66,1,2,1,222
356,19,2,4,5,8,23,44,4,6,24,266
356,20,4,2,6,7,42,-75,6,1,66,191
356,21,4,2,9,4,-55,22,1,3,11,213
356,22,5,2,10,3,55,21,6,4,66,234
356,23,5,2,9,4,-46,22,0,6,20,256
356,24,2,5,4,9,22,-46,2,0,42,210
356,25,2,4,6,7,24,43,6,3,66,253
356,26,4,2,6,7,42,25,8,8,108,278
356,27,3,3,5,8,-68,-65,0,3,40,213
356,28,3,4,4,9,31,45,1,8,71,258
356,29,4,3,6,7,42,-66,3,2,113,192
356,30,3,3,6,7,33,34,6,6,146,226
356,31,2,4,5,8,23,-56,9,0,169,170
356,32,2,4,6,7,-76,43,3,3,93,213
356,33,4,3,6,7,42,34,5,7,135,247
356,34,4,3,8,5,44,32,9,9,179,279
356,35,2,4,3,10,-79,-54,0,5,100,225
356,36,3,4,6,7,33,43,3,8,133,268
356,37,4,3,9,4,45,31,8,9,178,299
356,38,2,5,6,7,-76,-48,2,1,102,251
356,39,3,4,4,9,31,45,3,6,133,296
356,40,2,4,4,9,22,-55,5,1,155,241
356,41,4,3,6,7,42,34,7,5,197,275
356,42,5,2,9,4,-46,22,1,7,151,297
356,43,2,5,3,10,21,-45,2,2,172,252
356,44,5,2,9,4,54,22,6,4,226,274
356,45,3,5,4,9,31,54,7,8,257,328
356,46,2,4,8,5,-74,41,3,9,183,369
356,47,3,3,4,9,31,-64,4,5,214,305
356,48,3,3,7,6,34,33,8,8,248,338
356,49,3,3,5,8,-68,-65,0,3,180,273
356,50,2,4,9,4,27,40,7,3,207,313
356,51,4,3,8,5,-56,32,1,5,151,345
356,52,3,3,7,6,34,33,5,8,185,378
356,53,4,3,7,6,43,-67,8,1,228,311
356,54,3,3,7,6,-66,33,2,4,162,344
356,55,4,3,5,8,41,35,3,9,203,379
356,56,3,3,7,6,34,-67,7,2,237,312
356,57,2,5,5,8,-77,53,0,5,160,365
356,58,4,2,9,4,45,22,5,7,205,387
356,59,3,3,8,5,-65,32,0,9,140,419
356,60,2,4,6,7,24,-57,4,2,164,362
356,61,5,2,10,3,55,21,9,3,219,383
356,62,5,2,11,2,-44,20,5,3,175,403
356,63,3,3,7,6,34,33,9,6,209,436
356,64,2,4,3,10,-79,-54,0,2,130,382
356,65,3,3,6,7,33,34,3,6,163,416
356,66,2,4,3,10,21,-54,4,2,184,362
356,67,4,2,10,3,-54,21,0,3,130,383
356,68,4,2,6,7,42,25,2,8,172,408
356,69,4,2,7,6,43,-76,5,2,215,332
356,70,3,3,9,4,-64,31,1,3,151,363
356,71,3,3,6,7,33,34,4,7,184,397
356,72,3,4,5,8,32,-56,6,1,216,341
356,73,5,2,9,4,-46,22,0,3,170,363
356,74,2,4,3,10,21,46,1,9,191,409
356,75,3,3,5,8,32,-65,3,4,223,344
356,76,4,3,6,7,42,34,5,8,265,378
356,77,3,3,8,5,-65,-68,0,0,200,310
356,78,4,3,9,4,45,31,5,1,245,341
356,79,3,3,6,7,33,34,8,5,278,375
356,80,4,3,10,3,-54,30,4,5,224,405
356,81,3,4,4,9,31,-55,5,0,255,350
356,82,4,3,9,4,-55,31,0,1,200,381
356,83,4,2,10,3,46,21,6,2,246,402
356,84,2,4,7,6,-75,42,1,4,171,444
356,85,3,4,4,9,31,45,2,9,202,489
356,86,2,5,4,9,22,-46,4,3,224,443
356,87,4,3,7,6,43,33,7,6,267,476
356,88,4,2,8,5,-56,23,1,9,211,499
356,89,4,3,8,5,44,-68,5,1,255,431
356,90,5,2,9,4,54,22,9,3,309,453
356,91,2,5,4,9,-78,54,1,7,231,507
357,1,4,3,7,6,43,33,3,3,43,33
357,2,2,4,6,7,24,43,7,6,67,76
357,3,2,5,2,11,20,-44,7,2,87,32
357,4,4,3,8,5,-56,32,1,4,31,64
357,5,3,3,5,8,32,35,3,9,63,99
357,6,2,4,8,5,26,-59,9,0,89,40
357,7,4,2,5,8,-59,26,0,6,30,66
357,8,4,2,5,8,41,-74,1,2,71,-8
357,9,3,3,9,4,36,31,7,3,107,23
357,10,3,4,7,6,-66,42,1,5,41,65
357,11,5,2,10,3,55,21,6,6,96,86
357,12,4,3,8,5,-56,32,0,8,40,118
357,13,2,5,4,9,22,-46,2,2,62,72
357,14,4,2,10,3,46,21,8,3,108,93
357,15,4,3,8,5,-56,32,2,5,52,125
357,16,4,3,7,6,43,33,5,8,95,158
357,17,3,3,5,8,32,-65,7,3,127,93
357,18,3,4,4,9,31,45,8,8,158,138
357,19,3,3,8,5,-65,-68,3,0,93,70
357,20,5,2,9,4,54,22,7,2,147,92
357,21,2,6,3,10,21,64,8,6,168,156
357,22,4,3,10,3,-54,30,4,6,114,186
357,23,5,2,8,5,53,23,7,9,167,209
357,24,2,5,3,10,21,-45,8,4,188,164
357,25,3,4,3,10,30,-54,8,0,218,110
357,26,2,4,5,8,-77,44,1,4,141,154
357,27,3,4,5,8,32,44,3,8,173,198
357,28,3,3,6,7,33,-66,6,2,206,132
357,29,2,5,4,9,22,54,8,6,228,186
357,30,2,4,4,9,-78,-55,0,1,150,131
357,31,3,3,5,8,32,35,2,6,182,166
357,32,3,4,4,9,31,-55,3,1,213,111
357,33,5,2,9,4,54,22,7,3,267,133
357,34,5,2,10,3,-45,21,2,4,222,154
357,35,4,2,8,5,44,23,6,7,266,177
357,36,4,3,7,6,43,-67,9,0,309,110
357,37,3,3,5,8,-68,35,1,5,241,145
357,38,4,3,5,8,41,-65,2,0,282,80
357,39,3,4,4,9,31,45,3,5,313,125
357,40,4,3,9,4,45,31,8,6,358,156
357,41,4,3,8,5,-56,32,2,8,302,188
357,42,4,2,7,6,43,-76,5,2,345,112
357,43,4,3,9,4,-55,31,0,3,290,143
357,44,3,4,5,8,32,44,2,7,322,187
357,45,3,4,6,7,33,-57,5,0,355,130
357,46,4,3,7,6,43,33,8,3,398,163
357,47,2,4,4,9,-78,45,0,8,320,208
357,48,3,4,6,7,33,-57,3,1,353,151
357,49,4,2,8,5,44,23,7,4,397,174
357,50,2,4,4,9,22,45,9,9,419,219
357,51,3,3,5,8,-68,-65,1,4,351,154
357,52,2,4,7,6,25,42,6,6,376,196
357,53,2,5,3,10,21,-45,7,1,397,151
357,54,3,4,5,8,32,44,9,5,429,195
357,55,4,3,6,7,-58,34,1,9,371,229
357,56,2,4,3,10,21,-54,2,5,392,175
357,57,3,3,8,5,35,32,7,7,427,207
357,58,4,3,5,8,41,-65,8,2,468,142
357,59,4,3,7,6,-57,33,1,5,411,175
357,60,2,6,2,11,20,-35,1,0,431,140
357,61,2,4,4,9,22,45,3,5,453,185
357,62,3,3,8,5,35,32,8,7,488,217
357,63,6,2,10,3,-36,21,2,8,452,238
357,64,6,2,11,2,65,20,7,8,517,258
358,1,2,5,6,7,24,52,4,2,24,52
358,2,5,3,7,6,52,33,6,5,76,85
358,3,4,3,5,8,41,-65,7,0,117,20
358,4,4,2,8,5,-56,23,1,3,61,43
358,5,3,3,7,6,34,33,5,6,95,76
358,6,4,3,8,5,44,32,9,8,139,108
358,7,4,2,7,6,-57,-76,2,2,82,32
358,8,3,4,6,7,33,43,5,5,115,75
358,9,2,4,3,10,21,-54,6,1,136,21
358,10,4,2,8,5,-56,23,0,4,80,44
358,11,2,5,4,9,22,54,2,8,102,98
358,12,5,3,10,3,55,30,7,8,157,128
358,13,3,3,7,6,-66,-67,1,1,91,61
358,14,4,3,5,8,41,35,2,6,132,96
358,15,2,5,5,8,23,53,5,9,155,149
358,16,4,2,10,3,-54,-79,1,0,101,70
358,17,3,4,6,7,33,43,4,3,134,113
358,18,5,3,7,6,52,33,6,6,186,146
358,19,4,3,8,5,-56,32,0,8,130,178
358,20,2,6,2,11,20,-35,0,3,150,143
358,21,2,5,3,10,21,55,1,8,171,198
358,22,4,4,6,7,42,-57,3,1,213,141
358,23,2,4,5,8,23,44,6,5,236,185
358,24,3,3,6,7,33,34,9,9,269,219
358,25,5,2,9,4,-46,-78,3,1,223,141
358,26,4,4,5,8,41,44,4,5,264,185
358,27,3,3,8,5,35,32,9,7,299,217
358,28,4,4,8,5,-56,41,3,8,243,258
358,29,5,2,7,6,52,-76,5,2,295,182
358,30,3,4,3,10,30,46,5,8,325,228
358,31,2,6,1,12,-20,-34,5,4,305,194
358,32,3,4,5,8,32,44,7,8,337,238
358,33,3,4,8,5,-65,41,2,9,272,279
358,34,2,4,4,9,22,-55,4,4,294,224
358,35,2,5,3,10,21,55,5,9,315,279
358,36,5,3,8,5,53,-68,8,1,368,211
358,37,3,3,4,9,31,36,9,7,399,247
358,38,3,3,4,9,-69,-64,0,3,330,183
358,39,4,3,7,6,43,33,3,6,373,216
358,40,6,2,11,2,65,20,8,6,438,236
358,41,4,2,9,4,-55,22,3,8,383,258
358,42,3,3,9,4,36,31,9,9,419,289
358,43,3,4,7,6,-66,-58,3,1,353,231
358,44,3,3,6,7,33,34,6,5,386,265
358,45,3,3,6,7,33,34,9,9,419,299
358,46,2,5,6,7,-76,-48,3,1,343,251
358,47,2,4,7,6,25,42,8,3,368,293
358,48,6,2,10,3,-36,21,2,4,332,314
358,49,3,3,7,6,34,33,6,7,366,347
358,50,2,5,6,7,-76,52,0,9,290,399
358,51,3,4,6,7,33,-57,3,2,323,342
358,52,4,4,7,6,43,42,6,4,366,384
358,53,3,3,8,5,-65,32,1,6,301,416
358,54,4,3,8,5,44,32,5,8,345,448
358,55,3,3,5,8,32,-65,7,3,377,383
358,56,4,3,7,6,-57,33,0,6,320,416
358,57,2,5,5,8,23,53,3,9,343,469
358,58,5,2,6,7,51,-75,4,4,394,394
358,59,3,3,8,5,35,32,9,6,429,426
358,60,3,4,6,7,-67,43,2,9,362,469
358,61,3,3,5,8,32,-65,4,4,394,404
358,62,4,3,6,7,42,34,6,8,436,438
358,63,2,5,3,10,21,-45,7,3,457,393
358,64,4,2,8,5,-56,23,1,6,401,416
358,65,4,4,5,8,41,-56,2,0,442,360
358,66,4,3,8,5,44,32,6,2,486,392
358,67,2,5,5,8,23,53,9,5,509,445
359,1,2,5,6,7,24,52,4,2,24,52
359,2,3,3,6,7,33,34,7,6,57,86
359,3,3,3,7,6,-66,33,1,9,-9,119
359,4,3,3,9,4,36,-69,7,0,27,50
359,5,2,4,6,7,-76,43,1,3,-49,93
359,6,3,3,3,10,30,-63,1,0,-19,30
359,7,4,2,7,6,43,24,4,4,24,54
359,8,4,3,6,7,42,34,6,8,66,88
359,9,4,3,7,6,43,-67,9,1,109,21
359,10,4,2,7,6,-57,24,2,5,52,45
359,11,2,5,3,10,21,-45,3,0,73,0
359,12,3,4,4,9,31,45,4,5,104,45
359,13,4,2,7,6,43,24,7,9,147,69
359,14,3,3,5,8,32,-65,9,4,179,4
359,15,3,4,7,6,-66,42,3,6,113,46
359,16,2,4,5,8,23,-56,6,0,136,-10
359,17,5,2,10,3,-45,21,1,1,91,11
359,18,4,2,8,5,44,23,5,4,135,34
359,19,3,4,4,9,31,45,6,9,166,79
359,20,5,2,8,5,53,-77,9,2,219,2
359,21,3,3,8,5,-65,32,4,4,154,34
359,22,3,3,6,7,33,34,7,8,187,68
359,23,2,4,9,4,-73,40,4,8,114,108
359,24,4,3,9,4,45,31,9,9,159,139
359,25,2,5,4,9,-78,-46,1,3,81,93
359,26,2,4,8,5,26,41,7,4,107,134
359,27,3,4,6,7,-67,43,0,7,40,177
359,28,3,3,6,7,33,-66,3,1,73,111
359,29,3,3,5,8,32,35,5,6,105,146
359,30,3,4,4,9,31,-55,6,1,136,91
359,31,3,3,8,5,-65,32,1,3,71,123
359,32,5,2,11,2,56,20,7,3,127,143
359,33,4,2,7,6,-57,24,0,7,70,167
359,34,4,3,5,8,41,-65,1,2,111,102
359,35,3,3,7,6,34,33,5,5,145,135
359,36,2,4,4,9,22,-55,7,0,167,80
359,37,4,2,7,6,-57,24,0,4,110,104
359,38,3,3,9,4,36,31,6,5,146,135
359,39,3,3,4,9,31,-64,7,1,177,71
359,40,3,3,8,5,-65,32,2,3,112,103
359,41,6,2,11,2,65,20,7,3,177,123
359,42,3,4,6,7,-67,43,0,6,110,166
359,43,4,2,8,5,44,23,4,9,154,189
359,44,2,4,4,9,22,-55,6,4,176,134
359,45,3,5,4,9,31,54,7,8,207,188
359,46,2,5,7,6,-75,51,2,9,132,239
359,47,4,3,6,7,42,-66,4,3,174,173
359,48,3,4,5,8,32,44,6,7,206,217
359,49,4,3,9,4,-55,31,1,8,151,248
359,50,3,3,7,6,34,-67,5,1,185,181
359,51,3,3,8,5,-65,32,0,3,120,213
359,52,4,3,8,5,44,32,4,5,164,245
359,53,3,3,7,6,34,33,8,8,198,278
359,54,4,3,9,4,-55,31,3,9,143,309
359,55,2,4,4,9,22,-55,5,4,165,254
359,56,2,4,6,7,24,43,9,7,189,297
359,57,2,4,4,9,-78,-55,1,2,111,242
359,58,3,5,4,9,31,54,2,6,142,296
359,59,2,5,4,9,22,-46,4,0,164,250
359,60,3,3,4,9,31,36,5,6,195,286
359,61,3,4,4,9,31,-55,6,1,226,231
359,62,2,5,4,9,22,54,8,5,248,285
359,63,3,4,3,10,30,-54,8,1,278,231
359,64,3,3,7,6,-66,33,2,4,212,264
359,65,3,4,6,7,33,43,5,7,245,307
359,66,3,3,7,6,34,-67,9,0,279,240
359,67,2,6,3,10,-79,64,0,4,200,304
359,68,4,4,7,6,43,42,3,6,243,346
359,69,3,3,7,6,34,33,7,9,277,379
359,70,4,3,6,7,42,-66,9,3,319,313
359,71,2,5,3,10,-79,55,0,8,240,368
359,72,2,5,4,9,22,-46,2,2,262,322
359,73,3,3,7,6,34,33,6,5,296,355
359,74,3,3,6,7,33,34,9,9,329,389
359,75,2,4,4,9,-78,-55,1,4,251,334
359,76,6,2,11,2,65,20,6,4,316,354
359,77,5,2,8,5,53,23,9,7,369,377
359,78,3,4,6,7,-67,-57,2,0,302,320
359,79,2,4,4,9,22,45,4,5,324,365
359,80,3,3,5,8,32,-65,6,0,356,300
359,81,3,3,5,8,32,35,8,5,388,335
359,82,2,4,5,8,-77,44,1,9,311,379
359,83,4,3,9,4,45,-69,6,0,356,310
359,84,4,3,9,4,-55,31,1,1,301,341
359,85,5,2,9,4,54,22,5,3,355,363
359,86,3,4,7,6,34,42,9,5,389,405
359,87,3,4,6,7,-67,43,2,8,322,448
359,88,2,5,3,10,21,-45,3,3,343,403
359,89,2,4,6,7,24,43,7,6,367,446
359,90,3,3,6,7,-67,-66,0,0,300,380
359,91,3,4,6,7,33,43,3,3,333,423
359,92,3,4,4,9,31,45,4,8,364,468
359,93,3,4,6,7,33,-57,7,1,397,411
359,94,3,4,3,10,30,46,7,7,427,457
359,95,4,3,9,4,-55,31,2,8,372,488
359,96,4,3,7,6,43,-67,5,1,415,421
359,97,4,3,9,4,-55,31,0,2,360,452
359,98,5,3,8,5,53,32,3,4,413,484
359,99,4,2,8,5,44,23,7,7,457,507
360,1,2,5,3,10,21,55,1,5,21,55
360,2,5,2,9,4,54,22,5,7,75,77
360,3,3,3,6,7,33,-66,8,1,108,11
360,4,4,2,9,4,-55,22,3,3,53,33
360,5,5,2,9,4,54,22,7,5,107,55
360,6,2,5,5,8,-77,53,0,8,30,108
360,7,4,3,8,5,44,-68,4,0,74,40
360,8,4,3,6,7,42,34,6,4,116,74
360,9,2,4,6,7,-76,43,0,7,40,117
360,10,2,4,3,10,21,-54,1,3,61,63
360,11,5,2,9,4,54,22,5,5,115,85
360,12,2,4,4,9,22,-55,7,0,137,30
360,13,4,3,10,3,-54,30,3,0,83,60
360,14,4,2,8,5,44,23,7,3,127,83
360,15,4,3,9,4,-55,31,2,4,72,114
360,16,3,4,5,8,32,44,4,8,104,158
360,17,2,5,3,10,21,-45,5,3,125,113
360,18,4,3,4,9,40,36,5,9,165,149
360,19,3,4,5,8,32,-56,7,3,197,93
360,20,4,2,10,3,-54,21,3,4,143,114
360,21,3,3,8,5,35,32,8,6,178,146
360,22,3,3,6,7,-67,-66,1,0,111,80
360,23,2,4,4,9,22,45,3,5,133,125
360,24,2,4,7,6,25,42,8,7,158,167
360,25,4,2,7,6,-57,-76,1,1,101,91
360,26,3,4,7,6,34,42,5,3,135,133
360,27,3,3,6,7,33,34,8,7,168,167
360,28,5,2,7,6,-48,-76,0,1,120,91
360,29,3,4,5,8,32,44,2,5,152,135
360,30,3,3,9,4,36,31,8,6,188,166
360,31,5,3,9,4,-46,31,2,7,142,197
360,32,2,5,4,9,22,-46,4,1,164,151
360,33,4,3,6,7,42,34,6,5,206,185
360,34,5,2,10,3,-45,21,1,6,161,206
360,35,3,5,6,7,33,52,4,8,194,258
360,36,4,4,6,7,42,-57,6,1,236,201
360,37,4,2,7,6,43,24,9,5,279,225
360,38,5,2,8,5,-47,23,2,8,232,248
360,39,5,2,7,6,52,-76,4,2,284,172
360,40,3,3,6,7,33,34,7,6,317,206
360,41,2,6,6,7,-76,61,1,7,241,267
360,42,3,3,7,6,34,-67,5,0,275,200
360,43,4,3,4,9,40,36,5,6,315,236
360,44,5,2,9,4,54,22,9,8,369,258
360,45,3,4,4,9,-69,-55,0,3,300,203
360,46,4,2,7,6,43,24,3,7,343,227
360,47,2,4,6,7,24,-57,7,0,367,170
360,48,3,4,4,9,31,45,8,5,398,215
360,49,2,4,4,9,-78,-55,0,0,320,160
360,50,5,2,11,2,56,20,6,0,376,180
360,51,3,4,6,7,33,43,9,3,409,223
360,52,3,5,6,7,-67,52,2,5,342,275
360,53,4,3,7,6,43,33,5,8,385,308
360,54,3,3,4,9,31,-64,6,4,416,244
360,55,3,3,10,3,-63,30,3,4,353,274
360,56,3,4,6,7,33,43,6,7,386,317
360,57,3,3,8,5,-65,32,1,9,321,349
360,58,3,3,5,8,32,-65,3,4,353,284
360,59,4,2,9,4,45,22,8,6,398,306
360,60,2,5,4,9,-78,-46,0,0,320,260
360,61,3,3,4,9,31,36,1,6,351,296
360,62,3,3,5,8,32,-65,3,1,383,231
360,63,2,5,2,11,20,56,3,7,403,287
360,64,4,3,7,6,43,-67,6,0,446,220
360,65,5,2,8,5,53,23,9,3,499,243
360,66,4,3,9,4,-55,31,4,4,444,274
360,67,3,4,3,10,30,-54,4,0,474,220
360,68,3,5,4,9,31,54,5,4,505,274
361,1,4,2,9,4,45,22,5,2,45,22
361,2,3,3,9,4,-64,31,1,3,-19,53
361,3,3,4,7,6,34,42,5,5,15,95
361,4,3,3,4,9,31,-64,6,1,46,31
361,5,6,2,12,1,-34,-20,2,1,12,11
361,6,4,3,9,4,45,31,7,2,57,42
361,7,4,3,5,8,41,35,8,7,98,77
361,8,4,3,9,4,-55,31,3,8,43,108
361,9,5,2,9,4,54,-78,7,0,97,30
361,10,4,2,5,8,41,26,8,6,138,56
361,11,4,2,7,6,-57,-76,1,0,81,-20
361,12,4,3,8,5,44,32,5,2,125,12
361,13,3,3,7,6,34,33,9,5,159,45
361,14,2,4,5,8,-77,44,2,9,82,89
361,15,4,2,8,5,44,-77,6,2,126,12
361,16,5,2,7,6,52,24,8,6,178,36
361,17,2,5,4,9,-78,-46,0,0,100,-10
361,18,3,4,6,7,33,43,3,3,133,33
361,19,4,2,7,6,43,24,6,7,176,57
361,20,3,5,2,11,-30,-44,6,3,146,13
361,21,4,2,11,2,-53,20,3,3,93,33
361,22,2,4,6,7,24,43,7,6,117,76
361,23,4,3,8,5,-56,32,1,8,61,108
361,24,3,3,7,6,34,-67,5,1,95,41
361,25,2,6,3,10,21,64,6,5,116,105
361,26,4,2,7,6,43,24,9,9,159,129
361,27,3,3,6,7,-67,-66,2,3,92,63
361,28,2,4,4,9,22,45,4,8,114,108
361,29,3,3,7,6,34,-67,8,1,148,41
361,30,3,3,8,5,-65,32,3,3,83,73
361,31,4,3,10,3,46,30,9,3,129,103
361,32,2,4,4,9,-78,45,1,8,51,148
361,33,4,3,10,3,46,30,7,8,97,178
361,34,3,4,6,7,-67,-57,0,1,30,121
361,35,2,4,5,8,23,44,3,5,53,165
361,36,3,4,4,9,31,-55,4,0,84,110
361,37,5,2,9,4,54,22,8,2,138,132
361,38,3,3,8,5,-65,32,3,4,73,164
361,39,3,3,8,5,35,32,8,6,108,196
361,40,2,4,3,10,21,-54,9,2,129,142
361,41,5,2,7,6,-48,24,1,6,81,166
361,42,5,2,9,4,54,22,5,8,135,188
361,43,3,4,5,8,32,-56,7,2,167,132
361,44,5,2,8,5,-47,23,0,5,120,155
361,45,3,4,5,8,32,44,2,9,152,199
361,46,2,4,2,11,20,-53,2,6,172,146
361,47,6,2,10,3,64,21,6,7,236,167
361,48,3,4,8,5,-65,41,1,8,171,208
361,49,5,2,9,4,54,-78,5,0,225,130
361,50,3,4,7,6,34,42,9,2,259,172
361,51,2,5,4,9,-78,54,1,6,181,226
361,52,2,6,3,10,21,-36,2,0,202,190
361,53,3,4,6,7,33,43,5,3,235,233
361,54,2,4,5,8,23,44,8,7,258,277
361,55,5,2,10,3,-45,21,3,8,213,298
361,56,4,3,8,5,44,-68,7,0,257,230
361,57,3,3,4,9,31,36,8,6,288,266
361,58,3,3,8,5,-65,32,3,8,223,298
361,59,4,3,6,7,42,-66,5,2,265,232
361,60,3,3,7,6,34,33,9,5,299,265
361,61,3,3,5,8,-68,-65,1,0,231,200
361,62,3,5,8,5,35,50,6,0,266,250
361,63,5,2,9,4,-46,22,0,2,220,272
361,64,2,4,5,8,23,44,3,6,243,316
361,65,2,4,5,8,23,-56,6,0,266,260
361,66,2,4,5,8,23,44,9,4,289,304
361,67,2,5,3,10,-79,55,0,9,210,359
361,68,2,5,6,7,24,-48,4,1,234,311
361,69,2,4,5,8,23,44,7,5,257,355
361,70,4,2,10,3,-54,21,3,6,203,376
361,71,3,3,8,5,35,32,8,8,238,408
361,72,4,2,7,6,-57,-76,1,2,181,332
361,73,3,3,4,9,31,36,2,8,212,368
361,74,4,3,7,6,43,-67,5,1,255,301
361,75,3,3,7,6,34,33,9,4,289,334
361,76,3,4,7,6,-66,42,3,6,223,376
361,77,5,2,9,4,54,22,7,8,277,398
361,78,3,4,4,9,31,-55,8,3,308,343
361,79,4,3,8,5,-56,32,2,5,252,375
361,80,2,5,5,8,23,53,5,8,275,428
361,81,4,3,9,4,-55,31,0,9,220,459
361,82,4,2,9,4,45,-78,5,1,265,381
361,83,5,2,9,4,54,22,9,3,319,403
361,84,3,4,4,9,-69,45,0,8,250,448
361,85,4,2,4,9,40,-73,0,5,290,375
361,86,2,4,4,9,22,-55,2,0,312,320
361,87,3,3,6,7,33,34,5,4,345,354
361,88,5,2,10,3,-45,21,0,5,300,375
361,89,4,3,10,3,46,30,6,5,346,405
361,90,2,5,5,8,23,53,9,8,369,458
361,91,3,4,8,5,-65,41,4,9,304,499
361,92,2,5,3,10,21,-45,5,4,325,454
361,93,4,2,6,7,42,25,7,9,367,479
361,94,6,2,11,2,-35,20,2,9,332,499
361,95,2,5,3,10,21,-45,3,4,353,454
361,96,3,4,5,8,32,44,5,8,385,498
361,97,5,2,7,6,52,-76,7,2,437,422
361,98,2,4,6,7,-76,43,1,5,361,465
361,99,4,2,8,5,44,23,5,8,405,488
361,100,3,4,3,10,30,-54,5,4,435,434
361,101,2,4,4,9,22,45,7,9,457,479
361,102,4,2,6,7,42,-75,9,4,499,404
361,103,5,2,7,6,-48,24,1,8,451,428
361,104,3,5,5,8,32,-47,3,1,483,381
361,105,4,3,7,6,43,33,6,4,526,414
362,1,6,2,9,4,63,22,3,2,63,22
362,2,3,4,8,5,35,41,8,3,98,63
362,3,2,5,4,9,-78,54,0,7,20,117
362,4,4,3,10,3,46,30,6,7,66,147
362,5,4,3,9,4,-55,31,1,8,11,178
362,6,3,4,7,6,34,-58,5,0,45,120
362,7,5,2,11,2,-44,20,1,0,1,140
362,8,2,5,4,9,22,54,3,4,23,194
362,9,2,4,2,11,20,-53,3,1,43,141
362,10,3,4,3,10,30,46,3,7,73,187
362,11,3,4,5,8,32,-56,5,1,105,131
362,12,4,2,10,3,-54,21,1,2,51,152
362,13,5,2,11,2,56,20,7,2,107,172
362,14,2,4,6,7,-76,43,1,5,31,215
362,15,3,3,6,7,33,34,4,9,64,249
362,16,3,3,7,6,34,-67,8,2,98,182
362,17,3,3,7,6,-66,33,2,5,32,215
362,18,4,3,5,8,41,-65,3,0,73,150
362,19,2,4,5,8,23,44,6,4,96,194
362,20,4,3,10,3,-54,30,2,4,42,224
362,21,4,3,6,7,42,34,4,8,84,258
362,22,2,4,6,7,24,-57,8,1,108,201
362,23,3,3,8,5,-65,32,3,3,43,233
362,24,2,4,5,8,23,44,6,7,66,277
362,25,4,3,9,4,-55,31,1,8,11,308
362,26,2,4,4,9,22,-55,3,3,33,253
362,27,3,4,3,10,30,46,3,9,63,299
362,28,3,3,5,8,32,-65,5,4,95,234
362,29,5,2,7,6,52,24,7,8,147,258
362,30,2,5,4,9,22,-46,9,2,169,212
362,31,4,3,7,6,-57,33,2,5,112,245
362,32,4,2,8,5,44,23,6,8,156,268
362,33,4,2,9,4,-55,-78,1,0,101,190
362,34,3,4,7,6,34,42,5,2,135,232
362,35,5,2,5,8,50,26,5,8,185,258
362,36,3,4,6,7,33,-57,8,1,218,201
362,37,3,4,3,10,30,46,8,7,248,247
362,38,3,3,8,5,-65,32,3,9,183,279
362,39,3,3,8,5,35,-68,8,1,218,211
362,40,3,4,7,6,-66,42,2,3,152,253
362,41,4,2,5,8,41,26,3,9,193,279
362,42,5,2,9,4,54,-78,7,1,247,201
362,43,3,3,5,8,32,35,9,6,279,236
362,44,4,3,9,4,-55,31,4,7,224,267
362,45,4,2,10,3,-54,21,0,8,170,288
362,46,4,2,9,4,45,-78,5,0,215,210
362,47,3,3,4,9,31,36,6,6,246,246
362,48,3,4,9,4,-64,40,2,6,182,286
362,49,5,2,9,4,54,22,6,8,236,308
362,50,4,3,7,6,43,-67,9,1,279,241
362,51,3,4,5,8,-68,44,1,5,211,285
362,52,5,2,8,5,53,23,4,8,264,308
362,53,5,2,6,7,51,-75,5,3,315,233
362,54,3,3,4,9,31,36,6,9,346,269
362,55,5,2,8,5,53,-77,9,2,399,192
362,56,2,4,3,10,-79,46,0,8,320,238
362,57,3,3,7,6,34,-67,4,1,354,171
362,58,3,4,7,6,34,42,8,3,388,213
362,59,5,2,10,3,-45,21,3,4,343,234
362,60,4,3,7,6,43,33,6,7,386,267
362,61,3,4,5,8,32,-56,8,1,418,211
362,62,4,2,11,2,-53,20,5,1,365,231
362,63,3,4,7,6,34,42,9,3,399,273
362,64,4,3,8,5,-56,32,3,5,343,305
362,65,3,4,5,8,32,44,5,9,375,349
362,66,3,4,8,5,-65,-59,0,0,310,290
362,67,4,3,8,5,44,32,4,2,354,322
362,68,2,4,3,10,21,46,5,8,375,368
362,69,2,6,3,10,21,-36,6,2,396,332
362,70,6,2,9,4,63,22,9,4,459,354
362,71,4,4,7,6,-57,42,2,6,402,396
362,72,4,3,9,4,45,31,7,7,447,427
362,73,2,4,7,6,-75,42,2,9,372,469
362,74,4,4,7,6,43,-58,5,1,415,411
362,75,3,4,5,8,32,44,7,5,447,455
362,76,4,3,8,5,-56,32,1,7,391,487
362,77,2,5,2,11,20,-44,1,3,411,443
362,78,4,2,9,4,45,22,6,5,456,465
362,79,3,5,4,9,31,54,7,9,487,519
363,1,4,3,8,5,44,32,4,2,44,32
363,2,4,2,9,4,45,22,9,4,89,54
363,3,3,3,7,6,-66,33,3,7,23,87
363,4,3,4,7,6,34,42,7,9,57,129
363,5,3,3,5,8,32,-65,9,4,89,64
363,6,2,4,3,10,-79,-54,0,0,10,10
363,7,3,3,9,4,36,31,6,1,46,41
363,8,3,3,5,8,32,35,8,6,78,76
363,9,5,2,9,4,-46,22,2,8,32,98
363,10,3,3,8,5,35,-68,7,0,67,30
363,11,3,3,6,7,-67,34,0,4,0,64
363,12,2,5,4,9,22,54,2,8,22,118
363,13,3,5,7,6,34,51,6,9,56,169
363,14,4,3,9,4,-55,-69,1,0,1,100
363,15,3,3,9,4,36,31,7,1,37,131
363,16,2,4,6,7,-76,43,1,4,-39,174
363,17,3,4,4,9,31,45,2,9,-8,219
363,18,4,2,7,6,43,-76,5,3,35,143
363,19,4,2,7,6,43,24,8,7,78,167
363,20,3,3,5,8,-68,-65,0,2,10,102
363,21,3,3,8,5,35,32,5,4,45,134
363,22,3,3,3,10,30,-63,5,1,75,71
363,23,2,5,4,9,22,54,7,5,97,125
363,24,3,4,6,7,-67,43,0,8,30,168
363,25,3,4,5,8,32,-56,2,2,62,112
363,26,3,3,9,4,36,31,8,3,98,143
363,27,5,2,10,3,-45,21,3,4,53,164
363,28,4,2,9,4,45,22,8,6,98,186
363,29,3,4,5,8,-68,-56,0,0,30,130
363,30,2,4,4,9,22,45,2,5,52,175
363,31,4,2,5,8,41,-74,3,1,93,101
363,32,4,3,5,8,41,35,4,6,134,136
363,33,4,2,9,4,45,22,9,8,179,158
363,34,2,6,4,9,-78,-37,1,1,101,121
363,35,2,5,5,8,23,53,4,4,124,174
363,36,4,3,9,4,45,31,9,5,169,205
363,37,2,4,6,7,-76,43,3,8,93,248
363,38,5,2,5,8,50,-74,3,4,143,174
363,39,3,4,5,8,32,44,5,8,175,218
363,40,2,4,5,8,23,-56,8,2,198,162
363,41,4,3,6,7,-58,34,0,6,140,196
363,42,4,4,6,7,42,43,2,9,182,239
363,43,5,2,9,4,54,-78,6,1,236,161
363,44,3,4,4,9,31,45,7,6,267,206
363,45,3,3,7,6,-66,33,1,9,201,239
363,46,3,4,8,5,35,-59,6,0,236,180
363,47,4,3,8,5,-56,32,0,2,180,212
363,48,4,3,6,7,42,34,2,6,222,246
363,49,3,3,6,7,33,-66,5,0,255,180
363,50,4,3,7,6,43,33,8,3,298,213
363,51,2,6,2,11,20,65,8,8,318,278
363,52,2,4,5,8,-77,-56,1,2,241,222
363,53,3,3,8,5,35,32,6,4,276,254
363,54,4,2,6,7,42,25,8,9,318,279
363,55,3,4,6,7,-67,-57,1,2,251,222
363,56,4,3,8,5,44,32,5,4,295,254
363,57,3,3,6,7,33,34,8,8,328,288
363,58,5,2,11,2,-44,20,4,8,284,308
363,59,4,3,7,6,43,-67,7,1,327,241
363,60,4,3,9,4,-55,31,2,2,272,272
363,61,2,5,5,8,23,53,5,5,295,325
363,62,3,4,5,8,32,44,7,9,327,369
363,63,4,3,9,4,-55,-69,2,0,272,300
363,64,3,4,5,8,32,44,4,4,304,344
363,65,3,3,6,7,33,34,7,8,337,378
363,66,3,3,6,7,-67,-66,0,2,270,312
363,67,3,4,4,9,31,45,1,7,301,357
363,68,4,3,8,5,44,32,5,9,345,389
363,69,2,4,3,10,21,-54,6,5,366,335
363,70,4,2,10,3,-54,21,2,6,312,356
363,71,5,2,8,5,53,23,5,9,365,379
363,72,2,4,5,8,23,-56,8,3,388,323
363,73,4,2,8,5,-56,23,2,6,332,346
363,74,2,4,4,9,22,-55,4,1,354,291
363,75,6,2,11,2,65,20,9,1,419,311
363,76,5,2,8,5,-47,23,2,4,372,334
363,77,2,5,4,9,22,54,4,8,394,388
363,78,6,2,8,5,62,-77,6,1,456,311
363,79,3,4,4,9,31,45,7,6,487,356
363,80,3,4,5,8,32,-56,9,0,519,300
364,1,4,2,8,5,44,23,4,3,44,23
364,2,2,4,5,8,23,44,7,7,67,67
364,3,2,5,3,10,21,-45,8,2,88,22
364,4,4,3,7,6,-57,33,1,5,31,55
364,5,2,5,6,7,24,52,5,7,55,107
364,6,3,4,3,10,30,-54,5,3,85,53
364,7,3,4,5,8,32,44,7,7,117,97
364,8,3,5,4,9,31,-46,8,1,148,51
364,9,3,3,5,8,-68,35,0,6,80,86
364,10,4,3,7,6,43,33,3,9,123,119
364,11,4,2,7,6,43,-76,6,3,166,43
364,12,2,4,6,7,-76,43,0,6,90,86
364,13,3,3,6,7,33,-66,3,0,123,20
364,14,2,4,5,8,23,44,6,4,146,64
364,15,2,4,2,11,20,-53,6,1,166,11
364,16,2,4,2,11,20,47,6,8,186,58
364,17,3,3,7,6,-66,-67,0,1,120,-9
364,18,4,2,8,5,44,23,4,4,164,14
364,19,4,2,10,3,-54,21,0,5,110,35
364,20,4,3,8,5,44,32,4,7,154,67
364,21,5,2,10,3,55,21,9,8,209,88
364,22,5,3,9,4,-46,31,3,9,163,119
364,23,4,2,8,5,44,-77,7,2,207,42
364,24,5,2,10,3,-45,21,2,3,162,63
364,25,3,4,8,5,35,41,7,4,197,104
364,26,3,4,4,9,31,45,8,9,228,149
364,27,4,3,7,6,-57,-67,1,2,171,82
364,28,2,5,4,9,22,54,3,6,193,136
364,29,4,3,8,5,44,32,7,8,237,168
364,30,2,5,3,10,21,-45,8,3,258,123
364,31,3,3,6,7,-67,34,1,7,191,157
364,32,3,3,6,7,33,-66,4,1,224,91
364,33,3,3,5,8,32,35,6,6,256,126
364,34,2,5,4,9,22,-46,8,0,278,80
364,35,3,4,5,8,-68,44,0,4,210,124
364,36,2,5,3,10,21,55,1,9,231,179
364,37,2,4,5,8,23,-56,4,3,254,123
364,38,3,4,6,7,33,43,7,6,287,166
364,39,5,2,9,4,-46,22,1,8,241,188
364,40,3,3,5,8,32,-65,3,3,273,123
364,41,3,4,4,9,31,45,4,8,304,168
364,42,3,3,5,8,32,-65,6,3,336,103
364,43,3,3,7,6,-66,33,0,6,270,136
364,44,5,2,6,7,51,-75,1,1,321,61
364,45,5,2,10,3,55,21,6,2,376,82
364,46,3,3,7,6,-66,33,0,5,310,115
364,47,4,2,11,2,47,20,7,5,357,135
364,48,2,4,4,9,22,-55,9,0,379,80
364,49,5,2,8,5,-47,23,2,3,332,103
364,50,2,5,5,8,23,53,5,6,355,156
364,51,2,4,4,9,22,-55,7,1,377,101
364,52,4,4,9,4,-55,40,2,1,322,141
364,53,4,2,7,6,43,24,5,5,365,165
364,54,2,5,4,9,22,54,7,9,387,219
364,55,2,4,4,9,22,-55,9,4,409,164
364,56,4,2,8,5,-56,23,3,7,353,187
364,57,3,3,6,7,33,-66,6,1,386,121
364,58,4,3,7,6,43,33,9,4,429,154
364,59,2,4,7,6,-75,42,4,6,354,196
364,60,4,3,9,4,45,31,9,7,399,227
364,61,4,2,7,6,-57,-76,2,1,342,151
364,62,3,3,7,6,34,33,6,4,376,184
364,63,4,3,9,4,-55,31,1,5,321,215
364,64,4,3,7,6,43,33,4,8,364,248
364,65,3,4,5,8,32,-56,6,2,396,192
364,66,2,5,7,6,-75,51,1,3,321,243
364,67,2,4,4,9,22,45,3,8,343,288
364,68,4,3,8,5,44,-68,7,0,387,220
364,69,4,3,7,6,-57,33,0,3,330,253
364,70,3,3,7,6,34,33,4,6,364,286
364,71,2,5,6,7,24,52,8,8,388,338
364,72,3,4,7,6,-66,-58,2,0,322,280
364,73,3,4,5,8,32,44,4,4,354,324
364,74,4,4,6,7,42,43,6,7,396,367
364,75,3,4,6,7,33,-57,9,0,429,310
364,76,3,3,6,7,-67,34,2,4,362,344
364,77,5,2,8,5,53,23,5,7,415,367
364,78,2,5,2,11,20,-44,5,3,435,323
364,79,5,2,9,4,54,22,9,5,489,345
364,80,2,4,7,6,-75,42,4,7,414,387
364,81,4,2,7,6,43,-76,7,1,457,311
364,82,2,5,3,10,21,55,8,6,478,366
364,83,3,3,6,7,-67,-66,1,0,411,300
364,84,4,3,10,3,46,30,7,0,457,330
364,85,3,4,6,7,-67,43,0,3,390,373
364,86,3,3,5,8,32,35,2,8,422,408
364,87,4,2,6,7,42,-75,4,3,464,333
364,88,2,5,3,10,21,55,5,8,485,388
364,89,2,5,5,8,23,-47,8,1,508,341
365,1,3,4,5,8,32,44,2,4,32,44
365,2,4,3,8,5,44,32,6,6,76,76
365,3,4,2,7,6,43,-76,9,0,119,0
365,4,3,3,8,5,-65,32,4,2,54,32
365,5,3,4,4,9,31,45,5,7,85,77
365,6,4,2,4,9,40,-73,5,4,125,4
365,7,6,2,12,1,-34,-20,1,4,91,-16
365,8,3,3,6,7,33,34,4,8,124,18
365,9,2,5,4,9,22,-46,6,2,146,-28
365,10,4,4,5,8,41,44,7,6,187,16
365,11,2,5,3,10,21,-45,8,1,208,-29
365,12,4,4,9,4,-55,40,3,1,153,11
365,13,3,3,8,5,35,32,8,3,188,43
365,14,3,3,7,6,-66,33,2,6,122,76
365,15,3,4,4,9,31,-55,3,1,153,21
365,16,3,4,7,6,34,42,7,3,187,63
365,17,3,3,4,9,31,36,8,9,218,99
365,18,3,4,5,8,-68,-56,0,3,150,43
365,19,3,4,5,8,32,44,2,7,182,87
365,20,4,3,8,5,44,32,6,9,226,119
365,21,2,5,3,10,21,-45,7,4,247,74
365,22,5,3,7,6,52,33,9,7,299,107
365,23,2,4,5,8,-77,-56,2,1,222,51
365,24,3,5,7,6,34,51,6,2,256,102
365,25,3,4,5,8,32,44,8,6,288,146
365,26,4,3,7,6,-57,33,1,9,231,179
365,27,5,2,9,4,54,-78,5,1,285,101
365,28,3,3,5,8,32,35,7,6,317,136
365,29,3,3,7,6,-66,33,1,9,251,169
365,30,3,3,6,7,33,-66,4,3,284,103
365,31,4,3,8,5,44,32,8,5,328,135
365,32,2,5,2,11,20,-44,8,1,348,91
365,33,4,2,9,4,-55,22,3,3,293,113
365,34,3,3,3,10,30,-63,3,0,323,50
365,35,5,2,10,3,55,21,8,1,378,71
365,36,2,5,3,10,21,55,9,6,399,126
365,37,3,3,6,7,-67,-66,2,0,332,60
365,38,5,2,10,3,55,21,7,1,387,81
365,39,4,3,10,3,-54,30,3,1,333,111
365,40,3,4,5,8,32,44,5,5,365,155
365,41,2,4,7,6,-75,42,0,7,290,197
365,42,4,2,8,5,44,-77,4,0,334,120
365,43,2,5,6,7,24,52,8,2,358,172
365,44,4,3,8,5,-56,32,2,4,302,204
365,45,4,3,9,4,45,31,7,5,347,235
365,46,4,3,9,4,-55,31,2,6,292,266
365,47,5,2,7,6,52,-76,4,0,344,190
365,48,2,5,5,8,23,53,7,3,367,243
365,49,3,3,9,4,-64,31,3,4,303,274
365,50,2,5,7,6,25,51,8,5,328,325
365,51,5,2,10,3,-45,21,3,6,283,346
365,52,3,3,6,7,33,-66,6,0,316,280
365,53,2,5,6,7,-76,52,0,2,240,332
365,54,2,6,4,9,22,63,2,5,262,395
365,55,3,3,4,9,31,-64,3,1,293,331
365,56,3,3,4,9,31,36,4,7,324,367
365,57,3,3,7,6,34,-67,8,0,358,300
365,58,3,3,8,5,-65,32,3,2,293,332
365,59,3,3,6,7,33,34,6,6,326,366
365,60,2,5,3,10,21,-45,7,1,347,321
365,61,2,6,2,11,20,65,7,6,367,386
365,62,4,2,9,4,-55,22,2,8,312,408
365,63,3,4,6,7,33,-57,5,1,345,351
365,64,4,2,5,8,41,26,6,7,386,377
365,65,4,3,8,5,-56,32,0,9,330,409
365,66,3,3,7,6,34,-67,4,2,364,342
365,67,3,4,6,7,33,43,7,5,397,385
365,68,3,4,8,5,-65,41,2,6,332,426
365,69,3,3,7,6,34,33,6,9,366,459
365,70,3,3,7,6,-66,-67,0,2,300,392
365,71,4,4,7,6,43,42,3,4,343,434
365,72,3,4,5,8,32,44,5,8,375,478
365,73,4,2,10,3,-54,21,1,9,321,499
365,74,3,3,7,6,34,-67,5,2,355,432
365,75,4,2,10,3,-54,21,1,3,301,453
365,76,4,3,6,7,42,34,3,7,343,487
365,77,5,2,11,2,56,20,9,7,399,507
366,1,2,4,5,8,23,44,3,4,23,44
366,2,3,4,4,9,31,45,4,9,54,89
366,3,4,2,8,5,44,-77,8,2,98,12
366,4,4,4,9,4,-55,40,3,2,43,52
366,5,2,5,5,8,23,53,6,5,66,105
366,6,4,2,10,3,-54,21,2,6,12,126
366,7,2,6,4,9,22,63,4,9,34,189
366,8,4,2,9,4,45,-78,9,1,79,111
366,9,4,3,5,8,-59,35,0,6,20,146
366,10,4,3,7,6,43,33,3,9,63,179
366,11,5,2,8,5,53,-77,6,2,116,102
366,12,2,5,6,7,-76,52,0,4,40,154
366,13,6,2,9,4,63,22,3,6,103,176
366,14,2,5,2,11,20,-44,3,2,123,132
366,15,3,4,4,9,31,45,4,7,154,177
366,16,3,4,6,7,33,-57,7,0,187,120
366,17,2,5,3,10,21,55,8,5,208,175
366,18,3,3,5,8,-68,-65,0,0,140,110
366,19,3,3,8,5,35,32,5,2,175,142
366,20,4,2,10,3,-54,21,1,3,121,163
366,21,3,4,4,9,31,45,2,8,152,208
366,22,3,4,8,5,35,41,7,9,187,249
366,23,2,5,4,9,22,-46,9,3,209,203
366,24,3,3,6,7,-67,34,2,7,142,237
366,25,2,5,4,9,22,-46,4,1,164,191
366,26,4,3,6,7,42,34,6,5,206,225
366,27,3,4,6,7,33,43,9,8,239,268
366,28,4,3,9,4,-55,31,4,9,184,299
366,29,4,2,7,6,43,-76,7,3,227,223
366,30,3,3,7,6,-66,33,1,6,161,256
366,31,4,2,8,5,44,23,5,9,205,279
366,32,4,3,8,5,44,-68,9,1,249,211
366,33,2,4,3,10,-79,46,0,7,170,257
366,34,4,3,8,5,44,32,4,9,214,289
366,35,3,3,7,6,34,-67,8,2,248,222
366,36,4,2,8,5,-56,23,2,5,192,245
366,37,2,4,4,9,22,-55,4,0,214,190
366,38,3,3,6,7,33,34,7,4,247,224
366,39,3,4,5,8,32,44,9,8,279,268
366,40,5,3,8,5,-47,-68,2,0,232,200
366,41,3,3,8,5,35,32,7,2,267,232
366,42,2,4,7,6,-75,42,2,4,192,274
366,43,5,3,6,7,51,34,3,8,243,308
366,44,4,3,7,6,43,-67,6,1,286,241
366,45,4,3,9,4,-55,31,1,2,231,272
366,46,3,5,7,6,34,51,5,3,265,323
366,47,4,3,9,4,-55,31,0,4,210,354
366,48,2,4,6,7,24,43,4,7,234,397
366,49,2,4,5,8,23,-56,7,1,257,341
366,50,3,4,7,6,-66,42,1,3,191,383
366,51,2,4,5,8,23,44,4,7,214,427
366,52,2,4,2,11,20,-53,4,4,234,374
366,53,5,2,10,3,55,21,9,5,289,395
366,54,5,2,8,5,-47,23,2,8,242,418
366,55,3,3,9,4,36,31,8,9,278,449
366,56,3,3,8,5,-65,-68,3,1,213,381
366,57,3,3,9,4,36,31,9,2,249,412
366,58,3,3,5,8,-68,35,1,7,181,447
366,59,3,3,5,8,32,-65,3,2,213,382
366,60,5,2,8,5,53,23,6,5,266,405
366,61,3,3,6,7,33,34,9,9,299,439
366,62,5,2,10,3,-45,-79,4,0,254,360
366,63,4,3,6,7,42,34,6,4,296,394
366,64,4,2,5,8,41,-74,7,0,337,320
366,65,2,5,4,9,22,54,9,4,359,374
366,66,3,3,6,7,-67,34,2,8,292,408
366,67,4,2,7,6,43,-76,5,2,335,332
366,68,4,3,10,3,-54,30,1,2,281,362
366,69,2,4,6,7,24,43,5,5,305,405
366,70,2,4,5,8,23,44,8,9,328,449
366,71,2,4,5,8,-77,-56,1,3,251,393
366,72,3,3,6,7,33,34,4,7,284,427
366,73,5,2,9,4,54,22,8,9,338,449
366,74,3,4,4,9,31,-55,9,4,369,394
366,75,2,4,5,8,-77,44,2,8,292,438
366,76,2,4,4,9,22,-55,4,3,314,383
366,77,2,5,4,9,22,54,6,7,336,437
366,78,3,4,3,10,30,-54,6,3,366,383
366,79,4,3,8,5,-56,32,0,5,310,415
366,80,3,4,3,10,30,-54,0,1,340,361
366,81,3,3,6,7,33,34,3,5,373,395
366,82,2,4,4,9,22,-55,5,0,395,340
366,83,3,3,7,6,34,33,9,3,429,373
366,84,3,3,8,5,-65,32,4,5,364,405
366,85,3,3,7,6,34,33,8,8,398,438
366,86,3,3,7,6,-66,-67,2,1,332,371
366,87,3,3,8,5,35,32,7,3,367,403
366,88,4,2,9,4,-55,22,2,5,312,425
366,89,3,5,7,6,34,51,6,6,346,476
366,90,3,4,6,7,33,43,9,9,379,519
367,1,5,2,10,3,55,21,5,1,55,21
367,2,3,3,7,6,34,33,9,4,89,54
367,3,4,3,7,6,-57,33,2,7,32,87
367,4,3,3,5,8,32,-65,4,2,64,22
367,5,3,3,9,4,-64,31,0,3,0,53
367,6,3,3,7,6,34,33,4,6,34,86
367,7,4,2,9,4,45,22,9,8,79,108
367,8,4,2,9,4,-55,-78,4,0,24,30
367,9,4,3,7,6,43,33,7,3,67,63
367,10,4,3,7,6,-57,33,0,6,10,96
367,11,3,4,6,7,33,43,3,9,43,139
367,12,4,3,7,6,43,-67,6,2,86,72
367,13,2,5,4,9,22,54,8,6,108,126
367,14,4,2,7,6,-57,-76,1,0,51,50
367,15,3,3,5,8,32,35,3,5,83,85
367,16,2,5,3,10,21,-45,4,0,104,40
367,17,4,3,7,6,43,33,7,3,147,73
367,18,4,2,6,7,42,25,9,8,189,98
367,19,4,2,11,2,-53,20,6,8,136,118
367,20,3,4,3,10,30,-54,6,4,166,64
367,21,3,4,7,6,-66,42,0,6,100,106
367,22,4,2,7,6,43,-76,3,0,143,30
367,23,3,4,7,6,34,42,7,2,177,72
367,24,4,2,9,4,-55,22,2,4,122,94
367,25,4,3,10,3,46,30,8,4,168,124
367,26,4,3,8,5,-56,32,2,6,112,156
367,27,5,2,9,4,54,22,6,8,166,178
367,28,4,2,11,2,-53,20,3,8,113,198
367,29,4,3,4,9,40,-64,3,4,153,134
367,30,4,3,6,7,42,34,5,8,195,168
367,31,3,3,5,8,32,-65,7,3,227,103
367,32,5,2,7,6,52,24,9,7,279,127
367,33,4,2,11,2,-53,20,6,7,226,147
367,34,3,3,8,5,-65,32,1,9,161,179
367,35,5,3,8,5,53,-68,4,1,214,111
367,36,3,4,4,9,31,45,5,6,245,156
367,37,4,2,8,5,44,23,9,9,289,179
367,38,4,2,10,3,-54,-79,5,0,235,100
367,39,5,2,10,3,-45,21,0,1,190,121
367,40,3,3,5,8,32,35,2,6,222,156
367,41,4,3,8,5,44,32,6,8,266,188
367,42,2,5,5,8,23,-47,9,1,289,141
367,43,3,3,9,4,-64,31,5,2,225,172
367,44,3,4,8,5,-65,41,0,3,160,213
367,45,4,2,7,6,43,24,3,7,203,237
367,46,4,4,8,5,44,41,7,8,247,278
367,47,3,3,5,8,32,-65,9,3,279,213
367,48,4,3,7,6,-57,33,2,6,222,246
367,49,3,3,3,10,30,-63,2,3,252,183
367,50,4,2,8,5,44,23,6,6,296,206
367,51,3,3,4,9,31,-64,7,2,327,142
367,52,2,5,5,8,-77,53,0,5,250,195
367,53,5,3,7,6,52,33,2,8,302,228
367,54,4,3,6,7,42,-66,4,2,344,162
367,55,2,4,4,9,22,45,6,7,366,207
367,56,2,5,4,9,22,-46,8,1,388,161
367,57,3,4,7,6,-66,42,2,3,322,203
367,58,4,2,9,4,45,22,7,5,367,225
367,59,3,3,7,6,-66,33,1,8,301,258
367,60,3,4,7,6,34,-58,5,0,335,200
367,61,3,4,6,7,33,43,8,3,368,243
367,62,2,4,6,7,-76,43,2,6,292,286
367,63,3,3,7,6,34,33,6,9,326,319
367,64,4,4,6,7,42,-57,8,2,368,262
367,65,3,4,4,9,31,45,9,7,399,307
367,66,5,2,8,5,-47,-77,2,0,352,230
367,67,3,4,4,9,31,45,3,5,383,275
367,68,5,2,9,4,54,22,7,7,437,297
367,69,4,2,6,7,42,-75,9,2,479,222
367,70,3,4,7,6,-66,42,3,4,413,264
367,71,5,2,10,3,55,21,8,5,468,285
367,72,2,5,3,10,21,-45,9,0,489,240
367,73,3,3,9,4,-64,31,5,1,425,271
367,74,4,4,7,6,43,42,8,3,468,313
367,75,3,3,8,5,-65,32,3,5,403,345
367,76,2,4,5,8,23,44,6,9,426,389
367,77,3,3,7,6,-66,-67,0,2,360,322
367,78,4,3,8,5,44,32,4,4,404,354
367,79,4,4,4,9,40,45,4,9,444,399
367,80,3,3,6,7,33,-66,7,3,477,333
367,81,4,2,11,2,-53,20,4,3,424,353
367,82,3,4,6,7,33,43,7,6,457,396
367,83,4,2,10,3,-54,21,3,7,403,417
367,84,2,5,6,7,24,52,7,9,427,469
367,85,3,3,8,5,-65,-68,2,1,362,401
367,86,3,3,3,10,30,37,2,8,392,438
367,87,2,5,5,8,23,-47,5,1,415,391
367,88,2,6,2,11,20,65,5,6,435,456
367,89,4,2,10,3,-54,21,1,7,381,477
367,90,3,4,6,7,33,-57,4,0,414,420
367,91,3,3,5,8,32,35,6,5,446,455
367,92,4,3,7,6,43,33,9,8,489,488
367,93,2,5,6,7,-76,-48,3,0,413,440
367,94,4,3,7,6,43,33,6,3,456,473
367,95,3,4,6,7,33,43,9,6,489,516
368,1,3,4,7,6,34,42,4,2,34,42
368,2,4,2,5,8,41,26,5,8,75,68
368,3,2,5,6,7,24,-48,9,0,99,20
368,4,2,5,3,10,-79,55,0,5,20,75
368,5,2,5,4,9,22,54,2,9,42,129
368,6,3,3,6,7,33,-66,5,3,75,63
368,7,5,3,5,8,50,35,5,8,125,98
368,8,4,3,9,4,-55,31,0,9,70,129
368,9,4,2,8,5,44,-77,4,2,114,52
368,10,3,3,7,6,34,33,8,5,148,85
368,11,3,3,6,7,-67,34,1,9,81,119
368,12,3,3,6,7,33,-66,4,3,114,53
368,13,3,4,8,5,35,41,9,4,149,94
368,14,2,5,3,10,-79,55,0,9,70,149
368,15,3,4,6,7,33,-57,3,2,103,92
368,16,5,2,10,3,55,21,8,3,158,113
368,17,5,3,9,4,-46,31,2,4,112,144
368,18,2,4,4,9,22,45,4,9,134,189
368,19,2,5,2,11,20,-44,4,5,154,145
368,20,4,4,5,8,41,44,5,9,195,189
368,21,2,5,4,9,22,-46,7,3,217,143
368,22,2,4,8,5,-74,41,3,4,143,184
368,23,5,2,7,6,52,24,5,8,195,208
368,24,3,4,7,6,34,-58,9,0,229,150
368,25,3,4,8,5,-65,41,4,1,164,191
368,26,3,3,7,6,34,33,8,4,198,224
368,27,4,3,7,6,-57,33,1,7,141,257
368,28,3,3,8,5,35,32,6,9,176,289
368,29,3,4,6,7,33,-57,9,2,209,232
368,30,4,2,9,4,-55,22,4,4,154,254
368,31,4,2,7,6,43,24,7,8,197,278
368,32,3,3,4,9,31,-64,8,4,228,214
368,33,4,2,10,3,-54,21,4,5,174,235
368,34,5,2,10,3,55,21,9,6,229,256
368,35,5,2,8,5,-47,23,2,9,182,279
368,36,4,2,9,4,45,-78,7,1,227,201
368,37,4,3,7,6,-57,33,0,4,170,234
368,38,4,2,8,5,44,23,4,7,214,257
368,39,3,4,8,5,35,41,9,8,249,298
368,40,2,5,5,8,-77,-47,2,1,172,251
368,41,4,2,9,4,45,22,7,3,217,273
368,42,3,3,8,5,-65,32,2,5,152,305
368,43,3,5,4,9,31,54,3,9,183,359
368,44,2,4,4,9,22,-55,5,4,205,304
368,45,5,2,9,4,54,22,9,6,259,326
368,46,3,4,5,8,-68,-56,1,0,191,270
368,47,4,3,8,5,44,32,5,2,235,302
368,48,3,3,8,5,-65,32,0,4,170,334
368,49,3,4,8,5,35,41,5,5,205,375
368,50,4,2,9,4,-55,22,0,7,150,397
368,51,3,3,4,9,31,-64,1,3,181,333
368,52,4,2,8,5,44,23,5,6,225,356
368,53,4,3,6,7,42,-66,7,0,267,290
368,54,4,3,6,7,42,34,9,4,309,324
368,55,2,4,6,7,-76,43,3,7,233,367
368,56,2,4,4,9,22,-55,5,2,255,312
368,57,3,3,7,6,34,33,9,5,289,345
368,58,2,4,4,9,-78,-55,1,0,211,290
368,59,3,3,8,5,35,32,6,2,246,322
368,60,4,3,7,6,43,33,9,5,289,355
368,61,2,6,3,10,-79,64,0,9,210,419
368,62,3,4,5,8,32,-56,2,3,242,363
368,63,4,2,7,6,43,24,5,7,285,387
368,64,4,2,9,4,-55,22,0,9,230,409
368,65,2,4,5,8,23,-56,3,3,253,353
368,66,2,5,5,8,23,53,6,6,276,406
368,67,3,3,4,9,31,-64,7,2,307,342
368,68,3,3,7,6,-66,33,1,5,241,375
368,69,2,5,5,8,23,53,4,8,264,428
368,70,4,3,6,7,42,-66,6,2,306,362
368,71,3,3,5,8,32,35,8,7,338,397
368,72,3,4,5,8,-68,-56,0,1,270,341
368,73,5,3,8,5,53,32,3,3,323,373
368,74,2,4,6,7,24,43,7,6,347,416
368,75,3,4,4,9,31,-55,8,1,378,361
368,76,2,4,6,7,-76,43,2,4,302,404
368,77,2,4,5,8,23,44,5,8,325,448
368,78,2,5,6,7,24,-48,9,0,349,400
368,79,4,3,4,9,40,36,9,6,389,436
368,80,4,2,9,4,-55,22,4,8,334,458
368,81,4,2,9,4,45,-78,9,0,379,380
368,82,2,4,4,9,-78,45,1,5,301,425
368,83,4,3,8,5,44,32,5,7,345,457
368,84,4,2,7,6,43,-76,8,1,388,381
368,85,3,3,5,8,-68,35,0,6,320,416
368,86,4,3,7,6,43,33,3,9,363,449
368,87,3,3,5,8,32,-65,5,4,395,384
368,88,3,3,4,9,31,-64,6,0,426,320
368,89,3,4,4,9,31,45,7,5,457,365
368,90,4,2,7,6,-57,24,0,9,400,389
368,91,2,5,7,6,25,-49,5,0,425,340
368,92,5,2,11,2,-44,20,1,0,381,360
368,93,3,4,6,7,33,43,4,3,414,403
368,94,4,2,6,7,42,25,6,8,456,428
368,95,4,2,7,6,43,-76,9,2,499,352
368,96,4,3,9,4,-55,31,4,3,444,383
368,97,4,3,8,5,44,32,8,5,488,415
368,98,4,2,9,4,-55,22,3,7,433,437
368,99,2,6,4,9,22,-37,5,0,455,400
368,100,3,4,4,9,31,45,6,5,486,445
368,101,4,3,7,6,43,33,9,8,529,478
369,1,3,4,6,7,33,43,3,3,33,43
369,2,2,4,2,11,20,-53,3,0,53,-10
369,3,2,4,6,7,24,43,7,3,77,33
369,4,3,4,4,9,31,45,8,8,108,78
369,5,5,2,7,6,-48,-76,0,2,60,2
369,6,4,3,6,7,42,34,2,6,102,36
369,7,4,2,7,6,43,-76,5,0,145,-40
369,8,3,4,3,10,30,46,5,6,175,6
369,9,3,4,5,8,32,-56,7,0,207,-50
369,10,3,4,6,7,-67,43,0,3,140,-7
369,11,4,3,5,8,41,35,1,8,181,28
369,12,3,4,7,6,34,-58,5,0,215,-30
369,13,3,4,3,10,30,46,5,6,245,16
369,14,2,4,7,6,-75,42,0,8,170,58
369,15,5,2,8,5,53,-77,3,1,223,-19
369,16,4,2,5,8,41,26,4,7,264,7
369,17,3,3,9,4,-64,31,0,8,200,38
369,18,3,3,7,6,34,-67,4,1,234,-29
369,19,3,3,6,7,33,34,7,5,267,5
369,20,4,2,9,4,-55,22,2,7,212,27
369,21,4,3,7,6,43,-67,5,0,255,-40
369,22,5,2,9,4,54,22,9,2,309,-18
369,23,3,4,9,4,-64,40,5,2,245,22
369,24,3,3,6,7,33,34,8,6,278,56
369,25,4,4,5,8,41,-56,9,0,319,0
369,26,2,4,5,8,-77,44,2,4,242,44
369,27,2,5,3,10,21,55,3,9,263,99
369,28,5,2,9,4,54,-78,7,1,317,21
369,29,5,2,10,3,-45,21,2,2,272,42
369,30,5,3,6,7,51,34,3,6,323,76
369,31,3,3,6,7,33,-66,6,0,356,10
369,32,3,4,4,9,31,45,7,5,387,55
369,33,2,4,4,9,22,-55,9,0,409,0
369,34,5,2,8,5,-47,23,2,3,362,23
369,35,2,5,5,8,23,53,5,6,385,76
369,36,4,2,8,5,44,23,9,9,429,99
369,37,3,4,4,9,-69,-55,0,4,360,44
369,38,3,3,6,7,33,34,3,8,393,78
369,39,5,2,9,4,54,-78,7,0,447,0
369,40,5,2,9,4,-46,22,1,2,401,22
369,41,5,2,11,2,56,20,7,2,457,42
369,42,4,2,8,5,-56,23,1,5,401,65
369,43,6,2,10,3,64,21,5,6,465,86
369,44,2,5,5,8,23,53,8,9,488,139
369,45,4,3,7,6,-57,-67,1,2,431,72
369,46,6,2,10,3,64,21,5,3,495,93
369,47,2,5,4,9,22,54,7,7,517,147
370,1,4,3,8,5,44,32,4,2,44,32
370,2,3,4,4,9,31,45,5,7,75,77
370,3,3,3,6,7,33,-66,8,1,108,11
370,4,2,4,6,7,-76,43,2,4,32,54
370,5,2,5,4,9,22,54,4,8,54,108
370,6,3,3,6,7,33,-66,7,2,87,42
370,7,2,4,7,6,-75,42,2,4,12,84
370,8,3,4,2,11,-30,-53,2,1,-18,31
370,9,3,3,7,6,34,33,6,4,16,64
370,10,3,4,8,5,-65,41,1,5,-49,105
370,11,3,3,4,9,31,-64,2,1,-18,41
370,12,3,4,4,9,31,45,3,6,13,86
370,13,3,4,5,8,32,-56,5,0,45,30
370,14,3,3,6,7,33,34,8,4,78,64
370,15,2,4,6,7,-76,43,2,7,2,107
370,16,2,4,3,10,21,-54,3,3,23,53
370,17,2,4,5,8,23,44,6,7,46,97
370,18,2,4,3,10,21,-54,7,3,67,43
370,19,2,5,2,11,20,56,7,9,87,99
370,20,4,3,8,5,-56,-68,1,1,31,31
370,21,2,4,5,8,23,44,4,5,54,75
370,22,4,2,6,7,42,-75,6,0,96,0
370,23,3,3,7,6,-66,33,0,3,30,33
370,24,3,3,6,7,33,34,3,7,63,67
370,25,3,3,5,8,32,-65,5,2,95,2
370,26,4,3,8,5,44,32,9,4,139,34
370,27,5,2,10,3,-45,21,4,5,94,55
370,28,3,3,6,7,33,34,7,9,127,89
370,29,4,3,10,3,-54,30,3,9,73,119
370,30,2,4,3,10,21,-54,4,5,94,65
370,31,2,4,4,9,22,-55,6,0,116,10
370,32,4,3,6,7,42,34,8,4,158,44
370,33,5,2,9,4,-46,22,2,6,112,66
370,34,3,3,5,8,32,-65,4,1,144,1
370,35,3,3,6,7,33,34,7,5,177,35
370,36,4,3,8,5,-56,32,1,7,121,67
370,37,4,3,9,4,45,31,6,8,166,98
370,38,3,3,7,6,-66,-67,0,1,100,31
370,39,2,4,6,7,24,43,4,4,124,74
370,40,5,2,10,3,55,21,9,5,179,95
370,41,2,5,5,8,-77,53,2,8,102,148
370,42,4,2,10,3,46,21,8,9,148,169
370,43,3,3,5,8,-68,-65,0,4,80,104
370,44,4,3,10,3,46,30,6,4,126,134
370,45,4,4,8,5,-56,41,0,5,70,175
370,46,3,3,7,6,34,33,4,8,104,208
370,47,5,2,7,6,52,-76,6,2,156,132
370,48,2,4,4,9,22,45,8,7,178,177
370,49,4,3,9,4,-55,31,3,8,123,208
370,50,5,3,7,6,52,-67,5,1,175,141
370,51,3,4,4,9,31,45,6,6,206,186
370,52,5,2,8,5,53,23,9,9,259,209
370,53,3,4,6,7,-67,-57,2,2,192,152
370,54,5,2,7,6,52,24,4,6,244,176
370,55,2,4,3,10,21,-54,5,2,265,122
370,56,4,3,6,7,42,34,7,6,307,156
370,57,4,3,6,7,42,-66,9,0,349,90
370,58,3,3,7,6,-66,33,3,3,283,123
370,59,4,2,10,3,46,21,9,4,329,144
370,60,2,5,5,8,-77,53,2,7,252,197
370,61,3,4,7,6,34,42,6,9,286,239
370,62,3,4,7,6,-66,-58,0,1,220,181
370,63,4,2,7,6,43,24,3,5,263,205
370,64,2,4,2,11,20,-53,3,2,283,152
370,65,3,3,5,8,32,35,5,7,315,187
370,66,4,3,10,3,-54,30,1,7,261,217
370,67,4,3,6,7,42,-66,3,1,303,151
370,68,3,3,7,6,34,33,7,4,337,184
370,69,3,4,6,7,-67,43,0,7,270,227
370,70,5,2,7,6,52,-76,2,1,322,151
370,71,5,2,9,4,54,22,6,3,376,173
370,72,4,2,9,4,-55,22,1,5,321,195
370,73,3,3,8,5,35,32,6,7,356,227
370,74,4,3,5,8,41,-65,7,2,397,162
370,75,2,5,3,10,21,55,8,7,418,217
370,76,3,4,6,7,-67,-57,1,0,351,160
370,77,3,3,6,7,33,34,4,4,384,194
370,78,4,3,6,7,42,34,6,8,426,228
370,79,4,3,10,3,-54,30,2,8,372,258
370,80,2,4,7,6,25,-58,7,0,397,200
370,81,3,4,5,8,32,44,9,4,429,244
370,82,3,4,6,7,-67,43,2,7,362,287
370,83,3,4,9,4,36,40,8,7,398,327
370,84,5,2,8,5,-47,-77,1,0,351,250
370,85,4,3,6,7,42,34,3,4,393,284
370,86,4,2,7,6,43,24,6,8,436,308
370,87,3,3,8,5,-65,-68,1,0,371,240
370,88,3,3,6,7,33,34,4,4,404,274
370,89,2,5,4,9,22,54,6,8,426,328
370,90,4,4,5,8,41,-56,7,2,467,272
370,91,3,3,7,6,-66,33,1,5,401,305
370,92,2,5,4,9,22,54,3,9,423,359
370,93,4,3,5,8,41,-65,4,4,464,294
370,94,5,2,8,5,53,23,7,7,517,317
371,1,4,2,6,7,42,25,2,5,42,25
371,2,3,4,6,7,33,43,5,8,75,68
371,3,3,4,5,8,32,-56,7,2,107,12
371,4,2,4,7,6,-75,42,2,4,32,54
371,5,5,2,9,4,54,22,6,6,86,76
371,6,3,4,5,8,32,-56,8,0,118,20
371,7,3,4,4,9,31,45,9,5,149,65
371,8,3,3,6,7,-67,34,2,9,82,99
371,9,2,5,6,7,24,-48,6,1,106,51
371,10,4,2,8,5,-56,23,0,4,50,74
371,11,4,4,5,8,41,44,1,8,91,118
371,12,2,5,2,11,20,-44,1,4,111,74
371,13,3,3,6,7,33,34,4,8,144,108
371,14,3,3,9,4,-64,31,0,9,80,139
371,15,5,3,7,6,52,-67,2,2,132,72
371,16,3,4,5,8,32,44,4,6,164,116
371,17,2,4,4,9,22,-55,6,1,186,61
371,18,3,4,5,8,32,44,8,5,218,105
371,19,3,3,7,6,-66,33,2,8,152,138
371,20,6,2,9,4,63,-78,5,0,215,60
371,21,4,3,7,6,43,33,8,3,258,93
371,22,3,4,7,6,-66,42,2,5,192,135
371,23,4,3,5,8,41,-65,3,0,233,70
371,24,2,4,2,11,20,47,3,7,253,117
371,25,2,5,2,11,20,-44,3,3,273,73
371,26,2,5,5,8,23,53,6,6,296,126
371,27,2,5,3,10,21,-45,7,1,317,81
371,28,5,2,11,2,-44,20,3,1,273,101
371,29,3,4,4,9,31,45,4,6,304,146
371,30,4,2,7,6,43,-76,7,0,347,70
371,31,2,4,6,7,-76,43,1,3,271,113
371,32,2,4,5,8,23,44,4,7,294,157
371,33,4,3,6,7,42,-66,6,1,336,91
371,34,2,4,4,9,22,45,8,6,358,136
371,35,3,4,5,8,-68,-56,0,0,290,80
371,36,3,3,4,9,31,36,1,6,321,116
371,37,5,2,11,2,56,20,7,6,377,136
371,38,3,3,6,7,-67,-66,0,0,310,70
371,39,5,2,8,5,53,23,3,3,363,93
371,40,3,4,6,7,33,43,6,6,396,136
371,41,2,5,5,8,23,53,9,9,419,189
371,42,2,4,4,9,-78,-55,1,4,341,134
371,43,3,3,9,4,36,31,7,5,377,165
371,44,4,3,6,7,42,34,9,9,419,199
371,45,2,4,7,6,-75,-58,4,1,344,141
371,46,3,4,5,8,32,44,6,5,376,185
371,47,3,4,5,8,32,44,8,9,408,229
371,48,3,4,6,7,-67,-57,1,2,341,172
371,49,3,3,6,7,33,34,4,6,374,206
371,50,2,4,4,9,22,-55,6,1,396,151
371,51,4,2,8,5,-56,23,0,4,340,174
371,52,5,2,7,6,52,24,2,8,392,198
371,53,3,4,5,8,32,-56,4,2,424,142
371,54,4,2,11,2,-53,20,1,2,371,162
371,55,4,3,8,5,44,32,5,4,415,194
371,56,3,3,7,6,34,33,9,7,449,227
371,57,3,4,6,7,-67,-57,2,0,382,170
371,58,2,4,4,9,22,45,4,5,404,215
371,59,5,2,9,4,54,22,8,7,458,237
371,60,3,4,5,8,-68,-56,0,1,390,181
371,61,3,4,4,9,31,45,1,6,421,226
371,62,4,3,5,8,41,-65,2,1,462,161
371,63,2,4,5,8,23,44,5,5,485,205
371,64,5,2,8,5,53,23,8,8,538,228
372,1,4,2,5,8,41,26,1,6,41,26
372,2,3,4,8,5,35,41,6,7,76,67
372,3,5,2,10,3,-45,21,1,8,31,88
372,4,3,3,6,7,33,-66,4,2,64,22
372,5,3,4,4,9,31,45,5,7,95,67
372,6,5,2,7,6,52,-76,7,1,147,-9
372,7,4,3,10,3,-54,30,3,1,93,21
372,8,6,2,7,6,61,24,4,5,154,45
372,9,4,3,9,4,45,31,9,6,199,76
372,10,6,2,10,3,-36,21,3,7,163,97
372,11,2,5,6,7,24,52,7,9,187,149
372,12,2,4,3,10,21,-54,8,5,208,95
372,13,5,2,8,5,-47,23,1,8,161,118
372,14,2,6,5,8,23,-38,4,0,184,80
372,15,3,3,4,9,31,36,5,6,215,116
372,16,3,4,7,6,34,42,9,8,249,158
372,17,3,3,9,4,-64,31,5,9,185,189
372,18,2,4,4,9,22,-55,7,4,207,134
372,19,5,2,10,3,-45,21,2,5,162,155
372,20,4,3,8,5,44,32,6,7,206,187
372,21,4,3,6,7,42,-66,8,1,248,121
372,22,2,4,5,8,-77,44,1,5,171,165
372,23,4,2,7,6,43,24,4,9,214,189
372,24,5,2,10,3,55,-79,9,0,269,110
372,25,2,6,6,7,-76,61,3,1,193,171
372,26,2,4,4,9,22,45,5,6,215,216
372,27,3,3,8,5,-65,32,0,8,150,248
372,28,4,3,6,7,42,-66,2,2,192,182
372,29,3,5,5,8,32,53,4,5,224,235
372,30,3,3,6,7,33,34,7,9,257,269
372,31,4,3,7,6,-57,-67,0,2,200,202
372,32,2,5,2,11,20,56,0,8,220,258
372,33,4,2,7,6,43,-76,3,2,263,182
372,34,4,3,8,5,44,32,7,4,307,214
372,35,4,3,6,7,42,34,9,8,349,248
372,36,5,2,9,4,-46,-78,3,0,303,170
372,37,4,2,7,6,43,24,6,4,346,194
372,38,2,5,6,7,-76,52,0,6,270,246
372,39,4,2,6,7,42,-75,2,1,312,171
372,40,2,4,5,8,23,44,5,5,335,215
372,41,2,5,2,11,20,-44,5,1,355,171
372,42,2,5,7,6,-75,51,0,2,280,222
372,43,5,2,8,5,53,23,3,5,333,245
372,44,2,5,4,9,22,54,5,9,355,299
372,45,4,2,6,7,42,-75,7,4,397,224
372,46,4,2,9,4,-55,22,2,6,342,246
372,47,2,5,4,9,22,-46,4,0,364,200
372,48,5,2,10,3,55,21,9,1,419,221
372,49,4,3,9,4,-55,31,4,2,364,252
372,50,5,2,7,6,52,24,6,6,416,276
372,51,3,3,5,8,32,-65,8,1,448,211
372,52,2,4,6,7,-76,43,2,4,372,254
372,53,2,4,5,8,23,44,5,8,395,298
372,54,4,3,7,6,43,-67,8,1,438,231
372,55,3,4,6,7,-67,43,1,4,371,274
372,56,4,2,6,7,42,25,3,9,413,299
372,57,4,3,7,6,43,-67,6,2,456,232
372,58,6,2,10,3,-36,21,0,3,420,253
372,59,4,2,8,5,44,23,4,6,464,276
372,60,3,3,7,6,34,33,8,9,498,309
372,61,7,2,10,3,-27,-79,1,0,471,230
372,62,3,3,5,8,32,35,3,5,503,265
373,1,4,2,8,5,44,23,4,3,44,23
373,2,4,2,7,6,43,24,7,7,87,47
373,3,3,4,7,6,-66,42,1,9,21,89
373,4,4,2,9,4,45,-78,6,1,66,11
373,5,2,4,6,7,-76,43,0,4,-10,54
373,6,4,3,9,4,45,31,5,5,35,85
373,7,5,3,10,3,-45,30,0,5,-10,115
373,8,3,4,5,8,32,44,2,9,22,159
373,9,3,3,5,8,32,-65,4,4,54,94
373,10,4,3,6,7,42,34,6,8,96,128
373,11,3,3,6,7,33,-66,9,2,129,62
373,12,2,4,2,11,20,47,9,9,149,109
373,13,2,4,5,8,-77,-56,2,3,72,53
373,14,5,2,10,3,55,21,7,4,127,74
373,15,2,5,4,9,22,54,9,8,149,128
373,16,7,2,9,4,-28,-78,1,0,121,50
373,17,3,3,5,8,32,35,3,5,153,85
373,18,2,5,5,8,23,53,6,8,176,138
373,19,2,4,5,8,23,-56,9,2,199,82
373,20,2,5,3,10,-79,55,0,7,120,137
373,21,3,3,6,7,33,-66,3,1,153,71
373,22,3,3,8,5,35,32,8,3,188,103
373,23,5,2,10,3,-45,21,3,4,143,124
373,24,5,2,9,4,54,22,7,6,197,146
373,25,3,3,7,6,-66,33,1,9,131,179
373,26,2,4,4,9,22,-55,3,4,153,124
373,27,4,2,7,6,43,24,6,8,196,148
373,28,6,2,10,3,-36,21,0,9,160,169
373,29,4,4,8,5,44,-59,4,0,204,110
373,30,4,3,7,6,43,33,7,3,247,143
373,31,3,3,8,5,-65,32,2,5,182,175
373,32,4,2,7,6,43,24,5,9,225,199
373,33,3,3,6,7,33,-66,8,3,258,133
373,34,4,2,9,4,-55,22,3,5,203,155
373,35,5,3,9,4,54,31,7,6,257,186
373,36,4,3,7,6,-57,33,0,9,200,219
373,37,5,2,8,5,53,-77,3,2,253,142
373,38,3,3,7,6,34,33,7,5,287,175
373,39,4,3,8,5,-56,32,1,7,231,207
373,40,3,3,4,9,31,-64,2,3,262,143
373,41,3,4,7,6,34,42,6,5,296,185
373,42,2,5,4,9,22,54,8,9,318,239
373,43,2,5,4,9,-78,-46,0,3,240,193
373,44,2,4,3,10,21,46,1,9,261,239
373,45,4,2,8,5,44,-77,5,2,305,162
373,46,5,2,10,3,-45,21,0,3,260,183
373,47,3,4,9,4,36,40,6,3,296,223
373,48,5,2,7,6,52,24,8,7,348,247
373,49,5,3,8,5,-47,32,1,9,301,279
373,50,3,4,7,6,34,-58,5,1,335,221
373,51,3,3,6,7,33,34,8,5,368,255
373,52,4,3,5,8,41,-65,9,0,409,190
373,53,3,4,6,7,-67,43,2,3,342,233
373,54,2,5,6,7,24,52,6,5,366,285
373,55,4,3,7,6,43,33,9,8,409,318
373,56,3,3,5,8,-68,-65,1,3,341,253
373,57,3,4,8,5,35,41,6,4,376,294
373,58,5,2,8,5,53,23,9,7,429,317
373,59,2,6,3,10,-79,-36,0,1,350,281
373,60,4,3,7,6,43,33,3,4,393,314
373,61,2,5,5,8,23,53,6,7,416,367
373,62,5,2,10,3,-45,21,1,8,371,388
373,63,3,3,8,5,35,-68,6,0,406,320
373,64,5,2,8,5,53,23,9,3,459,343
373,65,4,3,9,4,-55,31,4,4,404,374
373,66,3,3,9,4,-64,31,0,5,340,405
373,67,3,3,7,6,34,33,4,8,374,438
373,68,3,3,6,7,33,-66,7,2,407,372
373,69,2,4,6,7,-76,43,1,5,331,415
373,70,4,2,8,5,44,23,5,8,375,438
373,71,5,2,10,3,-45,21,0,9,330,459
373,72,3,4,7,6,34,-58,4,1,364,401
373,73,5,2,9,4,54,22,8,3,418,423
373,74,4,2,8,5,-56,23,2,6,362,446
373,75,5,2,7,6,52,-76,4,0,414,370
373,76,3,3,6,7,33,34,7,4,447,404
373,77,2,5,2,11,20,-44,7,0,467,360
373,78,3,3,4,9,31,36,8,6,498,396
373,79,5,2,9,4,-46,22,2,8,452,418
373,80,3,3,6,7,33,-66,5,2,485,352
373,81,2,4,5,8,23,44,8,6,508,396
374,1,3,4,4,9,31,45,1,5,31,45
374,2,4,3,9,4,45,31,6,6,76,76
374,3,3,3,8,5,-65,32,1,8,11,108
374,4,2,5,3,10,21,-45,2,3,32,63
374,5,3,3,10,3,37,30,9,3,69,93
374,6,2,5,6,7,-76,52,3,5,-7,145
374,7,3,4,5,8,32,44,5,9,25,189
374,8,2,4,4,9,22,-55,7,4,47,134
374,9,2,5,8,5,-74,50,3,4,-27,184
374,10,4,2,7,6,43,24,6,8,16,208
374,11,2,6,3,10,21,-36,7,2,37,172
374,12,2,5,5,8,-77,53,0,5,-40,225
374,13,4,2,8,5,44,23,4,8,4,248
374,14,3,3,7,6,34,-67,8,1,38,181
374,15,2,5,3,10,21,55,9,6,59,236
374,16,3,3,7,6,-66,33,3,9,-7,269
374,17,2,5,5,8,23,-47,6,2,16,222
374,18,4,2,7,6,43,24,9,6,59,246
374,19,3,4,6,7,-67,43,2,9,-8,289
374,20,4,2,9,4,45,-78,7,1,37,211
374,21,2,6,3,10,21,64,8,5,58,275
374,22,3,4,8,5,-65,41,3,6,-7,316
374,23,2,5,4,9,22,-46,5,0,15,270
374,24,4,3,9,4,-55,31,0,1,-40,301
374,25,2,4,5,8,23,44,3,5,-17,345
374,26,4,3,7,6,43,33,6,8,26,378
374,27,4,3,7,6,43,-67,9,1,69,311
374,28,4,2,10,3,-54,21,5,2,15,332
374,29,4,2,9,4,-55,22,0,4,-40,354
374,30,2,4,3,10,21,-54,1,0,-19,300
374,31,2,5,6,7,24,52,5,2,5,352
374,32,3,3,7,6,34,33,9,5,39,385
374,33,5,2,9,4,-46,22,3,7,-7,407
374,34,3,3,5,8,32,-65,5,2,25,342
374,35,3,3,7,6,34,33,9,5,59,375
374,36,4,3,10,3,-54,30,5,5,5,405
374,37,3,4,5,8,32,44,7,9,37,449
374,38,2,4,7,6,-75,-58,2,1,-38,391
374,39,3,3,4,9,31,36,3,7,-7,427
374,40,4,3,7,6,43,-67,6,0,36,360
374,41,5,2,9,4,-46,22,0,2,-10,382
374,42,2,5,5,8,23,53,3,5,13,435
374,43,4,2,9,4,45,22,8,7,58,457
374,44,4,3,8,5,-56,32,2,9,2,489
374,45,2,6,3,10,21,-36,3,3,23,453
374,46,3,4,7,6,34,42,7,5,57,495
374,47,4,3,7,6,-57,33,0,8,0,528
375,1,3,5,6,7,33,52,3,2,33,52
375,2,5,2,9,4,54,22,7,4,87,74
375,3,3,3,9,4,-64,31,3,5,23,105
375,4,3,3,7,6,34,33,7,8,57,138
375,5,3,4,6,7,-67,-57,0,1,-10,81
375,6,4,2,9,4,45,22,5,3,35,103
375,7,3,3,8,5,-65,32,0,5,-30,135
375,8,5,3,7,6,52,33,2,8,22,168
375,9,3,3,5,8,32,-65,4,3,54,103
375,10,3,3,8,5,35,32,9,5,89,135
375,11,3,4,4,9,-69,-55,0,0,20,80
375,12,5,2,9,4,54,22,4,2,74,102
375,13,4,3,8,5,44,32,8,4,118,134
375,14,3,3,6,7,-67,34,1,8,51,168
375,15,2,5,3,10,21,-45,2,3,72,123
375,16,3,4,4,9,31,45,3,8,103,168
375,17,2,5,4,9,22,-46,5,2,125,122
375,18,3,4,6,7,33,43,8,5,158,165
375,19,2,5,2,11,20,-44,8,1,178,121
375,20,5,2,8,5,-47,23,1,4,131,144
375,21,3,3,7,6,34,33,5,7,165,177
375,22,3,3,5,8,32,-65,7,2,197,112
375,23,4,3,6,7,42,34,9,6,239,146
375,24,3,4,4,9,-69,-55,0,1,170,91
375,25,5,2,7,6,52,24,2,5,222,115
375,26,3,4,7,6,34,42,6,7,256,157
375,27,5,2,9,4,-46,22,0,9,210,179
375,28,4,2,10,3,46,-79,6,0,256,100
375,29,5,2,11,2,-44,20,2,0,212,120
375,30,3,3,5,8,32,35,4,5,244,155
375,31,3,4,3,10,30,-54,4,1,274,101
375,32,4,3,8,5,44,32,8,3,318,133
375,33,3,3,8,5,-65,32,3,5,253,165
375,34,4,2,6,7,42,-75,5,0,295,90
375,35,4,2,8,5,44,23,9,3,339,113
375,36,4,3,8,5,-56,32,3,5,283,145
375,37,2,4,4,9,22,-55,5,0,305,90
375,38,2,4,8,5,-74,41,1,1,231,131
375,39,2,5,5,8,23,53,4,4,254,184
375,40,5,2,11,2,-44,20,0,4,210,204
375,41,2,5,2,11,20,-44,0,0,230,160
375,42,3,3,8,5,35,32,5,2,265,192
375,43,2,4,7,6,-75,42,0,4,190,234
375,44,3,3,9,4,36,31,6,5,226,265
375,45,3,3,6,7,33,34,9,9,259,299
375,46,3,3,8,5,-65,-68,4,1,194,231
375,47,5,3,9,4,54,31,8,2,248,262
375,48,3,4,4,9,31,45,9,7,279,307
375,49,4,2,10,3,-54,21,5,8,225,328
375,50,2,4,4,9,22,-55,7,3,247,273
375,51,3,3,7,6,-66,33,1,6,181,306
375,52,2,4,7,6,25,42,6,8,206,348
375,53,4,2,10,3,-54,21,2,9,152,369
375,54,3,4,5,8,32,-56,4,3,184,313
375,55,2,4,8,5,-74,41,0,4,110,354
375,56,3,4,5,8,32,44,2,8,142,398
375,57,2,4,5,8,23,-56,5,2,165,342
375,58,4,2,9,4,-55,22,0,4,110,364
375,59,2,5,3,10,21,55,1,9,131,419
375,60,5,2,9,4,54,-78,5,1,185,341
375,61,2,5,5,8,23,53,8,4,208,394
375,62,4,2,7,6,-57,24,1,8,151,418
375,63,3,3,8,5,35,-68,6,0,186,350
375,64,3,5,5,8,32,53,8,3,218,403
375,65,2,4,6,7,-76,43,2,6,142,446
375,66,5,3,8,5,53,32,5,8,195,478
375,67,2,4,7,6,-75,-58,0,0,120,420
375,68,3,3,7,6,34,33,4,3,154,453
375,69,3,3,8,5,35,32,9,5,189,485
375,70,2,5,4,9,-78,54,1,9,111,539
376,1,3,4,3,10,30,46,0,6,30,46
376,2,4,2,7,6,43,-76,3,0,73,-30
376,3,6,2,10,3,64,21,7,1,137,-9
376,4,3,3,6,7,-67,34,0,5,70,25
376,5,2,4,5,8,23,44,3,9,93,69
376,6,2,5,3,10,21,-45,4,4,114,24
376,7,2,5,3,10,21,55,5,9,135,79
376,8,2,5,2,11,20,-44,5,5,155,35
376,9,3,4,6,7,33,43,8,8,188,78
376,10,3,3,6,7,-67,-66,1,2,121,12
376,11,5,2,9,4,54,22,5,4,175,34
376,12,3,3,8,5,-65,32,0,6,110,66
376,13,4,3,6,7,42,-66,2,0,152,0
376,14,4,3,9,4,45,31,7,1,197,31
376,15,2,5,5,8,-77,53,0,4,120,84
376,16,5,2,11,2,56,20,6,4,176,104
376,17,2,5,4,9,22,54,8,8,198,158
376,18,3,3,6,7,-67,-66,1,2,131,92
376,19,4,3,6,7,42,34,3,6,173,126
376,20,4,3,5,8,41,-65,4,1,214,61
376,21,3,3,9,4,-64,31,0,2,150,92
376,22,3,4,3,10,30,46,0,8,180,138
376,23,3,4,7,6,34,-58,4,0,214,80
376,24,6,2,10,3,64,21,8,1,278,101
376,25,3,4,8,5,-65,41,3,2,213,142
376,26,4,2,9,4,45,22,8,4,258,164
376,27,4,2,8,5,-56,23,2,7,202,187
376,28,2,4,5,8,23,-56,5,1,225,131
376,29,2,4,5,8,23,44,8,5,248,175
376,30,2,6,2,11,20,-35,8,0,268,140
376,31,3,3,7,6,-66,33,2,3,202,173
376,32,3,3,7,6,34,33,6,6,236,206
376,33,2,5,3,10,21,-45,7,1,257,161
376,34,3,4,5,8,32,44,9,5,289,205
376,35,3,4,6,7,-67,43,2,8,222,248
376,36,3,4,4,9,31,-55,3,3,253,193
376,37,3,4,5,8,32,44,5,7,285,237
376,38,3,4,7,6,34,42,9,9,319,279
376,39,2,6,2,11,20,-35,9,4,339,244
376,40,3,4,7,6,-66,42,3,6,273,286
376,41,3,5,4,9,31,-46,4,0,304,240
376,42,3,5,7,6,34,51,8,1,338,291
376,43,4,3,9,4,-55,31,3,2,283,322
376,44,2,5,4,9,22,54,5,6,305,376
376,45,3,4,8,5,-65,41,0,7,240,417
376,46,4,2,6,7,42,-75,2,2,282,342
376,47,3,3,7,6,34,33,6,5,316,375
376,48,3,3,5,8,32,-65,8,0,348,310
376,49,4,3,5,8,41,35,9,5,389,345
376,50,4,3,9,4,-55,31,4,6,334,376
376,51,3,3,5,8,32,-65,6,1,366,311
376,52,3,4,6,7,33,43,9,4,399,354
376,53,5,2,9,4,-46,22,3,6,353,376
376,54,2,5,4,9,22,-46,5,0,375,330
376,55,5,2,7,6,52,24,7,4,427,354
376,56,3,4,5,8,32,44,9,8,459,398
376,57,4,3,7,6,-57,-67,2,1,402,331
376,58,4,2,8,5,44,23,6,4,446,354
376,59,2,4,7,6,-75,42,1,6,371,396
376,60,4,2,8,5,44,23,5,9,415,419
376,61,2,4,7,6,-75,-58,0,1,340,361
376,62,4,3,6,7,42,34,2,5,382,395
376,63,3,3,5,8,32,-65,4,0,414,330
376,64,3,3,7,6,34,33,8,3,448,363
376,65,3,3,8,5,-65,32,3,5,383,395
376,66,4,3,6,7,42,34,5,9,425,429
376,67,2,5,6,7,24,-48,9,1,449,381
376,68,5,2,11,2,-44,20,5,1,405,401
376,69,4,2,9,4,-55,22,0,3,350,423
376,70,5,2,8,5,53,23,3,6,403,446
376,71,2,4,5,8,23,-56,6,0,426,390
376,72,4,3,7,6,43,33,9,3,469,423
376,73,4,3,10,3,-54,30,5,3,415,453
376,74,2,5,4,9,22,54,7,7,437,507
377,1,3,4,6,7,33,43,3,3,33,43
377,2,2,4,4,9,22,45,5,8,55,88
377,3,2,5,3,10,21,-45,6,3,76,43
377,4,3,3,8,5,-65,32,1,5,11,75
377,5,3,3,5,8,32,-65,3,0,43,10
377,6,2,4,7,6,25,42,8,2,68,52
377,7,5,2,10,3,-45,21,3,3,23,73
377,8,2,5,2,11,20,56,3,9,43,129
377,9,3,3,7,6,34,-67,7,2,77,62
377,10,4,3,5,8,41,35,8,7,118,97
377,11,3,5,6,7,-67,52,1,9,51,149
377,12,2,5,6,7,24,-48,5,1,75,101
377,13,3,4,8,5,-65,41,0,2,10,142
377,14,3,4,5,8,32,44,2,6,42,186
377,15,3,4,6,7,33,43,5,9,75,229
377,16,3,3,8,5,-65,-68,0,1,10,161
377,17,3,3,9,4,36,31,6,2,46,192
377,18,4,2,9,4,-55,22,1,4,-9,214
377,19,2,4,4,9,22,45,3,9,13,259
377,20,5,2,9,4,54,-78,7,1,67,181
377,21,3,3,8,5,-65,32,2,3,2,213
377,22,3,3,5,8,32,35,4,8,34,248
377,23,3,4,4,9,31,-55,5,3,65,193
377,24,3,3,8,5,-65,32,0,5,0,225
377,25,2,5,4,9,22,54,2,9,22,279
377,26,3,3,4,9,31,-64,3,5,53,215
377,27,5,2,9,4,54,22,7,7,107,237
377,28,2,4,6,7,-76,-57,1,0,31,180
377,29,5,3,9,4,54,31,5,1,85,211
377,30,3,3,7,6,34,33,9,4,119,244
377,31,4,3,8,5,-56,32,3,6,63,276
377,32,2,4,5,8,23,-56,6,0,86,220
377,33,3,4,8,5,-65,41,1,1,21,261
377,34,3,4,6,7,33,43,4,4,54,304
377,35,3,4,3,10,30,-54,4,0,84,250
377,36,5,2,9,4,54,22,8,2,138,272
377,37,5,2,7,6,-48,24,0,6,90,296
377,38,3,3,7,6,34,33,4,9,124,329
377,39,5,3,6,7,51,-66,5,3,175,263
377,40,3,3,5,8,32,35,7,8,207,298
377,41,4,3,6,7,42,-66,9,2,249,232
377,42,5,2,7,6,-48,24,1,6,201,256
377,43,5,2,10,3,55,21,6,7,256,277
377,44,4,2,7,6,43,-76,9,1,299,201
377,45,4,2,11,2,-53,20,6,1,246,221
377,46,4,3,7,6,43,33,9,4,289,254
377,47,3,3,4,9,-69,-64,0,0,220,190
377,48,5,2,11,2,56,20,6,0,276,210
377,49,4,3,6,7,42,34,8,4,318,244
377,50,4,3,9,4,-55,31,3,5,263,275
377,51,3,4,6,7,33,43,6,8,296,318
377,52,2,5,4,9,22,-46,8,2,318,272
377,53,3,4,8,5,-65,41,3,3,253,313
377,54,2,5,4,9,22,54,5,7,275,367
377,55,5,2,7,6,52,-76,7,1,327,291
377,56,3,3,8,5,-65,32,2,3,262,323
377,57,2,4,6,7,24,43,6,6,286,366
377,58,5,2,9,4,-46,22,0,8,240,388
377,59,3,4,7,6,34,-58,4,0,274,330
377,60,4,2,6,7,42,25,6,5,316,355
377,61,2,4,6,7,-76,43,0,8,240,398
377,62,6,2,7,6,61,-76,1,2,301,322
377,63,2,6,3,10,21,64,2,6,322,386
377,64,2,4,5,8,23,-56,5,0,345,330
377,65,4,3,6,7,42,34,7,4,387,364
377,66,5,3,7,6,52,33,9,7,439,397
377,67,3,3,9,4,-64,31,5,8,375,428
377,68,4,3,8,5,44,-68,9,0,419,360
377,69,3,4,7,6,-66,42,3,2,353,402
377,70,4,3,7,6,43,33,6,5,396,435
377,71,4,4,6,7,42,43,8,8,438,478
377,72,2,4,9,4,-73,40,5,8,365,518
378,1,3,3,5,8,32,35,2,5,32,35
378,2,3,3,5,8,32,-65,4,0,64,-30
378,3,4,3,7,6,43,33,7,3,107,3
378,4,3,4,6,7,-67,43,0,6,40,46
378,5,4,3,8,5,44,32,4,8,84,78
378,6,4,2,9,4,45,-78,9,0,129,0
378,7,3,4,7,6,-66,42,3,2,63,42
378,8,2,5,7,6,25,51,8,3,88,93
378,9,4,3,6,7,-58,34,0,7,30,127
378,10,4,3,8,5,44,32,4,9,74,159
378,11,2,4,7,6,25,-58,9,1,99,101
378,12,4,3,8,5,-56,32,3,3,43,133
378,13,3,3,9,4,36,31,9,4,79,164
378,14,4,3,8,5,-56,32,3,6,23,196
378,15,5,2,8,5,53,23,6,9,76,219
378,16,3,3,7,6,-66,-67,0,2,10,152
378,17,3,3,4,9,31,36,1,8,41,188
378,18,6,2,9,4,63,-78,4,0,104,110
378,19,4,3,7,6,43,33,7,3,147,143
378,20,4,2,9,4,-55,22,2,5,92,165
378,21,3,4,6,7,33,43,5,8,125,208
378,22,3,3,5,8,32,-65,7,3,157,143
378,23,3,3,6,7,-67,34,0,7,90,177
378,24,3,4,4,9,31,-55,1,2,121,122
378,25,3,3,8,5,35,32,6,4,156,154
378,26,4,2,5,8,41,-74,7,0,197,80
378,27,3,3,6,7,-67,34,0,4,130,114
378,28,2,5,4,9,22,54,2,8,152,168
378,29,4,3,5,8,41,-65,3,3,193,103
378,30,4,3,7,6,43,33,6,6,236,136
378,31,4,3,5,8,41,-65,7,1,277,71
378,32,3,3,7,6,-66,33,1,4,211,104
378,33,2,5,4,9,22,54,3,8,233,158
378,34,4,3,7,6,43,-67,6,1,276,91
378,35,4,3,8,5,-56,32,0,3,220,123
378,36,3,4,5,8,32,44,2,7,252,167
378,37,3,3,3,10,30,-63,2,4,282,104
378,38,2,4,3,10,21,-54,3,0,303,50
378,39,3,4,5,8,32,44,5,4,335,94
378,40,3,5,4,9,31,54,6,8,366,148
378,41,4,2,9,4,-55,-78,1,0,311,70
378,42,3,3,8,5,35,32,6,2,346,102
378,43,2,5,5,8,23,53,9,5,369,155
378,44,4,2,7,6,-57,24,2,9,312,179
378,45,2,4,6,7,24,-57,6,2,336,122
378,46,4,2,7,6,43,24,9,6,379,146
378,47,4,4,5,8,-59,-56,0,0,320,90
378,48,4,3,6,7,42,34,2,4,362,124
378,49,4,2,8,5,44,23,6,7,406,147
378,50,4,3,7,6,43,-67,9,0,449,80
378,51,4,2,9,4,-55,22,4,2,394,102
378,52,3,4,8,5,35,41,9,3,429,143
378,53,4,3,7,6,-57,33,2,6,372,176
378,54,4,3,6,7,42,-66,4,0,414,110
378,55,3,4,4,9,31,45,5,5,445,155
378,56,5,2,11,2,-44,20,1,5,401,175
378,57,2,5,5,8,23,53,4,8,424,228
378,58,4,2,8,5,44,-77,8,1,468,151
378,59,3,4,5,8,-68,44,0,5,400,195
378,60,5,2,9,4,54,22,4,7,454,217
378,61,2,4,7,6,25,42,9,9,479,259
378,62,4,2,8,5,-56,-77,3,2,423,182
378,63,5,2,8,5,53,23,6,5,476,205
378,64,3,3,4,9,31,-64,7,1,507,141
379,1,5,2,8,5,53,23,3,3,53,23
379,2,3,3,7,6,34,33,7,6,87,56
379,3,5,2,9,4,-46,22,1,8,41,78
379,4,7,2,11,2,74,20,5,8,115,98
379,5,2,4,6,7,24,-57,9,1,139,41
379,6,2,4,6,7,-76,43,3,4,63,84
379,7,2,5,3,10,21,55,4,9,84,139
379,8,3,3,10,3,-63,30,1,9,21,169
379,9,4,3,10,3,46,30,7,9,67,199
379,10,4,3,6,7,42,-66,9,3,109,133
379,11,4,3,8,5,-56,32,3,5,53,165
379,12,3,3,7,6,34,33,7,8,87,198
379,13,4,2,8,5,-56,-77,1,1,31,121
379,14,3,3,5,8,32,35,3,6,63,156
379,15,3,3,4,9,31,-64,4,2,94,92
379,16,3,3,9,4,-64,31,0,3,30,123
379,17,3,3,8,5,35,32,5,5,65,155
379,18,3,3,6,7,33,34,8,9,98,189
379,19,4,2,8,5,-56,-77,2,2,42,112
379,20,3,3,6,7,33,34,5,6,75,146
379,21,3,4,7,6,34,42,9,8,109,188
379,22,4,2,5,8,-59,-74,0,4,50,114
379,23,3,3,8,5,35,32,5,6,85,146
379,24,4,2,11,2,-53,20,2,6,32,166
379,25,4,2,6,7,42,-75,4,1,74,91
379,26,3,3,6,7,33,34,7,5,107,125
379,27,3,4,5,8,32,44,9,9,139,169
379,28,3,4,6,7,-67,-57,2,2,72,112
379,29,2,4,5,8,23,44,5,6,95,156
379,30,3,3,9,4,-64,31,1,7,31,187
379,31,3,4,7,6,34,42,5,9,65,229
379,32,4,3,7,6,43,-67,8,2,108,162
379,33,3,3,7,6,-66,33,2,5,42,195
379,34,2,4,3,10,21,-54,3,1,63,141
379,35,4,3,5,8,41,35,4,6,104,176
379,36,4,3,8,5,44,32,8,8,148,208
379,37,2,5,4,9,-78,-46,0,2,70,162
379,38,4,2,11,2,47,20,7,2,117,182
379,39,3,4,6,7,-67,43,0,5,50,225
379,40,3,3,4,9,31,-64,1,1,81,161
379,41,3,4,5,8,32,44,3,5,113,205
379,42,4,3,4,9,40,-64,3,1,153,141
379,43,4,4,6,7,42,43,5,4,195,184
379,44,4,3,7,6,43,33,8,7,238,217
379,45,2,4,5,8,-77,-56,1,1,161,161
379,46,2,4,8,5,26,41,7,2,187,202
379,47,3,4,4,9,31,45,8,7,218,247
379,48,3,3,4,9,31,-64,9,3,249,183
379,49,2,4,4,9,-78,45,1,8,171,228
379,50,4,2,6,7,42,-75,3,3,213,153
379,51,4,2,10,3,46,21,9,4,259,174
379,52,2,5,2,11,20,-44,9,0,279,130
379,53,3,3,6,7,-67,34,2,4,212,164
379,54,3,3,6,7,33,34,5,8,245,198
379,55,4,3,7,6,43,-67,8,1,288,131
379,56,4,3,6,7,-58,34,0,5,230,165
379,57,4,2,11,2,47,20,7,5,277,185
379,58,3,4,3,10,30,-54,7,1,307,131
379,59,3,4,8,5,-65,41,2,2,242,172
379,60,4,3,8,5,44,32,6,4,286,204
379,61,2,5,4,9,22,54,8,8,308,258
379,62,4,3,5,8,41,-65,9,3,349,193
379,63,3,3,5,8,-68,35,1,8,281,228
379,64,2,4,3,10,21,-54,2,4,302,174
379,65,3,4,3,10,30,-54,2,0,332,120
379,66,4,3,8,5,44,32,6,2,376,152
379,67,3,3,7,6,-66,33,0,5,310,185
379,68,4,3,9,4,45,31,5,6,355,216
379,69,4,3,7,6,43,33,8,9,398,249
379,70,4,3,8,5,-56,-68,2,1,342,181
379,71,4,4,7,6,43,42,5,3,385,223
379,72,2,5,4,9,22,54,7,7,407,277
379,73,4,2,9,4,-55,22,2,9,352,299
379,74,2,4,5,8,23,-56,5,3,375,243
379,75,4,2,7,6,43,24,8,7,418,267
379,76,4,4,7,6,-57,42,1,9,361,309
379,77,3,5,6,7,33,-48,4,1,394,261
379,78,3,4,5,8,32,44,6,5,426,305
379,79,4,2,9,4,-55,22,1,7,371,327
379,80,4,2,9,4,45,22,6,9,416,349
379,81,4,3,7,6,43,-67,9,2,459,282
379,82,5,2,11,2,-44,20,5,2,415,302
379,83,4,2,7,6,43,24,8,6,458,326
379,84,3,3,4,9,31,-64,9,2,489,262
379,85,3,3,9,4,-64,31,5,3,425,293
379,86,2,4,3,10,21,46,6,9,446,339
379,87,5,3,8,5,53,-68,9,1,499,271
379,88,2,4,6,7,-76,43,3,4,423,314
379,89,3,3,4,9,31,-64,4,0,454,250
379,90,3,3,7,6,34,33,8,3,488,283
379,91,5,2,7,6,-48,24,0,7,440,307
379,92,3,4,7,6,34,42,4,9,474,349
379,93,4,3,6,7,42,-66,6,3,516,283
380,1,2,4,4,9,22,45,2,5,22,45
380,2,5,3,9,4,54,31,6,6,76,76
380,3,2,5,4,9,22,-46,8,0,98,30
380,4,3,4,5,8,-68,44,0,4,30,74
380,5,2,5,3,10,21,55,1,9,51,129
380,6,4,3,10,3,46,30,7,9,97,159
380,7,4,3,9,4,-55,-69,2,0,42,90
380,8,2,4,3,10,21,46,3,6,63,136
380,9,3,5,4,9,31,-46,4,0,94,90
380,10,3,4,5,8,32,44,6,4,126,134
380,11,3,3,9,4,-64,31,2,5,62,165
380,12,3,3,9,4,36,31,8,6,98,196
380,13,3,3,7,6,-66,33,2,9,32,229
380,14,4,3,8,5,44,-68,6,1,76,161
380,15,4,2,8,5,-56,23,0,4,20,184
380,16,4,2,9,4,45,22,5,6,65,206
380,17,4,2,6,7,42,-75,7,1,107,131
380,18,4,3,7,6,-57,33,0,4,50,164
380,19,3,4,6,7,33,43,3,7,83,207
380,20,4,3,7,6,43,-67,6,0,126,140
380,21,2,5,3,10,21,55,7,5,147,195
380,22,3,4,5,8,32,44,9,9,179,239
380,23,2,4,6,7,-76,-57,3,2,103,182
380,24,4,3,8,5,44,32,7,4,147,214
380,25,3,3,7,6,-66,33,1,7,81,247
380,26,4,3,9,4,45,31,6,8,126,278
380,27,3,3,6,7,33,-66,9,2,159,212
380,28,3,4,4,9,-69,45,0,7,90,257
380,29,4,3,5,8,41,-65,1,2,131,192
380,30,4,3,8,5,44,32,5,4,175,224
380,31,2,4,4,9,22,45,7,9,197,269
380,32,4,3,6,7,42,-66,9,3,239,203
380,33,4,2,8,5,-56,23,3,6,183,226
380,34,4,2,9,4,45,22,8,8,228,248
380,35,2,5,3,10,21,-45,9,3,249,203
380,36,3,4,5,8,-68,44,1,7,181,247
380,37,2,4,4,9,22,-55,3,2,203,192
380,38,3,3,5,8,32,35,5,7,235,227
380,39,5,2,10,3,-45,21,0,8,190,248
380,40,6,2,11,2,65,20,5,8,255,268
380,41,2,5,3,10,21,-45,6,3,276,223
380,42,4,4,7,6,43,42,9,5,319,265
380,43,4,3,5,8,-59,-65,0,0,260,200
380,44,3,3,8,5,35,32,5,2,295,232
380,45,5,2,10,3,-45,21,0,3,250,253
380,46,4,2,10,3,46,21,6,4,296,274
380,47,4,3,6,7,42,34,8,8,338,308
380,48,4,2,7,6,-57,-76,1,2,281,232
380,49,2,6,4,9,22,63,3,5,303,295
380,50,5,2,9,4,54,22,7,7,357,317
380,51,4,3,8,5,-56,32,1,9,301,349
380,52,4,2,9,4,45,-78,6,1,346,271
380,53,3,4,6,7,33,43,9,4,379,314
380,54,3,3,5,8,-68,35,1,9,311,349
380,55,3,4,4,9,31,-55,2,4,342,294
380,56,2,5,4,9,22,54,4,8,364,348
380,57,2,5,4,9,22,-46,6,2,386,302
380,58,4,4,7,6,43,42,9,4,429,344
380,59,3,3,7,6,-66,33,3,7,363,377
380,60,3,4,7,6,34,42,7,9,397,419
380,61,4,3,9,4,-55,-69,2,0,342,350
380,62,4,2,8,5,44,23,6,3,386,373
380,63,2,5,5,8,23,53,9,6,409,426
380,64,3,3,6,7,-67,-66,2,0,342,360
380,65,2,4,4,9,22,45,4,5,364,405
380,66,4,2,10,3,-54,21,0,6,310,426
380,67,2,4,7,6,25,42,5,8,335,468
380,68,3,3,5,8,32,-65,7,3,367,403
380,69,3,3,7,6,-66,33,1,6,301,436
380,70,5,2,10,3,55,21,6,7,356,457
380,71,3,3,7,6,-66,-67,0,0,290,390
380,72,3,4,4,9,31,45,1,5,321,435
380,73,4,3,10,3,46,30,7,5,367,465
380,74,4,3,5,8,41,-65,8,0,408,400
380,75,3,3,7,6,-66,33,2,3,342,433
380,76,3,4,5,8,32,44,4,7,374,477
380,77,4,3,7,6,43,-67,7,0,417,410
380,78,4,2,9,4,-55,22,2,2,362,432
380,79,3,3,9,4,36,31,8,3,398,463
380,80,3,4,4,9,31,45,9,8,429,508
381,1,3,3,6,7,33,34,3,4,33,34
381,2,4,3,8,5,44,32,7,6,77,66
381,3,3,4,4,9,31,-55,8,1,108,11
381,4,5,2,8,5,-47,23,1,4,61,34
381,5,4,2,7,6,43,24,4,8,104,58
381,6,4,2,9,4,45,-78,9,0,149,-20
381,7,2,4,8,5,-74,41,5,1,75,21
381,8,3,3,4,9,31,36,6,7,106,57
381,9,2,4,7,6,-75,42,1,9,31,99
381,10,3,3,8,5,35,-68,6,1,66,31
381,11,2,4,6,7,-76,43,0,4,-10,74
381,12,4,3,5,8,41,35,1,9,31,109
381,13,3,3,6,7,33,-66,4,3,64,43
381,14,4,3,8,5,44,32,8,5,108,75
381,15,4,2,6,7,-58,-75,0,0,50,0
381,16,3,4,7,6,34,42,4,2,84,42
381,17,4,3,8,5,44,32,8,4,128,74
381,18,3,3,4,9,31,-64,9,0,159,10
381,19,4,3,7,6,-57,33,2,3,102,43
381,20,3,4,4,9,31,45,3,8,133,88
381,21,5,2,10,3,55,21,8,9,188,109
381,22,3,3,8,5,-65,-68,3,1,123,41
381,23,2,4,8,5,26,41,9,2,149,82
381,24,4,2,6,7,-58,25,1,7,91,107
381,25,3,4,6,7,33,-57,4,0,124,50
381,26,4,2,6,7,42,25,6,5,166,75
381,27,3,4,6,7,33,43,9,8,199,118
381,28,3,4,7,6,-66,-58,3,0,133,60
381,29,3,4,4,9,31,45,4,5,164,105
381,30,2,5,7,6,25,51,9,6,189,156
381,31,2,5,4,9,-78,-46,1,0,111,110
381,32,2,4,7,6,25,42,6,2,136,152
381,33,5,2,11,2,-44,20,2,2,92,172
381,34,4,2,8,5,44,23,6,5,136,195
381,35,3,4,8,5,-65,41,1,6,71,236
381,36,3,4,5,8,32,-56,3,0,103,180
381,37,3,3,4,9,31,36,4,6,134,216
381,38,2,4,5,8,23,-56,7,0,157,160
381,39,2,6,4,9,22,63,9,3,179,223
381,40,3,4,5,8,-68,44,1,7,111,267
381,41,3,4,6,7,33,-57,4,0,144,210
381,42,5,2,9,4,54,22,8,2,198,232
381,43,3,4,6,7,-67,43,1,5,131,275
381,44,4,3,6,7,42,34,3,9,173,309
381,45,4,3,9,4,45,-69,8,0,218,240
381,46,2,5,3,10,21,55,9,5,239,295
381,47,4,2,8,5,-56,23,3,8,183,318
381,48,3,4,5,8,32,-56,5,2,215,262
381,49,4,2,11,2,-53,20,2,2,162,282
381,50,3,3,7,6,34,33,6,5,196,315
381,51,3,4,8,5,-65,41,1,6,131,356
381,52,4,3,6,7,42,-66,3,0,173,290
381,53,3,4,6,7,33,43,6,3,206,333
381,54,4,3,7,6,43,33,9,6,249,366
381,55,2,4,5,8,-77,-56,2,0,172,310
381,56,3,3,5,8,32,35,4,5,204,345
381,57,4,3,8,5,44,32,8,7,248,377
381,58,4,2,8,5,-56,-77,2,0,192,300
381,59,4,2,9,4,45,22,7,2,237,322
381,60,2,4,4,9,22,45,9,7,259,367
381,61,4,2,7,6,-57,-76,2,1,202,291
381,62,4,2,9,4,45,22,7,3,247,313
381,63,4,3,9,4,-55,31,2,4,192,344
381,64,2,4,7,6,25,42,7,6,217,386
381,65,2,4,6,7,-76,43,1,9,141,429
381,66,4,3,8,5,44,-68,5,1,185,361
381,67,5,2,8,5,53,23,8,4,238,384
381,68,4,2,8,5,-56,23,2,7,182,407
381,69,3,4,5,8,32,-56,4,1,214,351
381,70,2,5,4,9,22,54,6,5,236,405
381,71,4,3,9,4,-55,31,1,6,181,436
381,72,4,3,5,8,41,-65,2,1,222,371
381,73,5,2,10,3,55,21,7,2,277,392
381,74,3,4,5,8,32,44,9,6,309,436
381,75,4,3,8,5,-56,32,3,8,253,468
381,76,4,3,7,6,43,-67,6,1,296,401
381,77,3,3,6,7,33,34,9,5,329,435
381,78,3,4,3,10,30,-54,9,1,359,381
381,79,3,4,6,7,-67,43,2,4,292,424
381,80,4,2,9,4,45,22,7,6,337,446
381,81,4,2,5,8,41,-74,8,2,378,372
381,82,2,5,3,10,21,55,9,7,399,427
381,83,2,4,2,11,20,-53,9,4,419,374
381,84,2,4,7,6,-75,42,4,6,344,416
381,85,3,3,5,8,32,-65,6,1,376,351
381,86,3,5,3,10,30,55,6,6,406,406
381,87,6,2,9,4,63,22,9,8,469,428
381,88,2,4,6,7,-76,-57,3,1,393,371
381,89,2,5,2,11,20,56,3,7,413,427
381,90,4,3,7,6,43,-67,6,0,456,360
381,91,5,2,8,5,53,23,9,3,509,383
382,1,2,4,3,10,21,46,1,6,21,46
382,2,2,6,3,10,21,-36,2,0,42,10
382,3,5,2,8,5,53,23,5,3,95,33
382,4,4,3,8,5,44,32,9,5,139,65
382,5,2,5,4,9,-78,54,1,9,61,119
382,6,3,4,4,9,31,-55,2,4,92,64
382,7,4,3,7,6,43,33,5,7,135,97
382,8,3,3,9,4,-64,31,1,8,71,128
382,9,3,3,5,8,32,-65,3,3,103,63
382,10,4,3,7,6,43,33,6,6,146,96
382,11,3,4,8,5,-65,41,1,7,81,137
382,12,4,2,7,6,43,-76,4,1,124,61
382,13,4,3,6,7,42,34,6,5,166,95
382,14,2,4,3,10,21,-54,7,1,187,41
382,15,5,2,9,4,-46,22,1,3,141,63
382,16,5,2,8,5,53,23,4,6,194,86
382,17,4,2,7,6,43,-76,7,0,237,10
382,18,4,2,8,5,-56,23,1,3,181,33
382,19,5,2,10,3,55,21,6,4,236,54
382,20,2,4,5,8,23,44,9,8,259,98
382,21,3,4,5,8,-68,-56,1,2,191,42
382,22,2,5,4,9,22,54,3,6,213,96
382,23,4,3,7,6,43,33,6,9,256,129
382,24,3,5,6,7,33,-48,9,1,289,81
382,25,2,5,8,5,-74,50,5,1,215,131
382,26,2,6,2,11,20,65,5,6,235,196
382,27,5,2,9,4,54,22,9,8,289,218
382,28,5,2,8,5,-47,-77,2,1,242,141
382,29,4,3,7,6,43,33,5,4,285,174
382,30,3,4,7,6,34,42,9,6,319,216
382,31,3,3,7,6,-66,33,3,9,253,249
382,32,2,5,2,11,20,-44,3,5,273,205
382,33,4,3,8,5,44,32,7,7,317,237
382,34,4,3,8,5,-56,32,1,9,261,269
382,35,2,4,8,5,26,-59,7,0,287,210
382,36,2,5,3,10,21,55,8,5,308,265
382,37,4,2,7,6,-57,24,1,9,251,289
382,38,3,3,7,6,34,-67,5,2,285,222
382,39,3,3,7,6,34,33,9,5,319,255
382,40,2,4,6,7,-76,43,3,8,243,298
382,41,2,5,4,9,22,-46,5,2,265,252
382,42,4,3,5,8,41,35,6,7,306,287
382,43,4,3,8,5,-56,32,0,9,250,319
382,44,2,5,5,8,23,-47,3,2,273,272
382,45,3,4,5,8,32,44,5,6,305,316
382,46,3,3,5,8,32,-65,7,1,337,251
382,47,3,4,5,8,32,44,9,5,369,295
382,48,3,4,7,6,-66,42,3,7,303,337
382,49,4,3,8,5,44,32,7,9,347,369
382,50,5,2,8,5,-47,-77,0,2,300,292
382,51,3,3,10,3,37,30,7,2,337,322
382,52,4,2,9,4,-55,22,2,4,282,344
382,53,3,4,7,6,34,42,6,6,316,386
382,54,5,2,9,4,-46,22,0,8,270,408
382,55,4,3,6,7,42,-66,2,2,312,342
382,56,4,3,10,3,46,30,8,2,358,372
382,57,3,4,8,5,-65,41,3,3,293,413
382,58,3,4,6,7,33,43,6,6,326,456
382,59,2,5,4,9,22,-46,8,0,348,410
382,60,3,4,4,9,31,45,9,5,379,455
382,61,3,4,6,7,-67,43,2,8,312,498
382,62,2,4,4,9,22,-55,4,3,334,443
382,63,3,3,6,7,33,34,7,7,367,477
382,64,4,3,7,6,-57,-67,0,0,310,410
382,65,4,3,6,7,42,34,2,4,352,444
382,66,3,3,4,9,31,-64,3,0,383,380
382,67,3,4,8,5,35,41,8,1,418,421
382,68,4,3,8,5,-56,32,2,3,362,453
382,69,4,2,9,4,45,22,7,5,407,475
382,70,3,3,9,4,-64,31,3,6,343,506
383,1,3,3,4,9,31,36,1,6,31,36
383,2,4,2,7,6,43,-76,4,0,74,-40
383,3,4,3,6,7,42,34,6,4,116,-6
383,4,4,2,7,6,43,24,9,8,159,18
383,5,2,4,5,8,-77,-56,2,2,82,-38
383,6,2,6,3,10,21,64,3,6,103,26
383,7,5,2,10,3,55,21,8,7,158,47
383,8,4,3,6,7,-58,-66,0,1,100,-19
383,9,4,2,5,8,41,26,1,7,141,7
383,10,4,3,5,8,41,-65,2,2,182,-58
383,11,3,4,7,6,34,42,6,4,216,-16
383,12,3,3,7,6,-66,33,0,7,150,17
383,13,3,3,7,6,34,-67,4,0,184,-50
383,14,3,3,5,8,32,35,6,5,216,-15
383,15,4,4,9,4,-55,40,1,5,161,25
383,16,2,4,6,7,24,43,5,8,185,68
383,17,6,2,9,4,63,-78,8,0,248,-10
383,18,5,2,9,4,-46,22,2,2,202,12
383,19,3,4,5,8,32,44,4,6,234,56
383,20,4,2,8,5,44,23,8,9,278,79
383,21,2,6,2,11,20,-35,8,4,298,44
383,22,3,3,7,6,-66,33,2,7,232,77
383,23,2,4,5,8,23,-56,5,1,255,21
383,24,4,3,9,4,-55,31,0,2,200,52
383,25,2,5,5,8,23,53,3,5,223,105
383,26,2,5,5,8,23,53,6,8,246,158
383,27,4,2,7,6,43,-76,9,2,289,82
383,28,3,3,8,5,-65,32,4,4,224,114
383,29,3,4,6,7,33,43,7,7,257,157
383,30,4,3,9,4,-55,31,2,8,202,188
383,31,4,2,6,7,42,-75,4,3,244,113
383,32,4,3,7,6,43,33,7,6,287,146
383,33,3,4,5,8,32,-56,9,0,319,90
383,34,4,3,7,6,-57,33,2,3,262,123
383,35,2,5,5,8,23,53,5,6,285,176
383,36,5,2,6,7,51,-75,6,1,336,101
383,37,3,3,4,9,31,36,7,7,367,137
383,38,2,4,5,8,-77,-56,0,1,290,81
383,39,4,2,8,5,44,23,4,4,334,104
383,40,6,2,10,3,64,21,8,5,398,125
383,41,3,3,6,7,-67,34,1,9,331,159
383,42,3,4,5,8,32,-56,3,3,363,103
383,43,3,3,7,6,34,33,7,6,397,136
383,44,3,4,4,9,31,-55,8,1,428,81
383,45,4,3,5,8,41,35,9,6,469,116
383,46,4,2,10,3,-54,21,5,7,415,137
383,47,4,2,8,5,44,-77,9,0,459,60
383,48,2,5,6,7,-76,52,3,2,383,112
383,49,5,2,11,2,56,20,9,2,439,132
383,50,2,5,7,6,-75,51,4,3,364,183
383,51,5,2,10,3,55,21,9,4,419,204
383,52,2,5,7,6,-75,51,4,5,344,255
383,53,4,2,8,5,44,23,8,8,388,278
383,54,3,4,6,7,-67,-57,1,1,321,221
383,55,5,2,9,4,54,22,5,3,375,243
383,56,4,3,9,4,-55,31,0,4,320,274
383,57,3,5,4,9,31,54,1,8,351,328
383,58,3,3,8,5,35,-68,6,0,386,260
383,59,2,5,3,10,21,55,7,5,407,315
383,60,2,4,7,6,-75,42,2,7,332,357
383,61,2,4,6,7,24,-57,6,0,356,300
383,62,2,5,6,7,-76,52,0,2,280,352
383,63,2,5,4,9,22,54,2,6,302,406
383,64,3,3,6,7,33,-66,5,0,335,340
383,65,2,5,3,10,21,55,6,5,356,395
383,66,5,2,8,5,53,23,9,8,409,418
383,67,4,3,7,6,-57,-67,2,1,352,351
383,68,5,3,8,5,53,32,5,3,405,383
383,69,2,5,2,11,20,56,5,9,425,439
383,70,3,3,5,8,32,-65,7,4,457,374
383,71,2,5,4,9,22,54,9,8,479,428
383,72,4,2,7,6,-57,-76,2,2,422,352
383,73,3,3,7,6,34,33,6,5,456,385
383,74,3,3,5,8,32,-65,8,0,488,320
383,75,5,2,9,4,-46,22,2,2,442,342
383,76,2,4,4,9,22,45,4,7,464,387
383,77,4,2,8,5,44,-77,8,0,508,310
384,1,2,4,4,9,22,45,2,5,22,45
384,2,4,3,5,8,41,-65,3,0,63,-20
384,3,3,4,7,6,34,42,7,2,97,22
384,4,4,2,7,6,-57,24,0,6,40,46
384,5,2,4,5,8,23,-56,3,0,63,-10
384,6,2,5,2,11,20,56,3,6,83,46
384,7,2,4,4,9,22,-55,5,1,105,-9
384,8,4,3,10,3,-54,30,1,1,51,21
384,9,3,3,10,3,37,30,8,1,88,51
384,10,3,5,7,6,-66,51,2,2,22,102
384,11,4,2,9,4,45,22,7,4,67,124
384,12,3,3,7,6,-66,33,1,7,1,157
384,13,6,2,11,2,65,20,6,7,66,177
384,14,2,5,3,10,21,-45,7,2,87,132
384,15,5,3,7,6,52,33,9,5,139,165
384,16,3,3,7,6,-66,33,3,8,73,198
384,17,5,2,8,5,53,-77,6,1,126,121
384,18,3,3,9,4,-64,31,2,2,62,152
384,19,2,4,8,5,26,41,8,3,88,193
384,20,3,3,5,8,-68,35,0,8,20,228
384,21,6,2,10,3,64,21,4,9,84,249
384,22,2,5,3,10,21,-45,5,4,105,204
384,23,4,3,8,5,44,32,9,6,149,236
384,24,3,3,8,5,-65,32,4,8,84,268
384,25,4,2,7,6,43,-76,7,2,127,192
384,26,3,4,5,8,32,44,9,6,159,236
384,27,2,5,7,6,-75,51,4,7,84,287
384,28,2,4,4,9,22,-55,6,2,106,232
384,29,5,2,10,3,-45,21,1,3,61,253
384,30,3,4,5,8,32,44,3,7,93,297
384,31,5,2,9,4,54,22,7,9,147,319
384,32,3,4,7,6,-66,-58,1,1,81,261
384,33,3,3,7,6,34,33,5,4,115,294
384,34,4,3,8,5,44,32,9,6,159,326
384,35,3,4,5,8,-68,-56,1,0,91,270
384,36,2,5,6,7,24,52,5,2,115,322
384,37,5,2,6,7,51,25,6,7,166,347
384,38,3,3,7,6,-66,-67,0,0,100,280
384,39,5,2,7,6,52,24,2,4,152,304
384,40,4,4,7,6,43,42,5,6,195,346
384,41,5,2,7,6,52,-76,7,0,247,270
384,42,3,3,7,6,-66,33,1,3,181,303
384,43,3,3,6,7,33,34,4,7,214,337
384,44,2,4,6,7,24,-57,8,0,238,280
384,45,2,5,3,10,21,55,9,5,259,335
384,46,2,4,6,7,-76,43,3,8,183,378
384,47,4,3,8,5,44,-68,7,0,227,310
384,48,3,4,6,7,-67,43,0,3,160,353
384,49,4,3,7,6,43,33,3,6,203,386
384,50,3,3,7,6,34,33,7,9,237,419
384,51,5,2,7,6,52,-76,9,3,289,343
384,52,2,4,5,8,-77,44,2,7,212,387
384,53,4,3,8,5,44,32,6,9,256,419
384,54,4,3,8,5,-56,-68,0,1,200,351
384,55,2,5,3,10,21,55,1,6,221,406
384,56,4,3,8,5,44,32,5,8,265,438
384,57,2,5,4,9,22,-46,7,2,287,392
384,58,2,5,6,7,-76,52,1,4,211,444
384,59,4,2,8,5,44,23,5,7,255,467
384,60,2,5,4,9,22,-46,7,1,277,421
384,61,3,4,5,8,32,44,9,5,309,465
384,62,5,2,10,3,-45,21,4,6,264,486
384,63,4,2,5,8,41,-74,5,2,305,412
384,64,5,2,10,3,-45,21,0,3,260,433
384,65,3,3,6,7,33,34,3,7,293,467
384,66,4,2,8,5,44,-77,7,0,337,390
384,67,5,2,9,4,-46,22,1,2,291,412
384,68,3,4,5,8,32,44,3,6,323,456
384,69,3,4,6,7,33,43,6,9,356,499
384,70,2,4,7,6,-75,-58,1,1,281,441
384,71,4,4,6,7,42,43,3,4,323,484
384,72,2,5,5,8,23,53,6,7,346,537
385,1,5,2,10,3,55,21,5,1,55,21
385,2,2,4,5,8,23,44,8,5,78,65
385,3,3,4,5,8,-68,44,0,9,10,109
385,4,3,3,4,9,31,-64,1,5,41,45
385,5,2,4,5,8,23,44,4,9,64,89
385,6,4,2,11,2,-53,20,1,9,11,109
385,7,4,3,9,4,45,-69,6,0,56,40
385,8,4,2,9,4,-55,22,1,2,1,62
385,9,2,5,5,8,23,53,4,5,24,115
385,10,3,3,7,6,34,33,8,8,58,148
385,11,4,3,8,5,-56,-68,2,0,2,80
385,12,4,3,8,5,44,32,6,2,46,112
385,13,2,5,7,6,-75,51,1,3,-29,163
385,14,5,2,10,3,55,21,6,4,26,184
385,15,2,5,4,9,22,54,8,8,48,238
385,16,3,4,4,9,31,-55,9,3,79,183
385,17,4,3,8,5,-56,32,3,5,23,215
385,18,3,3,8,5,35,32,8,7,58,247
385,19,4,3,6,7,-58,-66,0,1,0,181
385,20,3,4,5,8,32,44,2,5,32,225
385,21,4,3,9,4,45,31,7,6,77,256
385,22,5,2,10,3,-45,21,2,7,32,277
385,23,3,3,7,6,34,-67,6,0,66,210
385,24,2,5,4,9,22,54,8,4,88,264
385,25,2,5,3,10,21,55,9,9,109,319
385,26,4,2,9,4,-55,-78,4,1,54,241
385,27,3,4,7,6,34,42,8,3,88,283
385,28,4,3,8,5,-56,32,2,5,32,315
385,29,2,4,6,7,24,43,6,8,56,358
385,30,5,2,9,4,-46,-78,0,0,10,280
385,31,4,3,7,6,43,33,3,3,53,313
385,32,3,4,5,8,32,44,5,7,85,357
385,33,4,3,9,4,-55,31,0,8,30,388
385,34,6,2,11,2,65,20,5,8,95,408
385,35,5,2,8,5,53,-77,8,1,148,331
385,36,2,4,4,9,-78,45,0,6,70,376
385,37,2,4,8,5,26,41,6,7,96,417
385,38,4,2,8,5,-56,-77,0,0,40,340
385,39,3,4,6,7,33,43,3,3,73,383
385,40,3,4,6,7,33,43,6,6,106,426
385,41,4,3,6,7,42,-66,8,0,148,360
385,42,5,2,11,2,-44,20,4,0,104,380
385,43,3,4,8,5,35,41,9,1,139,421
385,44,3,4,8,5,-65,41,4,2,74,462
385,45,4,4,7,6,43,42,7,4,117,504
386,1,3,4,7,6,34,42,4,2,34,42
386,2,3,3,7,6,34,33,8,5,68,75
386,3,5,2,8,5,-47,23,1,8,21,98
386,4,2,6,5,8,23,-38,4,0,44,60
386,5,3,4,4,9,31,45,5,5,75,105
386,6,2,4,7,6,-75,42,0,7,0,147
386,7,3,3,3,10,30,-63,0,4,30,84
386,8,4,2,8,5,44,23,4,7,74,107
386,9,4,2,10,3,-54,21,0,8,20,128
386,10,3,3,5,8,32,-65,2,3,52,63
386,11,4,2,8,5,44,23,6,6,96,86
386,12,4,3,6,7,42,-66,8,0,138,20
386,13,3,4,3,10,30,46,8,6,168,66
386,14,2,5,6,7,-76,52,2,8,92,118
386,15,4,3,9,4,45,31,7,9,137,149
386,16,2,4,3,10,21,-54,8,5,158,95
386,17,4,2,9,4,-55,22,3,7,103,117
386,18,4,2,9,4,45,22,8,9,148,139
386,19,3,3,6,7,-67,-66,1,3,81,73
386,20,4,3,8,5,44,32,5,5,125,105
386,21,4,3,8,5,44,32,9,7,169,137
386,22,4,3,8,5,-56,32,3,9,113,169
386,23,3,4,6,7,33,-57,6,2,146,112
386,24,4,2,7,6,43,24,9,6,189,136
386,25,4,3,10,3,-54,30,5,6,135,166
386,26,4,3,9,4,-55,31,0,7,80,197
386,27,3,4,4,9,31,-55,1,2,111,142
386,28,6,2,7,6,61,24,2,6,172,166
386,29,2,5,4,9,22,-46,4,0,194,120
386,30,3,3,6,7,33,34,7,4,227,154
386,31,2,5,4,9,22,54,9,8,249,208
386,32,3,4,7,6,-66,-58,3,0,183,150
386,33,3,4,5,8,32,44,5,4,215,194
386,34,4,2,8,5,44,23,9,7,259,217
386,35,3,4,9,4,-64,40,5,7,195,257
386,36,5,2,8,5,53,-77,8,0,248,180
386,37,3,4,7,6,-66,42,2,2,182,222
386,38,4,3,7,6,43,33,5,5,225,255
386,39,4,2,7,6,43,24,8,9,268,279
386,40,5,2,8,5,-47,-77,1,2,221,202
386,41,5,2,6,7,51,25,2,7,272,227
386,42,3,4,4,9,31,-55,3,2,303,172
386,43,2,6,2,11,20,65,3,7,323,237
386,44,4,3,7,6,43,-67,6,0,366,170
386,45,2,5,4,9,22,54,8,4,388,224
386,46,3,5,4,9,31,54,9,8,419,278
386,47,4,3,8,5,-56,-68,3,0,363,210
386,48,2,5,6,7,24,52,7,2,387,262
386,49,6,2,10,3,-36,21,1,3,351,283
386,50,2,4,7,6,25,42,6,5,376,325
386,51,3,3,6,7,33,34,9,9,409,359
386,52,4,4,6,7,-58,-57,1,2,351,302
386,53,3,3,7,6,34,33,5,5,385,335
386,54,5,2,6,7,51,-75,6,0,436,260
386,55,4,3,6,7,42,34,8,4,478,294
386,56,3,4,5,8,-68,44,0,8,410,338
386,57,4,3,7,6,43,-67,3,1,453,271
386,58,3,3,7,6,34,33,7,4,487,304
386,59,4,3,7,6,-57,33,0,7,430,337
386,60,2,5,6,7,24,52,4,9,454,389
386,61,4,3,6,7,42,-66,6,3,496,323
386,62,3,4,6,7,33,43,9,6,529,366
387,1,3,4,7,6,34,42,4,2,34,42
387,2,2,4,6,7,24,43,8,5,58,85
387,3,4,2,9,4,-55,22,3,7,3,107
387,4,5,2,7,6,52,-76,5,1,55,31
387,5,2,5,4,9,22,54,7,5,77,85
387,6,5,2,9,4,-46,22,1,7,31,107
387,7,4,3,10,3,46,30,7,7,77,137
387,8,5,3,6,7,51,-66,8,1,128,71
387,9,2,5,4,9,-78,54,0,5,50,125
387,10,3,4,6,7,33,43,3,8,83,168
387,11,5,2,9,4,54,-78,7,0,137,90
387,12,4,3,8,5,-56,32,1,2,81,122
387,13,5,2,11,2,56,20,7,2,137,142
387,14,2,4,5,8,-77,44,0,6,60,186
387,15,3,3,5,8,32,-65,2,1,92,121
387,16,5,2,11,2,56,20,8,1,148,141
387,17,4,4,6,7,-58,43,0,4,90,184
387,18,4,2,7,6,43,24,3,8,133,208
387,19,3,4,7,6,34,-58,7,0,167,150
387,20,4,3,8,5,-56,32,1,2,111,182
387,21,4,3,8,5,44,32,5,4,155,214
387,22,3,3,8,5,-65,32,0,6,90,246
387,23,3,4,5,8,32,-56,2,0,122,190
387,24,2,5,4,9,22,54,4,4,144,244
387,25,3,3,5,8,32,35,6,9,176,279
387,26,4,3,10,3,-54,30,2,9,122,309
387,27,5,2,7,6,52,-76,4,3,174,233
387,28,4,2,7,6,43,24,7,7,217,257
387,29,3,4,7,6,-66,42,1,9,151,299
387,30,2,4,3,10,21,-54,2,5,172,245
387,31,5,2,6,7,51,-75,3,0,223,170
387,32,3,3,7,6,34,33,7,3,257,203
387,33,4,2,7,6,-57,24,0,7,200,227
387,34,2,4,7,6,25,42,5,9,225,269
387,35,4,3,9,4,-55,-69,0,0,170,200
387,36,6,2,7,6,61,24,1,4,231,224
387,37,2,5,5,8,23,53,4,7,254,277
387,38,3,3,8,5,35,32,9,9,289,309
387,39,2,4,6,7,-76,-57,3,2,213,252
387,40,3,3,7,6,34,33,7,5,247,285
387,41,5,2,8,5,-47,23,0,8,200,308
387,42,2,5,4,9,22,-46,2,2,222,262
387,43,2,4,7,6,25,42,7,4,247,304
387,44,4,2,9,4,-55,22,2,6,192,326
387,45,3,4,6,7,33,43,5,9,225,369
387,46,2,4,7,6,-75,-58,0,1,150,311
387,47,4,2,8,5,44,23,4,4,194,334
387,48,3,4,6,7,33,43,7,7,227,377
387,49,4,3,8,5,-56,32,1,9,171,409
387,50,3,4,7,6,34,-58,5,1,205,351
387,51,4,3,6,7,42,34,7,5,247,385
387,52,5,3,9,4,-46,31,1,6,201,416
387,53,3,4,6,7,33,43,4,9,234,459
387,54,2,4,5,8,23,-56,7,3,257,403
387,55,3,3,7,6,-66,33,1,6,191,436
387,56,3,3,7,6,34,33,5,9,225,469
387,57,5,2,9,4,54,-78,9,1,279,391
387,58,2,4,4,9,-78,45,1,6,201,436
387,59,2,4,3,10,21,-54,2,2,222,382
387,60,3,3,5,8,32,35,4,7,254,417
387,61,5,2,9,4,54,22,8,9,308,439
387,62,4,2,10,3,-54,-79,4,0,254,360
387,63,3,4,4,9,31,45,5,5,285,405
387,64,4,2,5,8,41,-74,6,1,326,331
387,65,4,3,7,6,43,33,9,4,369,364
387,66,2,4,5,8,-77,44,2,8,292,408
387,67,3,4,5,8,32,-56,4,2,324,352
387,68,4,3,7,6,43,33,7,5,367,385
387,69,3,4,6,7,-67,43,0,8,300,428
387,70,4,3,10,3,46,30,6,8,346,458
387,71,3,3,7,6,-66,-67,0,1,280,391
387,72,3,3,6,7,33,34,3,5,313,425
387,73,3,4,4,9,31,-55,4,0,344,370
387,74,4,2,8,5,44,23,8,3,388,393
387,75,4,2,9,4,-55,22,3,5,333,415
387,76,4,3,7,6,43,33,6,8,376,448
387,77,4,4,5,8,41,-56,7,2,417,392
387,78,2,5,2,11,20,56,7,8,437,448
387,79,3,3,7,6,-66,-67,1,1,371,381
387,80,3,3,6,7,33,34,4,5,404,415
387,81,4,2,8,5,44,23,8,8,448,438
387,82,3,4,5,8,-68,-56,0,2,380,382
387,83,3,4,6,7,33,43,3,5,413,425
387,84,4,2,7,6,43,24,6,9,456,449
387,85,4,3,8,5,-56,-68,0,1,400,381
387,86,4,3,7,6,43,33,3,4,443,414
387,87,2,4,5,8,23,44,6,8,466,458
387,88,2,4,4,9,22,-55,8,3,488,403
387,89,3,4,5,8,-68,44,0,7,420,447
387,90,3,4,3,10,30,-54,0,3,450,393
387,91,2,5,6,7,24,52,4,5,474,445
387,92,5,2,9,4,54,22,8,7,528,467
388,1,2,4,5,8,23,44,3,4,23,44
388,2,3,4,8,5,35,41,8,5,58,85
388,3,2,4,5,8,-77,44,1,9,-19,129
388,4,2,5,3,10,21,-45,2,4,2,84
388,5,5,2,8,5,53,23,5,7,55,107
388,6,2,5,3,10,21,-45,6,2,76,62
388,7,3,3,5,8,32,35,8,7,108,97
388,8,3,3,6,7,-67,-66,1,1,41,31
388,9,4,4,8,5,44,41,5,2,85,72
388,10,3,3,10,3,-63,30,2,2,22,102
388,11,3,4,6,7,33,43,5,5,55,145
388,12,5,2,8,5,53,23,8,8,108,168
388,13,4,3,9,4,-55,31,3,9,53,199
388,14,3,5,5,8,32,-47,5,2,85,152
388,15,4,3,4,9,40,36,5,8,125,188
388,16,4,2,7,6,43,-76,8,2,168,112
388,17,3,3,8,5,-65,32,3,4,103,144
388,18,3,4,7,6,34,42,7,6,137,186
388,19,3,3,7,6,-66,33,1,9,71,219
388,20,3,3,5,8,32,-65,3,4,103,154
388,21,2,5,4,9,22,54,5,8,125,208
388,22,3,5,5,8,32,-47,7,1,157,161
388,23,5,2,8,5,-47,23,0,4,110,184
388,24,2,4,5,8,23,44,3,8,133,228
388,25,2,5,4,9,22,-46,5,2,155,182
388,26,2,5,6,7,24,52,9,4,179,234
388,27,3,4,4,9,-69,45,0,9,110,279
388,28,3,3,7,6,34,-67,4,2,144,212
388,29,2,5,3,10,21,55,5,7,165,267
388,30,3,4,8,5,-65,41,0,8,100,308
388,31,4,3,11,2,47,-30,7,8,147,278
388,32,4,4,8,5,-56,41,1,9,91,319
388,33,3,4,6,7,33,-57,4,2,124,262
388,34,4,3,8,5,44,32,8,4,168,294
388,35,2,5,4,9,-78,54,0,8,90,348
388,36,4,3,7,6,43,-67,3,1,133,281
388,37,4,2,8,5,44,23,7,4,177,304
388,38,2,5,4,9,22,54,9,8,199,358
388,39,4,3,5,8,-59,-65,0,3,140,293
388,40,2,5,4,9,22,54,2,7,162,347
388,41,4,2,11,2,47,20,9,7,209,367
388,42,4,2,9,4,-55,22,4,9,154,389
388,43,3,3,8,5,35,-68,9,1,189,321
388,44,3,4,9,4,-64,40,5,1,125,361
388,45,2,5,2,11,20,56,5,7,145,417
388,46,3,4,6,7,33,-57,8,0,178,360
388,47,4,2,9,4,-55,22,3,2,123,382
388,48,3,4,6,7,33,43,6,5,156,425
388,49,3,4,5,8,32,44,8,9,188,469
388,50,3,3,4,9,31,-64,9,5,219,405
388,51,2,5,4,9,-78,54,1,9,141,459
388,52,3,4,6,7,33,-57,4,2,174,402
388,53,2,4,7,6,25,42,9,4,199,444
388,54,4,2,7,6,-57,24,2,8,142,468
388,55,2,4,4,9,22,-55,4,3,164,413
388,56,4,3,10,3,-54,30,0,3,110,443
388,57,3,3,5,8,32,35,2,8,142,478
388,58,3,4,4,9,31,-55,3,3,173,423
388,59,2,4,3,10,21,46,4,9,194,469
388,60,5,2,9,4,54,-78,8,1,248,391
388,61,4,3,6,7,-58,34,0,5,190,425
388,62,5,2,9,4,54,22,4,7,244,447
388,63,3,3,7,6,34,-67,8,0,278,380
388,64,4,3,7,6,-57,33,1,3,221,413
388,65,4,2,7,6,43,24,4,7,264,437
388,66,2,5,2,11,20,-44,4,3,284,393
388,67,4,3,6,7,42,34,6,7,326,427
388,68,3,3,10,3,-63,30,3,7,263,457
388,69,4,3,9,4,45,31,8,8,308,488
388,70,2,4,8,5,-74,41,4,9,234,529
389,1,2,4,5,8,23,44,3,4,23,44
389,2,4,2,7,6,43,24,6,8,66,68
389,3,4,3,7,6,43,-67,9,1,109,1
389,4,3,4,6,7,-67,43,2,4,42,44
389,5,2,6,6,7,24,61,6,5,66,105
389,6,4,3,8,5,-56,32,0,7,10,137
389,7,2,4,6,7,24,-57,4,0,34,80
389,8,3,3,5,8,32,35,6,5,66,115
389,9,3,4,5,8,32,44,8,9,98,159
389,10,3,3,9,4,-64,-69,4,0,34,90
389,11,6,2,11,2,65,20,9,0,99,110
389,12,4,4,8,5,-56,41,3,1,43,151
389,13,3,4,8,5,35,41,8,2,78,192
389,14,3,3,7,6,-66,33,2,5,12,225
389,15,5,2,9,4,54,22,6,7,66,247
389,16,2,4,6,7,-76,-57,0,0,-10,190
389,17,4,3,7,6,43,33,3,3,33,223
389,18,5,2,10,3,55,21,8,4,88,244
389,19,4,2,8,5,-56,23,2,7,32,267
389,20,4,4,6,7,42,-57,4,0,74,210
389,21,2,5,3,10,21,55,5,5,95,265
389,22,6,2,10,3,64,21,9,6,159,286
389,23,3,3,4,9,-69,-64,0,2,90,222
389,24,2,4,3,10,21,46,1,8,111,268
389,25,3,4,4,9,31,-55,2,3,142,213
389,26,4,3,11,2,47,-30,9,3,189,183
389,27,2,6,3,10,-79,64,0,7,110,247
389,28,3,3,4,9,31,-64,1,3,141,183
389,29,2,5,4,9,22,54,3,7,163,237
389,30,5,2,8,5,53,-77,6,0,216,160
389,31,4,3,8,5,-56,32,0,2,160,192
389,32,3,4,3,10,30,46,0,8,190,238
389,33,3,3,8,5,35,-68,5,0,225,170
389,34,3,4,6,7,33,43,8,3,258,213
389,35,4,3,6,7,-58,34,0,7,200,247
389,36,5,2,7,6,52,-76,2,1,252,171
389,37,3,5,7,6,34,51,6,2,286,222
389,38,4,3,7,6,43,33,9,5,329,255
389,39,3,3,7,6,-66,33,3,8,263,288
389,40,3,3,7,6,34,-67,7,1,297,221
389,41,5,2,8,5,-47,23,0,4,250,244
389,42,4,3,9,4,45,31,5,5,295,275
389,43,6,2,11,2,-35,20,0,5,260,295
389,44,3,3,6,7,33,34,3,9,293,329
389,45,3,4,4,9,31,-55,4,4,324,274
389,46,4,2,8,5,44,23,8,7,368,297
389,47,3,3,10,3,-63,30,5,7,305,327
389,48,5,2,9,4,54,22,9,9,359,349
389,49,3,3,7,6,-66,-67,3,2,293,282
389,50,3,4,4,9,31,45,4,7,324,327
389,51,4,2,6,7,42,-75,6,2,366,252
389,52,3,4,4,9,31,45,7,7,397,297
389,53,5,2,8,5,-47,-77,0,0,350,220
389,54,4,3,6,7,42,34,2,4,392,254
389,55,2,5,3,10,21,55,3,9,413,309
389,56,5,2,10,3,55,-79,8,0,468,230
389,57,4,2,7,6,-57,24,1,4,411,254
389,58,2,4,5,8,23,44,4,8,434,298
389,59,3,4,8,5,35,41,9,9,469,339
389,60,4,2,9,4,-55,-78,4,1,414,261
389,61,3,4,5,8,32,44,6,5,446,305
389,62,3,5,4,9,31,54,7,9,477,359
389,63,4,3,8,5,-56,-68,1,1,421,291
389,64,3,3,7,6,34,33,5,4,455,324
389,65,3,4,7,6,34,42,9,6,489,366
389,66,4,3,8,5,-56,32,3,8,433,398
389,67,4,2,9,4,45,-78,8,0,478,320
389,68,5,2,8,5,-47,23,1,3,431,343
389,69,4,2,6,7,42,25,3,8,473,368
389,70,3,4,5,8,32,-56,5,2,505,312
390,1,3,3,8,5,35,32,5,2,35,32
390,2,4,2,6,7,42,25,7,7,77,57
390,3,4,3,7,6,-57,-67,0,0,20,-10
390,4,4,2,6,7,42,25,2,5,62,15
390,5,4,3,3,10,-40,-63,2,2,22,-48
390,6,4,3,10,3,46,30,8,2,68,-18
390,7,3,3,9,4,-64,31,4,3,4,13
390,8,3,4,3,10,30,46,4,9,34,59
390,9,4,2,9,4,45,-78,9,1,79,-19
390,10,3,4,9,4,-64,40,5,1,15,21
390,11,3,4,8,5,-65,41,0,2,-50,62
390,12,3,4,4,9,31,45,1,7,-19,107
390,13,2,4,5,8,23,-56,4,1,4,51
390,14,5,2,7,6,52,24,6,5,56,75
390,15,3,3,5,8,32,-65,8,0,88,10
390,16,3,4,4,9,31,45,9,5,119,55
390,17,3,4,3,10,30,-54,9,1,149,1
390,18,2,5,5,8,-77,53,2,4,72,54
390,19,4,3,7,6,43,33,5,7,115,87
390,20,3,5,4,9,31,-46,6,1,146,41
390,21,3,3,5,8,32,35,8,6,178,76
390,22,2,5,2,11,20,-44,8,2,198,32
390,23,2,4,6,7,-76,43,2,5,122,75
390,24,6,2,9,4,63,22,5,7,185,97
390,25,3,4,3,10,30,-54,5,3,215,43
390,26,3,4,6,7,33,43,8,6,248,86
390,27,3,4,5,8,-68,-56,0,0,180,30
390,28,3,4,6,7,33,43,3,3,213,73
390,29,2,5,7,6,25,51,8,4,238,124
390,30,5,2,8,5,-47,23,1,7,191,147
390,31,2,4,7,6,25,42,6,9,216,189
390,32,2,5,4,9,22,-46,8,3,238,143
390,33,4,3,9,4,-55,31,3,4,183,174
390,34,2,4,3,10,21,-54,4,0,204,120
390,35,2,5,5,8,23,53,7,3,227,173
390,36,4,3,6,7,42,34,9,7,269,207
390,37,2,5,3,10,-79,-45,0,2,190,162
390,38,4,2,10,3,46,21,6,3,236,183
390,39,3,4,5,8,32,44,8,7,268,227
390,40,5,2,9,4,-46,22,2,9,222,249
390,41,5,2,6,7,51,-75,3,4,273,174
390,42,3,3,5,8,32,35,5,9,305,209
390,43,4,3,7,6,43,-67,8,2,348,142
390,44,2,5,6,7,-76,52,2,4,272,194
390,45,4,2,7,6,43,24,5,8,315,218
390,46,2,5,5,8,23,-47,8,1,338,171
390,47,4,3,7,6,-57,33,1,4,281,204
390,48,3,3,7,6,34,33,5,7,315,237
390,49,4,2,9,4,-55,22,0,9,260,259
390,50,2,4,3,10,21,-54,1,5,281,205
390,51,2,5,4,9,22,54,3,9,303,259
390,52,6,2,10,3,64,-79,7,0,367,180
390,53,3,4,7,6,-66,42,1,2,301,222
390,54,2,4,2,11,20,47,1,9,321,269
390,55,3,3,10,3,37,30,8,9,358,299
390,56,4,2,9,4,-55,-78,3,1,303,221
390,57,2,4,4,9,22,45,5,6,325,266
390,58,4,2,6,7,42,-75,7,1,367,191
390,59,3,3,5,8,32,35,9,6,399,226
390,60,4,2,7,6,-57,-76,2,0,342,150
390,61,3,3,6,7,33,34,5,4,375,184
390,62,6,2,10,3,64,21,9,5,439,205
390,63,3,3,6,7,-67,34,2,9,372,239
390,64,3,4,7,6,34,-58,6,1,406,181
390,65,2,5,3,10,21,55,7,6,427,236
390,66,4,3,9,4,-55,31,2,7,372,267
390,67,2,4,4,9,22,-55,4,2,394,212
390,68,2,4,5,8,23,44,7,6,417,256
390,69,3,4,8,5,-65,41,2,7,352,297
390,70,2,4,5,8,23,-56,5,1,375,241
390,71,2,5,3,10,21,55,6,6,396,296
390,72,5,2,8,5,53,23,9,9,449,319
390,73,3,3,7,6,-66,-67,3,2,383,252
390,74,3,4,7,6,34,42,7,4,417,294
390,75,4,3,8,5,-56,32,1,6,361,326
390,76,3,4,4,9,31,-55,2,1,392,271
390,77,5,2,8,5,53,23,5,4,445,294
390,78,5,3,8,5,53,32,8,6,498,326
390,79,2,4,3,10,21,-54,9,2,519,272
391,1,2,5,4,9,22,54,2,4,22,54
391,2,4,2,8,5,44,23,6,7,66,77
391,3,2,4,5,8,23,-56,9,1,89,21
391,4,4,3,7,6,-57,33,2,4,32,54
391,5,2,5,4,9,22,54,4,8,54,108
391,6,4,2,8,5,44,-77,8,1,98,31
391,7,6,2,8,5,-38,23,0,4,60,54
391,8,4,3,6,7,42,34,2,8,102,88
391,9,3,3,8,5,35,-68,7,0,137,20
391,10,2,4,6,7,-76,43,1,3,61,63
391,11,2,4,4,9,22,45,3,8,83,108
391,12,3,3,8,5,35,-68,8,0,118,40
391,13,4,3,6,7,-58,34,0,4,60,74
391,14,4,3,10,3,46,30,6,4,106,104
391,15,3,4,6,7,33,43,9,7,139,147
391,16,3,5,4,9,-69,-46,0,1,70,101
391,17,2,4,6,7,24,43,4,4,94,144
391,18,3,3,5,8,32,35,6,9,126,179
391,19,5,2,9,4,-46,-78,0,1,80,101
391,20,5,2,8,5,53,23,3,4,133,124
391,21,2,4,8,5,26,41,9,5,159,165
391,22,3,3,8,5,-65,32,4,7,94,197
391,23,3,3,6,7,33,-66,7,1,127,131
391,24,2,5,4,9,22,54,9,5,149,185
391,25,3,3,5,8,-68,-65,1,0,81,120
391,26,4,4,6,7,42,43,3,3,123,163
391,27,2,4,3,10,21,46,4,9,144,209
391,28,4,3,9,4,45,-69,9,0,189,140
391,29,3,4,6,7,-67,43,2,3,122,183
391,30,2,5,3,10,21,55,3,8,143,238
391,31,3,3,9,4,36,31,9,9,179,269
391,32,3,3,6,7,-67,-66,2,3,112,203
391,33,3,3,6,7,33,34,5,7,145,237
391,34,3,3,6,7,33,-66,8,1,178,171
391,35,3,4,8,5,-65,41,3,2,113,212
391,36,2,5,4,9,22,54,5,6,135,266
391,37,3,3,7,6,34,33,9,9,169,299
391,38,3,4,5,8,-68,-56,1,3,101,243
391,39,3,4,8,5,35,41,6,4,136,284
391,40,3,4,8,5,-65,41,1,5,71,325
391,41,3,3,7,6,34,33,5,8,105,358
391,42,4,2,6,7,42,-75,7,3,147,283
391,43,4,3,4,9,40,36,7,9,187,319
391,44,2,4,8,5,-74,-59,3,0,113,260
391,45,2,4,5,8,23,44,6,4,136,304
391,46,2,4,5,8,23,44,9,8,159,348
391,47,3,3,7,6,-66,-67,3,1,93,281
391,48,5,2,8,5,53,23,6,4,146,304
391,49,2,5,7,6,-75,51,1,5,71,355
391,50,3,3,8,5,35,32,6,7,106,387
391,51,2,4,8,5,-74,41,2,8,32,428
391,52,3,3,7,6,34,-67,6,1,66,361
391,53,2,4,5,8,23,44,9,5,89,405
391,54,4,2,8,5,-56,23,3,8,33,428
391,55,3,5,5,8,32,-47,5,1,65,381
391,56,2,5,3,10,21,55,6,6,86,436
391,57,3,4,6,7,33,43,9,9,119,479
391,58,2,6,3,10,-79,-36,0,3,40,443
391,59,5,2,10,3,55,21,5,4,95,464
391,60,3,3,7,6,34,33,9,7,129,497
391,61,4,2,7,6,-57,-76,2,1,72,421
391,62,5,2,9,4,54,22,6,3,126,443
391,63,2,4,7,6,-75,42,1,5,51,485
391,64,4,3,5,8,41,-65,2,0,92,420
391,65,4,3,8,5,44,32,6,2,136,452
391,66,2,4,4,9,22,45,8,7,158,497
391,67,2,4,6,7,-76,-57,2,0,82,440
391,68,3,4,4,9,31,45,3,5,113,485
391,69,6,2,9,4,63,22,6,7,176,507
392,1,4,3,6,7,42,34,2,4,42,34
392,2,2,5,5,8,23,53,5,7,65,87
392,3,4,2,9,4,-55,22,0,9,10,109
392,4,4,2,6,7,42,-75,2,4,52,34
392,5,3,3,7,6,34,33,6,7,86,67
392,6,2,5,6,7,-76,52,0,9,10,119
392,7,3,4,4,9,31,-55,1,4,41,64
392,8,3,4,6,7,33,43,4,7,74,107
392,9,2,5,4,9,22,-46,6,1,96,61
392,10,4,3,8,5,-56,32,0,3,40,93
392,11,3,4,5,8,32,44,2,7,72,137
392,12,5,2,9,4,54,22,6,9,126,159
392,13,4,2,6,7,42,-75,8,4,168,84
392,14,3,4,6,7,-67,43,1,7,101,127
392,15,4,3,6,7,42,-66,3,1,143,61
392,16,3,4,7,6,34,42,7,3,177,103
392,17,2,5,4,9,22,54,9,7,199,157
392,18,4,3,6,7,-58,-66,1,1,141,91
392,19,3,3,7,6,34,33,5,4,175,124
392,20,3,3,8,5,-65,32,0,6,110,156
392,21,3,4,4,9,31,-55,1,1,141,101
392,22,4,3,6,7,42,34,3,5,183,135
392,23,2,6,5,8,23,62,6,7,206,197
392,24,4,3,8,5,-56,32,0,9,150,229
392,25,2,4,3,10,21,-54,1,5,171,175
392,26,4,3,6,7,42,34,3,9,213,209
392,27,3,3,7,6,34,-67,7,2,247,142
392,28,3,3,4,9,31,36,8,8,278,178
392,29,3,4,5,8,-68,-56,0,2,210,122
392,30,6,2,11,2,65,20,5,2,275,142
392,31,3,4,6,7,33,43,8,5,308,185
392,32,5,2,9,4,-46,22,2,7,262,207
392,33,3,3,9,4,36,31,8,8,298,238
392,34,2,5,4,9,-78,-46,0,2,220,192
392,35,5,2,8,5,53,23,3,5,273,215
392,36,5,2,11,2,56,20,9,5,329,235
392,37,3,4,5,8,-68,44,1,9,261,279
392,38,2,4,3,10,21,-54,2,5,282,225
392,39,4,2,10,3,46,21,8,6,328,246
392,40,4,3,9,4,-55,31,3,7,273,277
392,41,4,2,8,5,44,-77,7,0,317,200
392,42,3,4,3,10,30,46,7,6,347,246
392,43,2,4,4,9,22,-55,9,1,369,191
392,44,3,3,5,8,-68,35,1,6,301,226
392,45,3,3,6,7,33,-66,4,0,334,160
392,46,5,2,9,4,54,22,8,2,388,182
392,47,4,2,7,6,-57,24,1,6,331,206
392,48,3,4,7,6,34,42,5,8,365,248
392,49,5,2,9,4,54,-78,9,0,419,170
392,50,2,4,5,8,-77,44,2,4,342,214
392,51,4,2,8,5,44,23,6,7,386,237
392,52,3,3,8,5,-65,32,1,9,321,269
392,53,3,3,6,7,33,-66,4,3,354,203
392,54,4,3,6,7,42,34,6,7,396,237
392,55,5,2,8,5,53,-77,9,0,449,160
392,56,2,4,3,10,-79,46,0,6,370,206
392,57,3,5,4,9,31,-46,1,0,401,160
392,58,3,5,4,9,31,54,2,4,432,214
392,59,6,2,10,3,64,21,6,5,496,235
392,60,3,3,6,7,33,34,9,9,529,269
393,1,4,2,7,6,43,24,3,4,43,24
393,2,2,6,3,10,21,64,4,8,64,88
393,3,4,3,7,6,43,-67,7,1,107,21
393,4,3,3,6,7,-67,34,0,5,40,55
393,5,2,4,7,6,25,42,5,7,65,97
393,6,3,4,5,8,32,-56,7,1,97,41
393,7,3,4,6,7,-67,43,0,4,30,84
393,8,3,3,6,7,33,34,3,8,63,118
393,9,4,3,6,7,42,-66,5,2,105,52
393,10,3,3,7,6,34,33,9,5,139,85
393,11,3,4,5,8,-68,44,1,9,71,129
393,12,3,3,8,5,35,-68,6,1,106,61
393,13,5,2,6,7,51,25,7,6,157,86
393,14,3,4,4,9,31,-55,8,1,188,31
393,15,2,5,6,7,-76,52,2,3,112,83
393,16,3,4,8,5,35,41,7,4,147,124
393,17,4,2,9,4,-55,22,2,6,92,146
393,18,3,3,7,6,34,33,6,9,126,179
393,19,3,5,4,9,31,-46,7,3,157,133
393,20,3,4,6,7,-67,43,0,6,90,176
393,21,4,2,9,4,45,22,5,8,135,198
393,22,3,3,6,7,33,-66,8,2,168,132
393,23,2,5,3,10,21,55,9,7,189,187
393,24,3,4,4,9,-69,-55,0,2,120,132
393,25,2,4,4,9,22,45,2,7,142,177
393,26,3,3,5,8,32,-65,4,2,174,112
393,27,2,6,2,11,20,65,4,7,194,177
393,28,2,5,4,9,22,-46,6,1,216,131
393,29,4,2,7,6,43,24,9,5,259,155
393,30,2,4,7,6,-75,42,4,7,184,197
393,31,2,4,6,7,24,-57,8,0,208,140
393,32,4,3,8,5,-56,32,2,2,152,172
393,33,2,5,3,10,21,55,3,7,173,227
393,34,5,2,10,3,55,21,8,8,228,248
393,35,2,5,6,7,-76,-48,2,0,152,200
393,36,3,4,7,6,34,42,6,2,186,242
393,37,3,3,6,7,33,34,9,6,219,276
393,38,3,4,8,5,-65,41,4,7,154,317
393,39,4,3,9,4,45,31,9,8,199,348
393,40,5,2,7,6,-48,-76,1,2,151,272
393,41,4,2,9,4,45,22,6,4,196,294
393,42,4,2,7,6,43,24,9,8,239,318
393,43,4,2,7,6,-57,-76,2,2,182,242
393,44,3,4,4,9,31,45,3,7,213,287
393,45,4,2,6,7,42,-75,5,2,255,212
393,46,3,3,4,9,31,36,6,8,286,248
393,47,2,6,4,9,22,-37,8,1,308,211
393,48,3,4,6,7,-67,43,1,4,241,254
393,49,2,4,4,9,22,45,3,9,263,299
393,50,3,3,5,8,32,-65,5,4,295,234
393,51,3,3,8,5,-65,32,0,6,230,266
393,52,3,4,8,5,35,41,5,7,265,307
393,53,4,2,9,4,-55,22,0,9,210,329
393,54,3,4,4,9,31,-55,1,4,241,274
393,55,3,4,3,10,30,-54,1,0,271,220
393,56,4,3,6,7,42,34,3,4,313,254
393,57,3,3,8,5,35,32,8,6,348,286
393,58,2,4,5,8,-77,-56,1,0,271,230
393,59,4,3,10,3,46,30,7,0,317,260
393,60,3,4,7,6,-66,42,1,2,251,302
393,61,2,4,6,7,24,43,5,5,275,345
393,62,3,3,7,6,34,33,9,8,309,378
393,63,4,3,7,6,-57,-67,2,1,252,311
393,64,3,3,8,5,35,32,7,3,287,343
393,65,2,4,4,9,22,45,9,8,309,388
393,66,3,3,7,6,-66,-67,3,1,243,321
393,67,2,5,4,9,22,54,5,5,265,375
393,68,4,3,5,8,41,-65,6,0,306,310
393,69,3,4,6,7,33,43,9,3,339,353
393,70,5,2,6,7,-49,25,0,8,290,378
393,71,2,5,3,10,21,-45,1,3,311,333
393,72,4,2,10,3,46,21,7,4,357,354
393,73,4,3,9,4,-55,31,2,5,302,385
393,74,5,2,10,3,55,21,7,6,357,406
393,75,3,4,7,6,-66,42,1,8,291,448
393,76,2,5,5,8,23,-47,4,1,314,401
393,77,5,2,8,5,53,23,7,4,367,424
393,78,2,4,4,9,22,45,9,9,389,469
393,79,3,3,7,6,-66,-67,3,2,323,402
393,80,3,3,6,7,33,34,6,6,356,436
393,81,2,4,5,8,23,-56,9,0,379,380
393,82,5,2,8,5,-47,23,2,3,332,403
393,83,2,4,7,6,25,42,7,5,357,445
393,84,3,3,5,8,32,-65,9,0,389,380
393,85,4,2,7,6,-57,24,2,4,332,404
393,86,3,3,8,5,35,32,7,6,367,436
393,87,2,4,7,6,-75,42,2,8,292,478
393,88,4,2,8,5,44,-77,6,1,336,401
393,89,3,3,8,5,-65,32,1,3,271,433
393,90,3,4,3,10,30,46,1,9,301,479
393,91,2,4,5,8,23,-56,4,3,324,423
393,92,3,4,7,6,34,42,8,5,358,465
393,93,3,4,6,7,-67,43,1,8,291,508
394,1,4,2,6,7,42,25,2,5,42,25
394,2,3,3,8,5,35,32,7,7,77,57
394,3,3,3,7,6,-66,-67,1,0,11,-10
394,4,3,3,5,8,32,35,3,5,43,25
394,5,3,3,8,5,35,32,8,7,78,57
394,6,4,3,5,8,41,-65,9,2,119,-8
394,7,3,3,5,8,-68,35,1,7,51,27
394,8,3,3,6,7,33,-66,4,1,84,-39
394,9,3,3,3,10,30,37,4,8,114,-2
394,10,3,4,3,10,30,-54,4,4,144,-56
394,11,3,3,8,5,35,32,9,6,179,-24
394,12,4,2,11,2,-53,20,6,6,126,-4
394,13,3,4,6,7,33,43,9,9,159,39
394,14,4,3,10,3,-54,30,5,9,105,69
394,15,4,2,9,4,-55,-78,0,1,50,-9
394,16,4,3,9,4,45,31,5,2,95,22
394,17,5,2,9,4,54,22,9,4,149,44
394,18,3,4,5,8,-68,44,1,8,81,88
394,19,3,4,6,7,33,-57,4,1,114,31
394,20,4,3,10,3,-54,30,0,1,60,61
394,21,3,3,6,7,33,34,3,5,93,95
394,22,2,4,5,8,23,44,6,9,116,139
394,23,4,2,8,5,-56,-77,0,2,60,62
394,24,3,3,7,6,34,33,4,5,94,95
394,25,4,3,5,8,41,-65,5,0,135,30
394,26,2,4,4,9,22,45,7,5,157,75
394,27,4,2,7,6,-57,24,0,9,100,99
394,28,4,4,7,6,43,-58,3,1,143,41
394,29,4,3,9,4,45,31,8,2,188,72
394,30,3,3,8,5,-65,32,3,4,123,104
394,31,3,4,4,9,31,45,4,9,154,149
394,32,2,5,5,8,23,-47,7,2,177,102
394,33,3,3,5,8,32,35,9,7,209,137
394,34,2,4,4,9,-78,-55,1,2,131,82
394,35,2,4,3,10,21,46,2,8,152,128
394,36,2,4,7,6,25,-58,7,0,177,70
394,37,4,3,5,8,41,35,8,5,218,105
394,38,4,3,10,3,-54,30,4,5,164,135
394,39,2,5,4,9,22,54,6,9,186,189
394,40,5,2,7,6,52,-76,8,3,238,113
394,41,3,4,5,8,-68,44,0,7,170,157
394,42,3,3,8,5,35,32,5,9,205,189
394,43,3,3,9,4,-64,-69,1,0,141,120
394,44,4,3,7,6,43,33,4,3,184,153
394,45,4,3,8,5,44,32,8,5,228,185
394,46,4,2,8,5,-56,23,2,8,172,208
394,47,2,4,5,8,23,-56,5,2,195,152
394,48,4,2,7,6,43,24,8,6,238,176
394,49,4,3,9,4,-55,31,3,7,183,207
394,50,5,3,8,5,53,32,6,9,236,239
394,51,4,3,5,8,41,-65,7,4,277,174
394,52,4,2,9,4,-55,22,2,6,222,196
394,53,2,5,3,10,21,-45,3,1,243,151
394,54,4,3,7,6,43,33,6,4,286,184
394,55,5,2,8,5,53,23,9,7,339,207
394,56,4,2,7,6,-57,-76,2,1,282,131
394,57,2,4,3,10,21,46,3,7,303,177
394,58,4,3,6,7,42,-66,5,1,345,111
394,59,2,6,3,10,21,64,6,5,366,175
394,60,3,3,6,7,33,34,9,9,399,209
394,61,4,3,5,8,-59,-65,0,4,340,144
394,62,4,2,6,7,42,25,2,9,382,169
394,63,3,3,5,8,32,-65,4,4,414,104
394,64,3,3,5,8,32,35,6,9,446,139
394,65,2,4,3,10,21,-54,7,5,467,85
394,66,3,3,5,8,32,-65,9,0,499,20
394,67,5,2,9,4,-46,22,3,2,453,42
394,68,3,3,4,9,31,36,4,8,484,78
394,69,3,3,6,7,33,-66,7,2,517,12
395,1,4,2,9,4,45,22,5,2,45,22
395,2,3,3,7,6,34,33,9,5,79,55
395,3,3,3,7,6,-66,33,3,8,13,88
395,4,2,5,6,7,24,-48,7,0,37,40
395,5,3,4,6,7,-67,43,0,3,-30,83
395,6,4,3,10,3,46,30,6,3,16,113
395,7,2,5,5,8,23,53,9,6,39,166
395,8,2,6,4,9,-78,63,1,9,-39,229
395,9,3,4,6,7,33,-57,4,2,-6,172
395,10,2,5,3,10,21,55,5,7,15,227
395,11,3,3,7,6,34,-67,9,0,49,160
395,12,2,5,5,8,-77,53,2,3,-28,213
395,13,2,4,5,8,23,44,5,7,-5,257
395,14,3,3,7,6,34,-67,9,0,29,190
395,15,2,5,2,11,20,56,9,6,49,246
395,16,3,3,6,7,-67,-66,2,0,-18,180
395,17,2,4,4,9,22,45,4,5,4,225
395,18,4,3,10,3,-54,30,0,5,-50,255
395,19,3,3,7,6,34,33,4,8,-16,288
395,20,3,3,7,6,34,-67,8,1,18,221
395,21,2,4,2,11,20,47,8,8,38,268
395,22,5,2,9,4,-46,-78,2,0,-8,190
395,23,2,4,5,8,23,44,5,4,15,234
395,24,2,5,5,8,23,53,8,7,38,287
395,25,4,2,6,7,-58,-75,0,2,-20,212
395,26,2,4,6,7,24,43,4,5,4,255
395,27,2,5,4,9,22,54,6,9,26,309
395,28,4,3,8,5,-56,-68,0,1,-30,241
395,29,5,2,10,3,55,21,5,2,25,262
395,30,4,3,9,4,-55,31,0,3,-30,293
395,31,3,4,6,7,33,43,3,6,3,336
395,32,3,3,5,8,32,-65,5,1,35,271
395,33,3,3,8,5,-65,32,0,3,-30,303
395,34,3,4,7,6,34,42,4,5,4,345
395,35,2,4,6,7,24,43,8,8,28,388
395,36,5,2,10,3,-45,21,3,9,-17,409
395,37,3,3,6,7,33,-66,6,3,16,343
395,38,4,3,6,7,42,34,8,7,58,377
395,39,5,2,9,4,-46,22,2,9,12,399
395,40,3,4,7,6,34,-58,6,1,46,341
395,41,4,3,9,4,-55,31,1,2,-9,372
395,42,5,2,10,3,55,21,6,3,46,393
395,43,3,3,6,7,33,34,9,7,79,427
395,44,4,2,9,4,-55,22,4,9,24,449
395,45,4,2,8,5,44,-77,8,2,68,372
395,46,4,3,7,6,-57,33,1,5,11,405
395,47,3,4,3,10,30,-54,1,1,41,351
395,48,2,4,7,6,25,42,6,3,66,393
395,49,4,2,6,7,42,25,8,8,108,418
395,50,3,4,5,8,-68,-56,0,2,40,362
395,51,2,4,4,9,22,45,2,7,62,407
395,52,4,3,7,6,43,-67,5,0,105,340
395,53,4,3,7,6,43,33,8,3,148,373
395,54,5,2,9,4,-46,22,2,5,102,395
395,55,3,3,6,7,33,34,5,9,135,429
395,56,2,4,6,7,24,-57,9,2,159,372
395,57,3,3,7,6,-66,33,3,5,93,405
395,58,4,2,9,4,45,22,8,7,138,427
395,59,5,2,8,5,-47,-77,1,0,91,350
395,60,3,3,9,4,36,31,7,1,127,381
395,61,2,6,2,11,20,65,7,6,147,446
395,62,5,2,7,6,52,-76,9,0,199,370
395,63,6,2,8,5,-38,23,1,3,161,393
395,64,3,3,8,5,35,32,6,5,196,425
395,65,2,4,5,8,23,44,9,9,219,469
395,66,5,2,10,3,-45,-79,4,0,174,390
395,67,4,2,8,5,44,23,8,3,218,413
395,68,4,3,8,5,-56,32,2,5,162,445
395,69,4,2,7,6,43,24,5,9,205,469
395,70,4,2,9,4,-55,-78,0,1,150,391
395,71,4,2,7,6,43,24,3,5,193,415
395,72,3,4,4,9,31,-55,4,0,224,360
395,73,2,6,6,7,24,61,8,1,248,421
395,74,2,4,3,10,21,46,9,7,269,467
395,75,4,2,9,4,-55,22,4,9,214,489
395,76,2,4,7,6,25,-58,9,1,239,431
395,77,3,3,7,6,-66,33,3,4,173,464
395,78,4,3,9,4,45,31,8,5,218,495
395,79,3,3,4,9,31,-64,9,1,249,431
395,80,4,3,9,4,-55,31,4,2,194,462
395,81,4,3,6,7,42,34,6,6,236,496
395,82,2,4,8,5,-74,41,2,7,162,537
396,1,2,4,8,5,26,41,6,1,26,41
396,2,2,5,3,10,21,55,7,6,47,96
396,3,3,3,7,6,-66,33,1,9,-19,129
396,4,3,3,7,6,34,-67,5,2,15,62
396,5,2,5,4,9,22,54,7,6,37,116
396,6,4,2,8,5,-56,23,1,9,-19,139
396,7,3,4,6,7,33,-57,4,2,14,82
396,8,5,2,8,5,53,23,7,5,67,105
396,9,6,2,8,5,62,23,9,8,129,128
396,10,5,3,8,5,-47,-68,2,0,82,60
396,11,4,3,8,5,44,32,6,2,126,92
396,12,4,3,8,5,-56,32,0,4,70,124
396,13,3,3,4,9,31,-64,1,0,101,60
396,14,5,3,9,4,54,31,5,1,155,91
396,15,2,5,4,9,22,54,7,5,177,145
396,16,4,2,9,4,-55,22,2,7,122,167
396,17,4,2,7,6,43,-76,5,1,165,91
396,18,3,3,5,8,32,35,7,6,197,126
396,19,3,3,8,5,-65,32,2,8,132,158
396,20,4,3,10,3,46,30,8,8,178,188
396,21,4,3,7,6,-57,-67,1,1,121,121
396,22,3,4,4,9,31,45,2,6,152,166
396,23,4,2,7,6,43,-76,5,0,195,90
396,24,5,2,8,5,53,23,8,3,248,113
396,25,4,2,9,4,-55,22,3,5,193,135
396,26,4,3,8,5,44,32,7,7,237,167
396,27,4,3,5,8,41,-65,8,2,278,102
396,28,4,3,8,5,-56,32,2,4,222,134
396,29,2,5,2,11,20,-44,2,0,242,90
396,30,6,2,10,3,64,21,6,1,306,111
396,31,3,3,8,5,-65,32,1,3,241,143
396,32,5,2,10,3,55,21,6,4,296,164
396,33,3,4,5,8,32,44,8,8,328,208
396,34,4,3,9,4,-55,31,3,9,273,239
396,35,2,6,4,9,22,-37,5,2,295,202
396,36,2,5,5,8,23,53,8,5,318,255
396,37,4,2,6,7,-58,-75,0,0,260,180
396,38,3,3,7,6,34,33,4,3,294,213
396,39,2,4,5,8,23,44,7,7,317,257
396,40,4,3,9,4,-55,31,2,8,262,288
396,41,3,3,6,7,33,-66,5,2,295,222
396,42,2,4,2,11,20,47,5,9,315,269
396,43,5,2,10,3,-45,-79,0,0,270,190
396,44,3,4,7,6,34,42,4,2,304,232
396,45,4,3,6,7,42,34,6,6,346,266
396,46,4,4,5,8,41,-56,7,0,387,210
396,47,2,4,3,10,21,46,8,6,408,256
396,48,3,4,5,8,-68,-56,0,0,340,200
396,49,4,2,8,5,44,23,4,3,384,223
396,50,3,3,7,6,34,33,8,6,418,256
396,51,4,2,6,7,-58,-75,0,1,360,181
396,52,4,2,9,4,45,22,5,3,405,203
396,53,2,4,4,9,22,45,7,8,427,248
396,54,5,2,10,3,-45,21,2,9,382,269
396,55,4,3,6,7,42,-66,4,3,424,203
396,56,4,2,5,8,41,26,5,9,465,229
396,57,2,5,5,8,23,-47,8,2,488,182
396,58,4,3,6,7,-58,34,0,6,430,216
396,59,3,3,6,7,33,-66,3,0,463,150
396,60,3,4,3,10,30,46,3,6,493,196
396,61,4,3,6,7,42,-66,5,0,535,130
397,1,2,5,5,8,23,53,3,3,23,53
397,2,4,2,8,5,44,23,7,6,67,76
397,3,2,5,5,8,-77,53,0,9,-10,129
397,4,5,2,11,2,56,20,6,9,46,149
397,5,4,2,9,4,-55,-78,1,1,-9,71
397,6,3,3,5,8,32,35,3,6,23,106
397,7,3,3,5,8,32,-65,5,1,55,41
397,8,5,2,10,3,-45,21,0,2,10,62
397,9,3,3,6,7,33,34,3,6,43,96
397,10,3,4,7,6,34,42,7,8,77,138
397,11,3,3,7,6,-66,-67,1,1,11,71
397,12,4,3,6,7,42,34,3,5,53,105
397,13,4,3,5,8,41,-65,4,0,94,40
397,14,4,3,9,4,45,31,9,1,139,71
397,15,3,3,6,7,-67,34,2,5,72,105
397,16,4,2,8,5,44,23,6,8,116,128
397,17,6,2,11,2,-35,20,1,8,81,148
397,18,3,3,9,4,36,31,7,9,117,179
397,19,3,3,8,5,-65,-68,2,1,52,111
397,20,3,5,5,8,32,53,4,4,84,164
397,21,3,3,8,5,35,32,9,6,119,196
397,22,4,2,6,7,-58,-75,1,1,61,121
397,23,2,5,3,10,21,55,2,6,82,176
397,24,3,4,4,9,31,-55,3,1,113,121
397,25,5,2,7,6,52,24,5,5,165,145
397,26,3,4,4,9,31,-55,6,0,196,90
397,27,4,3,8,5,-56,32,0,2,140,122
397,28,2,4,5,8,23,44,3,6,163,166
397,29,4,4,6,7,42,43,5,9,205,209
397,30,3,4,4,9,31,-55,6,4,236,154
397,31,2,4,7,6,-75,42,1,6,161,196
397,32,3,4,6,7,33,43,4,9,194,239
397,33,5,2,11,2,-44,20,0,9,150,259
397,34,2,5,4,9,22,-46,2,3,172,213
397,35,5,2,8,5,53,23,5,6,225,236
397,36,5,2,7,6,52,-76,7,0,277,160
397,37,4,4,8,5,-56,41,1,1,221,201
397,38,4,2,8,5,44,23,5,4,265,224
397,39,3,4,5,8,32,44,7,8,297,268
397,40,3,4,7,6,-66,-58,1,0,231,210
397,41,3,4,6,7,33,43,4,3,264,253
397,42,2,5,3,10,21,55,5,8,285,308
397,43,2,4,4,9,22,-55,7,3,307,253
397,44,3,3,7,6,-66,33,1,6,241,286
397,45,3,4,4,9,31,-55,2,1,272,231
397,46,3,3,6,7,33,34,5,5,305,265
397,47,3,3,7,6,34,33,9,8,339,298
397,48,3,3,8,5,-65,-68,4,0,274,230
397,49,2,4,6,7,24,43,8,3,298,273
397,50,3,3,5,8,-68,35,0,8,230,308
397,51,3,4,5,8,32,-56,2,2,262,252
397,52,2,5,4,9,22,54,4,6,284,306
397,53,5,2,9,4,54,22,8,8,338,328
397,54,4,2,9,4,-55,-78,3,0,283,250
397,55,5,2,8,5,53,23,6,3,336,273
397,56,5,3,8,5,53,32,9,5,389,305
397,57,4,3,7,6,-57,33,2,8,332,338
397,58,6,2,10,3,64,21,6,9,396,359
397,59,4,2,9,4,-55,-78,1,1,341,281
397,60,2,4,4,9,22,45,3,6,363,326
397,61,4,2,8,5,44,23,7,9,407,349
397,62,2,4,6,7,-76,-57,1,2,331,292
397,63,3,3,8,5,35,32,6,4,366,324
397,64,5,2,10,3,-45,21,1,5,321,345
397,65,4,3,8,5,44,32,5,7,365,377
397,66,2,5,5,8,23,-47,8,0,388,330
397,67,2,5,3,10,21,55,9,5,409,385
397,68,4,2,11,2,-53,20,6,5,356,405
397,69,5,2,11,2,-44,20,2,5,312,425
397,70,3,3,7,6,34,33,6,8,346,458
397,71,4,2,6,7,42,-75,8,3,388,383
397,72,4,4,6,7,-58,43,0,6,330,426
397,73,3,4,6,7,33,43,3,9,363,469
397,74,3,3,7,6,34,-67,7,2,397,402
397,75,5,2,9,4,-46,22,1,4,351,424
397,76,3,3,7,6,34,33,5,7,385,457
397,77,3,3,6,7,33,-66,8,1,418,391
397,78,3,3,6,7,-67,34,1,5,351,425
397,79,3,4,7,6,34,42,5,7,385,467
397,80,2,4,4,9,22,-55,7,2,407,412
397,81,3,3,4,9,31,36,8,8,438,448
397,82,4,3,7,6,-57,-67,1,1,381,381
397,83,3,4,4,9,31,45,2,6,412,426
397,84,3,3,4,9,31,-64,3,2,443,362
397,85,4,3,5,8,41,35,4,7,484,397
397,86,5,2,8,5,53,-77,7,0,537,320
398,1,4,3,5,8,41,35,1,5,41,35
398,2,3,3,9,4,36,31,7,6,77,66
398,3,5,2,9,4,-46,22,1,8,31,88
398,4,2,5,4,9,22,-46,3,2,53,42
398,5,4,4,7,6,43,42,6,4,96,84
398,6,3,4,4,9,31,45,7,9,127,129
398,7,3,4,7,6,-66,-58,1,1,61,71
398,8,3,4,6,7,33,43,4,4,94,114
398,9,4,3,6,7,42,34,6,8,136,148
398,10,3,4,8,5,-65,41,1,9,71,189
398,11,3,4,6,7,33,-57,4,2,104,132
398,12,3,4,5,8,32,44,6,6,136,176
398,13,5,2,6,7,51,-75,7,1,187,101
398,14,4,3,8,5,-56,32,1,3,131,133
398,15,2,4,5,8,23,44,4,7,154,177
398,16,3,3,7,6,34,-67,8,0,188,110
398,17,5,3,7,6,-48,33,0,3,140,143
398,18,3,3,5,8,32,35,2,8,172,178
398,19,3,3,6,7,33,-66,5,2,205,112
398,20,4,3,7,6,43,33,8,5,248,145
398,21,2,6,1,12,-20,-34,8,1,228,111
398,22,3,4,6,7,-67,43,1,4,161,154
398,23,4,3,8,5,44,32,5,6,205,186
398,24,4,3,8,5,44,32,9,8,249,218
398,25,2,4,8,5,-74,41,5,9,175,259
398,26,3,3,7,6,34,-67,9,2,209,192
398,27,4,3,7,6,-57,33,2,5,152,225
398,28,3,4,6,7,33,43,5,8,185,268
398,29,4,3,5,8,41,-65,6,3,226,203
398,30,4,4,7,6,43,42,9,5,269,245
398,31,3,4,4,9,-69,-55,0,0,200,190
398,32,2,4,9,4,27,40,7,0,227,230
398,33,2,5,6,7,-76,52,1,2,151,282
398,34,4,3,8,5,44,32,5,4,195,314
398,35,3,3,6,7,33,34,8,8,228,348
398,36,4,3,6,7,-58,-66,0,2,170,282
398,37,3,4,4,9,31,45,1,7,201,327
398,38,5,2,7,6,52,-76,3,1,253,251
398,39,3,4,4,9,31,45,4,6,284,296
398,40,3,4,4,9,31,-55,5,1,315,241
398,41,2,5,4,9,22,54,7,5,337,295
398,42,3,3,7,6,-66,33,1,8,271,328
398,43,4,3,8,5,44,-68,5,0,315,260
398,44,2,5,4,9,22,54,7,4,337,314
398,45,2,4,6,7,-76,43,1,7,261,357
398,46,4,2,8,5,44,-77,5,0,305,280
398,47,3,4,7,6,34,42,9,2,339,322
398,48,3,5,3,10,30,55,9,7,369,377
398,49,3,4,5,8,-68,-56,1,1,301,321
398,50,4,2,7,6,43,24,4,5,344,345
398,51,3,4,7,6,34,42,8,7,378,387
398,52,2,5,7,6,-75,51,3,8,303,438
398,53,4,2,8,5,44,-77,7,1,347,361
398,54,5,2,9,4,-46,22,1,3,301,383
398,55,2,5,4,9,22,54,3,7,323,437
398,56,2,4,5,8,23,-56,6,1,346,381
398,57,4,3,8,5,-56,32,0,3,290,413
398,58,2,5,3,10,21,55,1,8,311,468
398,59,3,4,7,6,34,-58,5,0,345,410
398,60,4,4,7,6,43,42,8,2,388,452
398,61,4,3,10,3,-54,30,4,2,334,482
398,62,3,4,8,5,35,41,9,3,369,523
399,1,2,4,4,9,22,45,2,5,22,45
399,2,4,3,6,7,42,34,4,9,64,79
399,3,3,3,6,7,33,-66,7,3,97,13
399,4,3,4,5,8,32,44,9,7,129,57
399,5,2,5,3,10,-79,-45,0,2,50,12
399,6,3,4,4,9,31,45,1,7,81,57
399,7,3,4,7,6,34,42,5,9,115,99
399,8,3,4,6,7,33,-57,8,2,148,42
399,9,3,3,7,6,-66,33,2,5,82,75
399,10,3,3,6,7,33,34,5,9,115,109
399,11,3,4,7,6,34,-58,9,1,149,51
399,12,3,3,6,7,-67,34,2,5,82,85
399,13,3,4,5,8,32,44,4,9,114,129
399,14,3,3,7,6,34,-67,8,2,148,62
399,15,4,2,6,7,-58,25,0,7,90,87
399,16,4,3,4,9,40,-64,0,3,130,23
399,17,2,4,5,8,23,44,3,7,153,67
399,18,3,3,4,9,31,-64,4,3,184,3
399,19,3,4,3,10,30,46,4,9,214,49
399,20,3,4,3,10,30,-54,4,5,244,-5
399,21,4,3,5,8,41,-65,5,0,285,-70
399,22,4,3,6,7,42,34,7,4,327,-36
399,23,2,5,4,9,22,54,9,8,349,18
399,24,4,3,7,6,-57,-67,2,1,292,-49
399,25,3,4,5,8,32,44,4,5,324,-5
399,26,2,6,6,7,24,61,8,6,348,56
399,27,2,4,6,7,-76,43,2,9,272,99
399,28,2,4,7,6,25,-58,7,1,297,41
399,29,4,2,8,5,-56,23,1,4,241,64
399,30,2,4,7,6,25,42,6,6,266,106
399,31,2,5,5,8,23,53,9,9,289,159
399,32,3,4,5,8,-68,-56,1,3,221,103
399,33,2,4,5,8,23,44,4,7,244,147
399,34,5,2,8,5,53,-77,7,0,297,70
399,35,3,3,7,6,-66,33,1,3,231,103
399,36,4,2,10,3,46,21,7,4,277,124
399,37,4,3,5,8,41,35,8,9,318,159
399,38,2,5,4,9,-78,-46,0,3,240,113
399,39,2,4,6,7,24,43,4,6,264,156
399,40,5,2,9,4,54,22,8,8,318,178
399,41,3,3,8,5,-65,-68,3,0,253,110
399,42,4,2,9,4,45,22,8,2,298,132
399,43,4,3,6,7,-58,34,0,6,240,166
399,44,3,4,4,9,31,-55,1,1,271,111
399,45,3,4,4,9,31,45,2,6,302,156
399,46,4,2,10,3,46,21,8,7,348,177
399,47,2,4,4,9,-78,-55,0,2,270,122
399,48,2,5,4,9,22,54,2,6,292,176
399,49,3,4,7,6,34,42,6,8,326,218
399,50,4,2,6,7,42,-75,8,3,368,143
399,51,3,4,5,8,-68,44,0,7,300,187
399,52,3,5,5,8,32,-47,2,0,332,140
399,53,2,5,4,9,22,54,4,4,354,194
399,54,2,4,4,9,22,45,6,9,376,239
399,55,4,3,7,6,43,-67,9,2,419,172
399,56,3,4,7,6,-66,42,3,4,353,214
399,57,2,5,6,7,24,52,7,6,377,266
399,58,3,3,4,9,31,-64,8,2,408,202
399,59,5,2,9,4,-46,22,2,4,362,224
399,60,3,3,6,7,33,34,5,8,395,258
399,61,2,4,3,10,21,-54,6,4,416,204
399,62,4,3,8,5,-56,32,0,6,360,236
399,63,4,3,6,7,42,-66,2,0,402,170
399,64,4,3,10,3,46,30,8,0,448,200
399,65,5,2,10,3,-45,21,3,1,403,221
399,66,2,5,4,9,22,54,5,5,425,275
399,67,5,2,8,5,53,23,8,8,478,298
399,68,4,2,9,4,-55,-78,3,0,423,220
399,69,4,2,9,4,45,22,8,2,468,242
399,70,4,3,8,5,-56,32,2,4,412,274
399,71,2,4,5,8,23,44,5,8,435,318
399,72,3,3,5,8,32,-65,7,3,467,253
399,73,3,3,9,4,-64,31,3,4,403,284
399,74,3,4,5,8,32,44,5,8,435,328
399,75,5,2,11,2,-44,20,1,8,391,348
399,76,3,4,6,7,33,-57,4,1,424,291
399,77,4,2,9,4,45,22,9,3,469,313
399,78,5,2,9,4,-46,22,3,5,423,335
399,79,2,5,5,8,23,53,6,8,446,388
399,80,5,2,9,4,-46,-78,0,0,400,310
399,81,3,3,7,6,34,33,4,3,434,343
399,82,3,3,6,7,33,34,7,7,467,377
399,83,4,3,6,7,42,-66,9,1,509,311
400,1,3,4,5,8,32,44,2,4,32,44
400,2,4,3,8,5,44,32,6,6,76,76
400,3,4,3,7,6,43,33,9,9,119,109
400,4,3,3,6,7,-67,-66,2,3,52,43
400,5,3,3,6,7,33,34,5,7,85,77
400,6,6,2,10,3,64,21,9,8,149,98
400,7,4,3,5,8,-59,-65,0,3,90,33
400,8,4,2,7,6,43,24,3,7,133,57
400,9,2,5,5,8,23,-47,6,0,156,10
400,10,3,3,9,4,-64,31,2,1,92,41
400,11,3,3,9,4,36,31,8,2,128,72
400,12,4,3,6,7,-58,34,0,6,70,106
400,13,3,3,3,10,30,-63,0,3,100,43
400,14,2,6,3,10,21,64,1,7,121,107
400,15,4,2,10,3,46,21,7,8,167,128
400,16,4,3,6,7,42,-66,9,2,209,62
400,17,2,5,4,9,-78,54,1,6,131,116
400,18,4,2,8,5,44,23,5,9,175,139
400,19,2,4,4,9,22,-55,7,4,197,84
400,20,3,3,7,6,-66,33,1,7,131,117
400,21,4,2,10,3,46,21,7,8,177,138
400,22,4,3,8,5,-56,-68,1,0,121,70
400,23,3,4,5,8,32,44,3,4,153,114
400,24,3,3,7,6,34,33,7,7,187,147
400,25,4,3,5,8,41,-65,8,2,228,82
400,26,3,3,6,7,-67,34,1,6,161,116
400,27,3,3,7,6,34,33,5,9,195,149
400,28,5,2,10,3,-45,-79,0,0,150,70
400,29,3,3,7,6,34,33,4,3,184,103
400,30,4,3,7,6,43,33,7,6,227,136
400,31,2,4,3,10,21,-54,8,2,248,82
400,32,3,3,5,8,-68,35,0,7,180,117
400,33,3,4,3,10,30,-54,0,3,210,63
400,34,3,4,8,5,35,41,5,4,245,104
400,35,3,4,6,7,33,43,8,7,278,147
400,36,2,5,4,9,-78,-46,0,1,200,101
400,37,3,3,5,8,32,35,2,6,232,136
400,38,3,3,4,9,31,-64,3,2,263,72
400,39,3,4,4,9,31,45,4,7,294,117
400,40,3,3,7,6,34,-67,8,0,328,50
400,41,3,3,4,9,31,36,9,6,359,86
400,42,3,4,6,7,-67,43,2,9,292,129
400,43,2,5,3,10,21,-45,3,4,313,84
400,44,4,3,6,7,42,34,5,8,355,118
400,45,2,4,6,7,24,-57,9,1,379,61
400,46,2,5,4,9,-78,54,1,5,301,115
400,47,3,3,7,6,34,33,5,8,335,148
400,48,4,4,5,8,41,-56,6,2,376,92
400,49,4,4,5,8,41,44,7,6,417,136
400,50,3,3,5,8,32,-65,9,1,449,71
400,51,3,4,4,9,-69,45,0,6,380,116
400,52,3,3,5,8,32,-65,2,1,412,51
400,53,4,3,8,5,44,32,6,3,456,83
400,54,2,4,4,9,22,45,8,8,478,128
400,55,3,4,6,7,-67,-57,1,1,411,71
400,56,3,3,4,9,31,36,2,7,442,107
400,57,3,3,8,5,35,32,7,9,477,139
400,58,4,3,6,7,42,-66,9,3,519,73
401,1,5,2,10,3,55,21,5,1,55,21
401,2,4,2,9,4,-55,22,0,3,0,43
401,3,2,4,6,7,24,43,4,6,24,86
401,4,4,3,6,7,42,-66,6,0,66,20
401,5,3,4,5,8,32,44,8,4,98,64
401,6,2,4,5,8,-77,44,1,8,21,108
401,7,3,3,5,8,32,-65,3,3,53,43
401,8,5,2,8,5,53,23,6,6,106,66
401,9,2,4,4,9,22,-55,8,1,128,11
401,10,4,2,9,4,-55,22,3,3,73,33
401,11,3,4,7,6,34,42,7,5,107,75
401,12,5,2,9,4,-46,22,1,7,61,97
401,13,4,3,7,6,43,-67,4,0,104,30
401,14,4,3,7,6,43,33,7,3,147,63
401,15,4,3,8,5,-56,32,1,5,91,95
401,16,3,3,6,7,33,34,4,9,124,129
401,17,4,2,7,6,43,-76,7,3,167,53
401,18,6,2,10,3,-36,21,1,4,131,74
401,19,4,3,8,5,44,32,5,6,175,106
401,20,4,2,8,5,44,23,9,9,219,129
401,21,2,4,6,7,-76,-57,3,2,143,72
401,22,5,2,6,7,51,25,4,7,194,97
401,23,2,4,6,7,24,-57,8,0,218,40
401,24,6,2,9,4,-37,22,1,2,181,62
401,25,5,2,7,6,52,24,3,6,233,86
401,26,3,4,4,9,31,-55,4,1,264,31
401,27,4,2,6,7,42,25,6,6,306,56
401,28,3,3,5,8,32,-65,8,1,338,-9
401,29,4,3,6,7,-58,34,0,5,280,25
401,30,3,4,8,5,35,41,5,6,315,66
401,31,5,2,8,5,53,23,8,9,368,89
401,32,3,4,6,7,-67,-57,1,2,301,32
401,33,3,3,9,4,36,31,7,3,337,63
401,34,4,2,9,4,-55,22,2,5,282,85
401,35,4,3,8,5,44,32,6,7,326,117
401,36,4,3,10,3,-54,30,2,7,272,147
401,37,2,5,5,8,23,-47,5,0,295,100
401,38,2,4,5,8,23,44,8,4,318,144
401,39,3,3,6,7,-67,34,1,8,251,178
401,40,5,3,7,6,52,-67,3,1,303,111
401,41,5,3,10,3,55,30,8,1,358,141
401,42,2,4,7,6,-75,42,3,3,283,183
401,43,3,3,5,8,32,35,5,8,315,218
401,44,2,4,2,11,20,-53,5,5,335,165
401,45,3,3,8,5,-65,32,0,7,270,197
401,46,2,5,4,9,22,-46,2,1,292,151
401,47,5,2,11,2,56,20,8,1,348,171
401,48,5,2,10,3,-45,21,3,2,303,192
401,49,2,5,4,9,22,54,5,6,325,246
401,50,4,3,6,7,42,-66,7,0,367,180
401,51,2,4,5,8,-77,44,0,4,290,224
401,52,2,5,4,9,22,54,2,8,312,278
401,53,4,2,7,6,43,-76,5,2,355,202
401,54,3,4,5,8,32,44,7,6,387,246
401,55,2,4,6,7,-76,43,1,9,311,289
401,56,3,3,8,5,35,-68,6,1,346,221
401,57,3,3,9,4,-64,31,2,2,282,252
401,58,3,4,8,5,35,41,7,3,317,293
401,59,2,5,3,10,21,55,8,8,338,348
401,60,3,5,5,8,-68,-47,0,1,270,301
401,61,2,4,5,8,23,44,3,5,293,345
401,62,3,4,7,6,34,42,7,7,327,387
401,63,5,2,7,6,52,-76,9,1,379,311
401,64,5,2,10,3,-45,21,4,2,334,332
401,65,3,4,8,5,35,41,9,3,369,373
401,66,3,3,8,5,-65,32,4,5,304,405
401,67,3,3,8,5,35,32,9,7,339,437
401,68,2,4,7,6,-75,42,4,9,264,479
401,69,4,2,7,6,43,-76,7,3,307,403
401,70,3,4,7,6,-66,42,1,5,241,445
401,71,3,5,7,6,34,51,5,6,275,496
401,72,5,2,11,2,-44,20,1,6,231,516
402,1,2,5,4,9,22,54,2,4,22,54
402,2,3,4,5,8,32,44,4,8,54,98
402,3,3,5,4,9,31,-46,5,2,85,52
402,4,3,3,8,5,-65,32,0,4,20,84
402,5,2,5,3,10,21,55,1,9,41,139
402,6,2,4,6,7,24,-57,5,2,65,82
402,7,3,4,5,8,32,44,7,6,97,126
402,8,5,3,8,5,-47,32,0,8,50,158
402,9,4,2,6,7,42,-75,2,3,92,83
402,10,3,3,10,3,37,30,9,3,129,113
402,11,2,4,6,7,-76,43,3,6,53,156
402,12,5,3,9,4,54,31,7,7,107,187
402,13,2,4,4,9,22,-55,9,2,129,132
402,14,5,3,10,3,-45,30,4,2,84,162
402,15,3,3,4,9,31,36,5,8,115,198
402,16,2,4,3,10,21,-54,6,4,136,144
402,17,4,2,9,4,-55,22,1,6,81,166
402,18,3,5,6,7,33,52,4,8,114,218
402,19,3,4,4,9,31,-55,5,3,145,163
402,20,2,5,4,9,22,54,7,7,167,217
402,21,3,3,8,5,-65,32,2,9,102,249
402,22,5,2,9,4,54,-78,6,1,156,171
402,23,2,5,7,6,-75,51,1,2,81,222
402,24,2,4,6,7,24,43,5,5,105,265
402,25,2,5,2,11,20,-44,5,1,125,221
402,26,3,3,4,9,31,36,6,7,156,257
402,27,3,4,5,8,32,-56,8,1,188,201
402,28,3,3,5,8,-68,35,0,6,120,236
402,29,3,4,6,7,33,43,3,9,153,279
402,30,4,2,8,5,44,-77,7,2,197,202
402,31,4,2,6,7,42,25,9,7,239,227
402,32,4,3,10,3,-54,30,5,7,185,257
402,33,3,3,5,8,32,-65,7,2,217,192
402,34,4,3,5,8,41,35,8,7,258,227
402,35,3,3,9,4,-64,31,4,8,194,258
402,36,4,3,7,6,43,-67,7,1,237,191
402,37,5,2,10,3,-45,21,2,2,192,212
402,38,2,5,4,9,22,54,4,6,214,266
402,39,6,2,10,3,64,21,8,7,278,287
402,40,2,4,7,6,-75,42,3,9,203,329
402,41,4,3,9,4,45,-69,8,0,248,260
402,42,5,2,8,5,-47,23,1,3,201,283
402,43,2,4,3,10,21,46,2,9,222,329
402,44,4,2,7,6,43,-76,5,3,265,253
402,45,3,3,5,8,32,35,7,8,297,288
402,46,3,4,8,5,-65,41,2,9,232,329
402,47,2,4,4,9,22,-55,4,4,254,274
402,48,4,2,5,8,41,-74,5,0,295,200
402,49,2,6,3,10,21,64,6,4,316,264
402,50,3,4,5,8,32,44,8,8,348,308
402,51,3,3,5,8,-68,-65,0,3,280,243
402,52,3,3,9,4,36,31,6,4,316,274
402,53,3,4,4,9,31,45,7,9,347,319
402,54,4,4,6,7,42,-57,9,2,389,262
402,55,3,4,7,6,-66,42,3,4,323,304
402,56,2,5,4,9,22,54,5,8,345,358
402,57,2,5,6,7,24,-48,9,0,369,310
402,58,4,2,8,5,-56,23,3,3,313,333
402,59,3,3,8,5,35,32,8,5,348,365
402,60,5,2,8,5,-47,23,1,8,301,388
402,61,3,4,8,5,35,41,6,9,336,429
402,62,2,5,4,9,22,-46,8,3,358,383
402,63,2,5,4,9,-78,54,0,7,280,437
402,64,4,3,8,5,44,32,4,9,324,469
402,65,3,3,5,8,32,-65,6,4,356,404
402,66,4,2,9,4,-55,22,1,6,301,426
402,67,4,2,5,8,41,-74,2,2,342,352
402,68,5,2,9,4,54,22,6,4,396,374
402,69,2,5,4,9,22,54,8,8,418,428
402,70,3,3,7,6,-66,-67,2,1,352,361
402,71,4,2,6,7,42,25,4,6,394,386
402,72,3,3,5,8,32,-65,6,1,426,321
402,73,3,3,9,4,-64,31,2,2,362,352
402,74,2,5,5,8,23,53,5,5,385,405
402,75,3,4,3,10,30,-54,5,1,415,351
402,76,4,3,8,5,44,32,9,3,459,383
402,77,3,5,5,8,-68,53,1,6,391,436
402,78,5,2,8,5,53,23,4,9,444,459
402,79,3,4,6,7,33,-57,7,2,477,402
402,80,3,3,6,7,-67,34,0,6,410,436
402,81,4,3,8,5,44,32,4,8,454,468
402,82,4,3,8,5,44,-68,8,0,498,400
402,83,3,3,8,5,-65,32,3,2,433,432
402,84,4,3,7,6,43,33,6,5,476,465
402,85,4,2,8,5,-56,23,0,8,420,488
402,86,3,3,8,5,35,-68,5,0,455,420
402,87,3,3,8,5,-65,32,0,2,390,452
402,88,3,3,7,6,34,33,4,5,424,485
402,89,3,4,6,7,33,43,7,8,457,528
403,1,3,3,7,6,34,33,4,3,34,33
403,2,3,4,6,7,33,43,7,6,67,76
403,3,5,2,11,2,-44,20,3,6,23,96
403,4,2,5,7,6,25,51,8,7,48,147
403,5,2,4,5,8,-77,-56,1,1,-29,91
403,6,2,4,4,9,22,45,3,6,-7,136
403,7,3,4,6,7,33,43,6,9,26,179
403,8,3,4,4,9,31,-55,7,4,57,124
403,9,3,3,5,8,32,35,9,9,89,159
403,10,3,4,7,6,-66,-58,3,1,23,101
403,11,4,3,6,7,42,34,5,5,65,135
403,12,4,3,9,4,-55,31,0,6,10,166
403,13,2,5,4,9,22,-46,2,0,32,120
403,14,3,4,7,6,34,42,6,2,66,162
403,15,4,2,8,5,-56,23,0,5,10,185
403,16,3,3,5,8,32,-65,2,0,42,120
403,17,3,3,7,6,34,33,6,3,76,153
403,18,3,3,4,9,31,36,7,9,107,189
403,19,3,3,3,10,30,-63,7,6,137,126
403,20,3,3,6,7,-67,-66,0,0,70,60
403,21,4,2,8,5,44,23,4,3,114,83
403,22,3,3,9,4,-64,31,0,4,50,114
403,23,5,3,8,5,53,32,3,6,103,146
403,24,3,3,8,5,35,32,8,8,138,178
403,25,4,2,8,5,-56,-77,2,1,82,101
403,26,3,3,5,8,32,35,4,6,114,136
403,27,2,6,3,10,21,-36,5,0,135,100
403,28,4,3,7,6,43,33,8,3,178,133
403,29,4,3,7,6,-57,33,1,6,121,166
403,30,5,2,11,2,56,20,7,6,177,186
403,31,2,5,3,10,21,-45,8,1,198,141
403,32,5,2,8,5,-47,23,1,4,151,164
403,33,3,4,5,8,32,44,3,8,183,208
403,34,3,5,4,9,31,-46,4,2,214,162
403,35,3,3,7,6,34,33,8,5,248,195
403,36,3,3,4,9,31,-64,9,1,279,131
403,37,4,4,7,6,-57,42,2,3,222,173
403,38,3,4,5,8,32,44,4,7,254,217
403,39,2,5,6,7,24,52,8,9,278,269
403,40,3,4,7,6,-66,-58,2,1,212,211
403,41,4,2,7,6,43,24,5,5,255,235
403,42,2,4,5,8,23,44,8,9,278,279
403,43,3,3,5,8,-68,-65,0,4,210,214
403,44,3,4,6,7,33,43,3,7,243,257
403,45,3,4,5,8,32,-56,5,1,275,201
403,46,2,5,6,7,24,52,9,3,299,253
403,47,4,3,7,6,-57,33,2,6,242,286
403,48,3,4,4,9,31,-55,3,1,273,231
403,49,4,3,5,8,41,35,4,6,314,266
403,50,5,2,9,4,54,22,8,8,368,288
403,51,3,4,7,6,-66,-58,2,0,302,230
403,52,2,4,4,9,22,45,4,5,324,275
403,53,5,2,9,4,54,22,8,7,378,297
403,54,4,3,9,4,-55,31,3,8,323,328
403,55,4,3,7,6,43,-67,6,1,366,261
403,56,2,4,8,5,-74,41,2,2,292,302
403,57,4,3,8,5,44,32,6,4,336,334
403,58,3,4,6,7,33,43,9,7,369,377
403,59,3,4,4,9,-69,-55,0,2,300,322
403,60,4,3,8,5,44,32,4,4,344,354
403,61,4,2,8,5,44,23,8,7,388,377
403,62,4,2,9,4,-55,22,3,9,333,399
403,63,2,4,6,7,24,-57,7,2,357,342
403,64,3,3,7,6,-66,33,1,5,291,375
403,65,4,3,9,4,45,31,6,6,336,406
403,66,2,6,3,10,21,-36,7,0,357,370
403,67,4,3,7,6,-57,33,0,3,300,403
403,68,3,3,8,5,35,32,5,5,335,435
403,69,4,3,8,5,44,32,9,7,379,467
403,70,2,4,5,8,-77,-56,2,1,302,411
403,71,4,2,7,6,43,24,5,5,345,435
403,72,3,4,6,7,33,43,8,8,378,478
403,73,5,3,10,3,-45,30,3,8,333,508
404,1,3,4,6,7,33,43,3,3,33,43
404,2,5,2,10,3,55,21,8,4,88,64
404,3,4,4,5,8,41,44,9,8,129,108
404,4,5,3,8,5,-47,-68,2,0,82,40
404,5,3,3,6,7,33,34,5,4,115,74
404,6,3,4,5,8,32,44,7,8,147,118
404,7,2,6,2,11,20,-35,7,3,167,83
404,8,2,5,7,6,-75,51,2,4,92,134
404,9,2,5,3,10,21,55,3,9,113,189
404,10,4,3,6,7,42,-66,5,3,155,123
404,11,3,4,6,7,33,43,8,6,188,166
404,12,5,2,9,4,-46,22,2,8,142,188
404,13,3,4,9,4,36,40,8,8,178,228
404,14,4,3,8,5,-56,-68,2,0,122,160
404,15,4,2,6,7,42,25,4,5,164,185
404,16,2,6,6,7,24,61,8,6,188,246
404,17,5,3,7,6,-48,33,0,9,140,279
404,18,3,3,5,8,32,-65,2,4,172,214
404,19,3,3,8,5,35,32,7,6,207,246
404,20,4,3,8,5,-56,32,1,8,151,278
404,21,2,4,6,7,24,-57,5,1,175,221
404,22,4,2,9,4,-55,22,0,3,120,243
404,23,3,3,9,4,36,31,6,4,156,274
404,24,4,4,8,5,-56,41,0,5,100,315
404,25,2,6,4,9,22,63,2,8,122,378
404,26,4,2,8,5,44,-77,6,1,166,301
404,27,3,3,5,8,32,35,8,6,198,336
404,28,3,4,7,6,-66,42,2,8,132,378
404,29,4,3,9,4,45,31,7,9,177,409
404,30,2,5,3,10,21,-45,8,4,198,364
404,31,3,3,8,5,-65,32,3,6,133,396
404,32,3,4,5,8,32,-56,5,0,165,340
404,33,3,3,4,9,31,36,6,6,196,376
404,34,2,4,4,9,22,-55,8,1,218,321
404,35,3,3,4,9,31,36,9,7,249,357
404,36,4,2,7,6,-57,-76,2,1,192,281
404,37,2,6,3,10,21,64,3,5,213,345
404,38,4,3,7,6,43,33,6,8,256,378
404,39,2,6,3,10,21,-36,7,2,277,342
404,40,4,3,8,5,-56,32,1,4,221,374
404,41,4,2,8,5,44,23,5,7,265,397
404,42,2,4,5,8,23,-56,8,1,288,341
404,43,2,4,6,7,-76,43,2,4,212,384
404,44,4,3,9,4,45,31,7,5,257,415
404,45,4,2,8,5,-56,23,1,8,201,438
404,46,3,3,5,8,32,-65,3,3,233,373
404,47,4,2,6,7,42,25,5,8,275,398
404,48,3,3,8,5,-65,-68,0,0,210,330
404,49,3,3,7,6,34,33,4,3,244,363
404,50,5,2,10,3,55,21,9,4,299,384
404,51,3,3,6,7,-67,34,2,8,232,418
404,52,2,4,6,7,24,-57,6,1,256,361
404,53,3,3,8,5,-65,32,1,3,191,393
404,54,3,3,4,9,31,36,2,9,222,429
404,55,4,2,9,4,45,-78,7,1,267,351
404,56,4,3,9,4,-55,31,2,2,212,382
404,57,3,3,8,5,35,32,7,4,247,414
404,58,3,4,7,6,-66,42,1,6,181,456
404,59,3,4,7,6,34,42,5,8,215,498
404,60,3,3,6,7,33,-66,8,2,248,432
404,61,4,2,6,7,-58,25,0,7,190,457
404,62,3,3,8,5,35,32,5,9,225,489
404,63,2,5,5,8,23,-47,8,2,248,442
404,64,3,3,7,6,-66,33,2,5,182,475
404,65,4,2,9,4,45,22,7,7,227,497
404,66,3,3,6,7,-67,-66,0,1,160,431
404,67,3,4,7,6,34,42,4,3,194,473
404,68,3,5,5,8,32,53,6,6,226,526
405,1,3,4,6,7,33,43,3,3,33,43
405,2,3,3,4,9,31,36,4,9,64,79
405,3,3,3,9,4,-64,-69,0,0,0,10
405,4,3,3,10,3,37,30,7,0,37,40
405,5,2,4,4,9,22,45,9,5,59,85
405,6,3,5,6,7,-67,52,2,7,-8,137
405,7,4,2,11,2,47,20,9,7,39,157
405,8,5,2,10,3,-45,21,4,8,-6,178
405,9,3,3,10,3,-63,30,1,8,-69,208
405,10,2,5,3,10,21,-45,2,3,-48,163
405,11,3,3,8,5,35,32,7,5,-13,195
405,12,5,2,10,3,-45,21,2,6,-58,216
405,13,3,3,6,7,33,-66,5,0,-25,150
405,14,4,3,10,3,-54,30,1,0,-79,180
405,15,3,3,7,6,34,33,5,3,-45,213
405,16,3,4,6,7,33,43,8,6,-12,256
405,17,2,4,5,8,-77,-56,1,0,-89,200
405,18,3,3,6,7,33,34,4,4,-56,234
405,19,4,3,8,5,44,32,8,6,-12,266
405,20,4,4,7,6,-57,42,1,8,-69,308
405,21,4,3,5,8,41,-65,2,3,-28,243
405,22,4,3,5,8,41,35,3,8,13,278
405,23,3,3,4,9,31,-64,4,4,44,214
405,24,4,3,8,5,44,32,8,6,88,246
405,25,2,4,8,5,-74,41,4,7,14,287
405,26,2,5,3,10,21,-45,5,2,35,242
405,27,5,2,10,3,-45,21,0,3,-10,263
405,28,4,3,9,4,45,31,5,4,35,294
405,29,4,4,4,9,40,45,5,9,75,339
405,30,3,3,7,6,34,-67,9,2,109,272
405,31,5,2,10,3,-45,21,4,3,64,293
405,32,3,3,7,6,34,33,8,6,98,326
405,33,4,2,7,6,-57,-76,1,0,41,250
405,34,3,3,7,6,34,33,5,3,75,283
405,35,2,4,6,7,24,43,9,6,99,326
405,36,3,4,4,9,-69,-55,0,1,30,271
405,37,7,2,10,3,73,21,3,2,103,292
405,38,2,4,5,8,23,44,6,6,126,336
405,39,3,3,7,6,-66,33,0,9,60,369
405,40,2,4,4,9,22,-55,2,4,82,314
405,41,5,2,10,3,55,21,7,5,137,335
405,42,2,4,7,6,-75,42,2,7,62,377
405,43,4,2,8,5,44,-77,6,0,106,300
405,44,4,3,8,5,-56,32,0,2,50,332
405,45,2,5,6,7,24,52,4,4,74,384
405,46,4,3,6,7,42,34,6,8,116,418
405,47,2,5,5,8,23,-47,9,1,139,371
405,48,3,3,7,6,-66,33,3,4,73,404
405,49,4,3,7,6,43,33,6,7,116,437
405,50,6,2,11,2,-35,20,1,7,81,457
405,51,4,4,5,8,41,-56,2,1,122,401
405,52,2,4,7,6,25,42,7,3,147,443
405,53,4,2,7,6,-57,24,0,7,90,467
405,54,2,4,6,7,24,-57,4,0,114,410
405,55,4,4,7,6,43,42,7,2,157,452
405,56,3,3,9,4,-64,31,3,3,93,483
405,57,3,3,8,5,35,32,8,5,128,515
406,1,3,4,3,10,30,46,0,6,30,46
406,2,4,3,7,6,43,33,3,9,73,79
406,3,4,2,7,6,43,-76,6,3,116,3
406,4,4,3,9,4,-55,31,1,4,61,34
406,5,5,3,6,7,51,34,2,8,112,68
406,6,3,4,8,5,35,41,7,9,147,109
406,7,4,3,9,4,-55,-69,2,0,92,40
406,8,4,3,9,4,45,31,7,1,137,71
406,9,5,2,8,5,-47,23,0,4,90,94
406,10,3,4,7,6,34,42,4,6,124,136
406,11,4,3,9,4,45,31,9,7,169,167
406,12,4,4,5,8,-59,-56,0,1,110,111
406,13,3,4,6,7,33,43,3,4,143,154
406,14,3,3,3,10,30,-63,3,1,173,91
406,15,3,4,7,6,34,42,7,3,207,133
406,16,2,5,6,7,-76,52,1,5,131,185
406,17,2,5,3,10,21,-45,2,0,152,140
406,18,4,3,7,6,43,33,5,3,195,173
406,19,4,3,8,5,44,32,9,5,239,205
406,20,5,2,11,2,-44,20,5,5,195,225
406,21,2,5,3,10,21,-45,6,0,216,180
406,22,3,4,7,6,-66,42,0,2,150,222
406,23,3,3,4,9,31,36,1,8,181,258
406,24,5,2,7,6,52,-76,3,2,233,182
406,25,4,2,7,6,43,24,6,6,276,206
406,26,2,4,5,8,23,-56,9,0,299,150
406,27,3,3,5,8,-68,35,1,5,231,185
406,28,4,4,8,5,44,41,5,6,275,226
406,29,5,2,10,3,-45,21,0,7,230,247
406,30,3,3,6,7,33,-66,3,1,263,181
406,31,3,4,4,9,31,45,4,6,294,226
406,32,3,3,6,7,33,-66,7,0,327,160
406,33,5,2,7,6,52,24,9,4,379,184
406,34,5,2,9,4,-46,22,3,6,333,206
406,35,5,2,6,7,51,-75,4,1,384,131
406,36,3,4,5,8,32,44,6,5,416,175
406,37,3,4,6,7,33,43,9,8,449,218
406,38,3,3,3,10,30,-63,9,5,479,155
406,39,2,4,7,6,-75,42,4,7,404,197
406,40,5,2,8,5,53,-77,7,0,457,120
406,41,2,4,4,9,22,45,9,5,479,165
406,42,5,2,10,3,-45,21,4,6,434,186
406,43,4,3,9,4,45,31,9,7,479,217
406,44,4,3,9,4,-55,31,4,8,424,248
406,45,4,2,7,6,43,-76,7,2,467,172
406,46,4,3,6,7,42,34,9,6,509,206
407,1,4,3,7,6,43,33,3,3,43,33
407,2,3,3,6,7,33,34,6,7,76,67
407,3,3,3,7,6,-66,-67,0,0,10,0
407,4,4,3,6,7,42,34,2,4,52,34
407,5,3,4,7,6,34,42,6,6,86,76
407,6,4,2,10,3,-54,21,2,7,32,97
407,7,4,2,6,7,42,-75,4,2,74,22
407,8,3,3,6,7,33,34,7,6,107,56
407,9,3,3,7,6,-66,33,1,9,41,89
407,10,4,3,4,9,40,-64,1,5,81,25
407,11,3,3,7,6,34,33,5,8,115,58
407,12,2,4,3,10,21,-54,6,4,136,4
407,13,2,4,7,6,-75,42,1,6,61,46
407,14,2,4,6,7,24,43,5,9,85,89
407,15,4,3,9,4,-55,-69,0,0,30,20
407,16,4,2,6,7,42,25,2,5,72,45
407,17,4,3,7,6,43,33,5,8,115,78
407,18,3,4,5,8,32,-56,7,2,147,22
407,19,3,3,6,7,-67,34,0,6,80,56
407,20,3,4,4,9,31,-55,1,1,111,1
407,21,4,3,8,5,44,32,5,3,155,33
407,22,2,4,5,8,23,44,8,7,178,77
407,23,4,3,8,5,-56,32,2,9,122,109
407,24,3,3,9,4,36,-69,8,0,158,40
407,25,5,2,8,5,-47,23,1,3,111,63
407,26,4,3,9,4,45,31,6,4,156,94
407,27,3,4,6,7,33,43,9,7,189,137
407,28,3,4,9,4,-64,40,5,7,125,177
407,29,3,4,6,7,33,-57,8,0,158,120
407,30,3,3,6,7,-67,34,1,4,91,154
407,31,3,4,7,6,34,42,5,6,125,196
407,32,3,4,4,9,31,-55,6,1,156,141
407,33,5,2,9,4,-46,22,0,3,110,163
407,34,4,2,8,5,44,23,4,6,154,186
407,35,3,3,7,6,34,33,8,9,188,219
407,36,2,5,5,8,-77,-47,1,2,111,172
407,37,3,3,6,7,33,34,4,6,144,206
407,38,4,3,10,3,-54,30,0,6,90,236
407,39,3,4,7,6,34,42,4,8,124,278
407,40,2,4,5,8,23,-56,7,2,147,222
407,41,4,3,7,6,-57,33,0,5,90,255
407,42,2,4,6,7,24,43,4,8,114,298
407,43,3,3,7,6,34,-67,8,1,148,231
407,44,3,4,6,7,-67,43,1,4,81,274
407,45,4,3,7,6,43,33,4,7,124,307
407,46,3,4,6,7,33,-57,7,0,157,250
407,47,2,5,6,7,-76,52,1,2,81,302
407,48,3,3,7,6,34,33,5,5,115,335
407,49,2,4,6,7,24,43,9,8,139,378
407,50,2,4,7,6,-75,-58,4,0,64,320
407,51,3,4,5,8,32,44,6,4,96,364
407,52,2,4,6,7,-76,43,0,7,20,407
407,53,3,3,5,8,32,-65,2,2,52,342
407,54,3,3,7,6,34,33,6,5,86,375
407,55,4,3,9,4,-55,31,1,6,31,406
407,56,4,3,10,3,46,30,7,6,77,436
407,57,4,3,6,7,42,-66,9,0,119,370
407,58,3,3,7,6,-66,33,3,3,53,403
407,59,3,5,5,8,32,53,5,6,85,456
407,60,2,4,4,9,22,-55,7,1,107,401
407,61,3,3,7,6,-66,33,1,4,41,434
407,62,2,6,2,11,20,65,1,9,61,499
407,63,3,3,5,8,32,-65,3,4,93,434
407,64,5,2,8,5,53,23,6,7,146,457
407,65,2,4,4,9,22,-55,8,2,168,402
407,66,4,2,7,6,-57,24,1,6,111,426
407,67,3,3,6,7,33,-66,4,0,144,360
407,68,4,3,7,6,43,33,7,3,187,393
407,69,3,4,7,6,-66,42,1,5,121,435
407,70,3,4,7,6,34,42,5,7,155,477
407,71,3,3,4,9,31,-64,6,3,186,413
407,72,2,4,5,8,23,44,9,7,209,457
407,73,3,3,7,6,-66,-67,3,0,143,390
407,74,3,4,7,6,34,42,7,2,177,432
407,75,3,3,8,5,-65,32,2,4,112,464
407,76,3,4,4,9,31,45,3,9,143,509
408,1,3,3,7,6,34,33,4,3,34,33
408,2,3,4,4,9,31,45,5,8,65,78
408,3,3,4,4,9,31,-55,6,3,96,23
408,4,4,3,7,6,43,33,9,6,139,56
408,5,3,3,9,4,-64,31,5,7,75,87
408,6,3,3,8,5,-65,32,0,9,10,119
408,7,2,4,7,6,25,-58,5,1,35,61
408,8,3,4,8,5,-65,41,0,2,-30,102
408,9,2,5,4,9,22,54,2,6,-8,156
408,10,4,3,5,8,41,-65,3,1,33,91
408,11,5,2,7,6,52,24,5,5,85,115
408,12,5,2,10,3,-45,21,0,6,40,136
408,13,4,2,11,2,47,20,7,6,87,156
408,14,3,4,7,6,-66,42,1,8,21,198
408,15,4,3,9,4,45,31,6,9,66,229
408,16,3,4,4,9,31,-55,7,4,97,174
408,17,3,4,6,7,-67,43,0,7,30,217
408,18,4,3,7,6,43,-67,3,0,73,150
408,19,3,3,7,6,34,33,7,3,107,183
408,20,3,4,6,7,-67,43,0,6,40,226
408,21,3,4,5,8,32,-56,2,0,72,170
408,22,4,3,7,6,43,33,5,3,115,203
408,23,3,3,4,9,31,36,6,9,146,239
408,24,3,4,5,8,32,-56,8,3,178,183
408,25,2,5,3,10,21,55,9,8,199,238
408,26,3,3,6,7,-67,-66,2,2,132,172
408,27,2,5,7,6,25,51,7,3,157,223
408,28,4,2,8,5,-56,23,1,6,101,246
408,29,3,3,6,7,33,-66,4,0,134,180
408,30,4,2,9,4,45,22,9,2,179,202
408,31,3,5,3,10,30,55,9,7,209,257
408,32,3,4,6,7,-67,-57,2,0,142,200
408,33,2,5,5,8,23,53,5,3,165,253
408,34,4,2,8,5,44,23,9,6,209,276
408,35,3,3,5,8,-68,-65,1,1,141,211
408,36,4,2,10,3,46,21,7,2,187,232
408,37,5,2,9,4,-46,22,1,4,141,254
408,38,5,2,7,6,52,24,3,8,193,278
408,39,5,2,10,3,55,21,8,9,248,299
408,40,3,4,8,5,-65,-59,3,0,183,240
408,41,2,5,3,10,21,55,4,5,204,295
408,42,3,3,5,8,32,-65,6,0,236,230
408,43,4,3,8,5,-56,32,0,2,180,262
408,44,3,3,6,7,33,34,3,6,213,296
408,45,2,4,6,7,24,43,7,9,237,339
408,46,3,4,4,9,31,-55,8,4,268,284
408,47,2,4,7,6,-75,42,3,6,193,326
408,48,4,3,6,7,42,-66,5,0,235,260
408,49,3,4,6,7,33,43,8,3,268,303
408,50,2,4,4,9,-78,45,0,8,190,348
408,51,3,3,6,7,33,-66,3,2,223,282
408,52,3,4,5,8,32,44,5,6,255,326
408,53,2,5,3,10,21,-45,6,1,276,281
408,54,3,4,7,6,-66,42,0,3,210,323
408,55,4,3,9,4,45,31,5,4,255,354
408,56,3,4,4,9,31,45,6,9,286,399
408,57,3,4,4,9,31,-55,7,4,317,344
408,58,4,3,8,5,-56,32,1,6,261,376
408,59,3,3,6,7,33,-66,4,0,294,310
408,60,3,4,6,7,33,43,7,3,327,353
408,61,2,4,5,8,-77,44,0,7,250,397
408,62,3,4,5,8,32,-56,2,1,282,341
408,63,4,3,5,8,41,35,3,6,323,376
408,64,3,3,5,8,32,-65,5,1,355,311
408,65,3,3,6,7,33,34,8,5,388,345
408,66,3,4,5,8,-68,44,0,9,320,389
408,67,3,3,9,4,36,-69,6,0,356,320
408,68,2,5,5,8,23,53,9,3,379,373
408,69,2,4,6,7,-76,43,3,6,303,416
408,70,3,4,6,7,33,43,6,9,336,459
408,71,4,3,6,7,42,-66,8,3,378,393
408,72,3,3,6,7,-67,34,1,7,311,427
408,73,4,3,10,3,46,30,7,7,357,457
408,74,5,2,11,2,-44,20,3,7,313,477
408,75,3,3,5,8,32,-65,5,2,345,412
408,76,3,4,4,9,31,45,6,7,376,457
408,77,3,4,3,10,30,-54,6,3,406,403
408,78,3,4,8,5,-65,41,1,4,341,444
408,79,3,4,7,6,34,42,5,6,375,486
408,80,3,3,7,6,34,33,9,9,409,519
409,1,5,3,9,4,54,31,4,1,54,31
409,2,3,3,5,8,32,35,6,6,86,66
409,3,2,5,5,8,23,53,9,9,109,119
409,4,4,2,10,3,-54,-79,5,0,55,40
409,5,2,4,2,11,20,47,5,7,75,87
409,6,2,4,5,8,23,-56,8,1,98,31
409,7,4,3,6,7,-58,34,0,5,40,65
409,8,3,3,5,8,32,-65,2,0,72,0
409,9,4,2,9,4,45,22,7,2,117,22
409,10,3,3,8,5,-65,32,2,4,52,54
409,11,3,3,7,6,34,33,6,7,86,87
409,12,5,2,9,4,-46,22,0,9,40,109
409,13,3,3,4,9,31,-64,1,5,71,45
409,14,4,2,7,6,43,24,4,9,114,69
409,15,5,2,9,4,54,-78,8,1,168,-9
409,16,2,4,4,9,-78,45,0,6,90,36
409,17,5,2,10,3,55,21,5,7,145,57
409,18,4,2,9,4,-55,22,0,9,90,79
409,19,4,3,7,6,43,-67,3,2,133,12
409,20,2,4,5,8,23,44,6,6,156,56
409,21,4,3,8,5,-56,32,0,8,100,88
409,22,4,2,8,5,44,-77,4,1,144,11
409,23,4,3,7,6,43,33,7,4,187,44
409,24,3,3,6,7,-67,34,0,8,120,78
409,25,4,4,5,8,41,-56,1,2,161,22
409,26,2,4,3,10,21,46,2,8,182,68
409,27,3,4,5,8,32,-56,4,2,214,12
409,28,2,5,3,10,21,55,5,7,235,67
409,29,4,2,6,7,42,-75,7,2,277,-8
409,30,4,3,6,7,42,34,9,6,319,26
409,31,4,3,10,3,-54,30,5,6,265,56
409,32,2,5,3,10,21,-45,6,1,286,11
409,33,3,3,7,6,-66,33,0,4,220,44
409,34,6,2,9,4,63,22,3,6,283,66
409,35,2,4,7,6,25,42,8,8,308,108
409,36,2,4,6,7,-76,-57,2,1,232,51
409,37,3,3,5,8,32,35,4,6,264,86
409,38,3,4,7,6,34,42,8,8,298,128
409,39,2,4,3,10,21,-54,9,4,319,74
409,40,2,4,3,10,-79,-54,0,0,240,20
409,41,4,4,7,6,43,42,3,2,283,62
409,42,3,4,4,9,31,45,4,7,314,107
409,43,3,3,6,7,33,-66,7,1,347,41
409,44,4,3,6,7,42,34,9,5,389,75
409,45,3,3,6,7,-67,34,2,9,322,109
409,46,4,2,8,5,44,-77,6,2,366,32
409,47,3,4,5,8,32,44,8,6,398,76
409,48,2,5,3,10,21,-45,9,1,419,31
409,49,5,2,10,3,-45,21,4,2,374,52
409,50,3,3,6,7,33,34,7,6,407,86
409,51,2,4,3,10,21,-54,8,2,428,32
409,52,3,3,6,7,-67,34,1,6,361,66
409,53,5,2,8,5,53,23,4,9,414,89
409,54,3,3,7,6,34,-67,8,2,448,22
409,55,3,5,4,9,31,54,9,6,479,76
409,56,4,2,5,8,-59,-74,0,2,420,2
409,57,4,2,8,5,44,23,4,5,464,25
409,58,4,2,10,3,-54,21,0,6,410,46
409,59,3,3,6,7,33,-66,3,0,443,-20
409,60,4,3,6,7,42,34,5,4,485,14
409,61,2,5,4,9,22,54,7,8,507,68
410,1,5,2,9,4,54,22,4,2,54,22
410,2,4,4,8,5,44,41,8,3,98,63
410,3,3,4,6,7,-67,43,1,6,31,106
410,4,4,3,10,3,46,30,7,6,77,136
410,5,2,5,6,7,-76,52,1,8,1,188
410,6,3,3,6,7,33,-66,4,2,34,122
410,7,4,3,6,7,42,34,6,6,76,156
410,8,3,5,5,8,32,53,8,9,108,209
410,9,3,3,7,6,-66,-67,2,2,42,142
410,10,4,3,9,4,45,31,7,3,87,173
410,11,4,2,7,6,-57,24,0,7,30,197
410,12,5,2,11,2,56,20,6,7,86,217
410,13,4,3,4,9,40,-64,6,3,126,153
410,14,4,3,6,7,42,34,8,7,168,187
410,15,3,4,6,7,-67,-57,1,0,101,130
410,16,4,3,7,6,43,33,4,3,144,163
410,17,2,4,4,9,22,45,6,8,166,208
410,18,3,3,9,4,-64,31,2,9,102,239
410,19,2,5,3,10,21,-45,3,4,123,194
410,20,5,2,10,3,55,21,8,5,178,215
410,21,2,6,2,11,20,-35,8,0,198,180
410,22,3,4,3,10,30,46,8,6,228,226
410,23,3,3,5,8,-68,-65,0,1,160,161
410,24,2,5,7,6,25,51,5,2,185,212
410,25,5,2,8,5,53,23,8,5,238,235
410,26,4,2,9,4,-55,22,3,7,183,257
410,27,4,3,7,6,43,-67,6,0,226,190
410,28,3,5,4,9,31,54,7,4,257,244
410,29,2,4,4,9,22,45,9,9,279,289
410,30,2,4,6,7,-76,-57,3,2,203,232
410,31,3,4,7,6,34,42,7,4,237,274
410,32,4,3,9,4,-55,31,2,5,182,305
410,33,4,2,8,5,44,23,6,8,226,328
410,34,2,5,5,8,23,-47,9,1,249,281
410,35,2,5,3,10,-79,55,0,6,170,336
410,36,3,4,7,6,34,42,4,8,204,378
410,37,5,2,9,4,54,-78,8,0,258,300
410,38,4,2,6,7,-58,25,0,5,200,325
410,39,4,3,6,7,42,34,2,9,242,359
410,40,4,2,9,4,45,-78,7,1,287,281
410,41,6,2,11,2,-35,20,2,1,252,301
410,42,3,4,3,10,30,46,2,7,282,347
410,43,3,4,4,9,31,-55,3,2,313,292
410,44,4,3,7,6,43,33,6,5,356,325
410,45,4,2,8,5,-56,23,0,8,300,348
410,46,3,3,5,8,32,-65,2,3,332,283
410,47,3,5,6,7,33,52,5,5,365,335
410,48,2,5,6,7,24,52,9,7,389,387
410,49,2,5,3,10,-79,-45,0,2,310,342
410,50,3,4,5,8,32,44,2,6,342,386
410,51,4,3,7,6,43,33,5,9,385,419
410,52,2,4,7,6,-75,-58,0,1,310,361
410,53,3,4,7,6,34,42,4,3,344,403
410,54,5,2,9,4,54,22,8,5,398,425
410,55,4,2,9,4,-55,22,3,7,343,447
410,56,2,5,5,8,23,-47,6,0,366,400
410,57,4,2,7,6,43,24,9,4,409,424
410,58,3,4,5,8,-68,44,1,8,341,468
410,59,4,2,8,5,44,-77,5,1,385,391
410,60,2,4,8,5,-74,41,1,2,311,432
410,61,3,4,3,10,30,46,1,8,341,478
410,62,3,3,8,5,35,-68,6,0,376,410
410,63,4,2,9,4,-55,22,1,2,321,432
410,64,3,4,4,9,31,45,2,7,352,477
410,65,2,5,2,11,20,-44,2,3,372,433
410,66,3,3,9,4,36,31,8,4,408,464
410,67,3,3,6,7,-67,34,1,8,341,498
410,68,5,2,10,3,55,21,6,9,396,519
411,1,4,2,6,7,42,25,2,5,42,25
411,2,3,3,5,8,32,-65,4,0,74,-40
411,3,2,6,3,10,21,64,5,4,95,24
411,4,5,2,8,5,53,23,8,7,148,47
411,5,4,3,9,4,-55,31,3,8,93,78
411,6,5,2,10,3,55,21,8,9,148,99
411,7,3,4,6,7,-67,-57,1,2,81,42
411,8,3,3,6,7,33,34,4,6,114,76
411,9,4,4,7,6,43,42,7,8,157,118
411,10,5,2,8,5,-47,-77,0,1,110,41
411,11,3,3,7,6,34,33,4,4,144,74
411,12,3,3,6,7,33,34,7,8,177,108
411,13,4,3,8,5,-56,-68,1,0,121,40
411,14,5,2,11,2,56,20,7,0,177,60
411,15,3,4,3,10,30,46,7,6,207,106
411,16,4,3,6,7,42,-66,9,0,249,40
411,17,5,3,9,4,-46,31,3,1,203,71
411,18,3,3,8,5,35,32,8,3,238,103
411,19,4,3,7,6,-57,33,1,6,181,136
411,20,3,4,5,8,32,-56,3,0,213,80
411,21,4,3,8,5,44,32,7,2,257,112
411,22,4,3,6,7,42,34,9,6,299,146
411,23,2,5,6,7,-76,52,3,8,223,198
411,24,3,3,7,6,34,-67,7,1,257,131
411,25,2,4,5,8,-77,44,0,5,180,175
411,26,4,2,9,4,45,22,5,7,225,197
411,27,2,5,4,9,22,-46,7,1,247,151
411,28,2,6,3,10,21,64,8,5,268,215
411,29,3,4,7,6,-66,42,2,7,202,257
411,30,3,3,5,8,32,-65,4,2,234,192
411,31,3,4,4,9,31,45,5,7,265,237
411,32,4,2,6,7,42,-75,7,2,307,162
411,33,4,2,6,7,42,25,9,7,349,187
411,34,2,4,6,7,-76,-57,3,0,273,130
411,35,4,3,5,8,41,35,4,5,314,165
411,36,4,2,9,4,45,22,9,7,359,187
411,37,3,3,8,5,-65,32,4,9,294,219
411,38,4,3,7,6,43,-67,7,2,337,152
411,39,4,3,7,6,-57,33,0,5,280,185
411,40,4,3,6,7,42,34,2,9,322,219
411,41,5,2,10,3,55,-79,7,0,377,140
411,42,5,2,10,3,-45,21,2,1,332,161
411,43,2,5,4,9,22,54,4,5,354,215
411,44,4,3,8,5,44,32,8,7,398,247
411,45,2,5,5,8,-77,-47,1,0,321,200
411,46,4,3,7,6,43,33,4,3,364,233
411,47,3,4,4,9,31,45,5,8,395,278
411,48,2,4,5,8,23,-56,8,2,418,222
411,49,5,2,8,5,-47,23,1,5,371,245
411,50,2,5,3,10,21,-45,2,0,392,200
411,51,5,2,9,4,54,22,6,2,446,222
411,52,4,2,9,4,-55,22,1,4,391,244
411,53,3,3,10,3,37,30,8,4,428,274
411,54,4,2,8,5,-56,23,2,7,372,297
411,55,2,5,4,9,22,-46,4,1,394,251
411,56,4,2,9,4,45,22,9,3,439,273
411,57,2,4,6,7,-76,43,3,6,363,316
411,58,3,3,6,7,33,-66,6,0,396,250
411,59,2,4,2,11,20,47,6,7,416,297
411,60,3,4,5,8,32,-56,8,1,448,241
411,61,2,4,3,10,21,46,9,7,469,287
411,62,4,2,9,4,-55,22,4,9,414,309
411,63,2,4,5,8,23,-56,7,3,437,253
411,64,3,3,6,7,-67,34,0,7,370,287
411,65,3,4,8,5,35,41,5,8,405,328
411,66,4,3,8,5,44,-68,9,0,449,260
411,67,4,2,7,6,-57,24,2,4,392,284
411,68,3,3,7,6,34,33,6,7,426,317
411,69,3,3,6,7,33,-66,9,1,459,251
411,70,4,3,6,7,-58,34,1,5,401,285
411,71,3,4,3,10,30,-54,1,1,431,231
411,72,3,4,3,10,30,46,1,7,461,277
411,73,6,2,11,2,65,20,6,7,526,297
412,1,2,5,7,6,25,51,5,1,25,51
412,2,4,4,7,6,43,42,8,3,68,93
412,3,3,3,5,8,-68,35,0,8,0,128
412,4,2,4,5,8,23,-56,3,2,23,72
412,5,2,6,4,9,22,63,5,5,45,135
412,6,3,4,5,8,32,44,7,9,77,179
412,7,3,3,7,6,-66,-67,1,2,11,112
412,8,5,2,10,3,55,21,6,3,66,133
412,9,5,3,8,5,53,32,9,5,119,165
412,10,2,4,5,8,-77,44,2,9,42,209
412,11,3,4,4,9,31,-55,3,4,73,154
412,12,2,4,3,10,21,-54,4,0,94,100
412,13,3,3,5,8,32,35,6,5,126,135
412,14,4,3,6,7,42,34,8,9,168,169
412,15,4,2,8,5,-56,-77,2,2,112,92
412,16,2,5,3,10,21,55,3,7,133,147
412,17,2,4,6,7,24,-57,7,0,157,90
412,18,4,3,7,6,-57,33,0,3,100,123
412,19,4,3,7,6,43,33,3,6,143,156
412,20,2,5,5,8,23,53,6,9,166,209
412,21,4,3,9,4,-55,-69,1,0,111,140
412,22,2,5,8,5,26,50,7,0,137,190
412,23,2,5,4,9,22,54,9,4,159,244
412,24,4,3,7,6,-57,33,2,7,102,277
412,25,4,3,10,3,46,30,8,7,148,307
412,26,3,4,6,7,-67,-57,1,0,81,250
412,27,3,4,8,5,35,41,6,1,116,291
412,28,3,3,8,5,-65,32,1,3,51,323
412,29,4,3,8,5,44,32,5,5,95,355
412,30,2,5,4,9,22,54,7,9,117,409
412,31,3,4,4,9,31,-55,8,4,148,354
412,32,4,2,8,5,-56,23,2,7,92,377
412,33,4,3,7,6,43,-67,5,0,135,310
412,34,5,2,11,2,-44,20,1,0,91,330
412,35,3,3,7,6,34,33,5,3,125,363
412,36,2,4,3,10,21,46,6,9,146,409
412,37,4,4,7,6,43,-58,9,1,189,351
412,38,4,3,3,10,-40,37,9,8,149,388
412,39,3,4,6,7,-67,-57,2,1,82,331
412,40,3,4,6,7,33,43,5,4,115,374
412,41,3,3,4,9,31,-64,6,0,146,310
412,42,3,3,5,8,32,35,8,5,178,345
412,43,5,3,10,3,-45,30,3,5,133,375
412,44,5,2,8,5,53,23,6,8,186,398
412,45,4,4,7,6,43,-58,9,0,229,340
412,46,4,2,8,5,-56,23,3,3,173,363
412,47,4,3,6,7,42,34,5,7,215,397
412,48,4,3,6,7,42,-66,7,1,257,331
412,49,4,3,6,7,42,34,9,5,299,365
412,50,3,4,5,8,-68,44,1,9,231,409
412,51,5,2,10,3,55,-79,6,0,286,330
412,52,3,4,7,6,-66,42,0,2,220,372
412,53,3,3,7,6,34,33,4,5,254,405
412,54,2,4,4,9,22,-55,6,0,276,350
412,55,4,3,9,4,-55,31,1,1,221,381
412,56,3,3,5,8,32,35,3,6,253,416
412,57,3,3,4,9,31,-64,4,2,284,352
412,58,2,6,0,13,-20,67,4,9,264,419
412,59,2,5,3,10,21,-45,5,4,285,374
412,60,4,2,7,6,43,24,8,8,328,398
412,61,4,3,7,6,-57,-67,1,1,271,331
412,62,2,4,5,8,23,44,4,5,294,375
412,63,2,6,5,8,23,62,7,7,317,437
412,64,3,3,7,6,-66,-67,1,0,251,370
412,65,3,4,7,6,34,42,5,2,285,412
412,66,2,4,3,10,21,46,6,8,306,458
412,67,4,3,6,7,42,-66,8,2,348,392
412,68,2,5,4,9,-78,54,0,6,270,446
412,69,5,2,8,5,53,23,3,9,323,469
412,70,3,3,4,9,31,-64,4,5,354,405
412,71,3,4,5,8,32,44,6,9,386,449
412,72,2,4,6,7,-76,-57,0,2,310,392
412,73,4,3,8,5,44,32,4,4,354,424
412,74,4,3,8,5,44,32,8,6,398,456
412,75,3,3,7,6,-66,33,2,9,332,489
412,76,2,5,7,6,25,-49,7,0,357,440
412,77,4,2,7,6,-57,24,0,4,300,464
412,78,4,2,11,2,47,20,7,4,347,484
412,79,3,3,10,3,-63,30,4,4,284,514
413,1,3,3,8,5,35,32,5,2,35,32
413,2,3,3,4,9,31,36,6,8,66,68
413,3,3,4,9,4,-64,40,2,8,2,108
413,4,4,2,7,6,43,-76,5,2,45,32
413,5,2,5,6,7,24,52,9,4,69,84
413,6,4,3,6,7,-58,34,1,8,11,118
413,7,3,3,9,4,36,31,7,9,47,149
413,8,3,3,5,8,32,-65,9,4,79,84
413,9,4,3,8,5,-56,32,3,6,23,116
413,10,5,3,8,5,53,32,6,8,76,148
413,11,4,3,9,4,-55,31,1,9,21,179
413,12,3,4,6,7,33,-57,4,2,54,122
413,13,3,3,9,4,-64,31,0,3,-10,153
413,14,3,4,4,9,31,45,1,8,21,198
413,15,4,2,8,5,44,-77,5,1,65,121
413,16,2,6,2,11,20,65,5,6,85,186
413,17,3,4,6,7,33,43,8,9,118,229
413,18,4,2,6,7,-58,-75,0,4,60,154
413,19,4,3,7,6,43,33,3,7,103,187
413,20,3,4,7,6,34,42,7,9,137,229
413,21,3,4,6,7,-67,-57,0,2,70,172
413,22,4,2,9,4,45,22,5,4,115,194
413,23,3,3,7,6,34,33,9,7,149,227
413,24,5,2,10,3,-45,21,4,8,104,248
413,25,3,3,8,5,35,-68,9,0,139,180
413,26,4,3,7,6,-57,33,2,3,82,213
413,27,3,4,8,5,35,41,7,4,117,254
413,28,5,2,10,3,-45,21,2,5,72,275
413,29,5,2,11,2,56,20,8,5,128,295
413,30,5,2,10,3,-45,21,3,6,83,316
413,31,3,4,6,7,33,43,6,9,116,359
413,32,5,2,9,4,-46,-78,0,1,70,281
413,33,3,4,7,6,34,42,4,3,104,323
413,34,3,4,5,8,32,44,6,7,136,367
413,35,2,4,5,8,23,-56,9,1,159,311
413,36,4,3,4,9,40,36,9,7,199,347
413,37,3,4,6,7,-67,-57,2,0,132,290
413,38,4,3,6,7,42,34,4,4,174,324
413,39,2,4,4,9,22,45,6,9,196,369
413,40,4,3,7,6,43,-67,9,2,239,302
413,41,2,6,4,9,-78,63,1,5,161,365
413,42,5,2,9,4,54,22,5,7,215,387
413,43,4,3,6,7,42,-66,7,1,257,321
413,44,3,3,6,7,-67,34,0,5,190,355
413,45,3,3,8,5,35,32,5,7,225,387
413,46,3,4,4,9,31,-55,6,2,256,332
413,47,3,3,8,5,-65,32,1,4,191,364
413,48,3,4,3,10,30,-54,1,0,221,310
413,49,3,3,10,3,37,30,8,0,258,340
413,50,3,4,6,7,-67,43,1,3,191,383
413,51,3,3,7,6,34,33,5,6,225,416
413,52,3,3,7,6,34,33,9,9,259,449
413,53,4,2,7,6,-57,-76,2,3,202,373
413,54,3,4,5,8,32,44,4,7,234,417
413,55,3,4,6,7,33,-57,7,0,267,360
413,56,3,3,8,5,-65,32,2,2,202,392
413,57,2,6,3,10,21,64,3,6,223,456
413,58,3,3,5,8,32,-65,5,1,255,391
413,59,2,5,2,11,20,56,5,7,275,447
413,60,3,4,6,7,33,-57,8,0,308,390
413,61,3,3,6,7,-67,34,1,4,241,424
413,62,2,4,5,8,23,44,4,8,264,468
413,63,2,5,3,10,21,-45,5,3,285,423
413,64,2,4,3,10,21,46,6,9,306,469
413,65,3,4,7,6,-66,-58,0,1,240,411
413,66,4,3,8,5,44,32,4,3,284,443
413,67,3,3,7,6,34,33,8,6,318,476
413,68,4,3,7,6,-57,33,1,9,261,509
414,1,3,4,5,8,32,44,2,4,32,44
414,2,2,4,3,10,21,-54,3,0,53,-10
414,3,6,2,10,3,64,21,7,1,117,11
414,4,2,4,3,10,21,46,8,7,138,57
414,5,2,6,3,10,21,-36,9,1,159,21
414,6,2,4,4,9,-78,45,1,6,81,66
414,7,4,3,6,7,42,-66,3,0,123,0
414,8,5,2,8,5,53,23,6,3,176,23
414,9,3,3,6,7,33,34,9,7,209,57
414,10,3,4,9,4,-64,40,5,7,145,97
414,11,5,2,7,6,52,-76,7,1,197,21
414,12,3,3,5,8,32,35,9,6,229,56
414,13,3,4,7,6,-66,42,3,8,163,98
414,14,3,4,7,6,34,-58,7,0,197,40
414,15,4,3,7,6,-57,33,0,3,140,73
414,16,2,5,6,7,24,52,4,5,164,125
414,17,4,3,10,3,-54,30,0,5,110,155
414,18,4,3,4,9,40,-64,0,1,150,91
414,19,3,3,8,5,35,32,5,3,185,123
414,20,3,4,5,8,32,44,7,7,217,167
414,21,2,4,5,8,-77,-56,0,1,140,111
414,22,4,3,10,3,46,30,6,1,186,141
414,23,3,3,6,7,33,34,9,5,219,175
414,24,3,4,4,9,-69,-55,0,0,150,120
414,25,4,3,9,4,45,31,5,1,195,151
414,26,3,3,8,5,-65,32,0,3,130,183
414,27,3,3,10,3,37,30,7,3,167,213
414,28,3,3,9,4,-64,31,3,4,103,244
414,29,3,3,8,5,35,32,8,6,138,276
414,30,4,3,6,7,-58,-66,0,0,80,210
414,31,4,3,8,5,44,32,4,2,124,242
414,32,3,4,6,7,33,43,7,5,157,285
414,33,4,2,10,3,-54,21,3,6,103,306
414,34,4,3,7,6,43,33,6,9,146,339
414,35,4,3,8,5,-56,-68,0,1,90,271
414,36,4,2,7,6,43,24,3,5,133,295
414,37,5,2,10,3,55,21,8,6,188,316
414,38,5,2,10,3,-45,21,3,7,143,337
414,39,4,3,7,6,43,-67,6,0,186,270
414,40,5,2,10,3,-45,21,1,1,141,291
414,41,5,2,9,4,54,22,5,3,195,313
414,42,5,2,8,5,53,23,8,6,248,336
414,43,4,4,6,7,-58,43,0,9,190,379
414,44,2,4,5,8,23,-56,3,3,213,323
414,45,4,2,8,5,44,23,7,6,257,346
414,46,5,2,9,4,-46,22,1,8,211,368
414,47,3,4,6,7,33,-57,4,1,244,311
414,48,5,2,9,4,54,22,8,3,298,333
414,49,2,6,4,9,-78,63,0,6,220,396
414,50,3,4,5,8,32,-56,2,0,252,340
414,51,3,3,5,8,32,35,4,5,284,375
414,52,3,3,5,8,32,-65,6,0,316,310
414,53,3,3,6,7,33,34,9,4,349,344
414,54,4,4,9,4,-55,40,4,4,294,384
414,55,3,3,7,6,34,33,8,7,328,417
414,56,5,3,9,4,-46,31,2,8,282,448
414,57,2,4,5,8,23,-56,5,2,305,392
414,58,2,4,6,7,24,43,9,5,329,435
414,59,3,4,6,7,-67,43,2,8,262,478
414,60,3,4,8,5,35,41,7,9,297,519
415,1,4,3,7,6,43,33,3,3,43,33
415,2,4,2,11,2,-53,20,0,3,-10,53
415,3,3,3,8,5,35,32,5,5,25,85
415,4,3,4,7,6,34,42,9,7,59,127
415,5,4,2,9,4,-55,22,4,9,4,149
415,6,4,2,9,4,45,-78,9,1,49,71
415,7,3,4,5,8,-68,44,1,5,-19,115
415,8,3,4,4,9,31,-55,2,0,12,60
415,9,4,2,9,4,45,22,7,2,57,82
415,10,2,5,4,9,22,54,9,6,79,136
415,11,3,3,6,7,-67,-66,2,0,12,70
415,12,3,4,6,7,33,43,5,3,45,113
415,13,5,2,10,3,-45,21,0,4,0,134
415,14,3,3,9,4,36,31,6,5,36,165
415,15,4,3,6,7,42,34,8,9,78,199
415,16,5,2,9,4,-46,-78,2,1,32,121
415,17,3,3,7,6,34,33,6,4,66,154
415,18,2,4,4,9,22,45,8,9,88,199
415,19,3,3,6,7,-67,-66,1,3,21,133
415,20,2,4,6,7,24,43,5,6,45,176
415,21,2,4,3,10,21,-54,6,2,66,122
415,22,3,4,9,4,-64,40,2,2,2,162
415,23,3,4,4,9,31,45,3,7,33,207
415,24,3,4,4,9,31,-55,4,2,64,152
415,25,2,4,7,6,25,42,9,4,89,194
415,26,4,3,8,5,-56,32,3,6,33,226
415,27,3,4,9,4,36,40,9,6,69,266
415,28,3,4,5,8,-68,-56,1,0,1,210
415,29,4,3,6,7,42,34,3,4,43,244
415,30,5,2,9,4,54,22,7,6,97,266
415,31,2,5,3,10,21,-45,8,1,118,221
415,32,3,4,4,9,31,45,9,6,149,266
415,33,3,4,7,6,-66,42,3,8,83,308
415,34,2,5,6,7,24,-48,7,0,107,260
415,35,3,4,4,9,31,45,8,5,138,305
415,36,3,3,6,7,-67,34,1,9,71,339
415,37,5,2,8,5,53,-77,4,2,124,262
415,38,5,2,8,5,53,23,7,5,177,285
415,39,3,4,4,9,31,-55,8,0,208,230
415,40,2,4,7,6,-75,42,3,2,133,272
415,41,3,3,8,5,35,32,8,4,168,304
415,42,4,2,8,5,-56,23,2,7,112,327
415,43,3,3,6,7,33,-66,5,1,145,261
415,44,3,4,4,9,31,45,6,6,176,306
415,45,3,3,9,4,-64,31,2,7,112,337
415,46,3,3,5,8,32,-65,4,2,144,272
415,47,3,3,6,7,33,34,7,6,177,306
415,48,2,4,3,10,21,-54,8,2,198,252
415,49,3,3,9,4,-64,31,4,3,134,283
415,50,2,5,5,8,23,53,7,6,157,336
415,51,3,5,4,9,31,-46,8,0,188,290
415,52,5,2,9,4,-46,22,2,2,142,312
415,53,4,3,5,8,41,35,3,7,183,347
415,54,3,4,9,4,36,40,9,7,219,387
415,55,5,2,9,4,-46,22,3,9,173,409
415,56,5,2,10,3,55,-79,8,0,228,330
415,57,4,3,7,6,-57,33,1,3,171,363
415,58,4,2,8,5,44,23,5,6,215,386
415,59,2,5,5,8,23,53,8,9,238,439
415,60,4,2,7,6,-57,-76,1,3,181,363
415,61,5,2,7,6,52,24,3,7,233,387
415,62,3,3,7,6,34,-67,7,0,267,320
415,63,2,4,7,6,-75,42,2,2,192,362
415,64,3,4,3,10,30,46,2,8,222,408
415,65,3,4,5,8,32,-56,4,2,254,352
415,66,3,4,5,8,32,44,6,6,286,396
415,67,2,4,4,9,22,-55,8,1,308,341
415,68,4,2,6,7,-58,25,0,6,250,366
415,69,2,4,3,10,21,-54,1,2,271,312
415,70,4,3,7,6,43,33,4,5,314,345
415,71,3,3,6,7,33,34,7,9,347,379
415,72,3,3,6,7,-67,-66,0,3,280,313
415,73,4,2,7,6,43,24,3,7,323,337
415,74,3,3,8,5,35,32,8,9,358,369
415,75,4,3,7,6,-57,-67,1,2,301,302
415,76,3,4,5,8,32,44,3,6,333,346
415,77,3,3,8,5,35,32,8,8,368,378
415,78,4,3,10,3,-54,30,4,8,314,408
415,79,4,2,9,4,45,-78,9,0,359,330
415,80,4,3,7,6,-57,33,2,3,302,363
415,81,3,3,7,6,34,33,6,6,336,396
415,82,2,5,3,10,21,-45,7,1,357,351
415,83,4,3,10,3,-54,30,3,1,303,381
415,84,2,4,5,8,23,44,6,5,326,425
415,85,5,2,10,3,-45,21,1,6,281,446
415,86,4,3,6,7,42,-66,3,0,323,380
415,87,4,2,7,6,43,24,6,4,366,404
415,88,5,2,9,4,-46,22,0,6,320,426
415,89,5,3,8,5,53,32,3,8,373,458
415,90,2,5,3,10,21,-45,4,3,394,413
415,91,3,3,7,6,34,33,8,6,428,446
415,92,4,3,6,7,-58,-66,0,0,370,380
415,93,3,3,6,7,33,34,3,4,403,414
415,94,4,3,8,5,44,32,7,6,447,446
415,95,2,4,5,8,-77,-56,0,0,370,390
415,96,3,3,5,8,32,35,2,5,402,425
415,97,2,4,6,7,24,43,6,8,426,468
415,98,5,2,8,5,53,-77,9,1,479,391
415,99,4,2,6,7,-58,25,1,6,421,416
415,100,3,4,5,8,32,-56,3,0,453,360
415,101,2,5,3,10,21,55,4,5,474,415
415,102,2,6,3,10,21,64,5,9,495,479
415,103,6,2,9,4,63,-78,8,1,558,401
416,1,2,5,5,8,23,53,3,3,23,53
416,2,5,2,8,5,53,23,6,6,76,76
416,3,3,3,7,6,-66,33,0,9,10,109
416,4,3,3,6,7,33,-66,3,3,43,43
416,5,2,6,3,10,21,64,4,7,64,107
416,6,3,4,7,6,34,42,8,9,98,149
416,7,2,4,4,9,-78,-55,0,4,20,94
416,8,2,4,7,6,25,42,5,6,45,136
416,9,2,5,3,10,21,-45,6,1,66,91
416,10,3,3,5,8,32,35,8,6,98,126
416,11,4,3,5,8,41,-65,9,1,139,61
416,12,3,3,6,7,-67,34,2,5,72,95
416,13,5,2,9,4,54,22,6,7,126,117
416,14,5,2,6,7,51,-75,7,2,177,42
416,15,3,3,5,8,32,35,9,7,209,77
416,16,2,4,4,9,-78,-55,1,2,131,22
416,17,2,4,3,10,21,46,2,8,152,68
416,18,3,4,6,7,33,-57,5,1,185,11
416,19,4,2,6,7,42,25,7,6,227,36
416,20,4,3,9,4,-55,31,2,7,172,67
416,21,3,3,7,6,34,-67,6,0,206,0
416,22,3,4,6,7,33,43,9,3,239,43
416,23,2,4,3,10,-79,46,0,9,160,89
416,24,2,5,3,10,21,-45,1,4,181,44
416,25,2,4,7,6,25,42,6,6,206,86
416,26,4,3,9,4,-55,31,1,7,151,117
416,27,3,3,6,7,33,-66,4,1,184,51
416,28,2,4,6,7,24,43,8,4,208,94
416,29,2,5,6,7,-76,52,2,6,132,146
416,30,5,2,7,6,52,-76,4,0,184,70
416,31,3,3,7,6,34,33,8,3,218,103
416,32,3,3,7,6,-66,33,2,6,152,136
416,33,4,3,6,7,42,-66,4,0,194,70
416,34,4,3,7,6,43,33,7,3,237,103
416,35,5,2,10,3,-45,21,2,4,192,124
416,36,2,4,6,7,24,43,6,7,216,167
416,37,4,2,10,3,-54,21,2,8,162,188
416,38,2,4,6,7,24,-57,6,1,186,131
416,39,4,3,9,4,-55,31,1,2,131,162
416,40,2,4,4,9,22,45,3,7,153,207
416,41,4,3,8,5,44,32,7,9,197,239
416,42,4,3,9,4,-55,-69,2,0,142,170
416,43,3,4,6,7,33,43,5,3,175,213
416,44,2,6,4,9,22,63,7,6,197,276
416,45,3,3,6,7,-67,-66,0,0,130,210
416,46,3,4,6,7,33,43,3,3,163,253
416,47,2,4,6,7,24,43,7,6,187,296
416,48,2,4,4,9,22,-55,9,1,209,241
416,49,3,4,4,9,-69,45,0,6,140,286
416,50,3,4,6,7,33,43,3,9,173,329
416,51,2,6,5,8,23,-38,6,1,196,291
416,52,3,3,7,6,-66,33,0,4,130,324
416,53,3,4,5,8,32,44,2,8,162,368
416,54,4,2,8,5,44,-77,6,1,206,291
416,55,3,4,5,8,32,44,8,5,238,335
416,56,6,2,10,3,-36,21,2,6,202,356
416,57,3,3,9,4,36,31,8,7,238,387
416,58,3,4,4,9,31,-55,9,2,269,332
416,59,4,3,7,6,-57,33,2,5,212,365
416,60,4,2,10,3,46,21,8,6,258,386
416,61,3,3,8,5,-65,32,3,8,193,418
416,62,2,4,7,6,25,-58,8,0,218,360
416,63,4,3,8,5,-56,32,2,2,162,392
416,64,4,3,9,4,45,31,7,3,207,423
416,65,5,2,8,5,-47,23,0,6,160,446
416,66,4,2,10,3,46,21,6,7,206,467
416,67,3,4,6,7,33,-57,9,0,239,410
416,68,3,3,6,7,-67,34,2,4,172,444
416,69,3,3,10,3,37,30,9,4,209,474
416,70,2,4,6,7,-76,43,3,7,133,517
417,1,3,3,7,6,34,33,4,3,34,33
417,2,2,5,5,8,23,53,7,6,57,86
417,3,3,4,5,8,32,-56,9,0,89,30
417,4,4,2,10,3,-54,21,5,1,35,51
417,5,2,5,4,9,22,54,7,5,57,105
417,6,3,3,7,6,-66,33,1,8,-9,138
417,7,2,4,7,6,25,-58,6,0,16,80
417,8,4,3,6,7,42,34,8,4,58,114
417,9,3,4,5,8,-68,44,0,8,-10,158
417,10,3,4,6,7,33,-57,3,1,23,101
417,11,3,3,7,6,34,33,7,4,57,134
417,12,5,2,10,3,-45,21,2,5,12,155
417,13,5,2,7,6,52,24,4,9,64,179
417,14,4,3,7,6,43,-67,7,2,107,112
417,15,4,2,6,7,42,25,9,7,149,137
417,16,2,4,4,9,-78,-55,1,2,71,82
417,17,3,4,7,6,34,42,5,4,105,124
417,18,4,4,7,6,43,42,8,6,148,166
417,19,2,4,6,7,-76,43,2,9,72,209
417,20,3,3,7,6,34,-67,6,2,106,142
417,21,2,4,7,6,-75,42,1,4,31,184
417,22,3,4,5,8,32,44,3,8,63,228
417,23,3,4,8,5,35,41,8,9,98,269
417,24,4,2,8,5,-56,-77,2,2,42,192
417,25,2,4,7,6,25,42,7,4,67,234
417,26,2,5,5,8,-77,53,0,7,-10,287
417,27,3,4,8,5,35,41,5,8,25,328
417,28,3,4,6,7,33,-57,8,1,58,271
417,29,4,3,7,6,-57,33,1,4,1,304
417,30,4,2,8,5,44,23,5,7,45,327
417,31,4,3,6,7,42,-66,7,1,87,261
417,32,2,5,6,7,-76,52,1,3,11,313
417,33,3,3,5,8,32,35,3,8,43,348
417,34,5,2,7,6,52,-76,5,2,95,272
417,35,2,5,4,9,22,54,7,6,117,326
417,36,3,3,6,7,-67,-66,0,0,50,260
417,37,2,4,6,7,24,43,4,3,74,303
417,38,2,4,3,10,21,46,5,9,95,349
417,39,3,3,5,8,32,-65,7,4,127,284
417,40,4,3,9,4,-55,31,2,5,72,315
417,41,2,4,7,6,25,42,7,7,97,357
417,42,2,4,3,10,21,-54,8,3,118,303
417,43,3,3,7,6,-66,33,2,6,52,336
417,44,2,5,3,10,21,-45,3,1,73,291
417,45,4,3,8,5,44,32,7,3,117,323
417,46,4,3,7,6,-57,33,0,6,60,356
417,47,4,3,9,4,45,31,5,7,105,387
417,48,2,5,2,11,20,-44,5,3,125,343
417,49,3,4,3,10,30,46,5,9,155,389
417,50,4,2,7,6,43,-76,8,3,198,313
417,51,3,4,6,7,-67,43,1,6,131,356
417,52,4,2,10,3,46,21,7,7,177,377
417,53,3,3,7,6,-66,-67,1,0,111,310
417,54,3,3,9,4,36,31,7,1,147,341
417,55,3,3,6,7,-67,34,0,5,80,375
417,56,2,5,3,10,21,-45,1,0,101,330
417,57,2,5,7,6,25,51,6,1,126,381
417,58,3,3,5,8,32,35,8,6,158,416
417,59,3,3,6,7,-67,-66,1,0,91,350
417,60,4,3,6,7,42,34,3,4,133,384
417,61,2,4,2,11,20,-53,3,1,153,331
417,62,3,3,7,6,34,33,7,4,187,364
417,63,4,3,9,4,-55,31,2,5,132,395
417,64,3,3,3,10,30,-63,2,2,162,332
417,65,3,3,5,8,32,35,4,7,194,367
417,66,6,2,10,3,64,21,8,8,258,388
417,67,4,2,11,2,-53,20,5,8,205,408
417,68,4,2,8,5,44,-77,9,1,249,331
417,69,3,3,5,8,-68,35,1,6,181,366
417,70,3,4,6,7,33,43,4,9,214,409
417,71,4,3,7,6,43,-67,7,2,257,342
417,72,4,4,4,9,40,45,7,7,297,387
417,73,3,3,7,6,-66,-67,1,0,231,320
417,74,2,4,4,9,22,45,3,5,253,365
417,75,3,4,6,7,33,43,6,8,286,408
417,76,3,3,9,4,-64,31,2,9,222,439
417,77,4,3,5,8,41,-65,3,4,263,374
417,78,3,4,3,10,30,-54,3,0,293,320
417,79,3,4,7,6,34,42,7,2,327,362
417,80,3,3,7,6,-66,33,1,5,261,395
417,81,3,4,5,8,32,44,3,9,293,439
417,82,5,2,8,5,53,-77,6,2,346,362
417,83,4,3,7,6,43,33,9,5,389,395
417,84,2,4,4,9,-78,-55,1,0,311,340
417,85,2,4,6,7,24,43,5,3,335,383
417,86,3,4,3,10,30,46,5,9,365,429
417,87,4,3,7,6,43,-67,8,2,408,362
417,88,3,3,6,7,-67,34,1,6,341,396
417,89,3,4,6,7,33,43,4,9,374,439
417,90,2,5,4,9,22,-46,6,3,396,393
417,91,4,3,8,5,-56,32,0,5,340,425
417,92,2,6,2,11,20,-35,0,0,360,390
417,93,2,5,2,11,20,56,0,6,380,446
417,94,2,5,3,10,21,-45,1,1,401,401
417,95,4,3,10,3,46,30,7,1,447,431
417,96,4,3,7,6,-57,33,0,4,390,464
417,97,3,3,9,4,36,31,6,5,426,495
417,98,3,4,6,7,33,43,9,8,459,538
418,1,2,4,3,10,21,46,1,6,21,46
418,2,3,3,5,8,32,-65,3,1,53,-19
418,3,2,4,4,9,22,45,5,6,75,26
418,4,4,3,9,4,-55,31,0,7,20,57
418,5,2,5,6,7,24,52,4,9,44,109
418,6,3,4,7,6,34,-58,8,1,78,51
418,7,5,2,8,5,-47,23,1,4,31,74
418,8,4,3,9,4,45,31,6,5,76,105
418,9,4,3,9,4,-55,31,1,6,21,136
418,10,5,2,9,4,54,22,5,8,75,158
418,11,4,3,10,3,-54,30,1,8,21,188
418,12,4,2,9,4,45,-78,6,0,66,110
418,13,4,3,7,6,43,33,9,3,109,143
418,14,2,4,6,7,-76,43,3,6,33,186
418,15,4,2,8,5,44,23,7,9,77,209
418,16,3,4,6,7,-67,-57,0,2,10,152
418,17,4,2,8,5,44,23,4,5,54,175
418,18,3,4,5,8,32,44,6,9,86,219
418,19,2,5,5,8,23,-47,9,2,109,172
418,20,3,3,4,9,-69,36,0,8,40,208
418,21,3,3,6,7,33,-66,3,2,73,142
418,22,4,3,6,7,42,34,5,6,115,176
418,23,4,3,9,4,-55,31,0,7,60,207
418,24,2,5,3,10,21,-45,1,2,81,162
418,25,3,4,7,6,34,42,5,4,115,204
418,26,3,3,5,8,32,35,7,9,147,239
418,27,4,3,8,5,-56,-68,1,1,91,171
418,28,2,5,6,7,24,52,5,3,115,223
418,29,6,2,8,5,62,23,7,6,177,246
418,30,4,3,8,5,-56,32,1,8,121,278
418,31,4,3,8,5,44,-68,5,0,165,210
418,32,3,3,10,3,-63,30,2,0,102,240
418,33,2,5,5,8,23,53,5,3,125,293
418,34,3,4,8,5,-65,41,0,4,60,334
418,35,4,2,9,4,45,22,5,6,105,356
418,36,3,3,7,6,34,33,9,9,139,389
418,37,2,5,5,8,-77,-47,2,2,62,342
418,38,3,4,4,9,31,45,3,7,93,387
418,39,5,2,11,2,56,20,9,7,149,407
418,40,4,4,4,9,40,-55,9,2,189,352
418,41,4,2,9,4,-55,22,4,4,134,374
418,42,4,3,8,5,44,32,8,6,178,406
418,43,4,2,8,5,-56,23,2,9,122,429
418,44,2,5,4,9,22,-46,4,3,144,383
418,45,4,4,6,7,42,43,6,6,186,426
418,46,3,3,3,10,30,-63,6,3,216,363
418,47,4,3,7,6,43,33,9,6,259,396
418,48,3,4,4,9,-69,-55,0,1,190,341
418,49,3,4,3,10,30,46,0,7,220,387
418,50,4,3,6,7,42,-66,2,1,262,321
418,51,3,3,8,5,35,32,7,3,297,353
418,52,3,3,6,7,-67,34,0,7,230,387
418,53,5,2,9,4,54,22,4,9,284,409
418,54,3,3,9,4,-64,-69,0,0,220,340
418,55,3,3,6,7,33,34,3,4,253,374
418,56,5,2,9,4,54,22,7,6,307,396
418,57,2,5,5,8,-77,53,0,9,230,449
418,58,4,2,8,5,44,-77,4,2,274,372
418,59,4,2,9,4,45,22,9,4,319,394
418,60,2,4,4,9,-78,45,1,9,241,439
418,61,3,5,5,8,32,-47,3,2,273,392
418,62,4,3,6,7,42,34,5,6,315,426
418,63,4,2,10,3,-54,21,1,7,261,447
418,64,2,5,4,9,22,-46,3,1,283,401
418,65,2,5,7,6,25,51,8,2,308,452
418,66,3,4,5,8,-68,44,0,6,240,496
418,67,3,3,7,6,34,33,4,9,274,529
419,1,2,5,5,8,23,53,3,3,23,53
419,2,3,3,5,8,32,35,5,8,55,88
419,3,5,3,8,5,53,-68,8,0,108,20
419,4,4,3,6,7,-58,34,0,4,50,54
419,5,2,4,7,6,25,42,5,6,75,96
419,6,5,2,9,4,54,22,9,8,129,118
419,7,3,3,8,5,-65,-68,4,0,64,50
419,8,4,2,8,5,44,23,8,3,108,73
419,9,4,2,8,5,-56,23,2,6,52,96
419,10,5,2,8,5,53,23,5,9,105,119
419,11,3,3,4,9,31,-64,6,5,136,55
419,12,3,3,8,5,-65,32,1,7,71,87
419,13,3,3,5,8,32,-65,3,2,103,22
419,14,2,5,7,6,25,51,8,3,128,73
419,15,2,4,4,9,-78,45,0,8,50,118
419,16,3,4,6,7,33,-57,3,1,83,61
419,17,5,2,10,3,55,21,8,2,138,82
419,18,2,5,4,9,-78,54,0,6,60,136
419,19,3,4,5,8,32,-56,2,0,92,80
419,20,3,3,8,5,35,32,7,2,127,112
419,21,3,4,5,8,32,44,9,6,159,156
419,22,3,4,3,10,30,-54,9,2,189,102
419,23,3,3,7,6,-66,33,3,5,123,135
419,24,3,3,5,8,32,-65,5,0,155,70
419,25,4,2,7,6,43,24,8,4,198,94
419,26,3,3,7,6,-66,33,2,7,132,127
419,27,2,4,5,8,23,-56,5,1,155,71
419,28,4,3,7,6,43,33,8,4,198,104
419,29,2,4,6,7,-76,43,2,7,122,147
419,30,3,3,8,5,35,32,7,9,157,179
419,31,4,3,7,6,-57,-67,0,2,100,112
419,32,5,2,11,2,56,20,6,2,156,132
419,33,4,3,8,5,-56,32,0,4,100,164
419,34,6,2,11,2,65,20,5,4,165,184
419,35,3,3,5,8,32,35,7,9,197,219
419,36,2,5,5,8,-77,-47,0,2,120,172
419,37,4,2,10,3,46,21,6,3,166,193
419,38,2,4,7,6,-75,42,1,5,91,235
419,39,3,3,9,4,36,31,7,6,127,266
419,40,5,2,8,5,-47,23,0,9,80,289
419,41,3,4,4,9,31,-55,1,4,111,234
419,42,2,5,5,8,23,53,4,7,134,287
419,43,6,2,11,2,65,20,9,7,199,307
419,44,4,2,8,5,-56,-77,3,0,143,230
419,45,2,4,6,7,24,43,7,3,167,273
419,46,4,3,6,7,42,34,9,7,209,307
419,47,2,4,5,8,-77,-56,2,1,132,251
419,48,3,4,6,7,33,43,5,4,165,294
419,49,5,2,9,4,54,22,9,6,219,316
419,50,4,3,8,5,-56,32,3,8,163,348
419,51,4,2,8,5,44,-77,7,1,207,271
419,52,4,3,8,5,-56,32,1,3,151,303
419,53,5,2,9,4,54,22,5,5,205,325
419,54,5,2,7,6,52,24,7,9,257,349
419,55,4,3,8,5,-56,-68,1,1,201,281
419,56,4,2,6,7,42,25,3,6,243,306
419,57,4,2,9,4,45,22,8,8,288,328
419,58,2,4,5,8,-77,-56,1,2,211,272
419,59,3,4,5,8,32,44,3,6,243,316
419,60,2,5,5,8,23,53,6,9,266,369
419,61,4,2,10,3,-54,-79,2,0,212,290
419,62,5,2,11,2,56,20,8,0,268,310
419,63,4,3,9,4,-55,31,3,1,213,341
419,64,3,3,6,7,33,34,6,5,246,375
419,65,5,2,8,5,53,23,9,8,299,398
419,66,3,4,4,9,-69,-55,0,3,230,343
419,67,4,3,7,6,43,33,3,6,273,376
419,68,3,4,6,7,33,43,6,9,306,419
419,69,3,3,7,6,-66,-67,0,2,240,352
419,70,3,4,7,6,34,42,4,4,274,394
419,71,3,5,5,8,32,53,6,7,306,447
419,72,3,3,5,8,32,-65,8,2,338,382
419,73,4,3,8,5,-56,32,2,4,282,414
419,74,3,4,6,7,33,43,5,7,315,457
419,75,5,2,10,3,-45,21,0,8,270,478
419,76,2,5,6,7,24,-48,4,0,294,430
419,77,4,3,7,6,43,33,7,3,337,463
419,78,3,3,5,8,32,35,9,8,369,498
419,79,4,2,7,6,-57,-76,2,2,312,422
419,80,2,4,5,8,23,44,5,6,335,466
419,81,4,2,5,8,41,-74,6,2,376,392
419,82,3,4,6,7,33,43,9,5,409,435
419,83,3,3,5,8,-68,-65,1,0,341,370
419,84,3,3,7,6,34,33,5,3,375,403
419,85,3,3,9,4,-64,31,1,4,311,434
419,86,4,2,9,4,45,22,6,6,356,456
419,87,3,3,5,8,32,-65,8,1,388,391
419,88,4,3,6,7,-58,34,0,5,330,425
419,89,3,3,7,6,34,33,4,8,364,458
419,90,3,3,5,8,32,-65,6,3,396,393
419,91,5,2,7,6,52,24,8,7,448,417
419,92,5,2,7,6,-48,-76,0,1,400,341
419,93,4,3,6,7,42,34,2,5,442,375
419,94,5,2,10,3,55,21,7,6,497,396
419,95,2,4,7,6,-75,42,2,8,422,438
419,96,3,4,5,8,32,-56,4,2,454,382
419,97,4,3,6,7,42,34,6,6,496,416
419,98,4,3,8,5,-56,32,0,8,440,448
419,99,4,3,8,5,44,-68,4,0,484,380
419,100,3,3,9,4,-64,31,0,1,420,411
419,101,2,4,4,9,22,45,2,6,442,456
419,102,4,3,4,9,40,-64,2,2,482,392
419,103,5,2,10,3,55,21,7,3,537,413
420,1,3,3,10,3,37,30,7,0,37,30
420,2,2,5,6,7,-76,52,1,2,-39,82
420,3,3,4,4,9,31,45,2,7,-8,127
420,4,4,3,5,8,41,-65,3,2,33,62
420,5,3,4,6,7,33,43,6,5,66,105
420,6,2,4,5,8,23,44,9,9,89,149
420,7,2,5,5,8,-77,-47,2,2,12,102
420,8,4,2,8,5,44,23,6,5,56,125
420,9,3,4,4,9,31,-55,7,0,87,70
420,10,3,3,5,8,32,35,9,5,119,105
420,11,4,3,8,5,-56,32,3,7,63,137
420,12,3,4,6,7,33,-57,6,0,96,80
420,13,3,3,5,8,32,35,8,5,128,115
420,14,4,3,6,7,-58,34,0,9,70,149
420,15,3,4,3,10,30,-54,0,5,100,95
420,16,2,5,4,9,22,54,2,9,122,149
420,17,3,3,7,6,34,-67,6,2,156,82
420,18,4,3,8,5,-56,32,0,4,100,114
420,19,2,5,4,9,22,54,2,8,122,168
420,20,2,4,6,7,24,-57,6,1,146,111
420,21,3,4,7,6,-66,42,0,3,80,153
420,22,2,4,2,11,20,-53,0,0,100,100
420,23,3,3,7,6,34,33,4,3,134,133
420,24,2,4,6,7,24,43,8,6,158,176
420,25,2,6,3,10,21,-36,9,0,179,140
420,26,3,4,4,9,-69,45,0,5,110,185
420,27,6,2,10,3,64,21,4,6,174,206
420,28,2,4,7,6,25,42,9,8,199,248
420,29,3,3,9,4,-64,31,5,9,135,279
420,30,2,5,4,9,22,-46,7,3,157,233
420,31,4,2,6,7,42,25,9,8,199,258
420,32,4,4,7,6,-57,-58,2,0,142,200
420,33,3,3,9,4,36,31,8,1,178,231
420,34,2,5,2,11,20,56,8,7,198,287
420,35,2,5,6,7,-76,52,2,9,122,339
420,36,2,5,5,8,23,-47,5,2,145,292
420,37,3,4,4,9,31,45,6,7,176,337
420,38,3,3,5,8,32,-65,8,2,208,272
420,39,4,3,7,6,-57,33,1,5,151,305
420,40,3,4,5,8,32,44,3,9,183,349
420,41,4,3,7,6,43,-67,6,2,226,282
420,42,3,3,7,6,-66,33,0,5,160,315
420,43,3,4,8,5,35,41,5,6,195,356
420,44,4,4,8,5,44,41,9,7,239,397
420,45,2,5,2,11,20,-44,9,3,259,353
420,46,2,4,5,8,-77,44,2,7,182,397
420,47,2,4,4,9,22,-55,4,2,204,342
420,48,3,3,8,5,35,32,9,4,239,374
420,49,2,4,7,6,-75,42,4,6,164,416
420,50,4,2,7,6,43,-76,7,0,207,340
420,51,3,4,7,6,-66,42,1,2,141,382
420,52,4,2,10,3,46,21,7,3,187,403
420,53,3,3,7,6,-66,33,1,6,121,436
420,54,3,3,4,9,31,-64,2,2,152,372
420,55,6,2,7,6,61,24,3,6,213,396
420,56,3,4,5,8,32,-56,5,0,245,340
420,57,2,4,6,7,24,43,9,3,269,383
420,58,5,2,9,4,-46,22,3,5,223,405
420,59,2,5,6,7,24,52,7,7,247,457
420,60,3,3,5,8,32,-65,9,2,279,392
420,61,2,4,6,7,-76,43,3,5,203,435
420,62,5,2,10,3,55,21,8,6,258,456
420,63,4,3,7,6,-57,33,1,9,201,489
420,64,2,4,5,8,23,-56,4,3,224,433
420,65,3,3,8,5,35,32,9,5,259,465
420,66,2,5,4,9,-78,54,1,9,181,519
421,1,6,2,7,6,61,24,1,4,61,24
421,2,2,5,5,8,23,53,4,7,84,77
421,3,4,2,7,6,43,-76,7,1,127,1
421,4,5,2,6,7,51,25,8,6,178,26
421,5,4,3,5,8,41,-65,9,1,219,-39
421,6,3,3,5,8,-68,35,1,6,151,-4
421,7,2,5,4,9,22,-46,3,0,173,-50
421,8,3,4,3,10,30,46,3,6,203,-4
421,9,4,3,8,5,44,32,7,8,247,28
421,10,5,2,9,4,-46,-78,1,0,201,-50
421,11,3,3,5,8,32,35,3,5,233,-15
421,12,4,3,7,6,43,33,6,8,276,18
421,13,3,3,6,7,33,-66,9,2,309,-48
421,14,3,4,5,8,-68,44,1,6,241,-4
421,15,3,4,6,7,33,43,4,9,274,39
421,16,4,2,7,6,43,-76,7,3,317,-37
421,17,4,2,10,3,-54,21,3,4,263,-16
421,18,4,3,8,5,44,32,7,6,307,16
421,19,2,4,8,5,-74,41,3,7,233,57
421,20,2,4,9,4,-73,40,0,7,160,97
421,21,4,3,7,6,43,-67,3,0,203,30
421,22,3,3,9,4,36,31,9,1,239,61
421,23,4,3,6,7,-58,34,1,5,181,95
421,24,2,4,4,9,22,-55,3,0,203,40
421,25,3,3,7,6,34,33,7,3,237,73
421,26,3,3,6,7,-67,34,0,7,170,107
421,27,5,2,10,3,55,21,5,8,225,128
421,28,3,3,7,6,34,-67,9,1,259,61
421,29,3,3,5,8,-68,35,1,6,191,96
421,30,4,3,6,7,42,-66,3,0,233,30
421,31,5,2,7,6,52,24,5,4,285,54
421,32,3,4,5,8,32,44,7,8,317,98
421,33,3,3,8,5,-65,-68,2,0,252,30
421,34,4,4,4,9,40,45,2,5,292,75
421,35,4,3,7,6,43,33,5,8,335,108
421,36,2,5,6,7,24,-48,9,0,359,60
421,37,2,5,5,8,-77,53,2,3,282,113
421,38,4,3,6,7,42,34,4,7,324,147
421,39,4,2,10,3,-54,21,0,8,270,168
421,40,3,4,3,10,30,-54,0,4,300,114
421,41,3,4,5,8,32,44,2,8,332,158
421,42,5,2,8,5,53,-77,5,1,385,81
421,43,3,3,7,6,34,33,9,4,419,114
421,44,2,4,5,8,-77,44,2,8,342,158
421,45,4,2,8,5,44,-77,6,1,386,81
421,46,4,2,6,7,42,25,8,6,428,106
421,47,4,3,7,6,-57,33,1,9,371,139
421,48,4,2,10,3,46,-79,7,0,417,60
421,49,4,3,8,5,-56,32,1,2,361,92
421,50,3,3,6,7,33,34,4,6,394,126
421,51,2,4,4,9,22,-55,6,1,416,71
421,52,4,3,6,7,42,34,8,5,458,105
421,53,4,3,6,7,-58,34,0,9,400,139
421,54,3,4,8,5,35,-59,5,0,435,80
421,55,2,4,8,5,-74,41,1,1,361,121
421,56,3,3,3,10,30,37,1,8,391,158
421,57,5,2,9,4,54,-78,5,0,445,80
421,58,2,4,5,8,23,44,8,4,468,124
421,59,3,3,8,5,-65,32,3,6,403,156
421,60,3,3,6,7,33,-66,6,0,436,90
421,61,4,2,9,4,-55,22,1,2,381,112
421,62,4,3,7,6,43,33,4,5,424,145
421,63,5,2,8,5,53,23,7,8,477,168
421,64,3,3,9,4,-64,31,3,9,413,199
421,65,6,2,10,3,64,-79,7,0,477,120
421,66,3,3,7,6,-66,33,1,3,411,153
421,67,2,4,3,10,21,46,2,9,432,199
421,68,4,3,7,6,43,-67,5,2,475,132
421,69,5,2,8,5,53,23,8,5,528,155
422,1,3,3,9,4,36,31,6,1,36,31
422,2,2,4,6,7,-76,43,0,4,-40,74
422,3,4,3,9,4,45,31,5,5,5,105
422,4,4,2,7,6,43,24,8,9,48,129
422,5,4,2,9,4,-55,-78,3,1,-7,51
422,6,3,3,9,4,36,31,9,2,29,82
422,7,3,3,5,8,-68,35,1,7,-39,117
422,8,3,4,3,10,30,-54,1,3,-9,63
422,9,4,3,6,7,42,34,3,7,33,97
422,10,3,4,6,7,33,-57,6,0,66,40
422,11,3,3,5,8,32,35,8,5,98,75
422,12,2,5,3,10,21,-45,9,0,119,30
422,13,4,2,7,6,-57,24,2,4,62,54
422,14,4,2,8,5,44,23,6,7,106,77
422,15,4,3,10,3,-54,30,2,7,52,107
422,16,3,4,4,9,31,-55,3,2,83,52
422,17,3,5,3,10,30,55,3,7,113,107
422,18,4,4,8,5,44,41,7,8,157,148
422,19,4,3,8,5,-56,-68,1,0,101,80
422,20,5,2,8,5,53,23,4,3,154,103
422,21,3,3,8,5,35,32,9,5,189,135
422,22,2,4,7,6,-75,42,4,7,114,177
422,23,3,4,5,8,32,-56,6,1,146,121
422,24,2,4,7,6,-75,42,1,3,71,163
422,25,3,4,3,10,30,46,1,9,101,209
422,26,3,4,5,8,32,-56,3,3,133,153
422,27,3,3,5,8,32,35,5,8,165,188
422,28,4,2,5,8,41,-74,6,4,206,114
422,29,2,5,4,9,22,54,8,8,228,168
422,30,5,2,7,6,-48,-76,0,2,180,92
422,31,6,2,9,4,63,22,3,4,243,114
422,32,3,4,4,9,31,45,4,9,274,159
422,33,5,2,8,5,53,-77,7,2,327,82
422,34,4,3,8,5,-56,32,1,4,271,114
422,35,2,4,7,6,25,42,6,6,296,156
422,36,2,4,5,8,23,-56,9,0,319,100
422,37,2,4,5,8,-77,44,2,4,242,144
422,38,5,2,9,4,54,22,6,6,296,166
422,39,5,2,8,5,53,23,9,9,349,189
422,40,2,4,7,6,-75,-58,4,1,274,131
422,41,6,2,11,2,65,20,9,1,339,151
422,42,3,4,6,7,-67,43,2,4,272,194
422,43,4,3,8,5,44,32,6,6,316,226
422,44,4,2,9,4,-55,22,1,8,261,248
422,45,3,4,4,9,31,-55,2,3,292,193
422,46,3,4,4,9,31,45,3,8,323,238
422,47,3,4,6,7,33,-57,6,1,356,181
422,48,3,3,6,7,33,34,9,5,389,215
422,49,4,2,7,6,-57,24,2,9,332,239
422,50,3,4,5,8,32,-56,4,3,364,183
422,51,3,4,6,7,33,43,7,6,397,226
422,52,4,4,7,6,-57,42,0,8,340,268
422,53,3,4,6,7,33,-57,3,1,373,211
422,54,2,5,5,8,23,53,6,4,396,264
422,55,4,3,7,6,43,33,9,7,439,297
422,56,5,2,8,5,-47,-77,2,0,392,220
422,57,2,4,6,7,24,43,6,3,416,263
422,58,2,4,4,9,22,45,8,8,438,308
422,59,2,5,4,9,-78,-46,0,2,360,262
422,60,3,3,7,6,34,33,4,5,394,295
422,61,3,4,3,10,30,-54,4,1,424,241
422,62,3,4,5,8,32,44,6,5,456,285
422,63,2,5,2,11,20,-44,6,1,476,241
422,64,5,2,8,5,53,23,9,4,529,264
423,1,5,2,10,3,55,21,5,1,55,21
423,2,2,4,3,10,21,46,6,7,76,67
423,3,2,4,5,8,23,-56,9,1,99,11
423,4,2,4,3,10,-79,46,0,7,20,57
423,5,4,3,8,5,44,32,4,9,64,89
423,6,2,6,5,8,23,-38,7,1,87,51
423,7,3,3,7,6,-66,33,1,4,21,84
423,8,4,2,8,5,44,23,5,7,65,107
423,9,3,3,6,7,33,-66,8,1,98,41
423,10,5,2,6,7,51,25,9,6,149,66
423,11,3,4,4,9,-69,-55,0,1,80,11
423,12,3,4,4,9,31,45,1,6,111,56
423,13,4,3,10,3,46,30,7,6,157,86
423,14,2,5,2,11,20,-44,7,2,177,42
423,15,4,2,9,4,-55,22,2,4,122,64
423,16,4,2,6,7,42,25,4,9,164,89
423,17,4,3,6,7,42,-66,6,3,206,23
423,18,3,3,4,9,31,36,7,9,237,59
423,19,3,3,8,5,-65,-68,2,1,172,-9
423,20,2,4,6,7,24,43,6,4,196,34
423,21,4,2,7,6,43,24,9,8,239,58
423,22,4,2,6,7,-58,-75,1,3,181,-17
423,23,5,2,11,2,56,20,7,3,237,3
423,24,3,3,5,8,32,35,9,8,269,38
423,25,3,4,4,9,-69,-55,0,3,200,-17
423,26,4,3,7,6,43,33,3,6,243,16
423,27,6,2,9,4,63,22,6,8,306,38
423,28,3,3,9,4,-64,31,2,9,242,69
423,29,4,2,8,5,44,-77,6,2,286,-8
423,30,4,3,10,3,-54,30,2,2,232,22
423,31,4,3,9,4,45,31,7,3,277,53
423,32,2,6,4,9,22,63,9,6,299,116
423,33,3,4,5,8,-68,-56,1,0,231,60
423,34,4,2,7,6,43,24,4,4,274,84
423,35,4,2,9,4,45,22,9,6,319,106
423,36,4,2,7,6,-57,-76,2,0,262,30
423,37,2,4,5,8,23,44,5,4,285,74
423,38,4,3,10,3,-54,30,1,4,231,104
423,39,4,3,9,4,45,31,6,5,276,135
423,40,2,5,3,10,21,-45,7,0,297,90
423,41,2,5,6,7,-76,52,1,2,221,142
423,42,4,3,10,3,46,30,7,2,267,172
423,43,2,4,7,6,-75,42,2,4,192,214
423,44,3,4,5,8,32,44,4,8,224,258
423,45,3,3,8,5,35,-68,9,0,259,190
423,46,3,3,5,8,-68,35,1,5,191,225
423,47,3,3,6,7,33,34,4,9,224,259
423,48,3,3,8,5,35,-68,9,1,259,191
423,49,4,2,7,6,-57,24,2,5,202,215
423,50,3,5,6,7,33,52,5,7,235,267
423,51,3,4,9,4,-64,40,1,7,171,307
423,52,5,2,8,5,53,-77,4,0,224,230
423,53,5,2,8,5,53,23,7,3,277,253
423,54,5,2,10,3,-45,21,2,4,232,274
423,55,3,4,5,8,32,44,4,8,264,318
423,56,5,2,9,4,54,-78,8,0,318,240
423,57,3,4,7,6,-66,42,2,2,252,282
423,58,3,3,5,8,32,35,4,7,284,317
423,59,5,2,9,4,54,22,8,9,338,339
423,60,2,4,7,6,-75,-58,3,1,263,281
423,61,3,4,6,7,33,43,6,4,296,324
423,62,3,3,4,9,31,-64,7,0,327,260
423,63,3,3,7,6,-66,33,1,3,261,293
423,64,3,3,6,7,33,34,4,7,294,327
423,65,4,3,9,4,45,31,9,8,339,358
423,66,5,2,11,2,-44,20,5,8,295,378
423,67,5,2,9,4,54,-78,9,0,349,300
423,68,4,3,9,4,-55,31,4,1,294,331
423,69,2,4,5,8,23,44,7,5,317,375
423,70,3,3,5,8,32,-65,9,0,349,310
423,71,4,3,6,7,-58,34,1,4,291,344
423,72,2,4,6,7,24,43,5,7,315,387
423,73,4,3,7,6,43,-67,8,0,358,320
423,74,2,4,2,11,20,47,8,7,378,367
423,75,3,4,6,7,-67,-57,1,0,311,310
423,76,4,3,8,5,44,32,5,2,355,342
423,77,5,2,9,4,54,22,9,4,409,364
423,78,4,3,10,3,-54,30,5,4,355,394
423,79,2,4,7,6,-75,42,0,6,280,436
423,80,3,3,7,6,34,33,4,9,314,469
423,81,4,2,9,4,45,-78,9,1,359,391
423,82,2,4,5,8,-77,44,2,5,282,435
423,83,2,4,5,8,23,44,5,9,305,479
423,84,4,3,5,8,41,-65,6,4,346,414
423,85,3,3,7,6,-66,33,0,7,280,447
423,86,5,2,10,3,55,21,5,8,335,468
423,87,4,3,5,8,41,-65,6,3,376,403
423,88,3,3,5,8,32,35,8,8,408,438
423,89,3,3,7,6,-66,-67,2,1,342,371
423,90,5,2,9,4,54,22,6,3,396,393
423,91,5,2,9,4,-46,22,0,5,350,415
423,92,2,4,7,6,25,42,5,7,375,457
423,93,3,3,6,7,33,-66,8,1,408,391
423,94,3,4,3,10,30,46,8,7,438,437
423,95,2,5,6,7,-76,52,2,9,362,489
423,96,4,3,6,7,42,-66,4,3,404,423
423,97,4,2,6,7,42,25,6,8,446,448
423,98,3,3,5,8,32,-65,8,3,478,383
423,99,5,2,9,4,-46,22,2,5,432,405
423,100,5,2,8,5,53,23,5,8,485,428
423,101,3,3,6,7,33,-66,8,2,518,362
424,1,4,2,8,5,44,23,4,3,44,23
424,2,4,2,10,3,-54,21,0,4,-10,44
424,3,2,6,5,8,23,62,3,6,13,106
424,4,3,4,5,8,32,-56,5,0,45,50
424,5,2,4,3,10,21,46,6,6,66,96
424,6,3,3,8,5,-65,32,1,8,1,128
424,7,3,4,4,9,31,-55,2,3,32,73
424,8,3,4,6,7,33,43,5,6,65,116
424,9,5,2,8,5,53,23,8,9,118,139
424,10,2,4,7,6,-75,-58,3,1,43,81
424,11,4,3,7,6,43,33,6,4,86,114
424,12,2,4,5,8,23,44,9,8,109,158
424,13,4,2,9,4,-55,-78,4,0,54,80
424,14,2,5,4,9,22,54,6,4,76,134
424,15,4,2,6,7,42,25,8,9,118,159
424,16,3,4,6,7,-67,-57,1,2,51,102
424,17,4,2,5,8,41,26,2,8,92,128
424,18,4,3,7,6,43,-67,5,1,135,61
424,19,3,3,7,6,34,33,9,4,169,94
424,20,3,3,6,7,-67,34,2,8,102,128
424,21,2,4,5,8,23,-56,5,2,125,72
424,22,3,3,7,6,34,33,9,5,159,105
424,23,2,4,5,8,-77,44,2,9,82,149
424,24,3,4,8,5,35,-59,7,0,117,90
424,25,3,4,8,5,-65,41,2,1,52,131
424,26,5,3,8,5,53,32,5,3,105,163
424,27,3,3,8,5,-65,32,0,5,40,195
424,28,4,2,9,4,45,22,5,7,85,217
424,29,4,2,8,5,44,-77,9,0,129,140
424,30,4,3,7,6,-57,33,2,3,72,173
424,31,5,2,9,4,54,22,6,5,126,195
424,32,3,3,8,5,-65,32,1,7,61,227
424,33,3,3,7,6,34,-67,5,0,95,160
424,34,4,2,11,2,-53,20,2,0,42,180
424,35,4,3,8,5,44,32,6,2,86,212
424,36,5,3,7,6,52,33,8,5,138,245
424,37,3,3,6,7,-67,34,1,9,71,279
424,38,5,2,11,2,56,20,7,9,127,299
424,39,2,5,2,11,20,-44,7,5,147,255
424,40,2,5,4,9,22,54,9,9,169,309
424,41,3,3,5,8,-68,-65,1,4,101,244
424,42,3,3,7,6,34,33,5,7,135,277
424,43,5,3,8,5,53,32,8,9,188,309
424,44,4,4,8,5,-56,-59,2,0,132,250
424,45,4,3,5,8,41,35,3,5,173,285
424,46,5,2,7,6,52,24,5,9,225,309
424,47,5,2,10,3,-45,-79,0,0,180,230
424,48,3,4,6,7,33,43,3,3,213,273
424,49,2,5,6,7,24,52,7,5,237,325
424,50,2,5,3,10,21,-45,8,0,258,280
424,51,3,3,6,7,-67,34,1,4,191,314
424,52,3,3,6,7,33,34,4,8,224,348
424,53,3,3,6,7,33,-66,7,2,257,282
424,54,3,4,7,6,-66,42,1,4,191,324
424,55,2,5,4,9,22,54,3,8,213,378
424,56,2,6,4,9,22,-37,5,1,235,341
424,57,2,4,4,9,22,45,7,6,257,386
424,58,3,3,8,5,-65,32,2,8,192,418
424,59,4,3,8,5,44,-68,6,0,236,350
424,60,2,5,7,6,-75,51,1,1,161,401
424,61,6,2,9,4,63,22,4,3,224,423
424,62,3,3,8,5,35,32,9,5,259,455
424,63,3,4,4,9,-69,-55,0,0,190,400
424,64,3,4,6,7,33,43,3,3,223,443
424,65,3,4,5,8,32,44,5,7,255,487
424,66,5,2,10,3,-45,21,0,8,210,508
425,1,3,3,9,4,36,31,6,1,36,31
425,2,4,4,9,4,-55,40,1,1,-19,71
425,3,2,5,5,8,23,53,4,4,4,124
425,4,5,2,10,3,55,21,9,5,59,145
425,5,2,5,5,8,-77,53,2,8,-18,198
425,6,3,5,4,9,31,-46,3,2,13,152
425,7,3,3,6,7,33,34,6,6,46,186
425,8,3,3,5,8,32,-65,8,1,78,121
425,9,4,2,7,6,-57,24,1,5,21,145
425,10,4,2,9,4,45,22,6,7,66,167
425,11,4,3,9,4,-55,31,1,8,11,198
425,12,3,3,4,9,31,-64,2,4,42,134
425,13,3,4,4,9,31,45,3,9,73,179
425,14,5,2,8,5,53,-77,6,2,126,102
425,15,4,2,8,5,-56,23,0,5,70,125
425,16,4,3,6,7,42,34,2,9,112,159
425,17,3,4,5,8,32,-56,4,3,144,103
425,18,4,3,7,6,43,33,7,6,187,136
425,19,4,2,6,7,42,-75,9,1,229,61
425,20,4,2,9,4,-55,22,4,3,174,83
425,21,4,2,8,5,44,23,8,6,218,106
425,22,2,5,4,9,-78,-46,0,0,140,60
425,23,3,4,5,8,32,44,2,4,172,104
425,24,3,4,5,8,32,44,4,8,204,148
425,25,4,2,9,4,45,-78,9,0,249,70
425,26,3,4,5,8,-68,44,1,4,181,114
425,27,6,2,8,5,62,23,3,7,243,137
425,28,5,2,8,5,53,-77,6,0,296,60
425,29,3,4,8,5,-65,41,1,1,231,101
425,30,4,2,6,7,42,25,3,6,273,126
425,31,3,3,6,7,33,-66,6,0,306,60
425,32,5,2,9,4,-46,22,0,2,260,82
425,33,2,5,2,11,20,56,0,8,280,138
425,34,3,4,5,8,32,-56,2,2,312,82
425,35,2,4,6,7,24,43,6,5,336,125
425,36,3,4,8,5,-65,41,1,6,271,166
425,37,3,3,7,6,34,33,5,9,305,199
425,38,4,4,7,6,43,-58,8,1,348,141
425,39,3,3,7,6,-66,33,2,4,282,174
425,40,4,2,5,8,41,-74,3,0,323,100
425,41,3,4,4,9,31,45,4,5,354,145
425,42,4,2,8,5,44,23,8,8,398,168
425,43,2,5,5,8,-77,-47,1,1,321,121
425,44,3,3,7,6,34,33,5,4,355,154
425,45,2,4,4,9,22,45,7,9,377,199
425,46,2,5,3,10,21,-45,8,4,398,154
425,47,5,2,8,5,-47,23,1,7,351,177
425,48,4,3,8,5,44,32,5,9,395,209
425,49,4,3,7,6,43,-67,8,2,438,142
425,50,4,2,7,6,-57,24,1,6,381,166
425,51,5,3,9,4,54,31,5,7,435,197
425,52,4,2,8,5,44,-77,9,0,479,120
425,53,2,4,5,8,-77,44,2,4,402,164
425,54,3,3,8,5,35,32,7,6,437,196
425,55,3,4,7,6,-66,42,1,8,371,238
425,56,2,5,4,9,22,-46,3,2,393,192
425,57,2,6,5,8,23,62,6,4,416,254
425,58,3,4,4,9,31,45,7,9,447,299
425,59,3,3,10,3,-63,30,4,9,384,329
425,60,3,4,5,8,32,-56,6,3,416,273
425,61,4,2,7,6,43,24,9,7,459,297
425,62,3,4,7,6,-66,42,3,9,393,339
425,63,3,3,5,8,32,-65,5,4,425,274
425,64,4,3,8,5,44,32,9,6,469,306
425,65,3,3,9,4,-64,31,5,7,405,337
425,66,3,3,3,10,30,-63,5,4,435,274
425,67,3,4,8,5,-65,41,0,5,370,315
425,68,3,3,6,7,33,34,3,9,403,349
425,69,2,4,3,10,21,-54,4,5,424,295
425,70,3,4,6,7,33,43,7,8,457,338
425,71,5,2,8,5,-47,-77,0,1,410,261
425,72,3,4,6,7,33,43,3,4,443,304
425,73,3,3,7,6,34,33,7,7,477,337
425,74,2,4,6,7,-76,-57,1,0,401,280
425,75,3,4,4,9,31,45,2,5,432,325
425,76,3,3,8,5,35,32,7,7,467,357
425,77,2,4,5,8,-77,-56,0,1,390,301
425,78,3,3,5,8,32,35,2,6,422,336
425,79,3,4,4,9,31,-55,3,1,453,281
425,80,3,4,4,9,31,45,4,6,484,326
425,81,4,3,8,5,44,32,8,8,528,358
426,1,4,3,8,5,44,32,4,2,44,32
426,2,3,4,6,7,33,43,7,5,77,75
426,3,2,4,4,9,22,-55,9,0,99,20
426,4,4,3,7,6,-57,33,2,3,42,53
426,5,3,4,5,8,32,44,4,7,74,97
426,6,4,2,7,6,43,-76,7,1,117,21
426,7,5,2,11,2,-44,20,3,1,73,41
426,8,3,3,5,8,32,35,5,6,105,76
426,9,4,3,7,6,43,33,8,9,148,109
426,10,5,2,10,3,-45,-79,3,0,103,30
426,11,4,3,7,6,43,33,6,3,146,63
426,12,2,5,4,9,22,54,8,7,168,117
426,13,4,2,5,8,41,-74,9,3,209,43
426,14,3,3,5,8,-68,35,1,8,141,78
426,15,2,5,4,9,22,-46,3,2,163,32
426,16,3,3,5,8,32,35,5,7,195,67
426,17,2,5,5,8,23,-47,8,0,218,20
426,18,5,2,10,3,-45,21,3,1,173,41
426,19,6,2,10,3,64,21,7,2,237,62
426,20,2,5,5,8,-77,53,0,5,160,115
426,21,3,3,6,7,33,34,3,9,193,149
426,22,3,4,5,8,32,-56,5,3,225,93
426,23,3,3,5,8,32,35,7,8,257,128
426,24,3,3,7,6,-66,-67,1,1,191,61
426,25,4,2,10,3,46,21,7,2,237,82
426,26,3,4,6,7,-67,43,0,5,170,125
426,27,3,3,5,8,32,-65,2,0,202,60
426,28,3,4,6,7,33,43,5,3,235,103
426,29,2,5,4,9,22,54,7,7,257,157
426,30,4,4,6,7,42,-57,9,0,299,100
426,31,3,4,8,5,-65,41,4,1,234,141
426,32,3,4,4,9,31,45,5,6,265,186
426,33,3,3,7,6,34,33,9,9,299,219
426,34,4,2,6,7,-58,-75,1,4,241,144
426,35,4,3,5,8,41,35,2,9,282,179
426,36,2,4,7,6,25,-58,7,1,307,121
426,37,4,3,9,4,-55,31,2,2,252,152
426,38,3,4,5,8,32,44,4,6,284,196
426,39,4,3,6,7,42,-66,6,0,326,130
426,40,3,4,8,5,-65,41,1,1,261,171
426,41,3,3,5,8,32,35,3,6,293,206
426,42,2,4,4,9,22,-55,5,1,315,151
426,43,3,4,6,7,33,43,8,4,348,194
426,44,2,5,4,9,-78,54,0,8,270,248
426,45,4,3,6,7,42,-66,2,2,312,182
426,46,4,2,9,4,45,22,7,4,357,204
426,47,5,2,9,4,-46,22,1,6,311,226
426,48,3,4,6,7,33,43,4,9,344,269
426,49,2,5,3,10,21,-45,5,4,365,224
426,50,4,2,7,6,43,24,8,8,408,248
426,51,3,3,5,8,-68,-65,0,3,340,183
426,52,5,2,11,2,56,20,6,3,396,203
426,53,3,3,5,8,32,35,8,8,428,238
426,54,3,4,7,6,-66,-58,2,0,362,180
426,55,3,3,6,7,33,34,5,4,395,214
426,56,3,3,4,9,31,-64,6,0,426,150
426,57,2,5,4,9,22,54,8,4,448,204
426,58,4,3,6,7,-58,34,0,8,390,238
426,59,3,3,6,7,33,-66,3,2,423,172
426,60,3,3,7,6,34,33,7,5,457,205
426,61,2,5,4,9,22,54,9,9,479,259
426,62,4,2,8,5,-56,-77,3,2,423,182
426,63,2,5,4,9,22,54,5,6,445,236
426,64,4,3,6,7,42,-66,7,0,487,170
426,65,3,4,5,8,32,44,9,4,519,214
427,1,3,3,4,9,31,36,1,6,31,36
427,2,4,2,9,4,45,22,6,8,76,58
427,3,2,6,3,10,21,-36,7,2,97,22
427,4,3,4,4,9,31,45,8,7,128,67
427,5,3,3,6,7,-67,-66,1,1,61,1
427,6,3,3,4,9,31,36,2,7,92,37
427,7,2,4,6,7,24,-57,6,0,116,-20
427,8,3,3,6,7,33,34,9,4,149,14
427,9,2,4,5,8,-77,44,2,8,72,58
427,10,5,2,11,2,56,20,8,8,128,78
427,11,4,2,8,5,-56,-77,2,1,72,1
427,12,3,4,7,6,34,42,6,3,106,43
427,13,2,5,5,8,23,53,9,6,129,96
427,14,4,3,8,5,-56,32,3,8,73,128
427,15,2,5,6,7,24,-48,7,0,97,80
427,16,4,3,6,7,42,34,9,4,139,114
427,17,4,3,4,9,40,-64,9,0,179,50
427,18,3,4,6,7,-67,43,2,3,112,93
427,19,3,3,5,8,32,35,4,8,144,128
427,20,5,2,9,4,54,-78,8,0,198,50
427,21,4,2,9,4,-55,22,3,2,143,72
427,22,3,3,7,6,34,33,7,5,177,105
427,23,3,4,7,6,-66,42,1,7,111,147
427,24,3,3,5,8,32,-65,3,2,143,82
427,25,2,5,3,10,21,55,4,7,164,137
427,26,3,3,5,8,32,-65,6,2,196,72
427,27,3,3,5,8,32,35,8,7,228,107
427,28,2,6,2,11,20,-35,8,2,248,72
427,29,4,2,9,4,-55,22,3,4,193,94
427,30,4,3,4,9,40,-64,3,0,233,30
427,31,2,4,6,7,24,43,7,3,257,73
427,32,4,2,8,5,-56,23,1,6,201,96
427,33,3,4,6,7,33,43,4,9,234,139
427,34,3,3,8,5,35,-68,9,1,269,71
427,35,3,3,7,6,-66,33,3,4,203,104
427,36,4,3,8,5,44,32,7,6,247,136
427,37,4,3,8,5,-56,32,1,8,191,168
427,38,2,5,4,9,22,-46,3,2,213,122
427,39,3,4,7,6,34,42,7,4,247,164
427,40,2,4,6,7,-76,43,1,7,171,207
427,41,4,3,6,7,42,-66,3,1,213,141
427,42,3,4,3,10,30,46,3,7,243,187
427,43,3,3,6,7,33,-66,6,1,276,121
427,44,4,3,9,4,-55,31,1,2,221,152
427,45,2,4,4,9,22,45,3,7,243,197
427,46,4,3,9,4,45,31,8,8,288,228
427,47,3,3,9,4,-64,31,4,9,224,259
427,48,5,2,11,2,-44,20,0,9,180,279
427,49,4,3,4,9,40,-64,0,5,220,215
427,50,3,3,6,7,33,34,3,9,253,249
427,51,3,3,6,7,33,-66,6,3,286,183
427,52,4,3,6,7,42,34,8,7,328,217
427,53,4,2,10,3,-54,21,4,8,274,238
427,54,3,4,8,5,35,41,9,9,309,279
427,55,4,2,8,5,-56,-77,3,2,253,202
427,56,2,6,3,10,21,64,4,6,274,266
427,57,3,4,6,7,33,43,7,9,307,309
427,58,2,6,2,11,20,-35,7,4,327,274
427,59,3,4,5,8,32,44,9,8,359,318
427,60,5,2,9,4,-46,-78,3,0,313,240
427,61,3,3,6,7,33,34,6,4,346,274
427,62,3,4,4,9,31,45,7,9,377,319
427,63,3,3,10,3,-63,30,4,9,314,349
427,64,3,4,7,6,34,-58,8,1,348,291
427,65,3,4,6,7,-67,43,1,4,281,334
427,66,4,2,7,6,43,24,4,8,324,358
427,67,2,5,6,7,24,-48,8,0,348,310
427,68,4,3,8,5,-56,32,2,2,292,342
427,69,4,3,7,6,43,33,5,5,335,375
427,70,4,2,6,7,42,-75,7,0,377,300
427,71,3,4,4,9,31,45,8,5,408,345
427,72,2,5,4,9,-78,54,0,9,330,399
427,73,3,4,3,10,30,-54,0,5,360,345
427,74,3,4,5,8,32,44,2,9,392,389
427,75,3,4,5,8,32,-56,4,3,424,333
427,76,6,2,11,2,65,20,9,3,489,353
427,77,5,2,11,2,-44,20,5,3,445,373
427,78,3,4,5,8,32,44,7,7,477,417
427,79,2,5,5,8,-77,-47,0,0,400,370
427,80,2,5,5,8,23,53,3,3,423,423
427,81,3,3,9,4,36,31,9,4,459,454
427,82,4,2,10,3,-54,21,5,5,405,475
427,83,2,6,3,10,21,64,6,9,426,539
428,1,3,4,4,9,31,45,1,5,31,45
428,2,4,3,8,5,44,32,5,7,75,77
428,3,2,4,4,9,22,-55,7,2,97,22
428,4,4,4,5,8,41,44,8,6,138,66
428,5,3,4,7,6,-66,42,2,8,72,108
428,6,4,3,6,7,42,-66,4,2,114,42
428,7,4,3,9,4,45,31,9,3,159,73
428,8,4,3,10,3,-54,30,5,3,105,103
428,9,5,3,7,6,52,33,7,6,157,136
428,10,4,3,7,6,-57,33,0,9,100,169
428,11,3,3,10,3,37,30,7,9,137,199
428,12,4,2,7,6,-57,-76,0,3,80,123
428,13,3,4,4,9,31,45,1,8,111,168
428,14,3,4,7,6,34,-58,5,0,145,110
428,15,2,4,4,9,22,45,7,5,167,155
428,16,4,2,7,6,-57,24,0,9,110,179
428,17,3,4,6,7,33,-57,3,2,143,122
428,18,5,3,10,3,55,30,8,2,198,152
428,19,4,2,11,2,-53,20,5,2,145,172
428,20,4,3,10,3,-54,30,1,2,91,202
428,21,2,6,3,10,21,64,2,6,112,266
428,22,5,2,7,6,52,-76,4,0,164,190
428,23,2,4,5,8,23,44,7,4,187,234
428,24,5,2,10,3,-45,21,2,5,142,255
428,25,3,4,7,6,34,42,6,7,176,297
428,26,3,4,3,10,30,-54,6,3,206,243
428,27,4,3,5,8,41,35,7,8,247,278
428,28,5,2,10,3,-45,21,2,9,202,299
428,29,3,3,8,5,35,-68,7,1,237,231
428,30,2,4,5,8,-77,44,0,5,160,275
428,31,2,4,5,8,23,44,3,9,183,319
428,32,4,2,6,7,42,-75,5,4,225,244
428,33,4,3,6,7,42,34,7,8,267,278
428,34,2,5,4,9,22,-46,9,2,289,232
428,35,2,4,6,7,-76,43,3,5,213,275
428,36,3,4,8,5,35,41,8,6,248,316
428,37,2,4,4,9,-78,-55,0,1,170,261
428,38,3,3,8,5,35,32,5,3,205,293
428,39,2,4,7,6,-75,42,0,5,130,335
428,40,3,3,9,4,36,31,6,6,166,366
428,41,5,3,8,5,53,32,9,8,219,398
428,42,2,5,6,7,-76,-48,3,0,143,350
428,43,3,3,8,5,35,32,8,2,178,382
428,44,2,4,6,7,-76,43,2,5,102,425
428,45,2,5,5,8,23,53,5,8,125,478
428,46,2,4,6,7,24,-57,9,1,149,421
428,47,3,4,6,7,-67,43,2,4,82,464
428,48,4,3,8,5,44,32,6,6,126,496
428,49,3,3,6,7,33,-66,9,0,159,430
428,50,2,5,5,8,-77,53,2,3,82,483
428,51,3,4,5,8,32,44,4,7,114,527
429,1,3,4,7,6,34,42,4,2,34,42
429,2,5,2,7,6,52,24,6,6,86,66
429,3,2,5,4,9,22,-46,8,0,108,20
429,4,4,3,10,3,-54,30,4,0,54,50
429,5,3,4,5,8,32,44,6,4,86,94
429,6,4,3,7,6,43,33,9,7,129,127
429,7,3,4,9,4,-64,40,5,7,65,167
429,8,4,2,10,3,-54,21,1,8,11,188
429,9,2,4,6,7,24,-57,5,1,35,131
429,10,4,2,7,6,43,24,8,5,78,155
429,11,2,4,4,9,-78,-55,0,0,0,100
429,12,3,4,6,7,33,43,3,3,33,143
429,13,2,4,6,7,24,43,7,6,57,186
429,14,3,5,5,8,32,53,9,9,89,239
429,15,2,4,6,7,-76,-57,3,2,13,182
429,16,2,4,4,9,22,45,5,7,35,227
429,17,4,3,5,8,41,-65,6,2,76,162
429,18,2,5,3,10,21,55,7,7,97,217
429,19,3,4,6,7,-67,-57,0,0,30,160
429,20,2,4,5,8,23,44,3,4,53,204
429,21,2,4,7,6,25,42,8,6,78,246
429,22,3,3,7,6,-66,33,2,9,12,279
429,23,2,4,5,8,23,-56,5,3,35,223
429,24,4,3,6,7,42,34,7,7,77,257
429,25,3,3,8,5,-65,32,2,9,12,289
429,26,4,3,9,4,45,-69,7,0,57,220
429,27,3,4,3,10,30,46,7,6,87,266
429,28,5,2,11,2,-44,20,3,6,43,286
429,29,2,4,4,9,22,-55,5,1,65,231
429,30,3,3,7,6,34,33,9,4,99,264
429,31,3,3,6,7,-67,34,2,8,32,298
429,32,2,4,5,8,23,-56,5,2,55,242
429,33,4,3,9,4,-55,31,0,3,0,273
429,34,2,4,5,8,23,44,3,7,23,317
429,35,3,3,6,7,33,-66,6,1,56,251
429,36,4,2,11,2,-53,20,3,1,3,271
429,37,3,5,5,8,32,53,5,4,35,324
429,38,2,4,6,7,24,43,9,7,59,367
429,39,2,5,5,8,-77,-47,2,0,-18,320
429,40,3,3,6,7,33,34,5,4,15,354
429,41,4,2,9,4,-55,22,0,6,-40,376
429,42,4,2,9,4,45,22,5,8,5,398
429,43,3,4,7,6,34,-58,9,0,39,340
429,44,5,2,7,6,-48,24,1,4,-9,364
429,45,4,2,10,3,46,21,7,5,37,385
429,46,3,3,6,7,-67,34,0,9,-30,419
429,47,4,2,6,7,42,-75,2,4,12,344
429,48,4,3,8,5,44,32,6,6,56,376
429,49,3,3,8,5,-65,32,1,8,-9,408
429,50,2,4,7,6,25,-58,6,0,16,350
429,51,4,3,9,4,-55,31,1,1,-39,381
429,52,2,5,3,10,21,55,2,6,-18,436
429,53,2,5,3,10,21,-45,3,1,3,391
429,54,3,3,7,6,34,33,7,4,37,424
429,55,4,2,8,5,-56,23,1,7,-19,447
429,56,4,2,9,4,45,22,6,9,26,469
429,57,3,3,5,8,32,-65,8,4,58,404
429,58,4,2,9,4,-55,22,3,6,3,426
429,59,5,2,7,6,52,-76,5,0,55,350
429,60,5,2,6,7,51,25,6,5,106,375
429,61,4,3,7,6,43,33,9,8,149,408
429,62,2,5,7,6,-75,51,4,9,74,459
429,63,3,5,6,7,33,-48,7,1,107,411
429,64,3,4,4,9,31,45,8,6,138,456
429,65,2,5,4,9,-78,-46,0,0,60,410
429,66,3,4,6,7,33,43,3,3,93,453
429,67,4,2,9,4,45,22,8,5,138,475
429,68,2,4,5,8,-77,44,1,9,61,519
430,1,4,4,5,8,41,44,1,4,41,44
430,2,4,3,8,5,44,32,5,6,85,76
430,3,3,3,8,5,-65,32,0,8,20,108
430,4,4,3,7,6,43,-67,3,1,63,41
430,5,4,2,8,5,44,23,7,4,107,64
430,6,3,3,8,5,-65,32,2,6,42,96
430,7,3,3,7,6,34,33,6,9,76,129
430,8,5,2,9,4,-46,-78,0,1,30,51
430,9,4,3,7,6,43,33,3,4,73,84
430,10,4,3,6,7,42,34,5,8,115,118
430,11,3,3,8,5,-65,-68,0,0,50,50
430,12,4,3,8,5,44,32,4,2,94,82
430,13,3,3,7,6,34,33,8,5,128,115
430,14,2,5,3,10,21,-45,9,0,149,70
430,15,4,2,8,5,-56,23,3,3,93,93
430,16,3,5,6,7,33,52,6,5,126,145
430,17,4,3,9,4,-55,31,1,6,71,176
430,18,4,3,7,6,43,33,4,9,114,209
430,19,3,4,5,8,32,-56,6,3,146,153
430,20,3,5,6,7,33,52,9,5,179,205
430,21,2,4,6,7,-76,43,3,8,103,248
430,22,4,4,9,4,45,40,8,8,148,288
430,23,4,4,5,8,41,-56,9,2,189,232
430,24,3,4,7,6,-66,42,3,4,123,274
430,25,2,5,5,8,23,53,6,7,146,327
430,26,3,3,8,5,-65,32,1,9,81,359
430,27,3,4,3,10,30,-54,1,5,111,305
430,28,2,5,2,11,20,-44,1,1,131,261
430,29,5,2,8,5,53,23,4,4,184,284
430,30,3,4,7,6,34,42,8,6,218,326
430,31,2,6,4,9,-78,63,0,9,140,389
430,32,3,4,7,6,34,-58,4,1,174,331
430,33,3,3,7,6,34,33,8,4,208,364
430,34,3,3,5,8,-68,35,0,9,140,399
430,35,4,3,9,4,45,-69,5,0,185,330
430,36,4,3,4,9,40,36,5,6,225,366
430,37,2,5,5,8,23,53,8,9,248,419
430,38,3,4,5,8,-68,-56,0,3,180,363
430,39,2,6,3,10,21,64,1,7,201,427
430,40,4,3,7,6,43,-67,4,0,244,360
430,41,4,2,7,6,43,24,7,4,287,384
430,42,4,2,6,7,42,25,9,9,329,409
430,43,3,4,5,8,-68,-56,1,3,261,353
430,44,4,3,6,7,42,34,3,7,303,387
430,45,2,4,5,8,23,-56,6,1,326,331
430,46,4,3,10,3,-54,30,2,1,272,361
430,47,3,3,5,8,32,35,4,6,304,396
430,48,4,3,5,8,41,-65,5,1,345,331
430,49,2,4,6,7,24,43,9,4,369,374
430,50,3,4,5,8,-68,44,1,8,301,418
430,51,2,5,3,10,21,-45,2,3,322,373
430,52,5,2,9,4,54,22,6,5,376,395
430,53,3,3,7,6,-66,33,0,8,310,428
430,54,3,3,7,6,34,-67,4,1,344,361
430,55,3,3,5,8,32,35,6,6,376,396
430,56,4,3,6,7,42,-66,8,0,418,330
430,57,3,4,5,8,-68,44,0,4,350,374
430,58,4,2,8,5,44,23,4,7,394,397
430,59,4,2,7,6,43,-76,7,1,437,321
430,60,4,3,8,5,-56,32,1,3,381,353
430,61,2,5,2,11,20,56,1,9,401,409
430,62,2,4,6,7,24,-57,5,2,425,352
430,63,4,2,9,4,-55,22,0,4,370,374
430,64,2,6,6,7,24,61,4,5,394,435
430,65,4,2,9,4,45,22,9,7,439,457
430,66,4,2,10,3,-54,21,5,8,385,478
430,67,4,3,4,9,40,-64,5,4,425,414
430,68,4,3,9,4,-55,31,0,5,370,445
430,69,3,4,6,7,33,43,3,8,403,488
430,70,3,4,7,6,34,-58,7,0,437,430
430,71,2,4,4,9,22,45,9,5,459,475
430,72,2,4,7,6,-75,42,4,7,384,517
431,1,4,3,9,4,45,31,5,1,45,31
431,2,2,5,3,10,21,55,6,6,66,86
431,3,3,3,6,7,33,-66,9,0,99,20
431,4,2,5,6,7,-76,52,3,2,23,72
431,5,4,2,8,5,44,23,7,5,67,95
431,6,2,5,3,10,21,-45,8,0,88,50
431,7,4,3,6,7,-58,34,0,4,30,84
431,8,2,4,4,9,22,45,2,9,52,129
431,9,4,2,9,4,45,-78,7,1,97,51
431,10,3,4,7,6,-66,42,1,3,31,93
431,11,3,3,5,8,32,35,3,8,63,128
431,12,3,3,8,5,35,-68,8,0,98,60
431,13,4,2,6,7,-58,25,0,5,40,85
431,14,2,4,7,6,25,42,5,7,65,127
431,15,3,3,6,7,33,-66,8,1,98,61
431,16,3,5,5,8,-68,53,0,4,30,114
431,17,3,4,5,8,32,44,2,8,62,158
431,18,3,5,6,7,33,-48,5,0,95,110
431,19,2,6,1,12,-20,66,5,6,75,176
431,20,3,3,8,5,-65,32,0,8,10,208
431,21,2,5,8,5,26,50,6,8,36,258
431,22,5,2,10,3,-45,21,1,9,-9,279
431,23,3,4,4,9,31,-55,2,4,22,224
431,24,2,4,9,4,27,40,9,4,49,264
431,25,3,4,6,7,-67,43,2,7,-18,307
431,26,3,3,5,8,32,-65,4,2,14,242
431,27,3,4,3,10,30,46,4,8,44,288
431,28,5,2,10,3,55,21,9,9,99,309
431,29,3,4,5,8,-68,-56,1,3,31,253
431,30,4,3,9,4,45,31,6,4,76,284
431,31,5,2,10,3,-45,21,1,5,31,305
431,32,3,3,6,7,33,34,4,9,64,339
431,33,2,5,5,8,23,-47,7,2,87,292
431,34,4,2,6,7,42,25,9,7,129,317
431,35,3,3,8,5,-65,32,4,9,64,349
431,36,2,4,5,8,23,-56,7,3,87,293
431,37,3,4,7,6,-66,42,1,5,21,335
431,38,4,2,8,5,44,23,5,8,65,358
431,39,4,2,8,5,44,-77,9,1,109,281
431,40,4,2,8,5,-56,23,3,4,53,304
431,41,5,2,7,6,52,24,5,8,105,328
431,42,5,2,11,2,-44,20,1,8,61,348
431,43,3,4,6,7,33,-57,4,1,94,291
431,44,5,2,9,4,54,22,8,3,148,313
431,45,4,3,7,6,-57,33,1,6,91,346
431,46,2,4,5,8,23,-56,4,0,114,290
431,47,3,4,7,6,34,42,8,2,148,332
431,48,4,3,6,7,-58,34,0,6,90,366
431,49,4,2,7,6,43,-76,3,0,133,290
431,50,4,2,6,7,42,25,5,5,175,315
431,51,3,4,7,6,34,42,9,7,209,357
431,52,2,4,6,7,-76,-57,3,0,133,300
431,53,3,4,5,8,32,44,5,4,165,344
431,54,4,2,8,5,44,23,9,7,209,367
431,55,4,3,9,4,-55,31,4,8,154,398
431,56,4,2,7,6,43,-76,7,2,197,322
431,57,3,4,6,7,-67,43,0,5,130,365
431,58,4,2,9,4,45,22,5,7,175,387
431,59,3,3,8,5,-65,32,0,9,110,419
431,60,2,4,7,6,25,-58,5,1,135,361
431,61,3,4,6,7,33,43,8,4,168,404
431,62,3,4,7,6,-66,42,2,6,102,446
431,63,2,5,7,6,25,51,7,7,127,497
431,64,3,4,6,7,-67,-57,0,0,60,440
431,65,4,2,7,6,43,24,3,4,103,464
431,66,3,4,7,6,34,42,7,6,137,506
432,1,4,3,7,6,43,33,3,3,43,33
432,2,3,4,4,9,31,45,4,8,74,78
432,3,2,5,6,7,24,-48,8,0,98,30
432,4,5,2,8,5,-47,23,1,3,51,53
432,5,4,4,7,6,43,42,4,5,94,95
432,6,2,4,5,8,23,44,7,9,117,139
432,7,3,3,7,6,-66,-67,1,2,51,72
432,8,2,4,5,8,23,44,4,6,74,116
432,9,3,4,5,8,32,-56,6,0,106,60
432,10,3,5,3,10,30,55,6,5,136,115
432,11,5,2,7,6,52,24,8,9,188,139
432,12,2,5,7,6,-75,-49,3,0,113,90
432,13,2,4,5,8,23,44,6,4,136,134
432,14,2,4,6,7,-76,43,0,7,60,177
432,15,3,4,8,5,35,41,5,8,95,218
432,16,2,4,5,8,23,-56,8,2,118,162
432,17,3,4,6,7,-67,43,1,5,51,205
432,18,3,3,8,5,35,32,6,7,86,237
432,19,3,4,6,7,33,-57,9,0,119,180
432,20,3,3,7,6,-66,33,3,3,53,213
432,21,3,3,6,7,33,34,6,7,86,247
432,22,4,2,7,6,43,-76,9,1,129,171
432,23,4,2,5,8,-59,26,0,7,70,197
432,24,3,3,7,6,34,-67,4,0,104,130
432,25,2,5,6,7,24,52,8,2,128,182
432,26,2,6,4,9,-78,63,0,5,50,245
432,27,4,3,7,6,43,33,3,8,93,278
432,28,3,4,4,9,31,-55,4,3,124,223
432,29,5,2,10,3,55,21,9,4,179,244
432,30,2,5,3,10,-79,55,0,9,100,299
432,31,4,3,8,5,44,-68,4,1,144,231
432,32,3,4,7,6,34,42,8,3,178,273
432,33,2,5,2,11,20,56,8,9,198,329
432,34,4,2,8,5,-56,-77,2,2,142,252
432,35,4,3,8,5,44,32,6,4,186,284
432,36,3,4,3,10,30,-54,6,0,216,230
432,37,5,2,9,4,-46,22,0,2,170,252
432,38,3,4,4,9,31,45,1,7,201,297
432,39,5,2,9,4,54,22,5,9,255,319
432,40,4,3,7,6,43,-67,8,2,298,252
432,41,2,6,5,8,-77,62,1,4,221,314
432,42,3,4,4,9,31,45,2,9,252,359
432,43,5,2,9,4,54,-78,6,1,306,281
432,44,4,2,7,6,43,24,9,5,349,305
432,45,3,4,5,8,-68,44,1,9,281,349
432,46,3,4,7,6,34,-58,5,1,315,291
432,47,3,4,5,8,32,44,7,5,347,335
432,48,4,3,6,7,42,34,9,9,389,369
432,49,4,2,8,5,-56,-77,3,2,333,292
432,50,2,4,6,7,24,43,7,5,357,335
432,51,4,3,8,5,-56,32,1,7,301,367
432,52,4,2,9,4,45,22,6,9,346,389
432,53,4,3,9,4,-55,-69,1,0,291,320
432,54,5,2,5,8,50,26,1,6,341,346
432,55,3,4,3,10,30,-54,1,2,371,292
432,56,3,3,9,4,36,31,7,3,407,323
432,57,4,3,7,6,-57,33,0,6,350,356
432,58,3,3,7,6,34,33,4,9,384,389
432,59,4,2,8,5,44,-77,8,2,428,312
432,60,5,2,10,3,-45,21,3,3,383,333
432,61,3,3,4,9,31,36,4,9,414,369
432,62,3,4,7,6,34,-58,8,1,448,311
432,63,2,4,6,7,-76,43,2,4,372,354
432,64,4,3,9,4,45,31,7,5,417,385
432,65,3,3,7,6,-66,33,1,8,351,418
432,66,4,2,10,3,46,21,7,9,397,439
432,67,4,2,9,4,-55,-78,2,1,342,361
432,68,2,4,5,8,23,44,5,5,365,405
432,69,4,2,6,7,42,-75,7,0,407,330
432,70,5,2,9,4,-46,22,1,2,361,352
432,71,2,4,7,6,25,42,6,4,386,394
432,72,4,2,6,7,42,25,8,9,428,419
432,73,5,2,8,5,-47,-77,1,2,381,342
432,74,4,3,6,7,42,34,3,6,423,376
432,75,4,2,7,6,43,-76,6,0,466,300
432,76,2,4,5,8,23,44,9,4,489,344
432,77,4,2,8,5,-56,23,3,7,433,367
432,78,3,3,7,6,34,-67,7,0,467,300
432,79,2,5,5,8,-77,53,0,3,390,353
432,80,4,3,5,8,41,35,1,8,431,388
432,81,4,3,9,4,45,31,6,9,476,419
432,82,4,3,7,6,43,-67,9,2,519,352
433,1,4,3,7,6,43,33,3,3,43,33
433,2,4,2,8,5,44,23,7,6,87,56
433,3,2,4,5,8,-77,-56,0,0,10,0
433,4,2,4,4,9,22,45,2,5,32,45
433,5,2,4,6,7,24,43,6,8,56,88
433,6,3,3,9,4,-64,31,2,9,-8,119
433,7,3,3,5,8,32,-65,4,4,24,54
433,8,3,4,6,7,33,43,7,7,57,97
433,9,3,3,9,4,-64,31,3,8,-7,128
433,10,3,3,5,8,32,-65,5,3,25,63
433,11,4,3,7,6,43,33,8,6,68,96
433,12,6,2,10,3,-36,21,2,7,32,117
433,13,3,4,4,9,31,-55,3,2,63,62
433,14,3,3,6,7,33,34,6,6,96,96
433,15,3,5,6,7,33,52,9,8,129,148
433,16,3,4,4,9,-69,-55,0,3,60,93
433,17,3,4,4,9,31,45,1,8,91,138
433,18,3,3,8,5,35,-68,6,0,126,70
433,19,3,3,6,7,33,34,9,4,159,104
433,20,2,4,3,10,-79,-54,0,0,80,50
433,21,3,4,6,7,33,43,3,3,113,93
433,22,2,5,3,10,21,55,4,8,134,148
433,23,4,3,8,5,44,-68,8,0,178,80
433,24,4,2,7,6,-57,24,1,4,121,104
433,25,3,5,5,8,32,53,3,7,153,157
433,26,2,4,4,9,22,-55,5,2,175,102
433,27,3,3,4,9,31,36,6,8,206,138
433,28,3,5,7,6,-66,51,0,9,140,189
433,29,6,2,12,1,66,-20,6,9,206,169
433,30,4,2,8,5,-56,-77,0,2,150,92
433,31,3,3,8,5,35,32,5,4,185,124
433,32,5,2,9,4,54,22,9,6,239,146
433,33,2,6,5,8,-77,62,2,8,162,208
433,34,5,2,8,5,53,-77,5,1,215,131
433,35,4,2,6,7,42,25,7,6,257,156
433,36,3,5,5,8,32,53,9,9,289,209
433,37,4,2,8,5,-56,-77,3,2,233,132
433,38,4,3,10,3,46,30,9,2,279,162
433,39,5,2,12,1,-43,-20,6,2,236,142
433,40,2,5,4,9,22,54,8,6,258,196
433,41,4,2,8,5,-56,23,2,9,202,219
433,42,5,2,10,3,55,-79,7,0,257,140
433,43,4,2,6,7,42,25,9,5,299,165
433,44,2,5,4,9,-78,54,1,9,221,219
433,45,3,3,6,7,33,-66,4,3,254,153
433,46,3,4,7,6,34,42,8,5,288,195
433,47,4,2,8,5,-56,23,2,8,232,218
433,48,3,4,7,6,34,-58,6,0,266,160
433,49,3,4,9,4,-64,40,2,0,202,200
433,50,3,4,3,10,30,46,2,6,232,246
433,51,3,3,8,5,35,32,7,8,267,278
433,52,3,3,7,6,-66,-67,1,1,201,211
433,53,5,2,8,5,53,23,4,4,254,234
433,54,3,3,6,7,33,34,7,8,287,268
433,55,4,3,8,5,-56,-68,1,0,231,200
433,56,4,2,10,3,46,21,7,1,277,221
433,57,4,4,8,5,-56,41,1,2,221,262
433,58,4,3,8,5,44,32,5,4,265,294
433,59,5,3,9,4,54,31,9,5,319,325
433,60,6,2,11,2,-35,20,4,5,284,345
433,61,3,4,4,9,31,-55,5,0,315,290
433,62,3,4,5,8,32,44,7,4,347,334
433,63,4,3,7,6,-57,33,0,7,290,367
433,64,4,3,8,5,44,32,4,9,334,399
433,65,5,2,8,5,53,-77,7,2,387,322
433,66,5,2,11,2,-44,20,3,2,343,342
433,67,3,3,9,4,36,31,9,3,379,373
433,68,4,3,9,4,-55,31,4,4,324,404
433,69,2,4,4,9,22,45,6,9,346,449
433,70,4,3,6,7,42,-66,8,3,388,383
433,71,3,4,6,7,-67,43,1,6,321,426
433,72,2,4,6,7,24,43,5,9,345,469
433,73,4,2,7,6,43,-76,8,3,388,393
433,74,2,4,3,10,21,46,9,9,409,439
433,75,3,4,5,8,-68,-56,1,3,341,383
433,76,4,3,8,5,44,32,5,5,385,415
433,77,2,4,5,8,23,44,8,9,408,459
433,78,3,4,7,6,-66,-58,2,1,342,401
433,79,2,5,5,8,23,53,5,4,365,454
433,80,3,3,7,6,34,33,9,7,399,487
433,81,2,4,5,8,-77,-56,2,1,322,431
433,82,3,3,8,5,35,32,7,3,357,463
433,83,4,2,7,6,-57,24,0,7,300,487
433,84,3,4,7,6,34,42,4,9,334,529
434,1,3,4,4,9,31,45,1,5,31,45
434,2,2,5,6,7,24,52,5,7,55,97
434,3,4,4,8,5,44,41,9,8,99,138
434,4,4,2,11,2,-53,20,6,8,46,158
434,5,4,3,9,4,-55,31,1,9,-9,189
434,6,3,3,5,8,32,-65,3,4,23,124
434,7,5,3,7,6,52,33,5,7,75,157
434,8,3,4,8,5,-65,41,0,8,10,198
434,9,3,4,8,5,35,41,5,9,45,239
434,10,3,4,4,9,31,-55,6,4,76,184
434,11,4,3,5,8,41,35,7,9,117,219
434,12,3,3,4,9,31,-64,8,5,148,155
434,13,4,2,6,7,-58,-75,0,0,90,80
434,14,3,4,4,9,31,45,1,5,121,125
434,15,4,3,6,7,42,34,3,9,163,159
434,16,2,5,3,10,21,-45,4,4,184,114
434,17,4,4,7,6,43,42,7,6,227,156
434,18,3,3,6,7,-67,-66,0,0,160,90
434,19,3,4,6,7,33,43,3,3,193,133
434,20,4,3,7,6,43,33,6,6,236,166
434,21,2,4,5,8,23,-56,9,0,259,110
434,22,5,2,8,5,-47,23,2,3,212,133
434,23,3,3,5,8,32,35,4,8,244,168
434,24,4,2,10,3,-54,21,0,9,190,189
434,25,3,4,4,9,31,-55,1,4,221,134
434,26,3,4,5,8,32,44,3,8,253,178
434,27,4,3,9,4,45,31,8,9,298,209
434,28,3,4,3,10,30,-54,8,5,328,155
434,29,6,2,8,5,-38,23,0,8,290,178
434,30,4,2,6,7,42,-75,2,3,332,103
434,31,2,4,4,9,22,45,4,8,354,148
434,32,5,3,6,7,51,-66,5,2,405,82
434,33,3,4,5,8,32,44,7,6,437,126
434,34,3,4,8,5,-65,41,2,7,372,167
434,35,4,4,7,6,43,42,5,9,415,209
434,36,4,2,6,7,42,-75,7,4,457,134
434,37,3,4,6,7,-67,43,0,7,390,177
434,38,3,4,4,9,31,-55,1,2,421,122
434,39,3,3,8,5,35,32,6,4,456,154
434,40,3,3,3,10,30,-63,6,1,486,91
434,41,2,5,2,11,20,56,6,7,506,147
435,1,3,4,6,7,33,43,3,3,33,43
435,2,4,3,10,3,46,30,9,3,79,73
435,3,2,4,9,4,-73,40,6,3,6,113
435,4,4,3,9,4,-55,31,1,4,-49,144
435,5,2,5,2,11,20,-44,1,0,-29,100
435,6,4,3,6,7,42,34,3,4,13,134
435,7,3,4,6,7,33,43,6,7,46,177
435,8,3,4,7,6,-66,42,0,9,-20,219
435,9,3,3,8,5,35,-68,5,1,15,151
435,10,5,2,7,6,52,24,7,5,67,175
435,11,3,3,4,9,31,-64,8,1,98,111
435,12,3,4,8,5,-65,41,3,2,33,152
435,13,5,2,11,2,56,20,9,2,89,172
435,14,2,4,3,10,-79,46,0,8,10,218
435,15,4,2,7,6,43,-76,3,2,53,142
435,16,4,2,9,4,45,22,8,4,98,164
435,17,3,5,6,7,-67,52,1,6,31,216
435,18,4,2,6,7,42,-75,3,1,73,141
435,19,4,2,9,4,45,22,8,3,118,163
435,20,4,3,5,8,41,35,9,8,159,198
435,21,2,5,4,9,-78,-46,1,2,81,152
435,22,3,3,7,6,34,33,5,5,115,185
435,23,4,3,7,6,43,33,8,8,158,218
435,24,2,5,2,11,20,-44,8,4,178,174
435,25,3,3,7,6,-66,33,2,7,112,207
435,26,4,2,8,5,44,-77,6,0,156,130
435,27,4,3,7,6,43,33,9,3,199,163
435,28,3,4,5,8,-68,44,1,7,131,207
435,29,4,3,7,6,43,-67,4,0,174,140
435,30,3,3,6,7,33,34,7,4,207,174
435,31,4,3,7,6,-57,33,0,7,150,207
435,32,4,3,4,9,40,-64,0,3,190,143
435,33,4,3,5,8,41,35,1,8,231,178
435,34,5,2,9,4,54,-78,5,0,285,100
435,35,3,4,6,7,33,43,8,3,318,143
435,36,4,2,8,5,-56,23,2,6,262,166
435,37,4,2,7,6,43,-76,5,0,305,90
435,38,3,3,5,8,32,35,7,5,337,125
435,39,3,3,6,7,-67,34,0,9,270,159
435,40,2,4,7,6,25,-58,5,1,295,101
435,41,4,2,9,4,-55,22,0,3,240,123
435,42,3,5,5,8,32,53,2,6,272,176
435,43,4,4,7,6,43,42,5,8,315,218
435,44,4,3,7,6,43,-67,8,1,358,151
435,45,4,3,10,3,-54,30,4,1,304,181
435,46,2,5,3,10,21,55,5,6,325,236
435,47,2,5,5,8,23,53,8,9,348,289
435,48,4,2,11,2,-53,20,5,9,295,309
435,49,3,4,3,10,30,-54,5,5,325,255
435,50,2,4,3,10,21,-54,6,1,346,201
435,51,2,4,7,6,-75,42,1,3,271,243
435,52,3,4,4,9,31,45,2,8,302,288
435,53,5,2,8,5,53,-77,5,1,355,211
435,54,2,4,4,9,22,45,7,6,377,256
435,55,4,2,9,4,-55,22,2,8,322,278
435,56,3,3,5,8,32,-65,4,3,354,213
435,57,4,2,10,3,-54,21,0,4,300,234
435,58,2,5,4,9,22,54,2,8,322,288
435,59,4,3,8,5,44,-68,6,0,366,220
435,60,4,3,9,4,-55,31,1,1,311,251
435,61,3,3,7,6,34,33,5,4,345,284
435,62,2,4,6,7,24,43,9,7,369,327
435,63,5,2,7,6,-48,-76,1,1,321,251
435,64,2,5,3,10,21,55,2,6,342,306
435,65,4,3,9,4,45,31,7,7,387,337
435,66,5,2,8,5,-47,-77,0,0,340,260
435,67,3,4,7,6,34,42,4,2,374,302
435,68,4,2,8,5,44,23,8,5,418,325
435,69,2,4,5,8,-77,44,1,9,341,369
435,70,3,4,4,9,31,-55,2,4,372,314
435,71,4,3,7,6,43,33,5,7,415,347
435,72,3,3,4,9,31,-64,6,3,446,283
435,73,4,2,8,5,-56,23,0,6,390,306
435,74,2,5,6,7,24,52,4,8,414,358
435,75,5,2,10,3,55,21,9,9,469,379
435,76,4,2,8,5,-56,-77,3,2,413,302
435,77,5,2,9,4,54,22,7,4,467,324
435,78,5,3,6,7,51,34,8,8,518,358
436,1,3,4,7,6,34,42,4,2,34,42
436,2,3,3,7,6,34,33,8,5,68,75
436,3,4,2,8,5,-56,23,2,8,12,98
436,4,4,3,8,5,44,-68,6,0,56,30
436,5,4,4,5,8,41,44,7,4,97,74
436,6,4,2,6,7,42,25,9,9,139,99
436,7,3,3,5,8,-68,-65,1,4,71,34
436,8,4,3,8,5,44,32,5,6,115,66
436,9,3,4,6,7,33,43,8,9,148,109
436,10,5,3,7,6,-48,-67,0,2,100,42
436,11,3,3,5,8,32,35,2,7,132,77
436,12,3,3,5,8,32,-65,4,2,164,12
436,13,2,4,5,8,23,44,7,6,187,56
436,14,4,3,8,5,-56,32,1,8,131,88
436,15,5,2,9,4,54,-78,5,0,185,10
436,16,3,3,4,9,31,36,6,6,216,46
436,17,2,4,5,8,23,-56,9,0,239,-10
436,18,5,2,11,2,-44,20,5,0,195,10
436,19,3,4,7,6,34,42,9,2,229,52
436,20,5,2,8,5,-47,23,2,5,182,75
436,21,4,2,9,4,45,22,7,7,227,97
436,22,2,5,6,7,-76,52,1,9,151,149
436,23,2,5,6,7,24,-48,5,1,175,101
436,24,5,2,10,3,-45,21,0,2,130,122
436,25,6,2,10,3,64,21,4,3,194,143
436,26,3,4,7,6,34,42,8,5,228,185
436,27,4,3,6,7,-58,34,0,9,170,219
436,28,2,4,3,10,21,-54,1,5,191,165
436,29,2,5,4,9,22,54,3,9,213,219
436,30,4,2,8,5,44,-77,7,2,257,142
436,31,3,3,5,8,32,35,9,7,289,177
436,32,5,2,7,6,-48,-76,1,1,241,101
436,33,2,5,5,8,23,53,4,4,264,154
436,34,4,3,5,8,41,35,5,9,305,189
436,35,3,4,5,8,32,-56,7,3,337,133
436,36,2,5,5,8,-77,53,0,6,260,186
436,37,5,2,8,5,53,23,3,9,313,209
436,38,3,4,3,10,30,-54,3,5,343,155
436,39,2,4,7,6,25,42,8,7,368,197
436,40,3,3,8,5,-65,32,3,9,303,229
436,41,4,2,10,3,46,-79,9,0,349,150
436,42,2,5,4,9,-78,54,1,4,271,204
436,43,3,3,6,7,33,34,4,8,304,238
436,44,4,3,5,8,41,-65,5,3,345,173
436,45,4,2,5,8,41,26,6,9,386,199
436,46,4,3,7,6,43,-67,9,2,429,132
436,47,4,2,7,6,-57,24,2,6,372,156
436,48,4,3,6,7,42,-66,4,0,414,90
436,49,3,4,8,5,35,41,9,1,449,131
436,50,5,2,11,2,-44,20,5,1,405,151
436,51,3,3,6,7,33,34,8,5,438,185
436,52,2,4,4,9,-78,-55,0,0,360,130
436,53,3,4,4,9,31,45,1,5,391,175
436,54,2,4,8,5,26,41,7,6,417,216
436,55,2,6,3,10,21,-36,8,0,438,180
436,56,2,4,3,10,21,46,9,6,459,226
436,57,3,4,6,7,-67,43,2,9,392,269
436,58,4,3,8,5,44,-68,6,1,436,201
436,59,2,4,7,6,-75,42,1,3,361,243
436,60,4,3,6,7,42,34,3,7,403,277
436,61,4,3,4,9,40,-64,3,3,443,213
436,62,3,4,6,7,33,43,6,6,476,256
436,63,3,3,5,8,32,-65,8,1,508,191
437,1,3,3,8,5,35,32,5,2,35,32
437,2,4,2,8,5,44,23,9,5,79,55
437,3,3,4,6,7,-67,43,2,8,12,98
437,4,4,2,8,5,44,-77,6,1,56,21
437,5,5,2,7,6,52,24,8,5,108,45
437,6,2,4,4,9,-78,-55,0,0,30,-10
437,7,3,3,6,7,33,34,3,4,63,24
437,8,2,4,4,9,22,45,5,9,85,69
437,9,4,3,7,6,43,-67,8,2,128,2
437,10,4,3,6,7,-58,34,0,6,70,36
437,11,4,2,6,7,42,-75,2,1,112,-39
437,12,3,4,7,6,34,42,6,3,146,3
437,13,4,3,8,5,-56,32,0,5,90,35
437,14,2,6,3,10,21,64,1,9,111,99
437,15,2,6,3,10,21,-36,2,3,132,63
437,16,5,2,9,4,54,22,6,5,186,85
437,17,4,2,7,6,43,24,9,9,229,109
437,18,2,6,2,11,20,-35,9,4,249,74
437,19,3,4,5,8,-68,44,1,8,181,118
437,20,4,3,10,3,46,30,7,8,227,148
437,21,3,4,8,5,-65,41,2,9,162,189
437,22,2,5,6,7,24,-48,6,1,186,141
437,23,4,3,6,7,42,34,8,5,228,175
437,24,3,3,5,8,-68,-65,0,0,160,110
437,25,3,4,6,7,33,43,3,3,193,153
437,26,3,3,4,9,31,36,4,9,224,189
437,27,4,3,7,6,43,-67,7,2,267,122
437,28,4,2,7,6,-57,24,0,6,210,146
437,29,4,2,5,8,41,-74,1,2,251,72
437,30,3,3,5,8,32,35,3,7,283,107
437,31,4,3,6,7,42,-66,5,1,325,41
437,32,3,4,6,7,33,43,8,4,358,84
437,33,3,3,6,7,-67,34,1,8,291,118
437,34,4,3,7,6,43,-67,4,1,334,51
437,35,2,4,5,8,23,44,7,5,357,95
437,36,4,3,7,6,-57,33,0,8,300,128
437,37,3,4,8,5,35,41,5,9,335,169
437,38,2,4,5,8,23,-56,8,3,358,113
437,39,4,3,5,8,41,35,9,8,399,148
437,40,3,4,7,6,-66,-58,3,0,333,90
437,41,5,2,9,4,54,22,7,2,387,112
437,42,3,3,4,9,31,36,8,8,418,148
437,43,4,3,9,4,-55,31,3,9,363,179
437,44,3,4,5,8,32,-56,5,3,395,123
437,45,3,3,5,8,32,35,7,8,427,158
437,46,5,2,7,6,52,-76,9,2,479,82
437,47,4,2,11,2,-53,20,6,2,426,102
437,48,3,4,5,8,32,44,8,6,458,146
437,49,5,2,9,4,-46,22,2,8,412,168
437,50,2,4,4,9,22,-55,4,3,434,113
437,51,4,2,6,7,42,25,6,8,476,138
437,52,3,4,5,8,32,-56,8,2,508,82
438,1,2,4,7,6,25,42,5,2,25,42
438,2,2,4,5,8,23,44,8,6,48,86
438,3,2,4,5,8,-77,-56,1,0,-29,30
438,4,2,5,3,10,21,55,2,5,-8,85
438,5,5,2,7,6,52,24,4,9,44,109
438,6,4,3,7,6,43,-67,7,2,87,42
438,7,2,5,4,9,22,54,9,6,109,96
438,8,3,3,6,7,-67,-66,2,0,42,30
438,9,4,4,6,7,42,43,4,3,84,73
438,10,4,4,5,8,41,44,5,7,125,117
438,11,5,2,9,4,54,22,9,9,179,139
438,12,2,5,2,11,20,-44,9,5,199,95
438,13,4,2,9,4,-55,22,4,7,144,117
438,14,3,3,7,6,34,-67,8,0,178,50
438,15,4,2,10,3,-54,21,4,1,124,71
438,16,4,3,7,6,43,33,7,4,167,104
438,17,3,4,8,5,-65,41,2,5,102,145
438,18,5,3,9,4,54,31,6,6,156,176
438,19,3,4,5,8,32,-56,8,0,188,120
438,20,3,4,7,6,-66,42,2,2,122,162
438,21,5,2,9,4,54,22,6,4,176,184
438,22,4,3,7,6,43,33,9,7,219,217
438,23,5,2,6,7,-49,-75,0,2,170,142
438,24,5,2,10,3,55,21,5,3,225,163
438,25,3,4,9,4,-64,40,1,3,161,203
438,26,4,3,7,6,43,33,4,6,204,236
438,27,4,2,8,5,44,23,8,9,248,259
438,28,4,2,10,3,-54,-79,4,0,194,180
438,29,4,2,5,8,41,26,5,6,235,206
438,30,3,3,8,5,-65,32,0,8,170,238
438,31,4,2,8,5,44,-77,4,1,214,161
438,32,4,3,7,6,43,33,7,4,257,194
438,33,4,2,6,7,42,25,9,9,299,219
438,34,3,3,8,5,-65,-68,4,1,234,151
438,35,4,3,6,7,42,34,6,5,276,185
438,36,3,3,6,7,33,34,9,9,309,219
438,37,4,4,8,5,-56,-59,3,0,253,160
438,38,2,5,4,9,22,54,5,4,275,214
438,39,2,4,6,7,24,43,9,7,299,257
438,40,4,2,7,6,-57,-76,2,1,242,181
438,41,4,2,6,7,42,25,4,6,284,206
438,42,4,3,8,5,44,32,8,8,328,238
438,43,2,5,4,9,-78,-46,0,2,250,192
438,44,4,2,6,7,42,25,2,7,292,217
438,45,2,5,7,6,25,51,7,8,317,268
438,46,2,4,6,7,-76,-57,1,1,241,211
438,47,2,5,5,8,23,53,4,4,264,264
438,48,4,3,8,5,44,32,8,6,308,296
438,49,5,2,8,5,-47,23,1,9,261,319
438,50,5,2,7,6,52,-76,3,3,313,243
438,51,3,4,6,7,33,43,6,6,346,286
438,52,4,3,6,7,42,-66,8,0,388,220
438,53,6,2,8,5,-38,23,0,3,350,243
438,54,4,2,8,5,44,23,4,6,394,266
438,55,2,4,7,6,25,42,9,8,419,308
438,56,3,4,5,8,-68,-56,1,2,351,252
438,57,2,5,4,9,22,54,3,6,373,306
438,58,4,3,6,7,42,-66,5,0,415,240
438,59,5,2,9,4,54,22,9,2,469,262
438,60,2,5,4,9,-78,54,1,6,391,316
438,61,2,4,4,9,22,-55,3,1,413,261
438,62,3,4,5,8,32,44,5,5,445,305
438,63,4,2,8,5,44,23,9,8,489,328
438,64,5,2,10,3,-45,21,4,9,444,349
438,65,3,3,8,5,35,-68,9,1,479,281
438,66,4,2,8,5,-56,23,3,4,423,304
438,67,4,2,10,3,46,21,9,5,469,325
438,68,4,2,9,4,-55,22,4,7,414,347
438,69,4,2,7,6,43,-76,7,1,457,271
438,70,2,5,5,8,-77,53,0,4,380,324
438,71,2,4,3,10,21,-54,1,0,401,270
438,72,4,3,8,5,44,32,5,2,445,302
438,73,3,4,7,6,34,42,9,4,479,344
438,74,2,5,6,7,-76,52,3,6,403,396
438,75,4,3,5,8,41,-65,4,1,444,331
438,76,3,3,7,6,34,33,8,4,478,364
438,77,2,5,4,9,-78,54,0,8,400,418
438,78,3,4,5,8,32,-56,2,2,432,362
438,79,4,3,7,6,43,33,5,5,475,395
438,80,3,3,4,9,31,-64,6,1,506,331
439,1,3,4,7,6,34,42,4,2,34,42
439,2,2,4,4,9,22,45,6,7,56,87
439,3,3,4,8,5,-65,41,1,8,-9,128
439,4,2,5,4,9,22,-46,3,2,13,82
439,5,3,3,6,7,33,34,6,6,46,116
439,6,2,4,5,8,23,-56,9,0,69,60
439,7,2,5,5,8,-77,53,2,3,-8,113
439,8,3,4,6,7,33,43,5,6,25,156
439,9,2,4,7,6,-75,42,0,8,-50,198
439,10,3,3,7,6,34,-67,4,1,-16,131
439,11,2,4,5,8,23,44,7,5,7,175
439,12,4,3,7,6,-57,33,0,8,-50,208
439,13,4,3,7,6,43,-67,3,1,-7,141
439,14,3,3,7,6,34,33,7,4,27,174
439,15,5,3,9,4,-46,31,1,5,-19,205
439,16,4,2,8,5,44,23,5,8,25,228
439,17,3,4,4,9,31,-55,6,3,56,173
439,18,5,3,7,6,52,33,8,6,108,206
439,19,4,3,7,6,-57,33,1,9,51,239
439,20,2,4,4,9,22,-55,3,4,73,184
439,21,4,4,7,6,43,42,6,6,116,226
439,22,3,3,7,6,-66,33,0,9,50,259
439,23,5,2,9,4,54,-78,4,1,104,181
439,24,4,3,10,3,-54,30,0,1,50,211
439,25,3,4,4,9,31,45,1,6,81,256
439,26,4,2,7,6,43,-76,4,0,124,180
439,27,2,5,3,10,21,55,5,5,145,235
439,28,6,2,10,3,64,21,9,6,209,256
439,29,3,4,4,9,-69,-55,0,1,140,201
439,30,4,3,4,9,40,36,0,7,180,237
439,31,5,2,9,4,54,22,4,9,234,259
439,32,3,3,7,6,34,-67,8,2,268,192
439,33,4,3,8,5,-56,32,2,4,212,224
439,34,3,3,8,5,35,32,7,6,247,256
439,35,4,3,8,5,-56,32,1,8,191,288
439,36,3,3,6,7,33,-66,4,2,224,222
439,37,2,4,7,6,25,42,9,4,249,264
439,38,5,2,9,4,-46,22,3,6,203,286
439,39,2,5,5,8,23,53,6,9,226,339
439,40,2,5,4,9,22,-46,8,3,248,293
439,41,5,2,11,2,-44,20,4,3,204,313
439,42,3,3,8,5,35,32,9,5,239,345
439,43,2,4,3,10,-79,-54,0,1,160,291
439,44,5,3,9,4,54,31,4,2,214,322
439,45,4,3,7,6,43,33,7,5,257,355
439,46,3,3,8,5,-65,32,2,7,192,387
439,47,4,3,8,5,44,32,6,9,236,419
439,48,3,5,5,8,32,-47,8,2,268,372
439,49,5,2,8,5,-47,23,1,5,221,395
439,50,3,4,4,9,31,-55,2,0,252,340
439,51,4,3,7,6,43,33,5,3,295,373
439,52,4,3,7,6,43,33,8,6,338,406
439,53,5,2,9,4,-46,22,2,8,292,428
439,54,3,3,8,5,35,-68,7,0,327,360
439,55,4,2,10,3,-54,21,3,1,273,381
439,56,3,4,4,9,31,45,4,6,304,426
439,57,4,3,7,6,43,33,7,9,347,459
439,58,4,2,8,5,-56,-77,1,2,291,382
439,59,3,3,5,8,32,35,3,7,323,417
439,60,2,4,2,11,20,-53,3,4,343,364
439,61,4,3,8,5,44,32,7,6,387,396
439,62,3,4,5,8,32,-56,9,0,419,340
439,63,2,5,3,10,-79,55,0,5,340,395
439,64,3,3,6,7,33,34,3,9,373,429
439,65,4,3,10,3,46,30,9,9,419,459
439,66,4,3,7,6,-57,-67,2,2,362,392
439,67,3,4,5,8,32,44,4,6,394,436
439,68,3,4,4,9,31,-55,5,1,425,381
439,69,4,3,7,6,43,33,8,4,468,414
439,70,4,3,8,5,-56,32,2,6,412,446
439,71,3,4,5,8,32,-56,4,0,444,390
439,72,2,5,3,10,21,55,5,5,465,445
439,73,3,3,7,6,34,33,9,8,499,478
439,74,3,4,4,9,-69,-55,0,3,430,423
439,75,3,3,8,5,35,32,5,5,465,455
439,76,5,2,8,5,53,23,8,8,518,478
440,1,3,3,7,6,34,33,4,3,34,33
440,2,2,5,6,7,24,52,8,5,58,85
440,3,3,4,7,6,-66,42,2,7,-8,127
440,4,3,3,7,6,34,-67,6,0,26,60
440,5,4,3,8,5,-56,32,0,2,-30,92
440,6,2,5,3,10,21,55,1,7,-9,147
440,7,6,2,10,3,64,21,5,8,55,168
440,8,2,4,3,10,21,-54,6,4,76,114
440,9,5,2,8,5,53,23,9,7,129,137
440,10,4,3,9,4,-55,31,4,8,74,168
440,11,5,2,9,4,54,-78,8,0,128,90
440,12,2,4,6,7,-76,43,2,3,52,133
440,13,5,2,9,4,54,22,6,5,106,155
440,14,2,4,4,9,22,-55,8,0,128,100
440,15,3,4,5,8,-68,44,0,4,60,144
440,16,3,4,5,8,32,44,2,8,92,188
440,17,4,3,9,4,45,31,7,9,137,219
440,18,4,3,6,7,42,-66,9,3,179,153
440,19,3,3,8,5,-65,32,4,5,114,185
440,20,3,4,6,7,33,43,7,8,147,228
440,21,4,2,6,7,42,-75,9,3,189,153
440,22,4,3,7,6,-57,33,2,6,132,186
440,23,2,4,5,8,23,-56,5,0,155,130
440,24,3,4,6,7,33,43,8,3,188,173
440,25,4,3,7,6,-57,33,1,6,131,206
440,26,3,4,6,7,33,43,4,9,164,249
440,27,3,4,5,8,32,-56,6,3,196,193
440,28,4,2,8,5,-56,23,0,6,140,216
440,29,4,3,9,4,45,31,5,7,185,247
440,30,3,3,6,7,33,-66,8,1,218,181
440,31,2,4,3,10,21,46,9,7,239,227
440,32,5,2,7,6,-48,-76,1,1,191,151
440,33,4,3,8,5,44,32,5,3,235,183
440,34,2,4,4,9,22,45,7,8,257,228
440,35,2,5,3,10,21,-45,8,3,278,183
440,36,4,3,7,6,-57,33,1,6,221,216
440,37,3,3,5,8,32,-65,3,1,253,151
440,38,2,4,4,9,22,45,5,6,275,196
440,39,5,2,8,5,53,23,8,9,328,219
440,40,5,2,11,2,-44,20,4,9,284,239
440,41,4,3,8,5,44,-68,8,1,328,171
440,42,4,3,9,4,-55,31,3,2,273,202
440,43,3,3,7,6,34,33,7,5,307,235
440,44,3,4,7,6,-66,42,1,7,241,277
440,45,3,3,10,3,37,30,8,7,278,307
440,46,3,4,5,8,-68,-56,0,1,210,251
440,47,4,3,7,6,43,33,3,4,253,284
440,48,4,2,8,5,44,23,7,7,297,307
440,49,3,3,4,9,31,-64,8,3,328,243
440,50,5,3,9,4,-46,31,2,4,282,274
440,51,3,3,6,7,33,34,5,8,315,308
440,52,2,4,5,8,23,-56,8,2,338,252
440,53,2,5,4,9,-78,54,0,6,260,306
440,54,4,3,7,6,43,33,3,9,303,339
440,55,3,4,6,7,33,-57,6,2,336,282
440,56,4,3,9,4,-55,31,1,3,281,313
440,57,3,3,3,10,30,-63,1,0,311,250
440,58,4,3,7,6,43,33,4,3,354,283
440,59,3,4,6,7,33,43,7,6,387,326
440,60,4,2,7,6,-57,-76,0,0,330,250
440,61,2,5,5,8,23,53,3,3,353,303
440,62,3,4,5,8,32,44,5,7,385,347
440,63,3,3,8,5,-65,32,0,9,320,379
440,64,2,4,7,6,25,-58,5,1,345,321
440,65,4,2,9,4,-55,22,0,3,290,343
440,66,4,3,9,4,45,31,5,4,335,374
440,67,3,3,8,5,-65,32,0,6,270,406
440,68,3,3,5,8,32,-65,2,1,302,341
440,69,5,2,5,8,50,26,2,7,352,367
440,70,2,4,4,9,22,-55,4,2,374,312
440,71,2,5,4,9,22,54,6,6,396,366
440,72,3,3,6,7,33,-66,9,0,429,300
440,73,4,3,9,4,-55,31,4,1,374,331
440,74,2,5,5,8,23,53,7,4,397,384
440,75,3,4,7,6,-66,42,1,6,331,426
440,76,3,3,7,6,34,33,5,9,365,459
440,77,2,6,2,11,20,-35,5,4,385,424
440,78,2,4,6,7,24,43,9,7,409,467
440,79,3,4,5,8,-68,-56,1,1,341,411
440,80,2,5,4,9,22,54,3,5,363,465
440,81,3,4,4,9,31,-55,4,0,394,410
440,82,2,6,4,9,22,63,6,3,416,473
440,83,4,3,6,7,42,34,8,7,458,507
441,1,3,4,5,8,32,44,2,4,32,44
441,2,3,3,8,5,35,32,7,6,67,76
441,3,2,5,5,8,-77,53,0,9,-10,129
441,4,3,3,7,6,34,-67,4,2,24,62
441,5,4,4,7,6,43,42,7,4,67,104
441,6,4,3,5,8,41,35,8,9,108,139
441,7,2,4,6,7,-76,-57,2,2,32,82
441,8,2,4,6,7,24,43,6,5,56,125
441,9,3,4,7,6,-66,42,0,7,-10,167
441,10,2,4,4,9,22,-55,2,2,12,112
441,11,3,5,7,6,34,51,6,3,46,163
441,12,5,2,9,4,-46,22,0,5,0,185
441,13,2,4,6,7,24,43,4,8,24,228
441,14,5,2,8,5,53,-77,7,1,77,151
441,15,4,2,5,8,41,26,8,7,118,177
441,16,4,3,7,6,-57,-67,1,0,61,110
441,17,4,3,9,4,45,31,6,1,106,141
441,18,2,4,5,8,23,44,9,5,129,185
441,19,4,2,9,4,-55,22,4,7,74,207
441,20,2,5,3,10,21,-45,5,2,95,162
441,21,3,4,5,8,32,44,7,6,127,206
441,22,3,4,4,9,31,-55,8,1,158,151
441,23,2,5,3,10,21,55,9,6,179,206
441,24,4,3,6,7,-58,-66,1,0,121,140
441,25,3,3,5,8,32,35,3,5,153,175
441,26,3,4,3,10,30,-54,3,1,183,121
441,27,4,3,10,3,46,30,9,1,229,151
441,28,3,3,6,7,-67,34,2,5,162,185
441,29,4,3,7,6,43,33,5,8,205,218
441,30,4,3,8,5,44,-68,9,0,249,150
441,31,3,3,8,5,-65,32,4,2,184,182
441,32,3,4,7,6,34,42,8,4,218,224
441,33,3,5,6,7,-67,52,1,6,151,276
441,34,4,2,7,6,43,-76,4,0,194,200
441,35,3,3,6,7,33,34,7,4,227,234
441,36,3,3,7,6,-66,33,1,7,161,267
441,37,2,4,5,8,23,-56,4,1,184,211
441,38,2,5,4,9,22,54,6,5,206,265
441,39,4,3,6,7,42,34,8,9,248,299
441,40,4,2,8,5,-56,-77,2,2,192,222
441,41,2,5,4,9,22,54,4,6,214,276
441,42,5,2,10,3,55,21,9,7,269,297
441,43,4,3,8,5,-56,32,3,9,213,329
441,44,5,2,8,5,53,-77,6,2,266,252
441,45,2,4,4,9,22,45,8,7,288,297
441,46,2,5,2,11,20,-44,8,3,308,253
441,47,3,3,5,8,-68,35,0,8,240,288
441,48,2,4,4,9,22,-55,2,3,262,233
441,49,3,4,6,7,33,43,5,6,295,276
441,50,4,3,6,7,42,-66,7,0,337,210
441,51,4,3,8,5,-56,32,1,2,281,242
441,52,3,3,5,8,32,35,3,7,313,277
441,53,2,4,5,8,23,-56,6,1,336,221
441,54,3,4,3,10,30,46,6,7,366,267
441,55,4,3,5,8,41,-65,7,2,407,202
441,56,6,2,10,3,-36,21,1,3,371,223
441,57,4,2,6,7,42,25,3,8,413,248
441,58,5,2,9,4,54,-78,7,0,467,170
441,59,3,3,10,3,-63,30,4,0,404,200
441,60,2,4,7,6,25,42,9,2,429,242
441,61,5,2,10,3,-45,21,4,3,384,263
441,62,4,3,6,7,42,34,6,7,426,297
441,63,4,3,7,6,43,-67,9,0,469,230
441,64,3,4,4,9,-69,45,0,5,400,275
441,65,3,4,7,6,34,42,4,7,434,317
441,66,4,2,9,4,45,22,9,9,479,339
441,67,3,3,5,8,-68,-65,1,4,411,274
441,68,6,2,9,4,63,22,4,6,474,296
441,69,2,4,8,5,-74,41,0,7,400,337
441,70,3,4,3,10,30,-54,0,3,430,283
441,71,4,2,8,5,44,23,4,6,474,306
441,72,3,4,5,8,32,-56,6,0,506,250
442,1,5,2,10,3,55,21,5,1,55,21
442,2,5,2,10,3,-45,21,0,2,10,42
442,3,2,4,5,8,23,44,3,6,33,86
442,4,4,3,8,5,44,32,7,8,77,118
442,5,4,2,11,2,-53,20,4,8,24,138
442,6,4,2,7,6,43,-76,7,2,67,62
442,7,3,3,4,9,31,36,8,8,98,98
442,8,3,3,8,5,-65,-68,3,0,33,30
442,9,3,4,6,7,33,43,6,3,66,73
442,10,4,2,10,3,-54,21,2,4,12,94
442,11,4,3,8,5,44,32,6,6,56,126
442,12,5,3,8,5,53,32,9,8,109,158
442,13,3,3,5,8,-68,-65,1,3,41,93
442,14,4,2,7,6,43,24,4,7,84,117
442,15,5,2,10,3,55,21,9,8,139,138
442,16,4,3,6,7,-58,-66,1,2,81,72
442,17,3,3,9,4,36,31,7,3,117,103
442,18,3,3,5,8,32,35,9,8,149,138
442,19,4,2,6,7,-58,-75,1,3,91,63
442,20,3,4,6,7,33,43,4,6,124,106
442,21,2,4,5,8,23,-56,7,0,147,50
442,22,5,2,10,3,-45,21,2,1,102,71
442,23,2,4,4,9,22,45,4,6,124,116
442,24,3,3,7,6,34,33,8,9,158,149
442,25,3,3,6,7,-67,-66,1,3,91,83
442,26,3,3,7,6,34,33,5,6,125,116
442,27,2,4,5,8,23,-56,8,0,148,60
442,28,2,5,3,10,21,55,9,5,169,115
442,29,5,2,9,4,-46,22,3,7,123,137
442,30,6,2,11,2,65,20,8,7,188,157
442,31,2,6,2,11,20,-35,8,2,208,122
442,32,3,3,8,5,-65,32,3,4,143,154
442,33,3,3,7,6,34,33,7,7,177,187
442,34,4,3,8,5,-56,32,1,9,121,219
442,35,2,4,5,8,23,-56,4,3,144,163
442,36,2,4,4,9,22,45,6,8,166,208
442,37,4,3,6,7,42,-66,8,2,208,142
442,38,2,4,9,4,-73,40,5,2,135,182
442,39,3,3,5,8,32,35,7,7,167,217
442,40,2,4,4,9,22,-55,9,2,189,162
442,41,2,4,5,8,-77,44,2,6,112,206
442,42,3,4,8,5,35,41,7,7,147,247
442,43,4,2,11,2,-53,20,4,7,94,267
442,44,2,4,6,7,24,-57,8,0,118,210
442,45,4,3,7,6,-57,33,1,3,61,243
442,46,3,3,6,7,33,34,4,7,94,277
442,47,2,5,7,6,25,51,9,8,119,328
442,48,3,4,5,8,-68,-56,1,2,51,272
442,49,2,4,7,6,25,42,6,4,76,314
442,50,2,4,8,5,-74,41,2,5,2,355
442,51,3,3,7,6,34,33,6,8,36,388
442,52,4,3,10,3,-54,30,2,8,-18,418
442,53,5,2,9,4,54,-78,6,0,36,340
442,54,2,4,4,9,22,45,8,5,58,385
442,55,2,4,5,8,-77,44,1,9,-19,429
442,56,4,2,10,3,46,-79,7,0,27,350
442,57,3,4,5,8,32,44,9,4,59,394
442,58,3,3,5,8,-68,35,1,9,-9,429
442,59,4,3,8,5,44,-68,5,1,35,361
442,60,4,3,8,5,44,32,9,3,79,393
442,61,3,4,5,8,-68,44,1,7,11,437
442,62,2,4,5,8,23,-56,4,1,34,381
442,63,5,2,7,6,52,24,6,5,86,405
442,64,2,5,4,9,22,54,8,9,108,459
442,65,3,4,5,8,-68,-56,0,3,40,403
442,66,3,5,6,7,33,52,3,5,73,455
442,67,3,3,5,8,32,-65,5,0,105,390
442,68,3,4,6,7,33,43,8,3,138,433
442,69,3,4,4,9,31,45,9,8,169,478
442,70,3,4,4,9,-69,-55,0,3,100,423
442,71,3,4,5,8,32,44,2,7,132,467
442,72,3,4,5,8,32,-56,4,1,164,411
442,73,4,2,7,6,43,24,7,5,207,435
442,74,3,4,8,5,-65,41,2,6,142,476
442,75,4,2,9,4,45,22,7,8,187,498
442,76,3,4,3,10,30,-54,7,4,217,444
442,77,2,4,6,7,-76,43,1,7,141,487
442,78,4,3,7,6,43,-67,4,0,184,420
442,79,2,4,5,8,23,44,7,4,207,464
442,80,3,4,6,7,-67,43,0,7,140,507
443,1,4,4,8,5,44,41,4,1,44,41
443,2,3,4,6,7,33,43,7,4,77,84
443,3,4,3,10,3,-54,30,3,4,23,114
443,4,4,3,7,6,43,33,6,7,66,147
443,5,4,3,7,6,43,-67,9,0,109,80
443,6,3,4,6,7,-67,43,2,3,42,123
443,7,6,2,9,4,63,22,5,5,105,145
443,8,5,2,8,5,53,23,8,8,158,168
443,9,2,5,5,8,-77,-47,1,1,81,121
443,10,3,4,5,8,32,44,3,5,113,165
443,11,3,4,4,9,31,-55,4,0,144,110
443,12,3,4,7,6,34,42,8,2,178,152
443,13,2,4,7,6,-75,42,3,4,103,194
443,14,5,2,7,6,52,24,5,8,155,218
443,15,3,4,5,8,32,-56,7,2,187,162
443,16,3,3,9,4,-64,31,3,3,123,193
443,17,4,2,8,5,44,23,7,6,167,216
443,18,5,2,5,8,50,-74,7,2,217,142
443,19,2,4,5,8,-77,44,0,6,140,186
443,20,4,2,7,6,43,-76,3,0,183,110
443,21,4,2,11,2,-53,20,0,0,130,130
443,22,2,5,6,7,24,52,4,2,154,182
443,23,4,3,5,8,41,35,5,7,195,217
443,24,3,3,6,7,33,-66,8,1,228,151
443,25,2,6,2,11,20,65,8,6,248,216
443,26,5,2,9,4,-46,22,2,8,202,238
443,27,6,2,9,4,63,-78,5,0,265,160
443,28,2,4,6,7,24,43,9,3,289,203
443,29,5,2,11,2,-44,20,5,3,245,223
443,30,4,3,5,8,41,35,6,8,286,258
443,31,3,4,7,6,-66,-58,0,0,220,200
443,32,3,3,3,10,30,37,0,7,250,237
443,33,2,4,5,8,23,-56,3,1,273,181
443,34,4,3,9,4,45,31,8,2,318,212
443,35,4,3,8,5,-56,32,2,4,262,244
443,36,4,2,8,5,44,23,6,7,306,267
443,37,3,3,6,7,33,-66,9,1,339,201
443,38,2,5,4,9,-78,54,1,5,261,255
443,39,2,5,4,9,22,54,3,9,283,309
443,40,3,4,6,7,33,-57,6,2,316,252
443,41,4,2,9,4,-55,22,1,4,261,274
443,42,2,4,4,9,22,45,3,9,283,319
443,43,3,4,7,6,34,-58,7,1,317,261
443,44,4,2,9,4,-55,22,2,3,262,283
443,45,5,2,9,4,54,22,6,5,316,305
443,46,3,4,5,8,32,44,8,9,348,349
443,47,2,5,4,9,-78,-46,0,3,270,303
443,48,2,5,5,8,23,53,3,6,293,356
443,49,3,4,6,7,33,43,6,9,326,399
443,50,4,3,8,5,-56,-68,0,1,270,331
443,51,2,6,4,9,22,63,2,4,292,394
443,52,2,4,4,9,22,45,4,9,314,439
443,53,2,4,5,8,23,-56,7,3,337,383
443,54,3,3,6,7,-67,34,0,7,270,417
443,55,4,3,8,5,44,32,4,9,314,449
443,56,3,4,4,9,31,-55,5,4,345,394
443,57,3,3,7,6,34,33,9,7,379,427
443,58,3,4,4,9,-69,-55,0,2,310,372
443,59,2,4,7,6,25,42,5,4,335,414
443,60,4,3,9,4,-55,31,0,5,280,445
443,61,3,4,6,7,33,43,3,8,313,488
443,62,4,2,10,3,46,21,9,9,359,509
444,1,4,2,9,4,45,22,5,2,45,22
444,2,2,4,4,9,22,45,7,7,67,67
444,3,4,3,5,8,41,-65,8,2,108,2
444,4,2,5,4,9,-78,54,0,6,30,56
444,5,3,3,5,8,32,-65,2,1,62,-9
444,6,4,3,7,6,43,33,5,4,105,24
444,7,2,6,4,9,22,63,7,7,127,87
444,8,2,5,4,9,22,-46,9,1,149,41
444,9,2,4,7,6,-75,42,4,3,74,83
444,10,2,6,3,10,21,64,5,7,95,147
444,11,5,2,8,5,53,-77,8,0,148,70
444,12,3,3,6,7,-67,34,1,4,81,104
444,13,3,3,6,7,33,34,4,8,114,138
444,14,2,5,4,9,22,-46,6,2,136,92
444,15,3,3,8,5,-65,32,1,4,71,124
444,16,4,4,8,5,44,41,5,5,115,165
444,17,3,3,7,6,34,33,9,8,149,198
444,18,4,3,8,5,-56,-68,3,0,93,130
444,19,2,4,5,8,23,44,6,4,116,174
444,20,2,5,6,7,-76,52,0,6,40,226
444,21,3,3,5,8,32,-65,2,1,72,161
444,22,2,4,5,8,23,44,5,5,95,205
444,23,5,2,9,4,54,22,9,7,149,227
444,24,4,3,7,6,-57,-67,2,0,92,160
444,25,4,2,10,3,46,21,8,1,138,181
444,26,3,4,5,8,-68,44,0,5,70,225
444,27,2,5,5,8,23,53,3,8,93,278
444,28,5,2,9,4,54,-78,7,0,147,200
444,29,3,3,4,9,31,36,8,6,178,236
444,30,4,4,6,7,-58,43,0,9,120,279
444,31,3,3,4,9,31,-64,1,5,151,215
444,32,5,2,9,4,54,22,5,7,205,237
444,33,4,3,8,5,44,32,9,9,249,269
444,34,3,3,5,8,-68,-65,1,4,181,204
444,35,4,3,8,5,44,32,5,6,225,236
444,36,3,4,3,10,30,-54,5,2,255,182
444,37,5,3,9,4,54,31,9,3,309,213
444,38,3,3,4,9,-69,36,0,9,240,249
444,39,3,3,7,6,34,-67,4,2,274,182
444,40,3,5,6,7,33,52,7,4,307,234
444,41,5,3,9,4,-46,31,1,5,261,265
444,42,3,3,4,9,31,-64,2,1,292,201
444,43,2,5,7,6,25,51,7,2,317,252
444,44,5,2,9,4,-46,22,1,4,271,274
444,45,3,4,4,9,31,45,2,9,302,319
444,46,4,3,9,4,45,-69,7,0,347,250
444,47,5,2,12,1,-43,-20,4,0,304,230
444,48,4,3,7,6,43,33,7,3,347,263
444,49,3,3,7,6,-66,33,1,6,281,296
444,50,3,3,6,7,33,-66,4,0,314,230
444,51,4,2,7,6,43,24,7,4,357,254
444,52,4,2,9,4,-55,22,2,6,302,276
444,53,2,4,4,9,22,-55,4,1,324,221
444,54,2,5,4,9,22,54,6,5,346,275
444,55,3,3,8,5,-65,32,1,7,281,307
444,56,2,4,6,7,24,-57,5,0,305,250
444,57,4,2,9,4,-55,22,0,2,250,272
444,58,2,5,6,7,24,52,4,4,274,324
444,59,2,5,2,11,20,-44,4,0,294,280
444,60,5,2,9,4,54,22,8,2,348,302
444,61,3,3,6,7,-67,34,1,6,281,336
444,62,5,2,7,6,52,-76,3,0,333,260
444,63,4,2,7,6,43,24,6,4,376,284
444,64,3,4,5,8,32,44,8,8,408,328
444,65,4,4,5,8,41,-56,9,2,449,272
444,66,3,4,6,7,-67,43,2,5,382,315
444,67,3,3,5,8,32,-65,4,0,414,250
444,68,2,5,4,9,22,54,6,4,436,304
444,69,2,5,3,10,21,55,7,9,457,359
444,70,3,3,6,7,-67,-66,0,3,390,293
444,71,4,3,8,5,44,32,4,5,434,325
444,72,2,6,3,10,21,64,5,9,455,389
444,73,4,2,6,7,42,-75,7,4,497,314
444,74,3,3,5,8,32,35,9,9,529,349
445,1,3,4,6,7,33,43,3,3,33,43
445,2,4,3,6,7,42,34,5,7,75,77
445,3,4,2,5,8,41,-74,6,3,116,3
445,4,2,4,6,7,-76,43,0,6,40,46
445,5,2,5,4,9,22,-46,2,0,62,0
445,6,2,4,5,8,23,44,5,4,85,44
445,7,2,5,5,8,23,53,8,7,108,97
445,8,3,4,5,8,-68,-56,0,1,40,41
445,9,6,2,10,3,64,21,4,2,104,62
445,10,2,5,5,8,23,53,7,5,127,115
445,11,4,2,9,4,-55,22,2,7,72,137
445,12,2,5,6,7,24,52,6,9,96,189
445,13,3,4,5,8,32,-56,8,3,128,133
445,14,6,2,9,4,-37,22,1,5,91,155
445,15,4,3,10,3,46,30,7,5,137,185
445,16,5,2,10,3,-45,21,2,6,92,206
445,17,3,3,9,4,36,31,8,7,128,237
445,18,5,2,6,7,51,-75,9,2,179,162
445,19,4,4,8,5,-56,41,3,3,123,203
445,20,3,3,8,5,35,32,8,5,158,235
445,21,4,3,8,5,-56,32,2,7,102,267
445,22,5,2,10,3,55,21,7,8,157,288
445,23,2,4,7,6,-75,-58,2,0,82,230
445,24,2,6,3,10,21,64,3,4,103,294
445,25,5,2,11,2,56,20,9,4,159,314
445,26,4,3,7,6,-57,33,2,7,102,347
445,27,2,5,3,10,21,-45,3,2,123,302
445,28,3,3,7,6,34,33,7,5,157,335
445,29,4,3,9,4,-55,31,2,6,102,366
445,30,2,4,5,8,23,-56,5,0,125,310
445,31,5,2,8,5,53,23,8,3,178,333
445,32,2,4,3,10,21,46,9,9,199,379
445,33,2,4,7,6,-75,-58,4,1,124,321
445,34,3,4,5,8,32,44,6,5,156,365
445,35,4,2,7,6,43,24,9,9,199,389
445,36,3,4,4,9,-69,-55,0,4,130,334
445,37,4,2,9,4,45,22,5,6,175,356
445,38,4,2,7,6,43,-76,8,0,218,280
445,39,3,3,8,5,-65,32,3,2,153,312
445,40,5,2,11,2,56,20,9,2,209,332
445,41,3,4,6,7,-67,43,2,5,142,375
445,42,3,4,7,6,34,42,6,7,176,417
445,43,2,4,5,8,23,-56,9,1,199,361
445,44,3,4,6,7,-67,43,2,4,132,404
445,45,4,3,5,8,41,35,3,9,173,439
445,46,3,4,7,6,34,-58,7,1,207,381
445,47,3,4,3,10,30,46,7,7,237,427
445,48,3,5,3,10,30,-45,7,2,267,382
445,49,4,3,6,7,42,34,9,6,309,416
445,50,3,3,7,6,-66,33,3,9,243,449
445,51,3,4,6,7,33,-57,6,2,276,392
445,52,3,4,4,9,31,45,7,7,307,437
445,53,2,5,5,8,-77,-47,0,0,230,390
445,54,4,2,8,5,44,23,4,3,274,413
445,55,3,4,4,9,31,45,5,8,305,458
445,56,3,3,7,6,34,-67,9,1,339,391
445,57,3,3,6,7,-67,34,2,5,272,425
445,58,3,4,6,7,33,43,5,8,305,468
445,59,3,3,8,5,-65,-68,0,0,240,400
445,60,4,2,5,8,41,26,1,6,281,426
445,61,3,4,6,7,33,43,4,9,314,469
445,62,2,5,4,9,22,-46,6,3,336,423
445,63,5,2,8,5,53,23,9,6,389,446
445,64,3,3,7,6,-66,33,3,9,323,479
445,65,5,2,11,2,56,20,9,9,379,499
445,66,2,5,4,9,-78,-46,1,3,301,453
445,67,5,2,11,2,56,20,7,3,357,473
445,68,2,4,4,9,22,45,9,8,379,518
446,1,3,3,8,5,35,32,5,2,35,32
446,2,5,3,7,6,52,33,7,5,87,65
446,3,4,3,6,7,42,34,9,9,129,99
446,4,3,3,6,7,-67,-66,2,3,62,33
446,5,3,3,5,8,32,35,4,8,94,68
446,6,4,2,7,6,43,-76,7,2,137,-8
446,7,5,2,11,2,-44,20,3,2,93,12
446,8,3,3,7,6,34,33,7,5,127,45
446,9,6,2,9,4,-37,22,0,7,90,67
446,10,3,3,5,8,32,-65,2,2,122,2
446,11,5,2,9,4,54,22,6,4,176,24
446,12,5,2,9,4,-46,22,0,6,130,46
446,13,2,4,6,7,24,43,4,9,154,89
446,14,4,2,9,4,45,-78,9,1,199,11
446,15,5,2,8,5,-47,23,2,4,152,34
446,16,2,4,5,8,23,44,5,8,175,78
446,17,4,3,7,6,43,-67,8,1,218,11
446,18,2,6,3,10,21,64,9,5,239,75
446,19,2,5,3,10,-79,-45,0,0,160,30
446,20,4,3,9,4,45,31,5,1,205,61
446,21,4,3,8,5,44,32,9,3,249,93
446,22,4,3,6,7,-58,34,1,7,191,127
446,23,3,3,6,7,33,-66,4,1,224,61
446,24,2,6,2,11,20,65,4,6,244,126
446,25,3,3,6,7,33,-66,7,0,277,60
446,26,2,4,4,9,22,45,9,5,299,105
446,27,3,3,3,10,30,-63,9,2,329,42
446,28,3,3,5,8,-68,35,1,7,261,77
446,29,4,2,8,5,44,-77,5,0,305,0
446,30,4,3,7,6,43,33,8,3,348,33
446,31,3,3,9,4,-64,31,4,4,284,64
446,32,4,3,9,4,45,31,9,5,329,95
446,33,3,3,9,4,-64,31,5,6,265,126
446,34,4,3,8,5,44,32,9,8,309,158
446,35,5,2,9,4,-46,-78,3,0,263,80
446,36,2,5,4,9,22,54,5,4,285,134
446,37,4,3,8,5,44,32,9,6,329,166
446,38,2,4,7,6,-75,42,4,8,254,208
446,39,2,5,3,10,21,-45,5,3,275,163
446,40,4,2,5,8,41,26,6,9,316,189
446,41,3,4,6,7,33,-57,9,2,349,132
446,42,3,4,5,8,-68,44,1,6,281,176
446,43,3,4,6,7,33,43,4,9,314,219
446,44,2,4,4,9,22,-55,6,4,336,164
446,45,3,3,6,7,33,34,9,8,369,198
446,46,4,2,9,4,-55,-78,4,0,314,120
446,47,2,6,3,10,21,64,5,4,335,184
446,48,5,2,7,6,52,24,7,8,387,208
446,49,3,4,6,7,-67,-57,0,1,320,151
446,50,4,3,8,5,44,32,4,3,364,183
446,51,5,2,8,5,53,23,7,6,417,206
446,52,3,4,7,6,-66,42,1,8,351,248
446,53,2,5,3,10,21,-45,2,3,372,203
446,54,3,3,6,7,33,34,5,7,405,237
446,55,5,3,8,5,53,32,8,9,458,269
446,56,5,2,10,3,-45,-79,3,0,413,190
446,57,3,3,6,7,33,34,6,4,446,224
446,58,2,5,3,10,21,55,7,9,467,279
446,59,4,2,8,5,-56,-77,1,2,411,202
446,60,4,3,7,6,43,33,4,5,454,235
446,61,4,3,7,6,43,33,7,8,497,268
446,62,2,4,7,6,-75,-58,2,0,422,210
446,63,3,4,7,6,34,42,6,2,456,252
446,64,4,2,9,4,-55,22,1,4,401,274
446,65,4,2,7,6,43,24,4,8,444,298
446,66,2,5,2,11,20,-44,4,4,464,254
446,67,3,3,6,7,33,34,7,8,497,288
446,68,6,2,10,3,-36,21,1,9,461,309
446,69,2,4,8,5,26,-59,7,0,487,250
446,70,5,2,10,3,-45,21,2,1,442,271
446,71,4,3,7,6,43,33,5,4,485,304
446,72,4,2,10,3,-54,21,1,5,431,325
446,73,2,4,4,9,22,-55,3,0,453,270
446,74,3,4,4,9,31,45,4,5,484,315
446,75,3,4,6,7,33,43,7,8,517,358
447,1,4,4,8,5,44,41,4,1,44,41
447,2,4,3,9,4,45,31,9,2,89,72
447,3,5,2,9,4,-46,22,3,4,43,94
447,4,3,4,5,8,32,44,5,8,75,138
447,5,3,5,5,8,32,-47,7,1,107,91
447,6,4,3,6,7,42,34,9,5,149,125
447,7,5,2,11,2,-44,20,5,5,105,145
447,8,3,4,6,7,33,43,8,8,138,188
447,9,3,3,9,4,-64,31,4,9,74,219
447,10,5,2,8,5,53,-77,7,2,127,142
447,11,2,6,3,10,21,64,8,6,148,206
447,12,6,2,8,5,-38,23,0,9,110,229
447,13,2,4,5,8,23,-56,3,3,133,173
447,14,4,3,9,4,45,31,8,4,178,204
447,15,3,4,6,7,-67,43,1,7,111,247
447,16,2,4,5,8,23,-56,4,1,134,191
447,17,4,3,6,7,42,34,6,5,176,225
447,18,4,2,8,5,-56,23,0,8,120,248
447,19,3,4,6,7,33,-57,3,1,153,191
447,20,3,4,6,7,33,43,6,4,186,234
447,21,4,4,4,9,40,45,6,9,226,279
447,22,3,4,7,6,-66,-58,0,1,160,221
447,23,4,2,7,6,43,24,3,5,203,245
447,24,5,2,11,2,56,20,9,5,259,265
447,25,2,4,2,11,20,-53,9,2,279,212
447,26,4,3,10,3,-54,30,5,2,225,242
447,27,5,2,9,4,54,22,9,4,279,264
447,28,3,3,5,8,-68,35,1,9,211,299
447,29,3,4,6,7,33,-57,4,2,244,242
447,30,3,4,6,7,33,43,7,5,277,285
447,31,3,3,5,8,32,-65,9,0,309,220
447,32,4,3,8,5,-56,32,3,2,253,252
447,33,2,4,6,7,24,43,7,5,277,295
447,34,5,2,9,4,-46,22,1,7,231,317
447,35,3,4,7,6,34,42,5,9,265,359
447,36,4,2,8,5,44,-77,9,2,309,282
447,37,3,4,8,5,-65,41,4,3,244,323
447,38,3,3,5,8,32,35,6,8,276,358
447,39,4,3,5,8,41,-65,7,3,317,293
447,40,2,5,5,8,-77,53,0,6,240,346
447,41,4,3,8,5,44,32,4,8,284,378
447,42,3,3,7,6,34,-67,8,1,318,311
447,43,2,6,5,8,-77,62,1,3,241,373
447,44,3,3,6,7,33,34,4,7,274,407
447,45,4,2,9,4,45,22,9,9,319,429
447,46,3,4,5,8,-68,-56,1,3,251,373
447,47,2,4,6,7,24,43,5,6,275,416
447,48,3,4,5,8,32,-56,7,0,307,360
447,49,4,3,9,4,-55,31,2,1,252,391
447,50,3,5,3,10,30,55,2,6,282,446
447,51,2,4,6,7,24,43,6,9,306,489
447,52,2,4,6,7,-76,-57,0,2,230,432
447,53,3,4,4,9,31,45,1,7,261,477
447,54,3,4,3,10,30,-54,1,3,291,423
447,55,3,3,8,5,35,32,6,5,326,455
447,56,3,4,7,6,-66,42,0,7,260,497
447,57,4,2,9,4,45,22,5,9,305,519
448,1,3,4,8,5,35,41,5,1,35,41
448,2,2,5,4,9,22,54,7,5,57,95
448,3,4,4,5,8,41,44,8,9,98,139
448,4,2,4,2,11,20,-53,8,6,118,86
448,5,2,4,4,9,-78,-55,0,1,40,31
448,6,4,3,8,5,44,32,4,3,84,63
448,7,3,3,5,8,32,35,6,8,116,98
448,8,2,4,4,9,22,-55,8,3,138,43
448,9,2,4,5,8,-77,44,1,7,61,87
448,10,4,3,5,8,41,-65,2,2,102,22
448,11,2,4,7,6,25,42,7,4,127,64
448,12,2,5,4,9,22,54,9,8,149,118
448,13,3,3,7,6,-66,-67,3,1,83,51
448,14,4,3,6,7,42,34,5,5,125,85
448,15,4,2,7,6,43,24,8,9,168,109
448,16,2,4,7,6,-75,-58,3,1,93,51
448,17,3,4,5,8,32,44,5,5,125,95
448,18,4,2,9,4,-55,22,0,7,70,117
448,19,2,4,5,8,23,-56,3,1,93,61
448,20,3,3,5,8,32,35,5,6,125,96
448,21,2,4,6,7,24,43,9,9,149,139
448,22,4,3,7,6,-57,-67,2,2,92,72
448,23,3,3,6,7,33,34,5,6,125,106
448,24,4,2,7,6,43,-76,8,0,168,30
448,25,2,4,5,8,-77,44,1,4,91,74
448,26,3,3,6,7,33,34,4,8,124,108
448,27,4,3,7,6,43,-67,7,1,167,41
448,28,3,4,4,9,31,45,8,6,198,86
448,29,2,4,4,9,-78,-55,0,1,120,31
448,30,3,3,4,9,31,36,1,7,151,67
448,31,3,3,8,5,35,32,6,9,186,99
448,32,4,2,8,5,-56,-77,0,2,130,22
448,33,4,3,8,5,44,32,4,4,174,54
448,34,2,5,4,9,22,54,6,8,196,108
448,35,3,4,4,9,31,-55,7,3,227,53
448,36,4,2,10,3,-54,21,3,4,173,74
448,37,4,3,8,5,44,32,7,6,217,106
448,38,3,4,5,8,32,-56,9,0,249,50
448,39,4,2,10,3,-54,21,5,1,195,71
448,40,3,4,5,8,32,44,7,5,227,115
448,41,4,2,6,7,42,-75,9,0,269,40
448,42,5,2,8,5,-47,23,2,3,222,63
448,43,2,5,3,10,21,55,3,8,243,118
448,44,3,3,5,8,32,-65,5,3,275,53
448,45,2,4,4,9,22,45,7,8,297,98
448,46,4,3,7,6,-57,-67,0,1,240,31
448,47,2,4,5,8,23,44,3,5,263,75
448,48,4,2,10,3,46,21,9,6,309,96
448,49,2,4,5,8,-77,-56,2,0,232,40
448,50,3,3,8,5,35,32,7,2,267,72
448,51,3,3,8,5,-65,32,2,4,202,104
448,52,3,3,5,8,32,35,4,9,234,139
448,53,3,4,4,9,31,-55,5,4,265,84
448,54,4,3,6,7,42,34,7,8,307,118
448,55,2,5,3,10,21,-45,8,3,328,73
448,56,4,2,8,5,-56,23,2,6,272,96
448,57,5,2,9,4,54,22,6,8,326,118
448,58,3,4,7,6,-66,-58,0,0,260,60
448,59,3,4,7,6,34,42,4,2,294,102
448,60,3,3,8,5,35,32,9,4,329,134
448,61,2,4,7,6,-75,42,4,6,254,176
448,62,3,4,7,6,34,42,8,8,288,218
448,63,3,3,6,7,-67,-66,1,2,221,152
448,64,3,4,6,7,33,43,4,5,254,195
448,65,4,4,5,8,41,44,5,9,295,239
448,66,3,3,5,8,32,-65,7,4,327,174
448,67,6,2,10,3,-36,21,1,5,291,195
448,68,3,4,7,6,34,42,5,7,325,237
448,69,3,3,7,6,34,-67,9,0,359,170
448,70,5,2,9,4,-46,22,3,2,313,192
448,71,3,3,5,8,32,35,5,7,345,227
448,72,4,2,8,5,44,-77,9,0,389,150
448,73,4,2,8,5,-56,23,3,3,333,173
448,74,4,3,9,4,45,31,8,4,378,204
448,75,4,3,6,7,-58,34,0,8,320,238
448,76,2,4,5,8,23,-56,3,2,343,182
448,77,4,3,8,5,44,32,7,4,387,214
448,78,4,2,5,8,41,-74,8,0,428,140
448,79,3,3,7,6,-66,33,2,3,362,173
448,80,5,3,10,3,55,30,7,3,417,203
448,81,2,4,7,6,-75,42,2,5,342,245
448,82,3,3,6,7,33,34,5,9,375,279
448,83,5,3,9,4,54,-69,9,0,429,210
448,84,5,3,10,3,-45,30,4,0,384,240
448,85,2,4,4,9,22,45,6,5,406,285
448,86,3,4,7,6,-66,42,0,7,340,327
448,87,4,3,8,5,44,32,4,9,384,359
448,88,3,3,7,6,34,-67,8,2,418,292
448,89,3,3,7,6,-66,33,2,5,352,325
448,90,4,3,7,6,43,33,5,8,395,358
448,91,4,3,7,6,43,-67,8,1,438,291
448,92,2,5,4,9,-78,54,0,5,360,345
448,93,6,2,9,4,63,22,3,7,423,367
448,94,3,4,4,9,31,-55,4,2,454,312
448,95,3,3,5,8,32,35,6,7,486,347
448,96,4,2,9,4,-55,22,1,9,431,369
448,97,2,4,5,8,23,-56,4,3,454,313
448,98,4,3,11,2,-53,-30,1,3,401,283
448,99,2,5,4,9,22,54,3,7,423,337
448,100,4,4,6,7,42,-57,5,0,465,280
448,101,4,2,7,6,43,24,8,4,508,304
449,1,5,2,11,2,56,20,6,0,56,20
449,2,4,3,8,5,-56,32,0,2,0,52
449,3,3,3,6,7,33,34,3,6,33,86
449,4,3,3,6,7,33,-66,6,0,66,20
449,5,3,3,6,7,33,34,9,4,99,54
449,6,3,3,5,8,-68,35,1,9,31,89
449,7,3,4,8,5,35,-59,6,0,66,30
449,8,3,4,6,7,33,43,9,3,99,73
449,9,3,3,7,6,-66,33,3,6,33,106
449,10,3,3,7,6,34,33,7,9,67,139
449,11,4,3,7,6,-57,-67,0,2,10,72
449,12,5,3,8,5,53,32,3,4,63,104
449,13,2,4,6,7,24,43,7,7,87,147
449,14,5,2,5,8,50,-74,7,3,137,73
449,15,4,3,9,4,-55,31,2,4,82,104
449,16,4,2,7,6,43,24,5,8,125,128
449,17,4,3,7,6,43,-67,8,1,168,61
449,18,4,3,5,8,41,35,9,6,209,96
449,19,2,4,7,6,-75,42,4,8,134,138
449,20,2,5,4,9,22,-46,6,2,156,92
449,21,3,4,4,9,31,45,7,7,187,137
449,22,5,2,8,5,-47,-77,0,0,140,60
449,23,5,2,9,4,54,22,4,2,194,82
449,24,3,4,3,10,30,46,4,8,224,128
449,25,3,4,7,6,34,-58,8,0,258,70
449,26,3,4,5,8,-68,44,0,4,190,114
449,27,2,5,4,9,22,54,2,8,212,168
449,28,3,3,8,5,35,-68,7,0,247,100
449,29,5,2,10,3,-45,21,2,1,202,121
449,30,3,3,5,8,32,35,4,6,234,156
449,31,3,4,5,8,32,-56,6,0,266,100
449,32,2,5,4,9,22,54,8,4,288,154
449,33,3,3,5,8,-68,35,0,9,220,189
449,34,4,2,7,6,43,-76,3,3,263,113
449,35,4,2,8,5,44,23,7,6,307,136
449,36,3,4,6,7,-67,43,0,9,240,179
449,37,3,5,5,8,32,-47,2,2,272,132
449,38,4,3,7,6,43,33,5,5,315,165
449,39,4,2,6,7,42,-75,7,0,357,90
449,40,5,2,11,2,-44,20,3,0,313,110
449,41,5,2,9,4,54,22,7,2,367,132
449,42,3,4,7,6,-66,42,1,4,301,174
449,43,4,3,9,4,45,31,6,5,346,205
449,44,2,5,5,8,23,53,9,8,369,258
449,45,2,4,5,8,-77,-56,2,2,292,202
449,46,3,4,5,8,32,44,4,6,324,246
449,47,2,4,6,7,24,43,8,9,348,289
449,48,4,2,9,4,-55,-78,3,1,293,211
449,49,3,4,5,8,32,44,5,5,325,255
449,50,3,4,5,8,32,44,7,9,357,299
449,51,3,3,8,5,-65,-68,2,1,292,231
449,52,3,3,7,6,34,33,6,4,326,264
449,53,4,3,8,5,-56,32,0,6,270,296
449,54,2,4,4,9,22,-55,2,1,292,241
449,55,3,4,6,7,33,43,5,4,325,284
449,56,2,4,5,8,23,44,8,8,348,328
449,57,2,4,7,6,-75,-58,3,0,273,270
449,58,6,2,11,2,65,20,8,0,338,290
449,59,4,3,9,4,-55,31,3,1,283,321
449,60,3,4,6,7,33,43,6,4,316,364
449,61,2,5,4,9,22,54,8,8,338,418
449,62,5,2,9,4,-46,-78,2,0,292,340
449,63,2,5,5,8,23,53,5,3,315,393
449,64,4,3,5,8,41,35,6,8,356,428
449,65,2,5,5,8,23,-47,9,1,379,381
449,66,3,4,7,6,-66,42,3,3,313,423
449,67,4,2,7,6,43,24,6,7,356,447
449,68,2,5,5,8,23,-47,9,0,379,400
449,69,3,3,5,8,-68,35,1,5,311,435
449,70,3,3,7,6,34,33,5,8,345,468
449,71,2,5,3,10,21,-45,6,3,366,423
449,72,3,3,9,4,-64,31,2,4,302,454
449,73,2,4,2,11,20,-53,2,1,322,401
449,74,4,2,6,7,42,25,4,6,364,426
449,75,4,2,9,4,45,22,9,8,409,448
449,76,3,3,5,8,-68,-65,1,3,341,383
449,77,3,3,7,6,34,33,5,6,375,416
449,78,3,4,4,9,31,-55,6,1,406,361
449,79,4,2,10,3,-54,21,2,2,352,382
449,80,3,4,7,6,34,42,6,4,386,424
449,81,4,3,4,9,40,-64,6,0,426,360
449,82,4,3,9,4,-55,31,1,1,371,391
449,83,2,5,4,9,22,54,3,5,393,445
449,84,2,5,3,10,21,-45,4,0,414,400
449,85,4,3,6,7,42,34,6,4,456,434
449,86,2,5,3,10,21,55,7,9,477,489
449,87,3,5,5,8,32,-47,9,2,509,442
450,1,3,4,6,7,33,43,3,3,33,43
450,2,2,4,7,6,25,42,8,5,58,85
450,3,2,4,3,10,21,-54,9,1,79,31
450,4,4,3,7,6,-57,33,2,4,22,64
450,5,4,2,8,5,44,23,6,7,66,87
450,6,4,3,8,5,-56,32,0,9,10,119
450,7,5,3,10,3,55,30,5,9,65,149
450,8,5,2,10,3,-45,-79,0,0,20,70
450,9,3,3,5,8,32,35,2,5,52,105
450,10,2,4,3,10,21,-54,3,1,73,51
450,11,3,5,5,8,32,53,5,4,105,104
450,12,2,6,3,10,21,64,6,8,126,168
450,13,3,5,3,10,30,-45,6,3,156,123
450,14,4,3,6,7,42,34,8,7,198,157
450,15,2,6,3,10,21,-36,9,1,219,121
450,16,3,3,5,8,-68,35,1,6,151,156
450,17,5,2,9,4,54,22,5,8,205,178
450,18,2,5,7,6,-75,51,0,9,130,229
450,19,3,4,5,8,32,-56,2,3,162,173
450,20,3,4,8,5,35,41,7,4,197,214
450,21,2,5,4,9,22,54,9,8,219,268
450,22,4,3,10,3,-54,30,5,8,165,298
450,23,3,4,7,6,34,-58,9,0,199,240
450,24,3,4,5,8,-68,44,1,4,131,284
450,25,4,3,8,5,44,32,5,6,175,316
450,26,3,4,8,5,-65,41,0,7,110,357
450,27,2,4,8,5,26,41,6,8,136,398
450,28,3,3,8,5,-65,-68,1,0,71,330
450,29,4,2,8,5,44,23,5,3,115,353
450,30,4,2,8,5,44,23,9,6,159,376
450,31,3,4,6,7,-67,43,2,9,92,419
450,32,4,3,8,5,44,-68,6,1,136,351
450,33,2,6,5,8,23,62,9,3,159,413
450,34,2,5,3,10,-79,55,0,8,80,468
450,35,4,3,6,7,42,-66,2,2,122,402
450,36,3,3,9,4,36,31,8,3,158,433
450,37,4,3,7,6,-57,33,1,6,101,466
450,38,3,3,6,7,33,-66,4,0,134,400
450,39,4,2,9,4,45,22,9,2,179,422
450,40,5,2,10,3,-45,21,4,3,134,443
450,41,3,3,7,6,34,33,8,6,168,476
450,42,4,2,10,3,-54,21,4,7,114,497
450,43,5,2,8,5,53,-77,7,0,167,420
450,44,3,3,7,6,-66,33,1,3,101,453
450,45,5,2,10,3,55,21,6,4,156,474
450,46,4,3,8,5,-56,32,0,6,100,506
451,1,4,3,6,7,42,34,2,4,42,34
451,2,3,3,5,8,32,35,4,9,74,69
451,3,4,3,9,4,45,-69,9,0,119,0
451,4,2,4,4,9,-78,45,1,5,41,45
451,5,4,2,7,6,43,24,4,9,84,69
451,6,2,4,8,5,-74,-59,0,0,10,10
451,7,4,2,7,6,43,24,3,4,53,34
451,8,5,2,11,2,56,20,9,4,109,54
451,9,5,2,9,4,-46,22,3,6,63,76
451,10,3,3,7,6,34,33,7,9,97,109
451,11,3,3,5,8,32,-65,9,4,129,44
451,12,5,2,9,4,-46,22,3,6,83,66
451,13,2,5,4,9,22,-46,5,0,105,20
451,14,3,3,5,8,32,35,7,5,137,55
451,15,6,2,10,3,-36,21,1,6,101,76
451,16,4,2,9,4,45,22,6,8,146,98
451,17,4,3,10,3,-54,30,2,8,92,128
451,18,4,3,7,6,43,-67,5,1,135,61
451,19,2,4,6,7,24,43,9,4,159,104
451,20,4,3,9,4,-55,31,4,5,104,135
451,21,2,4,7,6,25,42,9,7,129,177
451,22,4,2,6,7,-58,-75,1,2,71,102
451,23,3,3,6,7,33,34,4,6,104,136
451,24,3,3,4,9,31,-64,5,2,135,72
451,25,3,5,3,10,30,55,5,7,165,127
451,26,2,4,7,6,-75,42,0,9,90,169
451,27,4,3,8,5,44,-68,4,1,134,101
451,28,2,4,7,6,25,42,9,3,159,143
451,29,3,4,4,9,-69,45,0,8,90,188
451,30,4,3,9,4,45,31,5,9,135,219
451,31,4,3,6,7,42,-66,7,3,177,153
451,32,2,4,4,9,22,45,9,8,199,198
451,33,5,3,9,4,-46,31,3,9,153,229
451,34,3,5,3,10,30,-45,3,4,183,184
451,35,2,5,4,9,22,54,5,8,205,238
451,36,4,3,8,5,44,-68,9,0,249,170
451,37,3,3,8,5,-65,32,4,2,184,202
451,38,3,4,7,6,34,42,8,4,218,244
451,39,4,3,6,7,-58,34,0,8,160,278
451,40,3,4,7,6,34,-58,4,0,194,220
451,41,5,2,8,5,53,23,7,3,247,243
451,42,3,5,6,7,-67,52,0,5,180,295
451,43,4,3,8,5,44,32,4,7,224,327
451,44,3,4,8,5,35,41,9,8,259,368
451,45,4,2,8,5,-56,-77,3,1,203,291
451,46,2,5,2,11,20,56,3,7,223,347
451,47,5,2,7,6,52,-76,5,1,275,271
451,48,4,2,10,3,-54,21,1,2,221,292
451,49,2,4,5,8,23,44,4,6,244,336
451,50,4,2,10,3,-54,21,0,7,190,357
451,51,6,2,9,4,63,22,3,9,253,379
451,52,3,4,5,8,32,-56,5,3,285,323
451,53,4,3,7,6,43,33,8,6,328,356
451,54,3,3,9,4,-64,31,4,7,264,387
451,55,2,4,4,9,22,-55,6,2,286,332
451,56,4,4,7,6,43,42,9,4,329,374
451,57,2,4,6,7,-76,43,3,7,253,417
451,58,6,2,9,4,63,22,6,9,316,439
451,59,4,2,7,6,43,-76,9,3,359,363
451,60,4,4,3,10,-40,46,9,9,319,409
451,61,4,3,6,7,-58,-66,1,3,261,343
451,62,4,2,7,6,43,24,4,7,304,367
451,63,5,2,10,3,55,21,9,8,359,388
451,64,3,3,8,5,-65,-68,4,0,294,320
451,65,4,2,7,6,43,24,7,4,337,344
451,66,3,3,6,7,-67,34,0,8,270,378
451,67,5,2,10,3,55,21,5,9,325,399
451,68,4,2,7,6,43,-76,8,3,368,323
451,69,4,3,9,4,-55,31,3,4,313,354
451,70,3,4,6,7,33,43,6,7,346,397
451,71,3,3,7,6,-66,-67,0,0,280,330
451,72,4,2,6,7,42,25,2,5,322,355
451,73,4,2,7,6,43,24,5,9,365,379
451,74,4,3,7,6,43,-67,8,2,408,312
451,75,5,2,10,3,-45,21,3,3,363,333
451,76,4,2,8,5,44,23,7,6,407,356
451,77,3,3,7,6,-66,33,1,9,341,389
451,78,5,2,7,6,52,-76,3,3,393,313
451,79,2,4,6,7,24,43,7,6,417,356
451,80,3,3,8,5,-65,32,2,8,352,388
451,81,6,2,10,3,64,21,6,9,416,409
451,82,2,5,2,11,20,-44,6,5,436,365
451,83,3,3,7,6,-66,33,0,8,370,398
451,84,4,3,8,5,44,-68,4,0,414,330
451,85,4,3,8,5,44,32,8,2,458,362
451,86,4,2,11,2,-53,20,5,2,405,382
451,87,2,5,5,8,23,53,8,5,428,435
451,88,5,2,10,3,-45,21,3,6,383,456
451,89,3,4,4,9,31,-55,4,1,414,401
451,90,5,2,8,5,53,23,7,4,467,424
451,91,4,3,8,5,-56,32,1,6,411,456
451,92,3,3,5,8,32,-65,3,1,443,391
451,93,3,3,7,6,34,33,7,4,477,424
451,94,4,3,8,5,-56,32,1,6,421,456
451,95,2,5,4,9,22,-46,3,0,443,410
451,96,4,3,9,4,45,31,8,1,488,441
451,97,2,4,4,9,-78,45,0,6,410,486
451,98,3,3,5,8,32,-65,2,1,442,421
451,99,2,5,5,8,23,53,5,4,465,474
451,100,2,5,3,10,21,55,6,9,486,529
452,1,2,4,8,5,26,41,6,1,26,41
452,2,5,2,8,5,53,23,9,4,79,64
452,3,2,4,6,7,-76,43,3,7,3,107
452,4,3,4,7,6,34,42,7,9,37,149
452,5,2,5,3,10,21,-45,8,4,58,104
452,6,3,3,7,6,-66,33,2,7,-8,137
452,7,3,3,7,6,34,-67,6,0,26,70
452,8,5,2,10,3,-45,21,1,1,-19,91
452,9,3,3,5,8,32,35,3,6,13,126
452,10,3,4,7,6,34,42,7,8,47,168
452,11,3,3,4,9,31,-64,8,4,78,104
452,12,3,4,4,9,31,45,9,9,109,149
452,13,4,2,8,5,-56,-77,3,2,53,72
452,14,3,5,6,7,33,52,6,4,86,124
452,15,5,3,6,7,51,34,7,8,137,158
452,16,3,4,6,7,-67,-57,0,1,70,101
452,17,4,3,7,6,43,33,3,4,113,134
452,18,6,2,10,3,64,21,7,5,177,155
452,19,5,2,7,6,52,24,9,9,229,179
452,20,3,3,5,8,-68,-65,1,4,161,114
452,21,4,2,6,7,42,25,3,9,203,139
452,22,2,4,4,9,22,-55,5,4,225,84
452,23,2,5,4,9,22,54,7,8,247,138
452,24,5,2,9,4,-46,-78,1,0,201,60
452,25,4,2,8,5,44,23,5,3,245,83
452,26,3,3,8,5,-65,32,0,5,180,115
452,27,4,2,6,7,42,-75,2,0,222,40
452,28,4,3,8,5,44,32,6,2,266,72
452,29,3,4,5,8,32,44,8,6,298,116
452,30,6,2,9,4,-37,22,1,8,261,138
452,31,3,4,6,7,33,-57,4,1,294,81
452,32,4,2,8,5,44,23,8,4,338,104
452,33,4,2,9,4,-55,22,3,6,283,126
452,34,4,3,6,7,42,-66,5,0,325,60
452,35,3,3,6,7,33,34,8,4,358,94
452,36,3,4,4,9,31,45,9,9,389,139
452,37,2,4,7,6,-75,-58,4,1,314,81
452,38,2,4,2,11,20,47,4,8,334,128
452,39,3,3,7,6,34,-67,8,1,368,61
452,40,3,4,5,8,-68,44,0,5,300,105
452,41,2,4,7,6,25,42,5,7,325,147
452,42,3,4,5,8,32,-56,7,1,357,91
452,43,4,3,5,8,41,35,8,6,398,126
452,44,4,2,7,6,-57,-76,1,0,341,50
452,45,2,4,5,8,23,44,4,4,364,94
452,46,3,4,4,9,31,45,5,9,395,139
452,47,5,2,7,6,52,-76,7,3,447,63
452,48,2,5,4,9,22,54,9,7,469,117
452,49,4,2,9,4,-55,22,4,9,414,139
452,50,4,3,5,8,41,-65,5,4,455,74
452,51,3,4,7,6,34,42,9,6,489,116
452,52,4,2,7,6,-57,-76,2,0,432,40
452,53,3,3,8,5,35,32,7,2,467,72
452,54,4,3,8,5,-56,32,1,4,411,104
452,55,3,4,4,9,31,45,2,9,442,149
452,56,3,4,8,5,35,-59,7,0,477,90
452,57,4,3,9,4,-55,31,2,1,422,121
452,58,2,5,5,8,23,53,5,4,445,174
452,59,3,3,6,7,33,34,8,8,478,208
452,60,3,4,5,8,-68,-56,0,2,410,152
452,61,4,2,7,6,43,24,3,6,453,176
452,62,4,3,7,6,43,33,6,9,496,209
452,63,4,3,8,5,-56,-68,0,1,440,141
452,64,2,5,4,9,22,54,2,5,462,195
452,65,4,3,7,6,43,33,5,8,505,228
453,1,4,3,7,6,43,33,3,3,43,33
453,2,3,4,5,8,32,44,5,7,75,77
453,3,4,3,7,6,43,-67,8,0,118,10
453,4,3,3,7,6,-66,33,2,3,52,43
453,5,4,3,9,4,45,31,7,4,97,74
453,6,2,4,5,8,-77,44,0,8,20,118
453,7,2,4,3,10,21,-54,1,4,41,64
453,8,4,2,10,3,46,21,7,5,87,85
453,9,3,4,5,8,32,44,9,9,119,129
453,10,3,3,5,8,-68,-65,1,4,51,64
453,11,3,3,4,9,31,-64,2,0,82,0
453,12,5,3,9,4,54,31,6,1,136,31
453,13,3,4,7,6,-66,42,0,3,70,73
453,14,4,3,10,3,46,30,6,3,116,103
453,15,3,4,3,10,30,46,6,9,146,149
453,16,2,5,4,9,22,-46,8,3,168,103
453,17,2,4,4,9,-78,45,0,8,90,148
453,18,4,2,9,4,45,-78,5,0,135,70
453,19,3,4,4,9,31,45,6,5,166,115
453,20,3,3,5,8,32,-65,8,0,198,50
453,21,3,3,7,6,-66,33,2,3,132,83
453,22,2,5,3,10,21,55,3,8,153,138
453,23,5,2,8,5,53,-77,6,1,206,61
453,24,3,3,9,4,-64,31,2,2,142,92
453,25,5,3,7,6,52,33,4,5,194,125
453,26,4,3,7,6,43,33,7,8,237,158
453,27,2,5,4,9,22,-46,9,2,259,112
453,28,4,3,6,7,-58,34,1,6,201,146
453,29,3,3,7,6,34,33,5,9,235,179
453,30,3,4,3,10,30,-54,5,5,265,125
453,31,5,2,9,4,54,22,9,7,319,147
453,32,4,2,9,4,-55,22,4,9,264,169
453,33,4,2,10,3,-54,-79,0,0,210,90
453,34,3,4,5,8,32,44,2,4,242,134
453,35,3,4,7,6,34,42,6,6,276,176
453,36,4,3,6,7,42,-66,8,0,318,110
453,37,3,3,7,6,-66,33,2,3,252,143
453,38,4,3,9,4,45,31,7,4,297,174
453,39,3,4,5,8,32,44,9,8,329,218
453,40,4,3,9,4,-55,31,4,9,274,249
453,41,3,4,7,6,34,-58,8,1,308,191
453,42,3,4,8,5,-65,41,3,2,243,232
453,43,5,3,9,4,54,31,7,3,297,263
453,44,3,4,8,5,-65,41,2,4,232,304
453,45,5,2,9,4,54,22,6,6,286,326
453,46,4,2,7,6,43,-76,9,0,329,250
453,47,5,2,11,2,-44,20,5,0,285,270
453,48,3,4,7,6,34,42,9,2,319,312
453,49,4,3,7,6,-57,33,2,5,262,345
453,50,5,2,11,2,56,20,8,5,318,365
453,51,3,4,5,8,-68,44,0,9,250,409
453,52,5,2,10,3,55,-79,5,0,305,330
453,53,2,6,4,9,22,63,7,3,327,393
453,54,4,3,8,5,-56,32,1,5,271,425
453,55,3,5,6,7,33,52,4,7,304,477
453,56,4,2,9,4,45,22,9,9,349,499
453,57,4,4,9,4,-55,40,4,9,294,539
454,1,2,5,6,7,24,52,4,2,24,52
454,2,2,4,6,7,24,43,8,5,48,95
454,3,2,5,3,10,21,-45,9,0,69,50
454,4,3,3,3,10,30,37,9,7,99,87
454,5,3,3,6,7,-67,-66,2,1,32,21
454,6,4,2,9,4,45,22,7,3,77,43
454,7,2,4,5,8,-77,44,0,7,0,87
454,8,4,3,9,4,45,31,5,8,45,118
454,9,2,5,3,10,21,-45,6,3,66,73
454,10,3,4,6,7,33,43,9,6,99,116
454,11,3,4,8,5,-65,41,4,7,34,157
454,12,4,2,8,5,44,-77,8,0,78,80
454,13,4,3,7,6,-57,33,1,3,21,113
454,14,4,2,10,3,46,21,7,4,67,134
454,15,3,3,10,3,-63,30,4,4,4,164
454,16,2,5,5,8,23,53,7,7,27,217
454,17,4,3,9,4,-55,31,2,8,-28,248
454,18,5,2,8,5,53,-77,5,1,25,171
454,19,2,6,4,9,22,63,7,4,47,234
454,20,4,3,6,7,42,34,9,8,89,268
454,21,2,5,4,9,-78,-46,1,2,11,222
454,22,5,2,11,2,56,20,7,2,67,242
454,23,4,3,8,5,-56,32,1,4,11,274
454,24,3,4,7,6,34,42,5,6,45,316
454,25,4,2,6,7,42,-75,7,1,87,241
454,26,3,3,4,9,31,36,8,7,118,277
454,27,3,3,9,4,-64,31,4,8,54,308
454,28,4,2,7,6,43,-76,7,2,97,232
454,29,3,3,6,7,-67,34,0,6,30,266
454,30,6,2,11,2,65,20,5,6,95,286
454,31,3,3,8,5,-65,32,0,8,30,318
454,32,4,2,8,5,44,-77,4,1,74,241
454,33,3,4,5,8,32,44,6,5,106,285
454,34,3,4,6,7,33,43,9,8,139,328
454,35,4,3,8,5,-56,-68,3,0,83,260
454,36,3,4,4,9,31,45,4,5,114,305
454,37,4,3,6,7,42,34,6,9,156,339
454,38,2,4,3,10,21,-54,7,5,177,285
454,39,3,4,4,9,31,-55,8,0,208,230
454,40,3,3,7,6,-66,33,2,3,142,263
454,41,3,3,5,8,32,35,4,8,174,298
454,42,3,3,8,5,35,-68,9,0,209,230
454,43,3,3,5,8,-68,35,1,5,141,265
454,44,2,4,5,8,23,44,4,9,164,309
454,45,3,3,3,10,30,-63,4,6,194,246
454,46,2,5,4,9,22,-46,6,0,216,200
454,47,3,4,9,4,-64,40,2,0,152,240
454,48,4,2,9,4,45,22,7,2,197,262
454,49,2,4,4,9,22,45,9,7,219,307
454,50,3,4,5,8,-68,-56,1,1,151,251
454,51,2,4,4,9,22,45,3,6,173,296
454,52,2,4,7,6,25,42,8,8,198,338
454,53,3,3,7,6,-66,-67,2,1,132,271
454,54,2,6,4,9,22,63,4,4,154,334
454,55,2,5,6,7,24,52,8,6,178,386
454,56,3,3,7,6,-66,33,2,9,112,419
454,57,4,2,8,5,44,-77,6,2,156,342
454,58,3,4,5,8,32,44,8,6,188,386
454,59,2,5,5,8,-77,53,1,9,111,439
454,60,5,2,7,6,52,-76,3,3,163,363
454,61,3,4,6,7,33,43,6,6,196,406
454,62,3,4,4,9,31,-55,7,1,227,351
454,63,4,3,9,4,-55,31,2,2,172,382
454,64,2,4,6,7,24,43,6,5,196,425
454,65,4,2,6,7,42,-75,8,0,238,350
454,66,3,4,5,8,-68,44,0,4,170,394
454,67,3,3,8,5,35,32,5,6,205,426
454,68,3,3,8,5,-65,32,0,8,140,458
454,69,3,3,6,7,33,-66,3,2,173,392
454,70,2,4,4,9,22,45,5,7,195,437
454,71,3,3,7,6,34,-67,9,0,229,370
454,72,3,3,7,6,-66,33,3,3,163,403
454,73,3,3,9,4,36,31,9,4,199,434
454,74,3,4,4,9,-69,45,0,9,130,479
454,75,3,3,7,6,34,-67,4,2,164,412
454,76,3,4,4,9,31,45,5,7,195,457
454,77,5,2,10,3,-45,21,0,8,150,478
454,78,5,2,9,4,54,-78,4,0,204,400
454,79,6,2,11,2,65,20,9,0,269,420
454,80,3,3,5,8,-68,35,1,5,201,455
454,81,3,4,5,8,32,44,3,9,233,499
454,82,3,3,6,7,33,-66,6,3,266,433
454,83,3,3,5,8,32,35,8,8,298,468
454,84,4,3,6,7,-58,-66,0,2,240,402
454,85,3,4,5,8,32,44,2,6,272,446
454,86,3,4,5,8,32,-56,4,0,304,390
454,87,3,5,4,9,31,54,5,4,335,444
454,88,3,3,8,5,-65,32,0,6,270,476
454,89,4,3,8,5,44,32,4,8,314,508
455,1,3,3,5,8,32,35,2,5,32,35
455,2,2,5,4,9,22,54,4,9,54,89
455,3,4,2,9,4,45,-78,9,1,99,11
455,4,4,3,4,9,40,36,9,7,139,47
455,5,4,3,6,7,-58,-66,1,1,81,-19
455,6,4,2,9,4,45,22,6,3,126,3
455,7,3,5,7,6,-66,51,0,4,60,54
455,8,2,5,5,8,23,53,3,7,83,107
455,9,2,6,2,11,20,-35,3,2,103,72
455,10,3,4,6,7,33,43,6,5,136,115
455,11,4,2,8,5,-56,23,0,8,80,138
455,12,4,3,8,5,44,-68,4,0,124,70
455,13,3,5,6,7,33,52,7,2,157,122
455,14,5,2,8,5,-47,23,0,5,110,145
455,15,4,3,9,4,45,31,5,6,155,176
455,16,3,4,5,8,32,-56,7,0,187,120
455,17,4,3,8,5,-56,32,1,2,131,152
455,18,4,3,6,7,42,34,3,6,173,186
455,19,3,3,7,6,34,33,7,9,207,219
455,20,3,3,7,6,-66,-67,1,2,141,152
455,21,2,5,3,10,21,55,2,7,162,207
455,22,3,3,8,5,35,32,7,9,197,239
455,23,3,3,7,6,-66,-67,1,2,131,172
455,24,4,2,10,3,46,21,7,3,177,193
455,25,2,5,4,9,22,54,9,7,199,247
455,26,3,4,7,6,-66,42,3,9,133,289
455,27,3,3,9,4,36,-69,9,0,169,220
455,28,2,4,5,8,-77,44,2,4,92,264
455,29,3,4,8,5,35,41,7,5,127,305
455,30,2,5,5,8,-77,53,0,8,50,358
455,31,3,3,6,7,33,-66,3,2,83,292
455,32,5,2,7,6,52,24,5,6,135,316
455,33,4,3,9,4,-55,31,0,7,80,347
455,34,4,3,5,8,41,-65,1,2,121,282
455,35,2,5,2,11,20,56,1,8,141,338
455,36,4,3,9,4,45,31,6,9,186,369
455,37,5,2,9,4,-46,-78,0,1,140,291
455,38,2,4,5,8,23,44,3,5,163,335
455,39,4,3,9,4,45,31,8,6,208,366
455,40,3,3,7,6,-66,33,2,9,142,399
455,41,2,4,8,5,26,-59,8,0,168,340
455,42,4,2,8,5,-56,23,2,3,112,363
455,43,5,3,7,6,52,33,4,6,164,396
455,44,3,3,10,3,-63,30,1,6,101,426
455,45,2,4,5,8,23,-56,4,0,124,370
455,46,2,4,4,9,22,45,6,5,146,415
455,47,2,4,5,8,23,44,9,9,169,459
455,48,2,5,5,8,-77,-47,2,2,92,412
455,49,3,3,4,9,31,36,3,8,123,448
455,50,6,2,10,3,64,21,7,9,187,469
455,51,2,5,3,10,21,-45,8,4,208,424
455,52,2,4,5,8,-77,44,1,8,131,468
455,53,5,3,9,4,54,31,5,9,185,499
455,54,3,3,6,7,33,-66,8,3,218,433
455,55,2,4,7,6,-75,42,3,5,143,475
455,56,3,3,7,6,34,33,7,8,177,508
456,1,5,3,9,4,54,31,4,1,54,31
456,2,3,3,6,7,33,34,7,5,87,65
456,3,4,3,7,6,-57,33,0,8,30,98
456,4,3,4,8,5,35,41,5,9,65,139
456,5,5,2,8,5,53,-77,8,2,118,62
456,6,3,4,5,8,-68,44,0,6,50,106
456,7,4,2,6,7,42,-75,2,1,92,31
456,8,3,3,7,6,34,33,6,4,126,64
456,9,4,2,9,4,-55,22,1,6,71,86
456,10,4,3,9,4,45,31,6,7,116,117
456,11,3,4,4,9,31,-55,7,2,147,62
456,12,3,3,7,6,-66,33,1,5,81,95
456,13,3,4,7,6,34,42,5,7,115,137
456,14,3,3,8,5,-65,32,0,9,50,169
456,15,4,2,8,5,44,-77,4,2,94,92
456,16,3,3,8,5,35,32,9,4,129,124
456,17,3,4,6,7,-67,43,2,7,62,167
456,18,4,2,8,5,44,-77,6,0,106,90
456,19,2,4,5,8,23,44,9,4,129,134
456,20,3,3,9,4,-64,31,5,5,65,165
456,21,4,3,5,8,41,-65,6,0,106,100
456,22,3,4,4,9,31,45,7,5,137,145
456,23,4,3,9,4,-55,31,2,6,82,176
456,24,4,4,7,6,43,42,5,8,125,218
456,25,3,4,7,6,34,-58,9,0,159,160
456,26,2,5,4,9,-78,54,1,4,81,214
456,27,2,4,3,10,21,-54,2,0,102,160
456,28,3,4,7,6,34,42,6,2,136,202
456,29,4,3,7,6,43,33,9,5,179,235
456,30,3,4,4,9,-69,-55,0,0,110,180
456,31,4,4,7,6,43,42,3,2,153,222
456,32,3,4,4,9,31,45,4,7,184,267
456,33,3,3,8,5,35,32,9,9,219,299
456,34,3,3,5,8,-68,-65,1,4,151,234
456,35,2,5,4,9,22,54,3,8,173,288
456,36,4,3,6,7,42,-66,5,2,215,222
456,37,3,4,6,7,33,43,8,5,248,265
456,38,4,2,8,5,-56,23,2,8,192,288
456,39,6,2,11,2,65,20,7,8,257,308
456,40,6,2,11,2,-35,20,2,8,222,328
456,41,2,4,4,9,22,-55,4,3,244,273
456,42,4,2,7,6,43,24,7,7,287,297
456,43,4,2,7,6,-57,-76,0,1,230,221
456,44,4,2,6,7,42,25,2,6,272,246
456,45,4,3,8,5,44,32,6,8,316,278
456,46,3,3,5,8,32,-65,8,3,348,213
456,47,3,4,6,7,-67,43,1,6,281,256
456,48,5,2,10,3,55,21,6,7,336,277
456,49,3,3,9,4,-64,31,2,8,272,308
456,50,2,5,5,8,23,-47,5,1,295,261
456,51,3,3,6,7,33,34,8,5,328,295
456,52,3,4,7,6,-66,42,2,7,262,337
456,53,3,4,4,9,31,-55,3,2,293,282
456,54,2,5,4,9,22,54,5,6,315,336
456,55,4,3,7,6,43,33,8,9,358,369
456,56,4,2,10,3,-54,-79,4,0,304,290
456,57,3,4,5,8,32,44,6,4,336,334
456,58,3,3,8,5,-65,32,1,6,271,366
456,59,3,4,5,8,32,-56,3,0,303,310
456,60,4,3,9,4,45,31,8,1,348,341
456,61,6,2,10,3,-36,21,2,2,312,362
456,62,2,4,4,9,22,45,4,7,334,407
456,63,3,3,4,9,31,-64,5,3,365,343
456,64,4,3,7,6,43,33,8,6,408,376
456,65,3,4,6,7,-67,43,1,9,341,419
456,66,4,3,9,4,45,-69,6,0,386,350
456,67,4,3,10,3,-54,30,2,0,332,380
456,68,2,5,7,6,25,51,7,1,357,431
456,69,3,3,7,6,-66,33,1,4,291,464
456,70,3,3,9,4,36,31,7,5,327,495
456,71,5,3,9,4,-46,31,1,6,281,526
457,1,4,2,11,2,47,20,7,0,47,20
457,2,3,5,6,7,-67,52,0,2,-20,72
457,3,3,4,7,6,34,42,4,4,14,114
457,4,5,3,6,7,51,34,5,8,65,148
457,5,2,5,5,8,23,-47,8,1,88,101
457,6,2,4,9,4,-73,40,5,1,15,141
457,7,4,3,10,3,-54,30,1,1,-39,171
457,8,2,4,5,8,23,44,4,5,-16,215
457,9,4,3,8,5,44,32,8,7,28,247
457,10,4,3,7,6,-57,-67,1,0,-29,180
457,11,3,3,8,5,35,32,6,2,6,212
457,12,2,4,7,6,-75,42,1,4,-69,254
457,13,3,3,8,5,35,32,6,6,-34,286
457,14,3,3,6,7,33,-66,9,0,-1,220
457,15,4,3,7,6,-57,33,2,3,-58,253
457,16,5,2,11,2,56,20,8,3,-2,273
457,17,4,3,6,7,-58,34,0,7,-60,307
457,18,3,3,6,7,33,-66,3,1,-27,241
457,19,2,4,4,9,22,45,5,6,-5,286
457,20,2,4,5,8,23,-56,8,0,18,230
457,21,3,5,8,5,-65,50,3,0,-47,280
457,22,2,4,6,7,24,43,7,3,-23,323
457,23,3,3,6,7,-67,34,0,7,-90,357
457,24,3,4,7,6,34,42,4,9,-56,399
457,25,3,3,4,9,31,-64,5,5,-25,335
457,26,2,5,2,11,20,-44,5,1,-5,291
457,27,5,2,9,4,54,22,9,3,49,313
457,28,3,3,5,8,-68,35,1,8,-19,348
457,29,2,6,3,10,21,-36,2,2,2,312
457,30,4,3,7,6,43,33,5,5,45,345
457,31,2,4,5,8,23,44,8,9,68,389
457,32,3,4,5,8,-68,-56,0,3,0,333
457,33,2,4,7,6,25,42,5,5,25,375
457,34,4,4,4,9,40,-55,5,0,65,320
457,35,3,3,6,7,33,34,8,4,98,354
457,36,3,3,7,6,-66,33,2,7,32,387
457,37,3,4,7,6,34,42,6,9,66,429
457,38,3,3,10,3,-63,30,3,9,3,459
457,39,5,2,10,3,55,-79,8,0,58,380
457,40,2,5,4,9,-78,54,0,4,-20,434
457,41,4,3,8,5,44,32,4,6,24,466
457,42,3,3,6,7,33,-66,7,0,57,400
457,43,2,4,6,7,-76,43,1,3,-19,443
457,44,2,4,5,8,23,44,4,7,4,487
457,45,4,3,8,5,44,32,8,9,48,519
458,1,4,3,9,4,45,31,5,1,45,31
458,2,2,5,4,9,22,54,7,5,67,85
458,3,3,4,5,8,32,44,9,9,99,129
458,4,4,2,8,5,-56,-77,3,2,43,52
458,5,3,4,9,4,36,40,9,2,79,92
458,6,4,3,8,5,-56,32,3,4,23,124
458,7,3,4,4,9,31,45,4,9,54,169
458,8,2,6,4,9,22,-37,6,2,76,132
458,9,2,4,6,7,-76,43,0,5,0,175
458,10,4,2,8,5,44,23,4,8,44,198
458,11,4,3,8,5,44,-68,8,0,88,130
458,12,4,3,8,5,-56,32,2,2,32,162
458,13,2,5,5,8,23,53,5,5,55,215
458,14,4,4,5,8,41,44,6,9,96,259
458,15,3,4,7,6,-66,-58,0,1,30,201
458,16,6,2,10,3,64,21,4,2,94,222
458,17,4,3,7,6,43,33,7,5,137,255
458,18,2,4,4,9,22,-55,9,0,159,200
458,19,3,4,8,5,-65,41,4,1,94,241
458,20,2,5,6,7,24,52,8,3,118,293
458,21,3,4,6,7,-67,43,1,6,51,336
458,22,4,3,7,6,43,33,4,9,94,369
458,23,3,3,9,4,-64,-69,0,0,30,300
458,24,5,3,6,7,51,34,1,4,81,334
458,25,3,3,6,7,33,34,4,8,114,368
458,26,4,3,7,6,43,-67,7,1,157,301
458,27,3,4,6,7,-67,43,0,4,90,344
458,28,3,3,5,8,32,35,2,9,122,379
458,29,3,4,5,8,32,-56,4,3,154,323
458,30,2,5,4,9,22,54,6,7,176,377
458,31,3,3,6,7,33,-66,9,1,209,311
458,32,3,3,5,8,-68,35,1,6,141,346
458,33,3,3,5,8,32,-65,3,1,173,281
458,34,3,4,4,9,31,45,4,6,204,326
458,35,2,5,4,9,22,-46,6,0,226,280
458,36,2,4,5,8,23,44,9,4,249,324
458,37,2,5,2,11,20,-44,9,0,269,280
458,38,3,3,6,7,-67,34,2,4,202,314
458,39,5,2,10,3,55,21,7,5,257,335
458,40,4,3,8,5,-56,32,1,7,201,367
458,41,5,2,8,5,53,-77,4,0,254,290
458,42,3,4,4,9,31,45,5,5,285,335
458,43,3,3,8,5,-65,32,0,7,220,367
458,44,3,3,6,7,33,-66,3,1,253,301
458,45,4,3,6,7,42,34,5,5,295,335
458,46,4,3,9,4,-55,31,0,6,240,366
458,47,5,2,10,3,55,21,5,7,295,387
458,48,3,3,5,8,32,-65,7,2,327,322
458,49,4,2,9,4,-55,22,2,4,272,344
458,50,3,3,7,6,34,33,6,7,306,377
458,51,3,4,5,8,32,-56,8,1,338,321
458,52,4,2,9,4,-55,22,3,3,283,343
458,53,2,5,5,8,23,53,6,6,306,396
458,54,5,2,9,4,-46,22,0,8,260,418
458,55,4,3,7,6,43,-67,3,1,303,351
458,56,2,4,7,6,25,42,8,3,328,393
458,57,4,3,6,7,-58,34,0,7,270,427
458,58,4,3,10,3,46,30,6,7,316,457
458,59,4,3,9,4,-55,31,1,8,261,488
458,60,3,5,6,7,33,-48,4,0,294,440
458,61,5,2,10,3,55,21,9,1,349,461
458,62,4,3,9,4,-55,31,4,2,294,492
458,63,2,4,7,6,25,42,9,4,319,534
459,1,4,3,7,6,43,33,3,3,43,33
459,2,4,3,7,6,43,33,6,6,86,66
459,3,4,2,11,2,-53,20,3,6,33,86
459,4,3,4,6,7,33,43,6,9,66,129
459,5,3,4,8,5,-65,-59,1,0,1,70
459,6,2,4,8,5,26,41,7,1,27,111
459,7,4,3,7,6,-57,33,0,4,-30,144
459,8,3,3,8,5,35,32,5,6,5,176
459,9,2,4,6,7,24,43,9,9,29,219
459,10,5,2,10,3,-45,-79,4,0,-16,140
459,11,4,3,9,4,45,31,9,1,29,171
459,12,4,3,7,6,-57,33,2,4,-28,204
459,13,4,2,7,6,43,24,5,8,15,228
459,14,5,3,10,3,-45,30,0,8,-30,258
459,15,2,4,3,10,21,-54,1,4,-9,204
459,16,2,5,2,11,20,-44,1,0,11,160
459,17,3,3,6,7,33,34,4,4,44,194
459,18,4,3,7,6,43,33,7,7,87,227
459,19,4,4,6,7,42,-57,9,0,129,170
459,20,5,2,10,3,-45,21,4,1,84,191
459,21,3,4,5,8,32,44,6,5,116,235
459,22,3,3,4,9,31,-64,7,1,147,171
459,23,5,2,8,5,-47,23,0,4,100,194
459,24,4,2,9,4,45,22,5,6,145,216
459,25,3,4,6,7,33,43,8,9,178,259
459,26,5,2,9,4,-46,-78,2,1,132,181
459,27,2,4,6,7,24,43,6,4,156,224
459,28,5,2,9,4,-46,22,0,6,110,246
459,29,2,5,5,8,23,53,3,9,133,299
459,30,2,4,4,9,22,-55,5,4,155,244
459,31,4,4,4,9,40,45,5,9,195,289
459,32,3,4,4,9,31,-55,6,4,226,234
459,33,4,2,8,5,-56,23,0,7,170,257
459,34,2,4,7,6,25,42,5,9,195,299
459,35,4,3,5,8,41,-65,6,4,236,234
459,36,3,3,6,7,33,34,9,8,269,268
459,37,3,3,6,7,-67,-66,2,2,202,202
459,38,3,3,7,6,34,33,6,5,236,235
459,39,2,5,4,9,22,54,8,9,258,289
459,40,5,2,7,6,-48,-76,0,3,210,213
459,41,2,4,5,8,23,44,3,7,233,257
459,42,4,3,8,5,44,32,7,9,277,289
459,43,3,3,5,8,32,-65,9,4,309,224
459,44,4,3,5,8,-59,35,0,9,250,259
459,45,4,3,8,5,44,-68,4,1,294,191
459,46,2,4,3,10,21,46,5,7,315,237
459,47,4,2,8,5,44,-77,9,0,359,160
459,48,4,3,6,7,-58,34,1,4,301,194
459,49,4,2,11,2,47,20,8,4,348,214
459,50,4,2,5,8,41,-74,9,0,389,140
459,51,3,3,6,7,-67,34,2,4,322,174
459,52,2,5,3,10,21,55,3,9,343,229
459,53,3,4,5,8,32,-56,5,3,375,173
459,54,3,4,5,8,32,44,7,7,407,217
459,55,3,4,3,10,30,-54,7,3,437,163
459,56,4,3,5,8,41,35,8,8,478,198
459,57,4,2,7,6,-57,-76,1,2,421,122
459,58,3,3,7,6,34,33,5,5,455,155
459,59,5,3,8,5,53,32,8,7,508,187
460,1,3,4,4,9,31,45,1,5,31,45
460,2,2,4,3,10,21,-54,2,1,52,-9
460,3,3,4,5,8,32,44,4,5,84,35
460,4,2,4,5,8,23,44,7,9,107,79
460,5,3,3,8,5,-65,-68,2,1,42,11
460,6,5,2,8,5,53,23,5,4,95,34
460,7,2,5,2,11,20,-44,5,0,115,-10
460,8,5,2,11,2,-44,20,1,0,71,10
460,9,2,4,4,9,22,45,3,5,93,55
460,10,3,4,6,7,33,43,6,8,126,98
460,11,3,3,6,7,33,-66,9,2,159,32
460,12,3,3,7,6,-66,33,3,5,93,65
460,13,3,3,5,8,32,-65,5,0,125,0
460,14,2,4,8,5,-74,41,1,1,51,41
460,15,3,4,7,6,34,42,5,3,85,83
460,16,5,2,10,3,-45,21,0,4,40,104
460,17,3,3,8,5,35,32,5,6,75,136
460,18,3,4,7,6,34,42,9,8,109,178
460,19,3,3,7,6,-66,-67,3,1,43,111
460,20,4,3,7,6,43,33,6,4,86,144
460,21,2,4,6,7,-76,43,0,7,10,187
460,22,4,3,9,4,45,31,5,8,55,218
460,23,2,5,5,8,23,-47,8,1,78,171
460,24,3,3,7,6,-66,33,2,4,12,204
460,25,3,4,8,5,35,41,7,5,47,245
460,26,2,5,3,10,21,-45,8,0,68,200
460,27,5,2,7,6,-48,24,0,4,20,224
460,28,4,2,6,7,42,25,2,9,62,249
460,29,3,4,7,6,34,-58,6,1,96,191
460,30,3,3,6,7,33,34,9,5,129,225
460,31,5,2,11,2,-44,20,5,5,85,245
460,32,4,3,9,4,-55,31,0,6,30,276
460,33,3,4,5,8,32,-56,2,0,62,220
460,34,3,3,3,10,30,37,2,7,92,257
460,35,4,2,9,4,45,22,7,9,137,279
460,36,3,4,4,9,31,-55,8,4,168,224
460,37,4,2,6,7,-58,25,0,9,110,249
460,38,3,4,5,8,32,-56,2,3,142,193
460,39,5,2,11,2,56,20,8,3,198,213
460,40,3,4,8,5,-65,41,3,4,133,254
460,41,2,5,4,9,22,54,5,8,155,308
460,42,2,4,4,9,22,-55,7,3,177,253
460,43,3,4,6,7,-67,43,0,6,110,296
460,44,2,5,4,9,22,-46,2,0,132,250
460,45,4,2,10,3,46,21,8,1,178,271
460,46,2,4,5,8,-77,44,1,5,101,315
460,47,3,3,9,4,36,31,7,6,137,346
460,48,3,3,7,6,-66,33,1,9,71,379
460,49,4,3,7,6,43,-67,4,2,114,312
460,50,5,2,9,4,54,22,8,4,168,334
460,51,6,2,9,4,-37,22,1,6,131,356
460,52,2,5,5,8,23,53,4,9,154,409
460,53,3,4,5,8,32,-56,6,3,186,353
460,54,3,4,7,6,-66,42,0,5,120,395
460,55,2,4,4,9,22,-55,2,0,142,340
460,56,3,3,7,6,34,33,6,3,176,373
460,57,3,3,5,8,32,35,8,8,208,408
460,58,3,3,7,6,-66,-67,2,1,142,341
460,59,3,3,7,6,34,33,6,4,176,374
460,60,4,3,6,7,42,34,8,8,218,408
460,61,3,3,6,7,-67,-66,1,2,151,342
460,62,5,2,9,4,54,22,5,4,205,364
460,63,4,3,7,6,43,33,8,7,248,397
460,64,3,3,9,4,-64,31,4,8,184,428
460,65,3,4,4,9,31,-55,5,3,215,373
460,66,3,4,6,7,33,43,8,6,248,416
460,67,3,3,6,7,-67,-66,1,0,181,350
460,68,4,3,8,5,44,32,5,2,225,382
460,69,4,4,6,7,42,43,7,5,267,425
460,70,3,3,10,3,-63,30,4,5,204,455
460,71,2,4,7,6,25,42,9,7,229,497
460,72,2,4,3,10,-79,-54,0,3,150,443
460,73,3,4,3,10,30,46,0,9,180,489
460,74,2,5,6,7,24,-48,4,1,204,441
460,75,3,4,4,9,31,45,5,6,235,486
460,76,2,4,8,5,-74,41,1,7,161,527
461,1,4,3,8,5,44,32,4,2,44,32
461,2,3,3,5,8,32,35,6,7,76,67
461,3,5,2,11,2,-44,20,2,7,32,87
461,4,3,4,6,7,33,-57,5,0,65,30
461,5,3,5,5,8,32,53,7,3,97,83
461,6,4,4,4,9,40,45,7,8,137,128
461,7,5,2,10,3,-45,21,2,9,92,149
461,8,2,5,4,9,22,-46,4,3,114,103
461,9,2,4,5,8,23,44,7,7,137,147
461,10,3,3,8,5,-65,32,2,9,72,179
461,11,4,3,8,5,44,-68,6,1,116,111
461,12,4,3,7,6,43,33,9,4,159,144
461,13,2,4,5,8,-77,44,2,8,82,188
461,14,4,2,8,5,44,-77,6,1,126,111
461,15,2,4,7,6,-75,42,1,3,51,153
461,16,3,3,7,6,34,33,5,6,85,186
461,17,3,3,7,6,34,33,9,9,119,219
461,18,2,5,3,10,-79,-45,0,4,40,174
461,19,3,3,8,5,35,32,5,6,75,206
461,20,3,3,6,7,33,-66,8,0,108,140
461,21,4,2,8,5,-56,23,2,3,52,163
461,22,4,2,8,5,44,23,6,6,96,186
461,23,3,4,6,7,33,43,9,9,129,229
461,24,6,2,8,5,-38,-77,1,2,91,152
461,25,3,5,5,8,32,53,3,5,123,205
461,26,4,3,8,5,44,32,7,7,167,237
461,27,3,3,7,6,-66,-67,1,0,101,170
461,28,3,3,9,4,36,31,7,1,137,201
461,29,3,5,5,8,32,53,9,4,169,254
461,30,3,3,7,6,-66,33,3,7,103,287
461,31,3,3,6,7,33,-66,6,1,136,221
461,32,3,4,5,8,32,44,8,5,168,265
461,33,5,3,9,4,-46,31,2,6,122,296
461,34,5,2,9,4,54,22,6,8,176,318
461,35,3,3,5,8,32,-65,8,3,208,253
461,36,4,2,7,6,-57,24,1,7,151,277
461,37,5,3,8,5,53,32,4,9,204,309
461,38,2,4,5,8,23,-56,7,3,227,253
461,39,4,2,6,7,42,25,9,8,269,278
461,40,4,3,10,3,-54,30,5,8,215,308
461,41,3,4,8,5,-65,41,0,9,150,349
461,42,4,3,9,4,45,-69,5,0,195,280
461,43,4,3,7,6,43,33,8,3,238,313
461,44,3,4,5,8,-68,44,0,7,170,357
461,45,2,6,3,10,21,-36,1,1,191,321
461,46,3,4,6,7,33,43,4,4,224,364
461,47,2,4,5,8,23,44,7,8,247,408
461,48,2,5,5,8,-77,-47,0,1,170,361
461,49,3,3,8,5,35,32,5,3,205,393
461,50,3,3,6,7,33,34,8,7,238,427
461,51,4,3,7,6,-57,-67,1,0,181,360
461,52,2,5,6,7,24,52,5,2,205,412
461,53,4,2,7,6,43,24,8,6,248,436
461,54,2,5,3,10,21,-45,9,1,269,391
461,55,4,3,8,5,-56,32,3,3,213,423
461,56,3,3,3,10,30,-63,3,0,243,360
461,57,2,5,5,8,23,53,6,3,266,413
461,58,4,3,7,6,43,33,9,6,309,446
461,59,4,2,10,3,-54,21,5,7,255,467
461,60,3,3,7,6,34,-67,9,0,289,400
461,61,3,4,6,7,-67,43,2,3,222,443
461,62,3,3,8,5,35,32,7,5,257,475
461,63,3,3,6,7,-67,34,0,9,190,509
462,1,4,2,8,5,44,23,4,3,44,23
462,2,2,6,2,11,20,65,4,8,64,88
462,3,2,5,7,6,25,51,9,9,89,139
462,4,4,3,9,4,-55,-69,4,0,34,70
462,5,2,4,4,9,22,45,6,5,56,115
462,6,3,4,4,9,31,-55,7,0,87,60
462,7,2,5,6,7,-76,52,1,2,11,112
462,8,3,4,4,9,31,45,2,7,42,157
462,9,3,3,3,10,30,-63,2,4,72,94
462,10,3,3,5,8,32,35,4,9,104,129
462,11,3,4,6,7,33,-57,7,2,137,72
462,12,2,5,2,11,20,56,7,8,157,128
462,13,4,3,8,5,-56,-68,1,0,101,60
462,14,3,4,8,5,35,41,6,1,136,101
462,15,4,3,8,5,-56,32,0,3,80,133
462,16,2,5,2,11,20,56,0,9,100,189
462,17,2,4,5,8,23,-56,3,3,123,133
462,18,4,2,8,5,44,23,7,6,167,156
462,19,3,3,8,5,-65,32,2,8,102,188
462,20,2,5,3,10,21,-45,3,3,123,143
462,21,2,4,6,7,24,43,7,6,147,186
462,22,3,3,7,6,-66,33,1,9,81,219
462,23,3,3,4,9,31,-64,2,5,112,155
462,24,3,3,7,6,34,33,6,8,146,188
462,25,2,5,6,7,-76,-48,0,0,70,140
462,26,3,3,9,4,36,31,6,1,106,171
462,27,5,3,9,4,-46,31,0,2,60,202
462,28,2,4,5,8,23,44,3,6,83,246
462,29,5,2,7,6,52,-76,5,0,135,170
462,30,4,3,8,5,44,32,9,2,179,202
462,31,3,3,3,10,30,37,9,9,209,239
462,32,2,5,4,9,-78,-46,1,3,131,193
462,33,2,5,5,8,23,53,4,6,154,246
462,34,2,6,5,8,23,62,7,8,177,308
462,35,4,2,8,5,-56,-77,1,1,121,231
462,36,4,2,9,4,45,22,6,3,166,253
462,37,2,6,4,9,22,63,8,6,188,316
462,38,5,2,8,5,-47,23,1,9,141,339
462,39,4,2,8,5,44,-77,5,2,185,262
462,40,3,3,7,6,34,33,9,5,219,295
462,41,2,4,4,9,-78,-55,1,0,141,240
462,42,2,5,4,9,22,54,3,4,163,294
462,43,4,3,6,7,42,34,5,8,205,328
462,44,2,4,8,5,-74,41,1,9,131,369
462,45,3,4,7,6,34,-58,5,1,165,311
462,46,3,3,7,6,34,33,9,4,199,344
462,47,2,5,3,10,-79,55,0,9,120,399
462,48,4,3,8,5,44,-68,4,1,164,331
462,49,3,3,8,5,35,32,9,3,199,363
462,50,3,3,5,8,-68,35,1,8,131,398
462,51,3,4,4,9,31,-55,2,3,162,343
462,52,3,4,6,7,33,43,5,6,195,386
462,53,4,3,6,7,42,-66,7,0,237,320
462,54,3,4,5,8,32,44,9,4,269,364
462,55,5,2,9,4,-46,22,3,6,223,386
462,56,3,4,4,9,31,-55,4,1,254,331
462,57,2,4,7,6,25,42,9,3,279,373
462,58,2,5,3,10,-79,55,0,8,200,428
462,59,4,2,9,4,45,-78,5,0,245,350
462,60,4,3,7,6,43,33,8,3,288,383
462,61,4,2,6,7,-58,25,0,8,230,408
462,62,3,3,9,4,36,31,6,9,266,439
462,63,4,2,8,5,-56,-77,0,2,210,362
462,64,3,3,8,5,35,32,5,4,245,394
462,65,3,3,6,7,33,34,8,8,278,428
462,66,3,3,6,7,-67,-66,1,2,211,362
462,67,5,2,11,2,56,20,7,2,267,382
462,68,3,3,8,5,-65,32,2,4,202,414
462,69,5,3,10,3,55,30,7,4,257,444
462,70,4,3,8,5,-56,32,1,6,201,476
462,71,2,4,5,8,23,-56,4,0,224,420
462,72,3,3,6,7,33,34,7,4,257,454
462,73,3,3,6,7,-67,34,0,8,190,488
462,74,2,4,5,8,23,-56,3,2,213,432
462,75,3,4,4,9,31,45,4,7,244,477
462,76,4,2,7,6,43,-76,7,1,287,401
462,77,3,3,6,7,-67,34,0,5,220,435
462,78,4,3,9,4,45,31,5,6,265,466
462,79,2,4,6,7,24,43,9,9,289,509
463,1,3,4,8,5,35,41,5,1,35,41
463,2,2,4,5,8,23,44,8,5,58,85
463,3,4,3,9,4,-55,31,3,6,3,116
463,4,3,3,5,8,32,-65,5,1,35,51
463,5,4,2,8,5,44,23,9,4,79,74
463,6,2,4,4,9,-78,45,1,9,1,119
463,7,3,3,8,5,35,-68,6,1,36,51
463,8,4,3,6,7,42,34,8,5,78,85
463,9,5,2,10,3,-45,21,3,6,33,106
463,10,3,3,8,5,35,32,8,8,68,138
463,11,4,2,6,7,-58,-75,0,3,10,63
463,12,4,3,8,5,44,32,4,5,54,95
463,13,4,3,10,3,-54,30,0,5,0,125
463,14,3,3,9,4,36,31,6,6,36,156
463,15,3,4,6,7,33,43,9,9,69,199
463,16,2,5,5,8,-77,-47,2,2,-8,152
463,17,3,4,7,6,34,42,6,4,26,194
463,18,3,4,8,5,-65,41,1,5,-39,235
463,19,3,3,7,6,34,33,5,8,-5,268
463,20,2,4,6,7,24,-57,9,1,19,211
463,21,3,3,8,5,-65,32,4,3,-46,243
463,22,3,3,6,7,33,34,7,7,-13,277
463,23,4,2,10,3,-54,21,3,8,-67,298
463,24,4,3,6,7,42,-66,5,2,-25,232
463,25,3,3,7,6,34,33,9,5,9,265
463,26,5,2,8,5,-47,23,2,8,-38,288
463,27,4,3,10,3,46,30,8,8,8,318
463,28,2,4,3,10,21,-54,9,4,29,264
463,29,3,3,4,9,-69,-64,0,0,-40,200
463,30,3,3,6,7,33,34,3,4,-7,234
463,31,2,4,5,8,23,44,6,8,16,278
463,32,5,3,9,4,-46,31,0,9,-30,309
463,33,4,3,8,5,44,-68,4,1,14,241
463,34,4,3,6,7,42,34,6,5,56,275
463,35,3,3,5,8,32,-65,8,0,88,210
463,36,4,3,7,6,-57,33,1,3,31,243
463,37,3,3,6,7,33,34,4,7,64,277
463,38,2,4,5,8,23,-56,7,1,87,221
463,39,5,2,9,4,-46,22,1,3,41,243
463,40,3,3,5,8,32,35,3,8,73,278
463,41,3,4,6,7,33,-57,6,1,106,221
463,42,4,2,9,4,-55,22,1,3,51,243
463,43,4,3,6,7,42,34,3,7,93,277
463,44,3,3,4,9,31,-64,4,3,124,213
463,45,5,2,11,2,-44,20,0,3,80,233
463,46,2,4,4,9,22,45,2,8,102,278
463,47,2,4,6,7,24,-57,6,1,126,221
463,48,2,4,7,6,-75,42,1,3,51,263
463,49,3,3,7,6,34,33,5,6,85,296
463,50,3,4,5,8,32,-56,7,0,117,240
463,51,4,3,5,8,41,35,8,5,158,275
463,52,5,2,8,5,-47,23,1,8,111,298
463,53,2,5,3,10,21,-45,2,3,132,253
463,54,4,2,7,6,43,24,5,7,175,277
463,55,4,3,9,4,-55,31,0,8,120,308
463,56,2,5,4,9,22,-46,2,2,142,262
463,57,3,4,4,9,31,45,3,7,173,307
463,58,2,4,7,6,25,42,8,9,198,349
463,59,3,3,7,6,-66,-67,2,2,132,282
463,60,2,6,4,9,22,63,4,5,154,345
463,61,3,3,6,7,33,34,7,9,187,379
463,62,3,3,5,8,32,-65,9,4,219,314
463,63,3,4,8,5,-65,41,4,5,154,355
463,64,4,3,6,7,42,34,6,9,196,389
463,65,3,3,4,9,31,-64,7,5,227,325
463,66,3,4,5,8,32,44,9,9,259,369
463,67,3,4,8,5,-65,-59,4,0,194,310
463,68,3,3,8,5,35,32,9,2,229,342
463,69,3,4,6,7,-67,43,2,5,162,385
463,70,5,2,9,4,54,22,6,7,216,407
463,71,4,4,7,6,43,42,9,9,259,449
463,72,3,3,5,8,-68,-65,1,4,191,384
463,73,5,2,8,5,53,23,4,7,244,407
463,74,3,3,5,8,32,-65,6,2,276,342
463,75,3,4,7,6,-66,42,0,4,210,384
463,76,4,4,6,7,42,43,2,7,252,427
463,77,2,4,5,8,23,-56,5,1,275,371
463,78,4,3,9,4,-55,31,0,2,220,402
463,79,3,3,8,5,35,32,5,4,255,434
463,80,4,3,7,6,43,33,8,7,298,467
463,81,4,2,8,5,-56,-77,2,0,242,390
463,82,4,3,7,6,43,33,5,3,285,423
463,83,3,4,5,8,32,44,7,7,317,467
463,84,3,3,7,6,-66,-67,1,0,251,400
463,85,3,3,5,8,32,35,3,5,283,435
463,86,4,3,9,4,45,31,8,6,328,466
463,87,3,4,6,7,-67,43,1,9,261,509
464,1,6,2,9,4,63,22,3,2,63,22
464,2,2,6,2,11,20,65,3,7,83,87
464,3,3,3,6,7,33,-66,6,1,116,21
464,4,2,5,2,11,20,56,6,7,136,77
464,5,4,3,4,9,40,-64,6,3,176,13
464,6,3,3,6,7,33,34,9,7,209,47
464,7,3,3,5,8,-68,-65,1,2,141,-18
464,8,3,3,4,9,31,36,2,8,172,18
464,9,4,2,8,5,44,-77,6,1,216,-59
464,10,3,4,6,7,33,43,9,4,249,-16
464,11,3,4,7,6,-66,42,3,6,183,26
464,12,4,3,7,6,43,33,6,9,226,59
464,13,3,3,5,8,32,-65,8,4,258,-6
464,14,4,3,8,5,-56,32,2,6,202,26
464,15,5,2,9,4,54,22,6,8,256,48
464,16,2,5,4,9,22,-46,8,2,278,2
464,17,3,4,8,5,-65,41,3,3,213,43
464,18,4,3,8,5,44,32,7,5,257,75
464,19,5,2,9,4,-46,22,1,7,211,97
464,20,3,3,9,4,36,31,7,8,247,128
464,21,2,5,3,10,21,-45,8,3,268,83
464,22,4,3,9,4,-55,31,3,4,213,114
464,23,3,3,7,6,34,33,7,7,247,147
464,24,4,2,8,5,-56,-77,1,0,191,70
464,25,3,4,3,10,30,46,1,6,221,116
464,26,2,5,7,6,25,51,6,7,246,167
464,27,3,4,4,9,31,-55,7,2,277,112
464,28,4,3,9,4,-55,31,2,3,222,143
464,29,3,3,6,7,33,34,5,7,255,177
464,30,3,4,3,10,30,-54,5,3,285,123
464,31,3,3,4,9,31,36,6,9,316,159
464,32,3,4,6,7,33,-57,9,2,349,102
464,33,3,3,10,3,-63,30,6,2,286,132
464,34,3,4,3,10,30,46,6,8,316,178
464,35,3,3,4,9,31,-64,7,4,347,114
464,36,3,3,4,9,31,-64,8,0,378,50
464,37,4,4,7,6,-57,42,1,2,321,92
464,38,3,4,7,6,34,42,5,4,355,134
464,39,2,5,6,7,24,52,9,6,379,186
464,40,3,4,6,7,-67,43,2,9,312,229
464,41,3,3,6,7,33,-66,5,3,345,163
464,42,3,4,6,7,33,43,8,6,378,206
464,43,4,3,7,6,-57,33,1,9,321,239
464,44,2,5,5,8,23,-47,4,2,344,192
464,45,4,2,7,6,43,24,7,6,387,216
464,46,2,5,3,10,21,-45,8,1,408,171
464,47,2,4,7,6,-75,42,3,3,333,213
464,48,3,3,8,5,35,32,8,5,368,245
464,49,2,5,6,7,-76,52,2,7,292,297
464,50,4,3,9,4,45,31,7,8,337,328
464,51,4,3,6,7,42,-66,9,2,379,262
464,52,3,3,8,5,-65,32,4,4,314,294
464,53,3,4,9,4,-64,40,0,4,250,334
464,54,3,3,4,9,31,-64,1,0,281,270
464,55,3,4,6,7,33,43,4,3,314,313
464,56,2,5,3,10,21,55,5,8,335,368
464,57,3,3,7,6,34,-67,9,1,369,301
464,58,2,5,5,8,-77,53,2,4,292,354
464,59,2,5,3,10,21,55,3,9,313,409
464,60,3,4,5,8,32,-56,5,3,345,353
464,61,4,3,8,5,44,32,9,5,389,385
464,62,2,4,7,6,-75,42,4,7,314,427
464,63,2,5,5,8,23,-47,7,0,337,380
464,64,5,2,8,5,-47,23,0,3,290,403
464,65,3,3,7,6,34,33,4,6,324,436
464,66,2,5,3,10,21,-45,5,1,345,391
464,67,4,3,6,7,42,34,7,5,387,425
464,68,3,3,5,8,32,-65,9,0,419,360
464,69,5,2,9,4,-46,22,3,2,373,382
464,70,3,4,6,7,33,43,6,5,406,425
464,71,4,3,10,3,-54,30,2,5,352,455
464,72,4,3,9,4,45,31,7,6,397,486
464,73,3,4,3,10,30,-54,7,2,427,432
464,74,2,5,5,8,-77,53,0,5,350,485
464,75,3,4,7,6,34,42,4,7,384,527
465,1,4,2,8,5,44,23,4,3,44,23
465,2,4,3,7,6,43,33,7,6,87,56
465,3,4,2,7,6,-57,-76,0,0,30,-20
465,4,3,4,5,8,32,44,2,4,62,24
465,5,2,4,5,8,23,44,5,8,85,68
465,6,2,4,5,8,23,-56,8,2,108,12
465,7,4,2,8,5,-56,23,2,5,52,35
465,8,5,2,9,4,54,22,6,7,106,57
465,9,4,3,7,6,43,-67,9,0,149,-10
465,10,4,2,10,3,-54,21,5,1,95,11
465,11,2,4,7,6,-75,42,0,3,20,53
465,12,2,4,6,7,24,43,4,6,44,96
465,13,2,4,5,8,23,-56,7,0,67,40
465,14,4,3,7,6,-57,33,0,3,10,73
465,15,3,3,8,5,35,32,5,5,45,105
465,16,4,3,6,7,42,34,7,9,87,139
465,17,3,4,6,7,-67,-57,0,2,20,82
465,18,3,4,5,8,32,44,2,6,52,126
465,19,3,3,6,7,33,-66,5,0,85,60
465,20,2,4,5,8,23,44,8,4,108,104
465,21,2,4,7,6,-75,42,3,6,33,146
465,22,4,2,9,4,45,22,8,8,78,168
465,23,2,4,3,10,21,-54,9,4,99,114
465,24,3,3,3,10,30,-63,9,1,129,51
465,25,2,4,5,8,-77,44,2,5,52,95
465,26,3,3,8,5,35,32,7,7,87,127
465,27,3,3,5,8,32,-65,9,2,119,62
465,28,4,3,8,5,-56,32,3,4,63,94
465,29,4,2,8,5,44,23,7,7,107,117
465,30,2,4,4,9,22,-55,9,2,129,62
465,31,2,5,4,9,-78,54,1,6,51,116
465,32,3,3,6,7,33,-66,4,0,84,50
465,33,4,2,9,4,45,22,9,2,129,72
465,34,2,4,8,5,-74,41,5,3,55,113
465,35,3,4,6,7,33,43,8,6,88,156
465,36,4,2,10,3,-54,21,4,7,34,177
465,37,3,4,4,9,31,-55,5,2,65,122
465,38,4,3,7,6,43,33,8,5,108,155
465,39,2,4,7,6,-75,42,3,7,33,197
465,40,2,4,7,6,25,42,8,9,58,239
465,41,3,3,4,9,31,-64,9,5,89,175
465,42,2,4,8,5,-74,41,5,6,15,216
465,43,3,4,5,8,32,-56,7,0,47,160
465,44,4,3,9,4,-55,31,2,1,-8,191
465,45,4,3,6,7,42,34,4,5,34,225
465,46,5,3,7,6,52,33,6,8,86,258
465,47,2,4,6,7,-76,-57,0,1,10,201
465,48,3,3,6,7,33,34,3,5,43,235
465,49,2,4,5,8,23,44,6,9,66,279
465,50,5,2,10,3,-45,-79,1,0,21,200
465,51,4,3,7,6,43,33,4,3,64,233
465,52,3,3,6,7,33,34,7,7,97,267
465,53,4,3,8,5,-56,32,1,9,41,299
465,54,2,5,5,8,23,-47,4,2,64,252
465,55,5,2,10,3,55,21,9,3,119,273
465,56,5,2,9,4,-46,22,3,5,73,295
465,57,3,4,5,8,32,44,5,9,105,339
465,58,3,4,4,9,31,-55,6,4,136,284
465,59,3,3,6,7,33,34,9,8,169,318
465,60,3,3,8,5,-65,-68,4,0,104,250
465,61,4,3,9,4,45,31,9,1,149,281
465,62,4,4,7,6,-57,42,2,3,92,323
465,63,3,3,4,9,31,36,3,9,123,359
465,64,2,6,2,11,20,-35,3,4,143,324
465,65,3,3,7,6,34,33,7,7,177,357
465,66,3,3,7,6,-66,-67,1,0,111,290
465,67,3,3,10,3,37,30,8,0,148,320
465,68,3,3,7,6,-66,33,2,3,82,353
465,69,3,4,5,8,32,44,4,7,114,397
465,70,4,2,9,4,45,22,9,9,159,419
465,71,5,2,8,5,-47,-77,2,2,112,342
465,72,3,4,8,5,35,41,7,3,147,383
465,73,2,4,6,7,-76,43,1,6,71,426
465,74,3,4,4,9,31,-55,2,1,102,371
465,75,3,4,7,6,34,42,6,3,136,413
465,76,3,3,6,7,33,34,9,7,169,447
465,77,4,2,6,7,-58,-75,1,2,111,372
465,78,2,5,4,9,22,54,3,6,133,426
465,79,3,3,5,8,32,-65,5,1,165,361
465,80,4,2,6,7,42,25,7,6,207,386
465,81,3,3,8,5,-65,32,2,8,142,418
465,82,4,3,9,4,45,31,7,9,187,449
465,83,3,3,7,6,-66,-67,1,2,121,382
465,84,2,4,6,7,24,43,5,5,145,425
465,85,2,5,3,10,21,-45,6,0,166,380
465,86,4,3,5,8,41,35,7,5,207,415
465,87,2,5,5,8,-77,53,0,8,130,468
465,88,3,3,7,6,34,-67,4,1,164,401
465,89,3,3,4,9,31,36,5,7,195,437
465,90,2,4,8,5,-74,41,1,8,121,478
465,91,5,2,7,6,52,-76,3,2,173,402
465,92,4,3,7,6,43,33,6,5,216,435
465,93,3,4,4,9,31,-55,7,0,247,380
465,94,4,2,6,7,42,25,9,5,289,405
465,95,2,5,2,11,20,-44,9,1,309,361
465,96,4,3,8,5,-56,32,3,3,253,393
465,97,2,4,6,7,24,43,7,6,277,436
465,98,3,3,6,7,-67,-66,0,0,210,370
465,99,3,3,6,7,33,34,3,4,243,404
465,100,5,3,6,7,51,34,4,8,294,438
465,101,3,3,7,6,34,-67,8,1,328,371
465,102,3,3,8,5,-65,32,3,3,263,403
465,103,3,4,9,4,36,40,9,3,299,443
465,104,2,5,3,10,-79,55,0,8,220,498
465,105,2,4,4,9,22,-55,2,3,242,443
465,106,4,3,5,8,41,35,3,8,283,478
465,107,2,5,6,7,24,-48,7,0,307,430
465,108,3,3,8,5,-65,32,2,2,242,462
465,109,4,2,9,4,45,22,7,4,287,484
465,110,4,3,8,5,-56,32,1,6,231,516
466,1,5,3,8,5,53,32,3,2,53,32
466,2,2,4,6,7,24,43,7,5,77,75
466,3,4,3,6,7,42,34,9,9,119,109
466,4,2,4,5,8,-77,-56,2,3,42,53
466,5,5,2,9,4,54,22,6,5,96,75
466,6,3,3,5,8,32,-65,8,0,128,10
466,7,4,3,9,4,-55,31,3,1,73,41
466,8,3,3,8,5,35,32,8,3,108,73
466,9,3,3,8,5,-65,32,3,5,43,105
466,10,4,3,6,7,42,34,5,9,85,139
466,11,5,3,8,5,53,-68,8,1,138,71
466,12,2,4,6,7,-76,43,2,4,62,114
466,13,4,3,7,6,43,33,5,7,105,147
466,14,4,2,9,4,-55,22,0,9,50,169
466,15,4,2,10,3,46,-79,6,0,96,90
466,16,3,3,4,9,31,36,7,6,127,126
466,17,3,3,5,8,32,-65,9,1,159,61
466,18,5,2,7,6,-48,24,1,5,111,85
466,19,3,3,8,5,35,32,6,7,146,117
466,20,2,5,3,10,21,-45,7,2,167,72
466,21,2,4,5,8,-77,44,0,6,90,116
466,22,3,4,7,6,34,42,4,8,124,158
466,23,5,2,9,4,54,-78,8,0,178,80
466,24,2,5,7,6,-75,51,3,1,103,131
466,25,5,2,8,5,53,23,6,4,156,154
466,26,2,5,5,8,23,53,9,7,179,207
466,27,3,4,7,6,-66,42,3,9,113,249
466,28,3,3,8,5,35,-68,8,1,148,181
466,29,3,3,8,5,-65,32,3,3,83,213
466,30,4,3,7,6,43,33,6,6,126,246
466,31,4,3,5,8,41,-65,7,1,167,181
466,32,3,4,5,8,32,44,9,5,199,225
466,33,3,3,4,9,-69,-64,0,1,130,161
466,34,2,4,5,8,23,44,3,5,153,205
466,35,4,3,7,6,43,33,6,8,196,238
466,36,5,2,10,3,-45,21,1,9,151,259
466,37,3,4,5,8,32,-56,3,3,183,203
466,38,4,3,8,5,44,32,7,5,227,235
466,39,2,5,5,8,-77,53,0,8,150,288
466,40,2,5,4,9,22,-46,2,2,172,242
466,41,5,2,10,3,55,21,7,3,227,263
466,42,3,4,4,9,31,45,8,8,258,308
466,43,2,4,7,6,-75,-58,3,0,183,250
466,44,3,3,9,4,36,31,9,1,219,281
466,45,4,2,6,7,-58,25,1,6,161,306
466,46,3,5,6,7,33,52,4,8,194,358
466,47,6,2,8,5,62,-77,6,1,256,281
466,48,4,2,9,4,-55,22,1,3,201,303
466,49,3,3,4,9,31,36,2,9,232,339
466,50,3,3,6,7,33,-66,5,3,265,273
466,51,3,3,4,9,31,36,6,9,296,309
466,52,2,4,3,10,21,-54,7,5,317,255
466,53,4,2,6,7,42,-75,9,0,359,180
466,54,2,5,4,9,-78,54,1,4,281,234
466,55,4,3,8,5,44,32,5,6,325,266
466,56,2,5,4,9,22,-46,7,0,347,220
466,57,2,5,4,9,22,54,9,4,369,274
466,58,3,3,7,6,-66,33,3,7,303,307
466,59,5,2,10,3,55,21,8,8,358,328
466,60,2,6,4,9,-78,-37,0,1,280,291
466,61,5,2,8,5,53,23,3,4,333,314
466,62,3,3,5,8,32,35,5,9,365,349
466,63,4,3,6,7,42,-66,7,3,407,283
466,64,4,3,6,7,42,34,9,7,449,317
466,65,3,3,3,10,30,-63,9,4,479,254
466,66,3,4,6,7,-67,43,2,7,412,297
466,67,5,2,10,3,55,21,7,8,467,318
466,68,3,4,5,8,32,-56,9,2,499,262
466,69,3,3,7,6,-66,33,3,5,433,295
466,70,2,4,3,10,21,-54,4,1,454,241
466,71,3,3,6,7,33,34,7,5,487,275
466,72,2,4,4,9,22,-55,9,0,509,220
467,1,3,3,8,5,35,32,5,2,35,32
467,2,4,2,9,4,-55,22,0,4,-20,54
467,3,3,3,6,7,33,34,3,8,13,88
467,4,5,2,9,4,54,-78,7,0,67,10
467,5,4,2,8,5,-56,23,1,3,11,33
467,6,2,4,4,9,22,45,3,8,33,78
467,7,2,5,5,8,23,-47,6,1,56,31
467,8,4,3,8,5,-56,32,0,3,0,63
467,9,4,2,6,7,42,25,2,8,42,88
467,10,4,2,6,7,42,-75,4,3,84,13
467,11,3,5,3,10,30,55,4,8,114,68
467,12,4,3,7,6,43,-67,7,1,157,1
467,13,4,2,4,9,40,27,7,8,197,28
467,14,2,5,3,10,21,-45,8,3,218,-17
467,15,2,5,4,9,-78,54,0,7,140,37
467,16,2,4,4,9,22,-55,2,2,162,-18
467,17,3,4,4,9,31,45,3,7,193,27
467,18,2,5,3,10,21,-45,4,2,214,-18
467,19,4,2,8,5,44,23,8,5,258,5
467,20,4,3,5,8,41,-65,9,0,299,-60
467,21,4,3,8,5,-56,32,3,2,243,-28
467,22,2,5,4,9,22,54,5,6,265,26
467,23,3,4,3,10,30,-54,5,2,295,-28
467,24,4,3,6,7,42,34,7,6,337,6
467,25,4,2,4,9,40,-73,7,3,377,-67
467,26,3,3,6,7,-67,34,0,7,310,-33
467,27,3,3,7,6,34,-67,4,0,344,-100
467,28,2,5,4,9,22,54,6,4,366,-46
467,29,5,2,11,2,-44,20,2,4,322,-26
467,30,4,2,7,6,43,24,5,8,365,-2
467,31,3,3,6,7,33,-66,8,2,398,-68
467,32,3,3,6,7,-67,34,1,6,331,-34
467,33,5,2,9,4,54,22,5,8,385,-12
467,34,4,3,9,4,-55,31,0,9,330,19
467,35,3,4,8,5,35,-59,5,0,365,-40
467,36,4,3,9,4,-55,31,0,1,310,-9
467,37,4,2,8,5,44,23,4,4,354,14
467,38,4,2,10,3,-54,21,0,5,300,35
467,39,3,4,6,7,33,43,3,8,333,78
467,40,4,3,7,6,43,-67,6,1,376,11
467,41,4,3,7,6,43,33,9,4,419,44
467,42,4,2,7,6,-57,24,2,8,362,68
467,43,3,4,7,6,34,-58,6,0,396,10
467,44,4,2,7,6,43,24,9,4,439,34
467,45,3,3,4,9,-69,-64,0,0,370,-30
467,46,3,4,4,9,31,45,1,5,401,15
467,47,2,4,6,7,24,43,5,8,425,58
467,48,4,2,6,7,42,-75,7,3,467,-17
467,49,3,3,8,5,-65,32,2,5,402,15
467,50,3,4,8,5,35,41,7,6,437,56
467,51,2,4,3,10,21,-54,8,2,458,2
467,52,3,3,7,6,-66,33,2,5,392,35
467,53,2,5,3,10,21,-45,3,0,413,-10
467,54,3,3,7,6,34,33,7,3,447,23
467,55,2,4,5,8,-77,44,0,7,370,67
467,56,4,2,10,3,46,21,6,8,416,88
467,57,5,2,7,6,52,-76,8,2,468,12
467,58,4,3,8,5,-56,32,2,4,412,44
467,59,2,6,1,12,-20,-34,2,0,392,10
467,60,3,3,5,8,32,35,4,5,424,45
467,61,2,4,7,6,25,42,9,7,449,87
467,62,3,3,8,5,-65,32,4,9,384,119
467,63,5,2,9,4,54,-78,8,1,438,41
467,64,4,2,7,6,-57,24,1,5,381,65
467,65,3,4,8,5,35,41,6,6,416,106
467,66,4,3,6,7,42,-66,8,0,458,40
467,67,4,3,9,4,-55,31,3,1,403,71
467,68,2,5,5,8,23,53,6,4,426,124
467,69,4,2,11,2,-53,20,3,4,373,144
467,70,4,2,8,5,44,23,7,7,417,167
467,71,3,4,6,7,-67,-57,0,0,350,110
467,72,5,2,11,2,56,20,6,0,406,130
467,73,2,5,2,11,20,56,6,6,426,186
467,74,4,2,7,6,43,-76,9,0,469,110
467,75,4,2,10,3,-54,21,5,1,415,131
467,76,4,3,6,7,42,34,7,5,457,165
467,77,4,2,9,4,-55,22,2,7,402,187
467,78,3,4,4,9,31,-55,3,2,433,132
467,79,5,2,12,1,-43,-20,0,2,390,112
467,80,3,4,7,6,34,42,4,4,424,154
467,81,4,2,10,3,-54,21,0,5,370,175
467,82,5,2,11,2,56,20,6,5,426,195
467,83,4,3,8,5,-56,32,0,7,370,227
467,84,2,5,5,8,23,-47,3,0,393,180
467,85,4,3,6,7,42,34,5,4,435,214
467,86,3,4,5,8,32,44,7,8,467,258
467,87,3,4,7,6,-66,-58,1,0,401,200
467,88,3,4,6,7,33,43,4,3,434,243
467,89,3,3,6,7,33,34,7,7,467,277
467,90,2,4,4,9,22,-55,9,2,489,222
467,91,4,2,7,6,-57,24,2,6,432,246
467,92,2,5,4,9,22,-46,4,0,454,200
467,93,3,4,6,7,33,43,7,3,487,243
467,94,2,5,5,8,-77,53,0,6,410,296
467,95,4,2,8,5,44,23,4,9,454,319
467,96,2,5,3,10,21,-45,5,4,475,274
467,97,2,5,4,9,22,54,7,8,497,328
467,98,3,4,5,8,32,-56,9,2,529,272
468,1,5,2,9,4,54,22,4,2,54,22
468,2,4,2,7,6,43,24,7,6,97,46
468,3,4,3,9,4,-55,31,2,7,42,77
468,4,3,3,5,8,32,-65,4,2,74,12
468,5,3,4,6,7,33,43,7,5,107,55
468,6,3,4,9,4,-64,40,3,5,43,95
468,7,2,5,4,9,22,54,5,9,65,149
468,8,2,4,6,7,24,-57,9,2,89,92
468,9,4,3,8,5,-56,32,3,4,33,124
468,10,4,2,6,7,42,25,5,9,75,149
468,11,3,4,6,7,33,-57,8,2,108,92
468,12,3,3,7,6,-66,33,2,5,42,125
468,13,3,3,8,5,35,32,7,7,77,157
468,14,2,5,2,11,20,-44,7,3,97,113
468,15,2,5,5,8,-77,53,0,6,20,166
468,16,3,3,6,7,33,-66,3,0,53,100
468,17,2,5,7,6,25,51,8,1,78,151
468,18,3,3,3,10,30,37,8,8,108,188
468,19,3,3,7,6,-66,-67,2,1,42,121
468,20,4,3,4,9,40,36,2,7,82,157
468,21,3,3,4,9,31,-64,3,3,113,93
468,22,3,3,7,6,34,33,7,6,147,126
468,23,4,3,9,4,-55,31,2,7,92,157
468,24,2,6,4,9,22,-37,4,0,114,120
468,25,4,2,7,6,43,24,7,4,157,144
468,26,3,5,4,9,31,54,8,8,188,198
468,27,3,3,7,6,-66,-67,2,1,122,131
468,28,4,2,10,3,46,21,8,2,168,152
468,29,4,3,9,4,-55,31,3,3,113,183
468,30,2,5,5,8,23,53,6,6,136,236
468,31,3,3,8,5,-65,32,1,8,71,268
468,32,2,4,9,4,27,40,8,8,98,308
468,33,3,3,6,7,-67,-66,1,2,31,242
468,34,3,4,7,6,34,42,5,4,65,284
468,35,3,4,6,7,33,43,8,7,98,327
468,36,3,4,6,7,-67,-57,1,0,31,270
468,37,4,2,8,5,44,23,5,3,75,293
468,38,4,3,6,7,42,34,7,7,117,327
468,39,3,4,4,9,31,-55,8,2,148,272
468,40,3,4,7,6,-66,42,2,4,82,314
468,41,3,4,5,8,32,44,4,8,114,358
468,42,2,5,3,10,21,-45,5,3,135,313
468,43,5,2,9,4,54,22,9,5,189,335
468,44,2,5,5,8,-77,53,2,8,112,388
468,45,2,5,4,9,22,-46,4,2,134,342
468,46,4,3,9,4,45,31,9,3,179,373
468,47,4,2,6,7,-58,25,1,8,121,398
468,48,2,4,6,7,24,-57,5,1,145,341
468,49,5,3,8,5,53,32,8,3,198,373
468,50,3,3,9,4,-64,31,4,4,134,404
468,51,4,3,8,5,44,32,8,6,178,436
468,52,3,3,6,7,-67,-66,1,0,111,370
468,53,3,5,6,7,33,52,4,2,144,422
468,54,3,4,4,9,31,45,5,7,175,467
468,55,3,4,7,6,34,42,9,9,209,509
469,1,6,2,7,6,61,24,1,4,61,24
469,2,5,2,8,5,53,23,4,7,114,47
469,3,3,3,5,8,32,-65,6,2,146,-18
469,4,3,3,6,7,33,34,9,6,179,16
469,5,2,6,3,10,-79,-36,0,0,100,-20
469,6,3,4,5,8,32,44,2,4,132,24
469,7,3,3,9,4,36,31,8,5,168,55
469,8,2,4,3,10,21,-54,9,1,189,1
469,9,5,3,9,4,-46,31,3,2,143,32
469,10,2,4,4,9,22,45,5,7,165,77
469,11,5,2,9,4,54,22,9,9,219,99
469,12,4,3,7,6,-57,-67,2,2,162,32
469,13,3,3,6,7,33,34,5,6,195,66
469,14,3,3,5,8,32,-65,7,1,227,1
469,15,3,4,4,9,31,45,8,6,258,46
469,16,3,4,4,9,31,-55,9,1,289,-9
469,17,5,2,6,7,-49,25,0,6,240,16
469,18,2,5,4,9,22,-46,2,0,262,-30
469,19,2,4,6,7,24,43,6,3,286,13
469,20,5,2,11,2,-44,20,2,3,242,33
469,21,3,3,6,7,33,34,5,7,275,67
469,22,3,4,6,7,33,-57,8,0,308,10
469,23,6,2,11,2,-35,20,3,0,273,30
469,24,2,5,5,8,23,53,6,3,296,83
469,25,5,2,7,6,52,24,8,7,348,107
469,26,2,4,4,9,-78,-55,0,2,270,52
469,27,4,2,8,5,44,23,4,5,314,75
469,28,5,2,9,4,54,22,8,7,368,97
469,29,3,4,6,7,-67,-57,1,0,301,40
469,30,2,4,6,7,24,43,5,3,325,83
469,31,4,3,6,7,42,34,7,7,367,117
469,32,3,4,6,7,-67,-57,0,0,300,60
469,33,4,2,4,9,40,27,0,7,340,87
469,34,2,4,2,11,20,-53,0,4,360,34
469,35,2,5,3,10,21,55,1,9,381,89
469,36,2,5,3,10,21,-45,2,4,402,44
469,37,2,4,4,9,22,45,4,9,424,89
469,38,4,3,5,8,41,-65,5,4,465,24
469,39,4,2,9,4,-55,22,0,6,410,46
469,40,5,2,10,3,55,21,5,7,465,67
469,41,2,6,5,8,23,62,8,9,488,129
469,42,3,3,4,9,31,-64,9,5,519,65
470,1,3,4,6,7,33,43,3,3,33,43
470,2,2,4,4,9,22,45,5,8,55,88
470,3,2,5,6,7,24,-48,9,0,79,40
470,4,3,4,8,5,-65,41,4,1,14,81
470,5,2,4,8,5,-74,41,0,2,-60,122
470,6,2,4,6,7,24,43,4,5,-36,165
470,7,5,2,10,3,55,21,9,6,19,186
470,8,4,3,8,5,-56,32,3,8,-37,218
470,9,4,2,7,6,43,-76,6,2,6,142
470,10,2,5,4,9,22,54,8,6,28,196
470,11,2,5,5,8,-77,53,1,9,-49,249
470,12,3,3,4,9,31,-64,2,5,-18,185
470,13,4,3,9,4,45,31,7,6,27,216
470,14,3,3,9,4,-64,31,3,7,-37,247
470,15,2,5,4,9,22,-46,5,1,-15,201
470,16,5,2,11,2,-44,20,1,1,-59,221
470,17,3,3,4,9,31,36,2,7,-28,257
470,18,2,5,4,9,22,-46,4,1,-6,211
470,19,3,3,5,8,32,35,6,6,26,246
470,20,3,3,9,4,-64,31,2,7,-38,277
470,21,2,4,8,5,26,41,8,8,-12,318
470,22,4,2,11,2,-53,20,5,8,-65,338
470,23,3,3,6,7,33,-66,8,2,-32,272
470,24,2,5,7,6,-75,51,3,3,-107,323
470,25,4,2,8,5,44,23,7,6,-63,346
470,26,5,2,10,3,-45,21,2,7,-108,367
470,27,2,4,7,6,25,42,7,9,-83,409
470,28,3,3,7,6,-66,-67,1,2,-149,342
470,29,2,5,6,7,24,52,5,4,-125,394
470,30,3,3,7,6,34,33,9,7,-91,427
470,31,3,3,7,6,-66,-67,3,0,-157,360
470,32,4,2,8,5,44,23,7,3,-113,383
470,33,3,3,5,8,32,35,9,8,-81,418
470,34,2,4,8,5,-74,41,5,9,-155,459
470,35,5,2,9,4,54,-78,9,1,-101,381
470,36,4,4,7,6,-57,42,2,3,-158,423
470,37,2,5,4,9,22,54,4,7,-136,477
470,38,3,4,7,6,34,42,8,9,-102,519
471,1,3,3,5,8,32,35,2,5,32,35
471,2,4,3,8,5,44,32,6,7,76,67
471,3,4,2,9,4,-55,22,1,9,21,89
471,4,3,3,6,7,33,-66,4,3,54,23
471,5,3,3,8,5,35,32,9,5,89,55
471,6,5,2,9,4,-46,22,3,7,43,77
471,7,3,3,8,5,35,32,8,9,78,109
471,8,3,3,8,5,-65,-68,3,1,13,41
471,9,3,3,6,7,33,34,6,5,46,75
471,10,3,4,4,9,31,-55,7,0,77,20
471,11,3,3,6,7,-67,34,0,4,10,54
471,12,5,2,10,3,55,21,5,5,65,75
471,13,2,4,6,7,24,43,9,8,89,118
471,14,4,3,9,4,-55,31,4,9,34,149
471,15,3,4,8,5,35,-59,9,0,69,90
471,16,4,3,5,8,-59,35,0,5,10,125
471,17,3,3,7,6,34,33,4,8,44,158
471,18,3,4,7,6,34,-58,8,0,78,100
471,19,3,3,10,3,-63,30,5,0,15,130
471,20,3,4,8,5,-65,41,0,1,-50,171
471,21,2,4,7,6,25,42,5,3,-25,213
471,22,3,4,9,4,-64,40,1,3,-89,253
471,23,2,4,5,8,23,44,4,7,-66,297
471,24,2,4,4,9,22,-55,6,2,-44,242
471,25,2,5,5,8,23,53,9,5,-21,295
471,26,4,2,8,5,-56,23,3,8,-77,318
471,27,2,4,4,9,22,-55,5,3,-55,263
471,28,2,6,5,8,23,62,8,5,-32,325
471,29,4,2,5,8,41,-74,9,1,9,251
471,30,4,3,8,5,-56,32,3,3,-47,283
471,31,3,4,4,9,31,45,4,8,-16,328
471,32,3,4,6,7,33,-57,7,1,17,271
471,33,3,3,5,8,32,35,9,6,49,306
471,34,6,2,10,3,-36,21,3,7,13,327
471,35,4,3,7,6,43,-67,6,0,56,260
471,36,4,3,5,8,41,35,7,5,97,295
471,37,4,3,8,5,-56,32,1,7,41,327
471,38,4,2,7,6,43,-76,4,1,84,251
471,39,4,2,9,4,45,22,9,3,129,273
471,40,3,4,5,8,-68,44,1,7,61,317
471,41,3,4,9,4,36,40,7,7,97,357
471,42,4,3,6,7,42,-66,9,1,139,291
471,43,4,3,8,5,-56,32,3,3,83,323
471,44,3,4,3,10,30,46,3,9,113,369
471,45,5,3,8,5,53,-68,6,1,166,301
471,46,2,4,4,9,22,45,8,6,188,346
471,47,2,4,5,8,-77,-56,1,0,111,290
471,48,4,3,6,7,42,34,3,4,153,324
471,49,2,4,5,8,23,44,6,8,176,368
471,50,4,3,4,9,40,-64,6,4,216,304
471,51,4,2,9,4,-55,22,1,6,161,326
471,52,4,3,9,4,45,31,6,7,206,357
471,53,3,3,8,5,-65,32,1,9,141,389
471,54,3,4,3,10,30,-54,1,5,171,335
471,55,3,3,10,3,37,30,8,5,208,365
471,56,4,2,10,3,-54,21,4,6,154,386
471,57,3,3,7,6,34,33,8,9,188,419
471,58,5,3,8,5,-47,-68,1,1,141,351
471,59,3,3,6,7,33,34,4,5,174,385
471,60,4,3,5,8,41,-65,5,0,215,320
471,61,2,5,4,9,22,54,7,4,237,374
471,62,5,2,7,6,52,24,9,8,289,398
471,63,4,3,7,6,-57,-67,2,1,232,331
471,64,4,2,6,7,42,25,4,6,274,356
471,65,3,3,3,10,30,-63,4,3,304,293
471,66,4,2,9,4,45,22,9,5,349,315
471,67,4,3,7,6,-57,33,2,8,292,348
471,68,2,4,3,10,21,-54,3,4,313,294
471,69,3,5,4,9,31,54,4,8,344,348
471,70,3,3,8,5,35,-68,9,0,379,280
471,71,5,3,8,5,-47,32,2,2,332,312
471,72,4,4,7,6,43,42,5,4,375,354
471,73,3,3,4,9,31,-64,6,0,406,290
471,74,3,3,6,7,33,34,9,4,439,324
471,75,3,4,6,7,-67,43,2,7,372,367
471,76,2,5,5,8,23,-47,5,0,395,320
471,77,2,5,3,10,21,55,6,5,416,375
471,78,3,5,7,6,-66,51,0,6,350,426
471,79,2,5,4,9,22,-46,2,0,372,380
471,80,3,3,8,5,35,32,7,2,407,412
471,81,3,4,6,7,-67,43,0,5,340,455
471,82,2,4,7,6,25,42,5,7,365,497
471,83,4,2,8,5,44,-77,9,0,409,420
471,84,2,5,7,6,-75,51,4,1,334,471
471,85,2,5,6,7,24,52,8,3,358,523
472,1,3,4,5,8,32,44,2,4,32,44
472,2,5,2,7,6,52,24,4,8,84,68
472,3,3,4,6,7,33,-57,7,1,117,11
472,4,4,2,7,6,-57,24,0,5,60,35
472,5,3,3,8,5,35,32,5,7,95,67
472,6,4,2,8,5,44,-77,9,0,139,-10
472,7,5,2,7,6,-48,24,1,4,91,14
472,8,3,3,8,5,35,32,6,6,126,46
472,9,2,4,4,9,22,-55,8,1,148,-9
472,10,3,4,5,8,-68,44,0,5,80,35
472,11,3,4,4,9,31,-55,1,0,111,-20
472,12,6,2,11,2,65,20,6,0,176,0
472,13,4,3,6,7,42,34,8,4,218,34
472,14,2,4,5,8,-77,44,1,8,141,78
472,15,5,2,9,4,54,-78,5,0,195,0
472,16,3,4,5,8,32,44,7,4,227,44
472,17,2,5,3,10,21,55,8,9,248,99
472,18,5,3,8,5,-47,-68,1,1,201,31
472,19,5,2,7,6,52,24,3,5,253,55
472,20,3,3,7,6,34,33,7,8,287,88
472,21,3,3,5,8,32,-65,9,3,319,23
472,22,2,5,2,11,20,56,9,9,339,79
472,23,3,3,4,9,-69,-64,0,5,270,15
472,24,3,3,6,7,33,34,3,9,303,49
472,25,2,5,3,10,21,-45,4,4,324,4
472,26,5,2,7,6,52,24,6,8,376,28
472,27,3,4,6,7,33,-57,9,1,409,-29
472,28,3,3,4,9,-69,36,0,7,340,7
472,29,2,5,6,7,24,52,4,9,364,59
472,30,2,4,4,9,22,-55,6,4,386,4
472,31,2,5,5,8,23,53,9,7,409,57
472,32,2,4,5,8,-77,-56,2,1,332,1
472,33,3,3,9,4,36,31,8,2,368,32
472,34,3,3,7,6,-66,33,2,5,302,65
472,35,2,4,5,8,23,44,5,9,325,109
472,36,5,2,8,5,53,-77,8,2,378,32
472,37,3,4,5,8,-68,44,0,6,310,76
472,38,3,3,6,7,33,-66,3,0,343,10
472,39,2,5,4,9,22,54,5,4,365,64
472,40,6,2,10,3,64,21,9,5,429,85
472,41,4,2,6,7,-58,-75,1,0,371,10
472,42,3,3,9,4,36,31,7,1,407,41
472,43,5,2,8,5,-47,23,0,4,360,64
472,44,3,4,3,10,30,-54,0,0,390,10
472,45,4,2,9,4,45,22,5,2,435,32
472,46,4,4,7,6,43,42,8,4,478,74
472,47,3,4,5,8,-68,44,0,8,410,118
472,48,3,4,6,7,33,-57,3,1,443,61
472,49,2,5,7,6,25,51,8,2,468,112
472,50,3,3,6,7,-67,34,1,6,401,146
472,51,3,4,5,8,32,-56,3,0,433,90
472,52,3,4,7,6,34,42,7,2,467,132
472,53,4,3,5,8,41,35,8,7,508,167
473,1,3,3,6,7,33,34,3,4,33,34
473,2,3,4,5,8,32,44,5,8,65,78
473,3,2,4,4,9,22,-55,7,3,87,23
473,4,3,4,4,9,31,45,8,8,118,68
473,5,5,2,7,6,-48,-76,0,2,70,-8
473,6,2,5,3,10,21,55,1,7,91,47
473,7,4,2,7,6,43,-76,4,1,134,-29
473,8,3,4,6,7,33,43,7,4,167,14
473,9,3,3,8,5,-65,32,2,6,102,46
473,10,3,4,4,9,31,-55,3,1,133,-9
473,11,4,3,6,7,42,34,5,5,175,25
473,12,4,3,5,8,41,-65,6,0,216,-40
473,13,3,3,4,9,31,36,7,6,247,-4
473,14,4,2,10,3,-54,21,3,7,193,17
473,15,5,3,9,4,54,31,7,8,247,48
473,16,2,4,5,8,-77,-56,0,2,170,-8
473,17,4,3,6,7,42,34,2,6,212,26
473,18,4,2,8,5,44,23,6,9,256,49
473,19,3,3,6,7,33,-66,9,3,289,-17
473,20,5,2,9,4,-46,22,3,5,243,5
473,21,5,2,8,5,53,23,6,8,296,28
473,22,4,2,6,7,42,-75,8,3,338,-47
473,23,2,4,2,11,20,-53,8,0,358,-100
473,24,2,4,3,10,21,46,9,6,379,-54
473,25,2,5,2,11,20,-44,9,2,399,-98
473,26,2,4,5,8,-77,44,2,6,322,-54
473,27,2,4,4,9,22,-55,4,1,344,-109
473,28,4,3,6,7,42,34,6,5,386,-75
473,29,4,2,9,4,-55,22,1,7,331,-53
473,30,6,2,9,4,63,22,4,9,394,-31
473,31,5,2,11,2,-44,20,0,9,350,-11
473,32,2,4,7,6,25,-58,5,1,375,-69
473,33,3,4,6,7,33,43,8,4,408,-26
473,34,3,4,8,5,-65,41,3,5,343,15
473,35,5,3,7,6,52,33,5,8,395,48
473,36,3,3,7,6,34,-67,9,1,429,-19
473,37,4,4,7,6,-57,42,2,3,372,23
473,38,3,3,5,8,32,35,4,8,404,58
473,39,2,6,5,8,23,-38,7,0,427,20
473,40,3,3,6,7,-67,34,0,4,360,54
473,41,2,6,3,10,21,64,1,8,381,118
473,42,4,3,5,8,41,-65,2,3,422,53
473,43,3,4,9,4,36,40,8,3,458,93
473,44,5,2,10,3,-45,21,3,4,413,114
473,45,3,3,9,4,36,31,9,5,449,145
473,46,4,3,7,6,-57,33,2,8,392,178
473,47,4,2,10,3,46,21,8,9,438,199
473,48,5,2,11,2,-44,20,4,9,394,219
473,49,3,4,5,8,32,-56,6,3,426,163
473,50,4,2,9,4,-55,22,1,5,371,185
473,51,3,4,3,10,30,-54,1,1,401,131
473,52,2,4,6,7,24,43,5,4,425,174
473,53,4,3,10,3,-54,30,1,4,371,204
473,54,4,3,9,4,45,31,6,5,416,235
473,55,4,2,7,6,43,24,9,9,459,259
473,56,4,3,7,6,-57,-67,2,2,402,192
473,57,4,2,7,6,43,24,5,6,445,216
473,58,2,5,5,8,23,53,8,9,468,269
473,59,3,3,6,7,-67,-66,1,3,401,203
473,60,3,4,6,7,33,43,4,6,434,246
473,61,3,4,5,8,32,-56,6,0,466,190
473,62,4,4,6,7,42,43,8,3,508,233
474,1,2,4,5,8,23,44,3,4,23,44
474,2,3,4,7,6,34,42,7,6,57,86
474,3,3,3,6,7,-67,-66,0,0,-10,20
474,4,2,5,4,9,22,54,2,4,12,74
474,5,3,4,4,9,31,45,3,9,43,119
474,6,2,5,3,10,21,-45,4,4,64,74
474,7,2,5,3,10,21,55,5,9,85,129
474,8,3,3,7,6,34,-67,9,2,119,62
474,9,2,4,3,10,-79,46,0,8,40,108
474,10,5,2,9,4,54,-78,4,0,94,30
474,11,4,2,10,3,-54,21,0,1,40,51
474,12,2,4,4,9,22,45,2,6,62,96
474,13,3,3,5,8,32,-65,4,1,94,31
474,14,3,3,8,5,35,32,9,3,129,63
474,15,2,5,6,7,-76,52,3,5,53,115
474,16,4,3,9,4,45,31,8,6,98,146
474,17,4,3,6,7,-58,-66,0,0,40,80
474,18,3,4,4,9,31,45,1,5,71,125
474,19,3,4,7,6,34,42,5,7,105,167
474,20,2,4,7,6,-75,42,0,9,30,209
474,21,3,3,7,6,34,-67,4,2,64,142
474,22,4,2,7,6,43,24,7,6,107,166
474,23,2,5,5,8,-77,53,0,9,30,219
474,24,4,2,11,2,47,20,7,9,77,239
474,25,4,3,8,5,-56,-68,1,1,21,171
474,26,3,4,7,6,34,42,5,3,55,213
474,27,4,4,8,5,44,41,9,4,99,254
474,28,3,3,5,8,-68,35,1,9,31,289
474,29,4,2,7,6,43,-76,4,3,74,213
474,30,4,3,8,5,44,32,8,5,118,245
474,31,3,3,3,10,30,-63,8,2,148,182
474,32,2,4,5,8,-77,44,1,6,71,226
474,33,4,2,8,5,44,23,5,9,115,249
474,34,4,3,9,4,-55,-69,0,0,60,180
474,35,3,4,5,8,32,44,2,4,92,224
474,36,4,3,9,4,45,31,7,5,137,255
474,37,3,4,8,5,-65,41,2,6,72,296
474,38,4,2,9,4,45,22,7,8,117,318
474,39,4,3,8,5,-56,-68,1,0,61,250
474,40,3,4,5,8,32,44,3,4,93,294
474,41,3,3,5,8,32,35,5,9,125,329
474,42,4,2,10,3,-54,-79,1,0,71,250
474,43,3,4,5,8,32,44,3,4,103,294
474,44,4,2,8,5,44,23,7,7,147,317
474,45,3,3,7,6,-66,-67,1,0,81,250
474,46,4,3,10,3,46,30,7,0,127,280
474,47,3,3,8,5,-65,32,2,2,62,312
474,48,4,3,8,5,44,32,6,4,106,344
474,49,2,4,6,7,-76,43,0,7,30,387
474,50,2,4,6,7,24,-57,4,0,54,330
474,51,2,4,8,5,-74,41,0,1,-20,371
474,52,4,3,9,4,45,31,5,2,25,402
474,53,3,4,4,9,31,45,6,7,56,447
474,54,5,2,8,5,53,-77,9,0,109,370
474,55,4,3,6,7,-58,34,1,4,51,404
474,56,4,3,9,4,45,31,6,5,96,435
474,57,2,5,4,9,22,54,8,9,118,489
474,58,2,5,4,9,-78,-46,0,3,40,443
474,59,4,2,4,9,40,-73,0,0,80,370
474,60,5,2,9,4,54,22,4,2,134,392
474,61,4,2,8,5,44,23,8,5,178,415
474,62,4,2,6,7,-58,-75,0,0,120,340
474,63,3,4,5,8,32,44,2,4,152,384
474,64,3,3,4,9,31,-64,3,0,183,320
474,65,4,3,7,6,43,33,6,3,226,353
474,66,4,3,6,7,42,34,8,7,268,387
474,67,3,3,8,5,-65,32,3,9,203,419
474,68,3,4,4,9,31,-55,4,4,234,364
474,69,3,4,5,8,32,44,6,8,266,408
474,70,5,2,10,3,-45,21,1,9,221,429
474,71,4,2,7,6,43,-76,4,3,264,353
474,72,2,5,5,8,23,53,7,6,287,406
474,73,4,3,8,5,-56,32,1,8,231,438
474,74,4,3,9,4,45,31,6,9,276,469
474,75,2,5,5,8,23,-47,9,2,299,422
474,76,3,4,5,8,-68,44,1,6,231,466
474,77,3,4,7,6,34,42,5,8,265,508
475,1,3,3,6,7,33,34,3,4,33,34
475,2,2,4,4,9,22,45,5,9,55,79
475,3,2,4,3,10,21,-54,6,5,76,25
475,4,2,4,4,9,22,-55,8,0,98,-30
475,5,3,4,4,9,31,45,9,5,129,15
475,6,4,3,7,6,-57,33,2,8,72,48
475,7,2,5,3,10,21,-45,3,3,93,3
475,8,4,2,7,6,43,24,6,7,136,27
475,9,2,4,8,5,-74,41,2,8,62,68
475,10,4,2,9,4,45,-78,7,0,107,-10
475,11,5,2,10,3,-45,21,2,1,62,11
475,12,2,5,4,9,22,54,4,5,84,65
475,13,4,2,6,7,42,-75,6,0,126,-10
475,14,2,4,5,8,23,44,9,4,149,34
475,15,2,6,3,10,-79,64,0,8,70,98
475,16,3,3,9,4,36,31,6,9,106,129
475,17,3,4,5,8,32,-56,8,3,138,73
475,18,3,4,7,6,-66,42,2,5,72,115
475,19,3,4,7,6,34,42,6,7,106,157
475,20,4,3,5,8,41,-65,7,2,147,92
475,21,3,3,8,5,-65,32,2,4,82,124
475,22,3,3,4,9,31,-64,3,0,113,60
475,23,3,3,5,8,32,35,5,5,145,95
475,24,3,3,6,7,33,34,8,9,178,129
475,25,3,4,5,8,-68,-56,0,3,110,73
475,26,3,3,8,5,35,32,5,5,145,105
475,27,2,4,5,8,23,44,8,9,168,149
475,28,3,3,7,6,-66,-67,2,2,102,82
475,29,3,3,8,5,35,32,7,4,137,114
475,30,3,4,4,9,31,45,8,9,168,159
475,31,3,3,6,7,-67,-66,1,3,101,93
475,32,2,4,5,8,23,44,4,7,124,137
475,33,2,4,7,6,25,42,9,9,149,179
475,34,3,4,8,5,-65,-59,4,0,84,120
475,35,3,4,5,8,32,44,6,4,116,164
475,36,2,5,4,9,22,54,8,8,138,218
475,37,2,5,5,8,-77,-47,1,1,61,171
475,38,3,4,4,9,31,45,2,6,92,216
475,39,2,4,4,9,22,-55,4,1,114,161
475,40,3,3,8,5,35,32,9,3,149,193
475,41,6,2,8,5,-38,23,1,6,111,216
475,42,3,4,7,6,34,42,5,8,145,258
475,43,3,3,6,7,33,-66,8,2,178,192
475,44,3,3,6,7,-67,34,1,6,111,226
475,45,3,4,5,8,32,-56,3,0,143,170
475,46,3,4,5,8,32,44,5,4,175,214
475,47,2,4,5,8,23,44,8,8,198,258
475,48,3,3,6,7,-67,-66,1,2,131,192
475,49,3,3,7,6,34,33,5,5,165,225
475,50,4,3,6,7,42,34,7,9,207,259
475,51,4,3,10,3,-54,30,3,9,153,289
475,52,5,2,9,4,54,-78,7,1,207,211
475,53,2,5,3,10,21,55,8,6,228,266
475,54,4,3,7,6,-57,33,1,9,171,299
475,55,2,4,7,6,25,-58,6,1,196,241
475,56,3,3,6,7,33,34,9,5,229,275
475,57,3,4,3,10,30,-54,9,1,259,221
475,58,5,2,8,5,-47,23,2,4,212,244
475,59,2,5,6,7,24,52,6,6,236,296
475,60,3,3,6,7,33,-66,9,0,269,230
475,61,5,2,8,5,-47,23,2,3,222,253
475,62,2,4,2,11,20,-53,2,0,242,200
475,63,3,4,5,8,32,44,4,4,274,244
475,64,4,3,7,6,43,33,7,7,317,277
475,65,3,3,10,3,-63,30,4,7,254,307
475,66,3,3,7,6,34,-67,8,0,288,240
475,67,4,3,3,10,-40,37,8,7,248,277
475,68,3,3,7,6,-66,-67,2,0,182,210
475,69,3,4,5,8,32,44,4,4,214,254
475,70,5,2,7,6,52,24,6,8,266,278
475,71,3,3,6,7,33,-66,9,2,299,212
475,72,6,2,10,3,-36,21,3,3,263,233
475,73,6,2,7,6,61,24,4,7,324,257
475,74,5,2,11,2,-44,20,0,7,280,277
475,75,4,2,8,5,44,-77,4,0,324,200
475,76,3,4,5,8,32,44,6,4,356,244
475,77,4,2,6,7,42,25,8,9,398,269
475,78,3,4,9,4,-64,40,4,9,334,309
475,79,3,3,6,7,33,-66,7,3,367,243
475,80,2,4,5,8,-77,44,0,7,290,287
475,81,3,3,6,7,33,-66,3,1,323,221
475,82,4,3,8,5,44,32,7,3,367,253
475,83,3,3,10,3,-63,30,4,3,304,283
475,84,3,4,6,7,33,43,7,6,337,326
475,85,2,4,6,7,-76,43,1,9,261,369
475,86,3,4,5,8,32,-56,3,3,293,313
475,87,3,3,6,7,33,34,6,7,326,347
475,88,5,2,10,3,-45,21,1,8,281,368
475,89,2,4,5,8,23,-56,4,2,304,312
475,90,3,3,6,7,33,34,7,6,337,346
475,91,2,5,4,9,22,-46,9,0,359,300
475,92,2,5,5,8,-77,53,2,3,282,353
475,93,5,2,10,3,55,21,7,4,337,374
475,94,6,2,10,3,-36,21,1,5,301,395
475,95,2,4,5,8,23,44,4,9,324,439
475,96,3,3,5,8,32,-65,6,4,356,374
475,97,6,2,9,4,63,22,9,6,419,396
475,98,3,3,5,8,-68,-65,1,1,351,331
475,99,4,2,7,6,43,24,4,5,394,355
475,100,2,4,6,7,24,43,8,8,418,398
475,101,6,2,10,3,-36,21,2,9,382,419
475,102,4,2,5,8,41,-74,3,5,423,345
475,103,2,5,4,9,22,54,5,9,445,399
475,104,3,3,5,8,32,-65,7,4,477,334
475,105,3,4,5,8,32,44,9,8,509,378
476,1,5,2,11,2,56,20,6,0,56,20
476,2,3,4,7,6,-66,42,0,2,-10,62
476,3,2,5,4,9,22,54,2,6,12,116
476,4,3,3,7,6,34,33,6,9,46,149
476,5,3,3,8,5,-65,-68,1,1,-19,81
476,6,5,2,10,3,55,21,6,2,36,102
476,7,3,4,7,6,-66,42,0,4,-30,144
476,8,3,3,5,8,32,35,2,9,2,179
476,9,6,2,7,6,61,-76,3,3,63,103
476,10,4,3,7,6,43,33,6,6,106,136
476,11,3,4,3,10,30,-54,6,2,136,82
476,12,4,2,10,3,-54,21,2,3,82,103
476,13,2,5,5,8,23,53,5,6,105,156
476,14,2,5,6,7,24,52,9,8,129,208
476,15,2,4,7,6,-75,-58,4,0,54,150
476,16,3,4,4,9,31,45,5,5,85,195
476,17,3,3,8,5,-65,32,0,7,20,227
476,18,3,3,6,7,33,-66,3,1,53,161
476,19,4,3,7,6,43,33,6,4,96,194
476,20,3,4,7,6,-66,42,0,6,30,236
476,21,2,5,6,7,24,52,4,8,54,288
476,22,4,3,7,6,43,-67,7,1,97,221
476,23,3,4,5,8,32,44,9,5,129,265
476,24,3,3,7,6,-66,33,3,8,63,298
476,25,3,4,6,7,33,-57,6,1,96,241
476,26,3,3,5,8,32,35,8,6,128,276
476,27,2,4,5,8,-77,-56,1,0,51,220
476,28,3,4,6,7,33,43,4,3,84,263
476,29,4,3,6,7,42,34,6,7,126,297
476,30,4,3,6,7,42,-66,8,1,168,231
476,31,3,4,5,8,-68,44,0,5,100,275
476,32,3,3,8,5,35,32,5,7,135,307
476,33,2,5,3,10,21,-45,6,2,156,262
476,34,2,4,1,12,-20,-52,6,0,136,210
476,35,4,3,9,4,-55,31,1,1,81,241
476,36,5,2,10,3,55,21,6,2,136,262
476,37,3,3,6,7,33,34,9,6,169,296
476,38,2,4,6,7,-76,43,3,9,93,339
476,39,2,5,3,10,21,-45,4,4,114,294
476,40,3,4,6,7,33,43,7,7,147,337
476,41,3,4,6,7,-67,-57,0,0,80,280
476,42,3,3,6,7,33,34,3,4,113,314
476,43,3,3,7,6,34,33,7,7,147,347
476,44,3,3,6,7,-67,-66,0,1,80,281
476,45,3,3,6,7,33,34,3,5,113,315
476,46,4,2,6,7,42,-75,5,0,155,240
476,47,3,3,8,5,-65,32,0,2,90,272
476,48,3,3,10,3,37,30,7,2,127,302
476,49,2,4,5,8,-77,44,0,6,50,346
476,50,3,4,8,5,35,41,5,7,85,387
476,51,4,3,8,5,44,32,9,9,129,419
476,52,2,5,5,8,-77,-47,2,2,52,372
476,53,2,4,5,8,23,44,5,6,75,416
476,54,2,4,4,9,22,-55,7,1,97,361
476,55,4,3,6,7,42,34,9,5,139,395
476,56,2,4,4,9,-78,-55,1,0,61,340
476,57,5,2,7,6,52,24,3,4,113,364
476,58,5,3,7,6,52,33,5,7,165,397
476,59,2,4,8,5,-74,41,1,8,91,438
476,60,3,4,7,6,34,-58,5,0,125,380
476,61,2,4,5,8,23,44,8,4,148,424
476,62,3,3,7,6,-66,33,2,7,82,457
476,63,3,4,5,8,32,-56,4,1,114,401
476,64,3,3,9,4,-64,31,0,2,50,432
476,65,2,6,3,10,21,64,1,6,71,496
476,66,4,2,6,7,42,-75,3,1,113,421
476,67,4,3,8,5,44,32,7,3,157,453
476,68,3,4,3,10,30,46,7,9,187,499
476,69,5,2,10,3,-45,-79,2,0,142,420
476,70,2,5,5,8,23,53,5,3,165,473
476,71,4,2,8,5,44,23,9,6,209,496
476,72,4,3,8,5,-56,32,3,8,153,528
477,1,4,3,6,7,42,34,2,4,42,34
477,2,5,2,10,3,55,21,7,5,97,55
477,3,4,2,7,6,-57,24,0,9,40,79
477,4,3,4,5,8,32,-56,2,3,72,23
477,5,4,3,8,5,44,32,6,5,116,55
477,6,3,3,7,6,-66,33,0,8,50,88
477,7,3,4,6,7,33,-57,3,1,83,31
477,8,4,3,7,6,43,33,6,4,126,64
477,9,3,3,6,7,33,34,9,8,159,98
477,10,4,3,6,7,-58,-66,1,2,101,32
477,11,5,3,5,8,50,35,1,7,151,67
477,12,4,3,7,6,43,-67,4,0,194,0
477,13,2,4,4,9,22,45,6,5,216,45
477,14,3,4,6,7,33,43,9,8,249,88
477,15,4,2,6,7,-58,-75,1,3,191,13
477,16,4,3,6,7,42,34,3,7,233,47
477,17,5,2,9,4,54,22,7,9,287,69
477,18,2,4,3,10,21,-54,8,5,308,15
477,19,3,4,4,9,31,-55,9,0,339,-40
477,20,4,2,6,7,-58,25,1,5,281,-15
477,21,2,4,6,7,24,43,5,8,305,28
477,22,4,2,9,4,-55,-78,0,0,250,-50
477,23,2,5,2,11,20,56,0,6,270,6
477,24,3,3,7,6,34,33,4,9,304,39
477,25,4,3,10,3,-54,30,0,9,250,69
477,26,2,4,7,6,25,-58,5,1,275,11
477,27,3,3,8,5,-65,32,0,3,210,43
477,28,3,3,7,6,34,33,4,6,244,76
477,29,2,5,6,7,24,52,8,8,268,128
477,30,2,5,4,9,-78,-46,0,2,190,82
477,31,4,2,5,8,41,26,1,8,231,108
477,32,2,5,2,11,20,-44,1,4,251,64
477,33,3,3,8,5,35,32,6,6,286,96
477,34,4,3,8,5,-56,32,0,8,230,128
477,35,3,3,8,5,35,-68,5,0,265,60
477,36,4,4,5,8,41,44,6,4,306,104
477,37,2,4,5,8,23,44,9,8,329,148
477,38,4,3,6,7,-58,-66,1,2,271,82
477,39,2,5,5,8,23,53,4,5,294,135
477,40,5,2,8,5,53,23,7,8,347,158
477,41,2,5,4,9,22,-46,9,2,369,112
477,42,3,4,6,7,-67,43,2,5,302,155
477,43,3,4,6,7,33,43,5,8,335,198
477,44,4,3,8,5,44,-68,9,0,379,130
477,45,4,3,5,8,-59,35,0,5,320,165
477,46,4,2,6,7,42,-75,2,0,362,90
477,47,2,4,6,7,24,43,6,3,386,133
477,48,5,2,8,5,53,23,9,6,439,156
477,49,4,3,5,8,-59,-65,0,1,380,91
477,50,3,3,5,8,32,35,2,6,412,126
477,51,2,4,7,6,25,42,7,8,437,168
477,52,2,5,4,9,22,-46,9,2,459,122
477,53,2,4,6,7,-76,43,3,5,383,165
477,54,4,2,10,3,46,21,9,6,429,186
477,55,2,5,3,10,-79,-45,0,1,350,141
477,56,4,3,8,5,44,32,4,3,394,173
477,57,5,2,10,3,55,21,9,4,449,194
477,58,4,2,7,6,-57,24,2,8,392,218
477,59,4,3,8,5,44,-68,6,0,436,150
477,60,3,4,7,6,-66,42,0,2,370,192
477,61,4,2,8,5,44,23,4,5,414,215
477,62,2,4,4,9,22,-55,6,0,436,160
477,63,4,2,8,5,-56,23,0,3,380,183
477,64,3,3,7,6,34,33,4,6,414,216
477,65,4,3,10,3,-54,30,0,6,360,246
477,66,3,3,7,6,34,33,4,9,394,279
477,67,4,3,7,6,43,-67,7,2,437,212
477,68,4,3,7,6,-57,33,0,5,380,245
477,69,5,2,8,5,53,23,3,8,433,268
477,70,5,2,9,4,54,-78,7,0,487,190
477,71,4,2,8,5,-56,23,1,3,431,213
477,72,3,4,4,9,31,45,2,8,462,258
477,73,3,3,8,5,35,-68,7,0,497,190
477,74,4,2,10,3,-54,21,3,1,443,211
477,75,5,2,10,3,55,21,8,2,498,232
477,76,3,3,7,6,-66,33,2,5,432,265
477,77,4,2,6,7,42,-75,4,0,474,190
477,78,2,5,4,9,22,54,6,4,496,244
477,79,4,2,9,4,-55,22,1,6,441,266
477,80,2,6,2,11,20,-35,1,1,461,231
477,81,4,3,7,6,43,33,4,4,504,264
478,1,3,3,8,5,35,32,5,2,35,32
478,2,3,4,5,8,32,44,7,6,67,76
478,3,3,3,7,6,-66,33,1,9,1,109
478,4,5,2,9,4,54,-78,5,1,55,31
478,5,3,3,9,4,-64,31,1,2,-9,62
478,6,4,3,6,7,42,34,3,6,33,96
478,7,4,3,10,3,46,30,9,6,79,126
478,8,4,3,9,4,-55,31,4,7,24,157
478,9,4,3,7,6,43,-67,7,0,67,90
478,10,2,6,3,10,21,64,8,4,88,154
478,11,2,5,2,11,20,-44,8,0,108,110
478,12,4,3,7,6,-57,33,1,3,51,143
478,13,2,4,6,7,24,43,5,6,75,186
478,14,4,2,6,7,42,-75,7,1,117,111
478,15,4,2,9,4,-55,22,2,3,62,133
478,16,4,2,5,8,41,26,3,9,103,159
478,17,3,4,4,9,31,-55,4,4,134,104
478,18,5,2,9,4,54,22,8,6,188,126
478,19,3,4,4,9,31,-55,9,1,219,71
478,20,3,4,6,7,-67,43,2,4,152,114
478,21,2,4,6,7,24,43,6,7,176,157
478,22,3,3,6,7,33,-66,9,1,209,91
478,23,3,4,5,8,-68,44,1,5,141,135
478,24,2,4,7,6,25,42,6,7,166,177
478,25,5,2,8,5,53,-77,9,0,219,100
478,26,3,3,9,4,-64,31,5,1,155,131
478,27,4,3,7,6,43,33,8,4,198,164
478,28,2,5,3,10,21,55,9,9,219,219
478,29,4,3,6,7,-58,-66,1,3,161,153
478,30,3,3,5,8,32,35,3,8,193,188
478,31,3,3,6,7,33,-66,6,2,226,122
478,32,2,4,6,7,-76,43,0,5,150,165
478,33,3,3,5,8,32,-65,2,0,182,100
478,34,3,3,4,9,31,36,3,6,213,136
478,35,5,2,11,2,56,20,9,6,269,156
478,36,4,3,6,7,-58,-66,1,0,211,90
478,37,5,2,10,3,55,21,6,1,266,111
478,38,3,4,8,5,-65,41,1,2,201,152
478,39,3,4,7,6,34,42,5,4,235,194
478,40,3,4,4,9,31,45,6,9,266,239
478,41,3,4,5,8,32,-56,8,3,298,183
478,42,3,4,8,5,-65,41,3,4,233,224
478,43,2,4,4,9,22,45,5,9,255,269
478,44,2,4,6,7,24,-57,9,2,279,212
478,45,3,3,6,7,-67,34,2,6,212,246
478,46,2,4,2,11,20,-53,2,3,232,193
478,47,3,3,8,5,35,32,7,5,267,225
478,48,3,3,7,6,-66,33,1,8,201,258
478,49,2,5,4,9,22,-46,3,2,223,212
478,50,3,5,4,9,31,54,4,6,254,266
478,51,3,3,8,5,35,32,9,8,289,298
478,52,2,4,6,7,-76,-57,3,1,213,241
478,53,3,3,5,8,32,35,5,6,245,276
478,54,3,3,8,5,-65,32,0,8,180,308
478,55,4,2,8,5,44,-77,4,1,224,231
478,56,2,5,5,8,23,53,7,4,247,284
478,57,2,4,5,8,-77,44,0,8,170,328
478,58,4,3,10,3,46,30,6,8,216,358
478,59,3,4,5,8,32,-56,8,2,248,302
478,60,4,2,9,4,-55,22,3,4,193,324
478,61,3,4,6,7,33,43,6,7,226,367
478,62,3,3,9,4,-64,31,2,8,162,398
478,63,3,4,4,9,31,-55,3,3,193,343
478,64,3,4,4,9,31,45,4,8,224,388
478,65,2,4,5,8,23,-56,7,2,247,332
478,66,3,3,5,8,32,35,9,7,279,367
478,67,4,3,8,5,-56,32,3,9,223,399
478,68,2,4,7,6,25,-58,8,1,248,341
478,69,3,3,7,6,-66,33,2,4,182,374
478,70,5,2,8,5,53,23,5,7,235,397
478,71,3,4,5,8,32,-56,7,1,267,341
478,72,3,4,7,6,-66,42,1,3,201,383
478,73,4,2,10,3,46,21,7,4,247,404
478,74,4,3,6,7,42,34,9,8,289,438
478,75,3,3,6,7,-67,-66,2,2,222,372
478,76,2,4,5,8,23,44,5,6,245,416
478,77,2,4,7,6,-75,42,0,8,170,458
478,78,4,3,8,5,44,-68,4,0,214,390
478,79,4,3,7,6,43,33,7,3,257,423
478,80,2,4,5,8,-77,44,0,7,180,467
478,81,3,4,5,8,32,-56,2,1,212,411
478,82,2,4,3,10,21,46,3,7,233,457
478,83,5,2,9,4,54,22,7,9,287,479
478,84,4,2,7,6,-57,-76,0,3,230,403
478,85,4,3,9,4,45,31,5,4,275,434
478,86,4,2,8,5,44,23,9,7,319,457
478,87,2,4,4,9,-78,-55,1,2,241,402
478,88,2,4,5,8,23,44,4,6,264,446
478,89,2,4,6,7,24,43,8,9,288,489
478,90,4,4,8,5,-56,-59,2,0,232,430
478,91,2,5,4,9,22,54,4,4,254,484
478,92,5,2,7,6,52,24,6,8,306,508
479,1,3,3,7,6,34,33,4,3,34,33
479,2,3,3,7,6,34,33,8,6,68,66
479,3,4,3,6,7,-58,-66,0,0,10,0
479,4,3,4,7,6,34,42,4,2,44,42
479,5,3,4,5,8,32,44,6,6,76,86
479,6,4,2,8,5,-56,23,0,9,20,109
479,7,5,2,10,3,55,-79,5,0,75,30
479,8,2,5,6,7,24,52,9,2,99,82
479,9,4,2,7,6,-57,24,2,6,42,106
479,10,3,3,6,7,33,-66,5,0,75,40
479,11,4,3,9,4,-55,31,0,1,20,71
479,12,3,4,5,8,32,44,2,5,52,115
479,13,5,2,9,4,54,22,6,7,106,137
479,14,4,3,10,3,-54,30,2,7,52,167
479,15,4,3,7,6,43,-67,5,0,95,100
479,16,2,5,4,9,22,54,7,4,117,154
479,17,2,4,6,7,-76,43,1,7,41,197
479,18,3,3,8,5,35,32,6,9,76,229
479,19,2,4,4,9,22,-55,8,4,98,174
479,20,3,3,7,6,-66,33,2,7,32,207
479,21,5,2,8,5,53,-77,5,0,85,130
479,22,4,3,7,6,43,33,8,3,128,163
479,23,3,4,7,6,-66,42,2,5,62,205
479,24,3,3,6,7,33,34,5,9,95,239
479,25,3,4,7,6,34,-58,9,1,129,181
479,26,2,4,7,6,-75,42,4,3,54,223
479,27,2,5,2,11,20,56,4,9,74,279
479,28,5,2,8,5,53,-77,7,2,127,202
479,29,2,4,7,6,-75,42,2,4,52,244
479,30,4,3,6,7,42,34,4,8,94,278
479,31,2,4,6,7,24,-57,8,1,118,221
479,32,3,3,8,5,-65,32,3,3,53,253
479,33,4,3,9,4,45,31,8,4,98,284
479,34,3,4,4,9,31,45,9,9,129,329
479,35,3,4,5,8,-68,-56,1,3,61,273
479,36,2,5,3,10,21,55,2,8,82,328
479,37,4,2,10,3,46,21,8,9,128,349
479,38,5,2,11,2,-44,20,4,9,84,369
479,39,4,3,7,6,43,-67,7,2,127,302
479,40,2,5,3,10,21,55,8,7,148,357
479,41,2,4,4,9,-78,-55,0,2,70,302
479,42,4,3,6,7,42,34,2,6,112,336
479,43,4,2,10,3,46,21,8,7,158,357
479,44,3,3,7,6,-66,-67,2,0,92,290
479,45,2,5,3,10,21,55,3,5,113,345
479,46,3,4,4,9,31,-55,4,0,144,290
479,47,4,3,7,6,43,33,7,3,187,323
479,48,4,2,8,5,-56,23,1,6,131,346
479,49,3,3,9,4,36,31,7,7,167,377
479,50,2,4,7,6,-75,42,2,9,92,419
479,51,4,2,7,6,43,-76,5,3,135,343
479,52,4,2,9,4,-55,22,0,5,80,365
479,53,4,2,8,5,44,23,4,8,124,388
479,54,5,2,10,3,55,21,9,9,179,409
479,55,3,4,4,9,-69,-55,0,4,110,354
479,56,4,3,8,5,44,32,4,6,154,386
479,57,4,2,9,4,45,22,9,8,199,408
479,58,4,2,7,6,-57,-76,2,2,142,332
479,59,3,3,7,6,34,33,6,5,176,365
479,60,3,4,5,8,32,44,8,9,208,409
479,61,3,4,8,5,-65,-59,3,0,143,350
479,62,2,5,5,8,23,53,6,3,166,403
479,63,2,5,2,11,20,56,6,9,186,459
479,64,2,4,3,10,21,-54,7,5,207,405
479,65,5,3,9,4,-46,31,1,6,161,436
479,66,4,3,6,7,42,-66,3,0,203,370
479,67,4,3,8,5,44,32,7,2,247,402
479,68,2,4,7,6,-75,42,2,4,172,444
479,69,3,3,4,9,31,-64,3,0,203,380
479,70,4,2,8,5,44,23,7,3,247,403
479,71,4,2,6,7,42,25,9,8,289,428
479,72,5,2,7,6,-48,-76,1,2,241,352
479,73,2,4,5,8,23,44,4,6,264,396
479,74,4,2,5,8,41,-74,5,2,305,322
479,75,3,4,5,8,32,44,7,6,337,366
479,76,5,2,10,3,-45,21,2,7,292,387
479,77,3,3,5,8,32,-65,4,2,324,322
479,78,4,2,8,5,44,23,8,5,368,345
479,79,3,4,6,7,-67,43,1,8,301,388
479,80,4,3,9,4,45,31,6,9,346,419
479,81,3,4,7,6,-66,-58,0,1,280,361
479,82,3,3,4,9,31,36,1,7,311,397
479,83,3,4,8,5,35,41,6,8,346,438
479,84,4,2,8,5,-56,-77,0,1,290,361
479,85,5,2,7,6,52,24,2,5,342,385
479,86,4,3,7,6,43,33,5,8,385,418
479,87,4,3,7,6,43,-67,8,1,428,351
479,88,2,4,3,10,21,46,9,7,449,397
479,89,2,5,6,7,-76,52,3,9,373,449
479,90,4,3,4,9,40,-64,3,5,413,385
479,91,3,4,6,7,33,43,6,8,446,428
479,92,4,2,11,2,-53,20,3,8,393,448
479,93,2,4,5,8,23,-56,6,2,416,392
479,94,3,4,4,9,31,45,7,7,447,437
479,95,3,5,7,6,-66,51,1,8,381,488
479,96,2,4,5,8,23,-56,4,2,404,432
479,97,2,4,6,7,24,43,8,5,428,475
479,98,5,3,7,6,-48,33,0,8,380,508
480,1,5,2,9,4,54,22,4,2,54,22
480,2,4,3,9,4,45,31,9,3,99,53
480,3,4,3,6,7,-58,34,1,7,41,87
480,4,5,3,5,8,50,-65,1,2,91,22
480,5,4,3,8,5,44,32,5,4,135,54
480,6,2,4,5,8,23,44,8,8,158,98
480,7,4,2,9,4,-55,-78,3,0,103,20
480,8,3,3,4,9,31,36,4,6,134,56
480,9,2,4,5,8,23,-56,7,0,157,0
480,10,4,3,9,4,-55,31,2,1,102,31
480,11,2,5,7,6,25,51,7,2,127,82
480,12,2,4,4,9,22,45,9,7,149,127
480,13,3,5,6,7,-67,52,2,9,82,179
480,14,2,5,3,10,21,-45,3,4,103,134
480,15,4,2,8,5,44,23,7,7,147,157
480,16,3,4,7,6,-66,42,1,9,81,199
480,17,2,5,4,9,22,-46,3,3,103,153
480,18,3,3,8,5,35,32,8,5,138,185
480,19,3,4,3,10,30,-54,8,1,168,131
480,20,4,3,7,6,-57,33,1,4,111,164
480,21,3,3,6,7,33,34,4,8,144,198
480,22,4,3,6,7,42,-66,6,2,186,132
480,23,3,4,8,5,-65,41,1,3,121,173
480,24,3,4,5,8,32,44,3,7,153,217
480,25,3,3,8,5,35,32,8,9,188,249
480,26,3,4,5,8,-68,-56,0,3,120,193
480,27,3,3,6,7,33,34,3,7,153,227
480,28,4,3,9,4,45,31,8,8,198,258
480,29,3,4,6,7,-67,-57,1,1,131,201
480,30,4,2,9,4,45,22,6,3,176,223
480,31,4,3,7,6,43,33,9,6,219,256
480,32,3,4,7,6,-66,42,3,8,153,298
480,33,3,4,4,9,31,-55,4,3,184,243
480,34,3,3,5,8,32,35,6,8,216,278
480,35,2,5,4,9,22,-46,8,2,238,232
480,36,3,3,10,3,-63,30,5,2,175,262
480,37,5,2,9,4,54,22,9,4,229,284
480,38,3,4,6,7,-67,43,2,7,162,327
480,39,4,3,5,8,41,-65,3,2,203,262
480,40,3,3,6,7,33,34,6,6,236,296
480,41,2,6,3,10,21,-36,7,0,257,260
480,42,6,2,9,4,-37,22,0,2,220,282
480,43,3,3,8,5,35,32,5,4,255,314
480,44,3,3,7,6,34,33,9,7,289,347
480,45,2,5,6,7,-76,52,3,9,213,399
480,46,3,4,5,8,32,-56,5,3,245,343
480,47,5,2,9,4,54,22,9,5,299,365
480,48,4,2,10,3,-54,21,5,6,245,386
480,49,2,4,4,9,22,-55,7,1,267,331
480,50,4,2,6,7,42,25,9,6,309,356
480,51,4,4,6,7,-58,43,1,9,251,399
480,52,4,3,8,5,44,-68,5,1,295,331
480,53,3,3,7,6,34,33,9,4,329,364
480,54,3,3,7,6,-66,33,3,7,263,397
480,55,3,3,5,8,32,-65,5,2,295,332
480,56,5,2,10,3,-45,21,0,3,250,353
480,57,4,3,6,7,42,34,2,7,292,387
480,58,3,3,8,5,35,32,7,9,327,419
480,59,3,3,6,7,-67,-66,0,3,260,353
480,60,3,4,7,6,34,42,4,5,294,395
480,61,5,2,6,7,51,-75,5,0,345,320
480,62,3,3,9,4,-64,31,1,1,281,351
480,63,4,3,8,5,44,32,5,3,325,383
480,64,3,4,4,9,31,45,6,8,356,428
480,65,5,2,8,5,53,-77,9,1,409,351
480,66,2,5,3,10,-79,55,0,6,330,406
480,67,2,4,7,6,25,42,5,8,355,448
480,68,3,5,6,7,33,-48,8,0,388,400
480,69,2,5,7,6,-75,51,3,1,313,451
480,70,3,4,6,7,33,43,6,4,346,494
480,71,2,4,4,9,22,45,8,9,368,539
481,1,3,3,7,6,34,33,4,3,34,33
481,2,3,4,6,7,33,43,7,6,67,76
481,3,2,5,5,8,-77,53,0,9,-10,129
481,4,5,2,7,6,52,-76,2,3,42,53
481,5,3,3,7,6,34,33,6,6,76,86
481,6,2,5,3,10,21,-45,7,1,97,41
481,7,3,4,6,7,-67,43,0,4,30,84
481,8,4,3,7,6,43,33,3,7,73,117
481,9,3,4,4,9,31,-55,4,2,104,62
481,10,2,4,5,8,23,44,7,6,127,106
481,11,5,2,6,7,51,-75,8,1,178,31
481,12,4,3,7,6,-57,33,1,4,121,64
481,13,2,6,5,8,23,62,4,6,144,126
481,14,2,4,4,9,22,-55,6,1,166,71
481,15,2,4,4,9,22,45,8,6,188,116
481,16,4,3,9,4,-55,31,3,7,133,147
481,17,2,4,4,9,22,-55,5,2,155,92
481,18,4,3,9,4,-55,31,0,3,100,123
481,19,3,3,7,6,34,33,4,6,134,156
481,20,4,3,10,3,-54,30,0,6,80,186
481,21,4,2,5,8,41,-74,1,2,121,112
481,22,3,3,9,4,36,31,7,3,157,143
481,23,3,4,5,8,32,44,9,7,189,187
481,24,4,2,8,5,-56,-77,3,0,133,110
481,25,4,4,6,7,42,43,5,3,175,153
481,26,3,5,3,10,30,55,5,8,205,208
481,27,4,2,7,6,43,-76,8,2,248,132
481,28,2,5,5,8,-77,53,1,5,171,185
481,29,3,3,5,8,32,-65,3,0,203,120
481,30,4,2,7,6,43,24,6,4,246,144
481,31,2,4,5,8,23,44,9,8,269,188
481,32,2,4,7,6,-75,-58,4,0,194,130
481,33,2,4,9,4,-73,40,1,0,121,170
481,34,3,3,6,7,33,34,4,4,154,204
481,35,4,3,6,7,42,34,6,8,196,238
481,36,4,2,8,5,-56,-77,0,1,140,161
481,37,5,2,7,6,52,24,2,5,192,185
481,38,2,4,4,9,22,-55,4,0,214,130
481,39,2,5,4,9,22,54,6,4,236,184
481,40,4,3,7,6,43,33,9,7,279,217
481,41,3,3,7,6,-66,-67,3,0,213,150
481,42,4,3,8,5,44,32,7,2,257,182
481,43,5,2,9,4,-46,22,1,4,211,204
481,44,3,4,4,9,31,45,2,9,242,249
481,45,3,3,6,7,33,-66,5,3,275,183
481,46,3,4,5,8,32,44,7,7,307,227
481,47,4,3,8,5,-56,32,1,9,251,259
481,48,4,2,6,7,42,-75,3,4,293,184
481,49,3,3,8,5,35,32,8,6,328,216
481,50,3,3,9,4,-64,31,4,7,264,247
481,51,3,4,4,9,31,-55,5,2,295,192
481,52,3,4,6,7,33,43,8,5,328,235
481,53,5,2,7,6,-48,24,0,9,280,259
481,54,2,5,7,6,25,-49,5,0,305,210
481,55,2,4,8,5,-74,41,1,1,231,251
481,56,2,5,4,9,22,54,3,5,253,305
481,57,5,2,6,7,51,-75,4,0,304,230
481,58,2,5,5,8,23,53,7,3,327,283
481,59,4,3,8,5,-56,32,1,5,271,315
481,60,4,2,5,8,41,-74,2,1,312,241
481,61,3,3,6,7,33,34,5,5,345,275
481,62,4,3,5,8,41,-65,6,0,386,210
481,63,4,3,6,7,42,34,8,4,428,244
481,64,4,2,7,6,-57,24,1,8,371,268
481,65,3,4,5,8,32,-56,3,2,403,212
481,66,5,2,10,3,55,21,8,3,458,233
481,67,4,4,8,5,-56,41,2,4,402,274
481,68,2,4,3,10,21,-54,3,0,423,220
481,69,4,3,7,6,43,33,6,3,466,253
481,70,4,2,8,5,-56,23,0,6,410,276
481,71,2,6,3,10,21,-36,1,0,431,240
481,72,2,5,5,8,23,53,4,3,454,293
481,73,3,4,4,9,31,45,5,8,485,338
481,74,4,3,7,6,43,-67,8,1,528,271
482,1,3,4,7,6,34,42,4,2,34,42
482,2,2,4,5,8,23,44,7,6,57,86
482,3,2,4,5,8,-77,-56,0,0,-20,30
482,4,4,2,7,6,43,24,3,4,23,54
482,5,3,3,6,7,33,34,6,8,56,88
482,6,3,3,6,7,33,-66,9,2,89,22
482,7,2,5,4,9,-78,54,1,6,11,76
482,8,5,2,7,6,52,-76,3,0,63,0
482,9,4,3,7,6,43,33,6,3,106,33
482,10,3,4,7,6,-66,42,0,5,40,75
482,11,4,2,10,3,46,21,6,6,86,96
482,12,2,5,5,8,23,53,9,9,109,149
482,13,3,3,9,4,-64,-69,5,0,45,80
482,14,3,4,4,9,31,45,6,5,76,125
482,15,4,3,6,7,42,34,8,9,118,159
482,16,3,4,6,7,-67,-57,1,2,51,102
482,17,3,3,6,7,33,34,4,6,84,136
482,18,2,4,7,6,25,42,9,8,109,178
482,19,2,5,2,11,20,-44,9,4,129,134
482,20,3,3,7,6,-66,33,3,7,63,167
482,21,2,4,7,6,25,42,8,9,88,209
482,22,2,5,4,9,-78,-46,0,3,10,163
482,23,4,2,7,6,43,24,3,7,53,187
482,24,2,4,4,9,22,-55,5,2,75,132
482,25,4,3,8,5,44,32,9,4,119,164
482,26,3,3,8,5,-65,32,4,6,54,196
482,27,4,3,8,5,44,32,8,8,98,228
482,28,5,2,9,4,-46,-78,2,0,52,150
482,29,3,4,6,7,33,43,5,3,85,193
482,30,2,6,2,11,20,65,5,8,105,258
482,31,4,3,8,5,44,-68,9,0,149,190
482,32,3,3,8,5,-65,32,4,2,84,222
482,33,3,3,7,6,34,33,8,5,118,255
482,34,6,2,10,3,-36,21,2,6,82,276
482,35,4,3,8,5,44,32,6,8,126,308
482,36,5,2,10,3,-45,21,1,9,81,329
482,37,4,3,8,5,44,-68,5,1,125,261
482,38,2,4,5,8,23,44,8,5,148,305
482,39,3,4,7,6,-66,42,2,7,82,347
482,40,4,3,6,7,42,-66,4,1,124,281
482,41,4,2,8,5,44,23,8,4,168,304
482,42,3,3,5,8,-68,35,0,9,100,339
482,43,3,4,8,5,35,-59,5,0,135,280
482,44,5,2,8,5,53,23,8,3,188,303
482,45,4,3,7,6,-57,33,1,6,131,336
482,46,3,4,4,9,31,-55,2,1,162,281
482,47,3,4,7,6,34,42,6,3,196,323
482,48,3,4,9,4,-64,40,2,3,132,363
482,49,2,5,7,6,25,51,7,4,157,414
482,50,2,5,4,9,22,54,9,8,179,468
482,51,3,4,5,8,-68,-56,1,2,111,412
482,52,3,3,6,7,33,34,4,6,144,446
482,53,4,3,10,3,-54,30,0,6,90,476
482,54,3,3,5,8,32,-65,2,1,122,411
482,55,2,4,6,7,24,43,6,4,146,454
482,56,3,3,9,4,-64,31,2,5,82,485
482,57,2,4,6,7,24,43,6,8,106,528
483,1,5,2,10,3,55,21,5,1,55,21
483,2,3,4,4,9,31,45,6,6,86,66
483,3,3,3,4,9,31,-64,7,2,117,2
483,4,2,5,4,9,22,54,9,6,139,56
483,5,6,2,9,4,-37,22,2,8,102,78
483,6,4,2,9,4,45,-78,7,0,147,0
483,7,3,3,6,7,-67,34,0,4,80,34
483,8,3,4,4,9,31,45,1,9,111,79
483,9,3,3,8,5,35,-68,6,1,146,11
483,10,2,5,2,11,20,56,6,7,166,67
483,11,2,4,5,8,23,-56,9,1,189,11
483,12,2,4,5,8,-77,44,2,5,112,55
483,13,3,3,6,7,33,34,5,9,145,89
483,14,4,3,7,6,43,-67,8,2,188,22
483,15,3,3,6,7,-67,34,1,6,121,56
483,16,3,3,6,7,33,-66,4,0,154,-10
483,17,5,2,9,4,54,22,8,2,208,12
483,18,2,4,5,8,-77,44,1,6,131,56
483,19,5,2,10,3,55,21,6,7,186,77
483,20,5,2,7,6,52,-76,8,1,238,1
483,21,2,5,7,6,-75,51,3,2,163,52
483,22,3,4,7,6,34,42,7,4,197,94
483,23,4,3,8,5,-56,32,1,6,141,126
483,24,3,4,4,9,31,-55,2,1,172,71
483,25,4,2,7,6,43,24,5,5,215,95
483,26,4,3,8,5,44,32,9,7,259,127
483,27,3,4,7,6,-66,42,3,9,193,169
483,28,3,3,4,9,31,-64,4,5,224,105
483,29,4,2,11,2,-53,20,1,5,171,125
483,30,2,4,6,7,24,43,5,8,195,168
483,31,3,4,7,6,34,-58,9,0,229,110
483,32,3,3,6,7,-67,34,2,4,162,144
483,33,2,4,6,7,24,43,6,7,186,187
483,34,3,3,9,4,-64,31,2,8,122,218
483,35,4,2,7,6,43,-76,5,2,165,142
483,36,4,3,9,4,-55,31,0,3,110,173
483,37,2,5,5,8,23,53,3,6,133,226
483,38,3,4,6,7,33,43,6,9,166,269
483,39,3,4,4,9,31,-55,7,4,197,214
483,40,3,3,7,6,-66,33,1,7,131,247
483,41,3,3,4,9,31,-64,2,3,162,183
483,42,3,3,9,4,36,31,8,4,198,214
483,43,3,4,8,5,-65,41,3,5,133,255
483,44,3,4,5,8,32,44,5,9,165,299
483,45,3,4,8,5,-65,-59,0,0,100,240
483,46,4,2,10,3,46,21,6,1,146,261
483,47,2,5,5,8,23,53,9,4,169,314
483,48,3,3,3,10,30,-63,9,1,199,251
483,49,3,3,5,8,-68,35,1,6,131,286
483,50,5,2,8,5,53,23,4,9,184,309
483,51,4,3,6,7,42,-66,6,3,226,243
483,52,5,2,9,4,-46,22,0,5,180,265
483,53,3,3,4,9,31,-64,1,1,211,201
483,54,3,3,6,7,33,34,4,5,244,235
483,55,2,4,7,6,25,42,9,7,269,277
483,56,4,3,7,6,-57,-67,2,0,212,210
483,57,4,4,5,8,41,44,3,4,253,254
483,58,3,4,5,8,32,44,5,8,285,298
483,59,4,3,5,8,41,-65,6,3,326,233
483,60,2,4,6,7,-76,43,0,6,250,276
483,61,2,4,6,7,24,43,4,9,274,319
483,62,3,3,7,6,34,-67,8,2,308,252
483,63,5,2,9,4,-46,22,2,4,262,274
483,64,5,2,8,5,53,23,5,7,315,297
483,65,2,5,3,10,21,-45,6,2,336,252
483,66,2,5,5,8,23,53,9,5,359,305
483,67,3,3,8,5,-65,32,4,7,294,337
483,68,4,2,6,7,42,-75,6,2,336,262
483,69,2,4,6,7,-76,43,0,5,260,305
483,70,4,2,6,7,42,-75,2,0,302,230
483,71,4,2,9,4,45,22,7,2,347,252
483,72,4,2,8,5,-56,23,1,5,291,275
483,73,3,4,5,8,32,44,3,9,323,319
483,74,3,3,5,8,32,-65,5,4,355,254
483,75,4,2,10,3,-54,21,1,5,301,275
483,76,5,2,9,4,54,22,5,7,355,297
483,77,4,3,7,6,43,-67,8,0,398,230
483,78,5,2,10,3,-45,21,3,1,353,251
483,79,3,3,7,6,34,33,7,4,387,284
483,80,4,3,9,4,-55,31,2,5,332,315
483,81,2,4,8,5,26,41,8,6,358,356
483,82,2,4,9,4,-73,40,5,6,285,396
483,83,3,3,8,5,-65,32,0,8,220,428
483,84,4,3,4,9,40,-64,0,4,260,364
483,85,4,2,8,5,44,23,4,7,304,387
483,86,3,3,6,7,33,-66,7,1,337,321
483,87,3,3,5,8,32,35,9,6,369,356
483,88,2,6,4,9,-78,63,1,9,291,419
483,89,3,4,6,7,33,-57,4,2,324,362
483,90,3,3,6,7,33,34,7,6,357,396
483,91,5,2,7,6,52,-76,9,0,409,320
483,92,5,2,9,4,-46,22,3,2,363,342
483,93,4,3,5,8,41,35,4,7,404,377
483,94,3,4,8,5,35,41,9,8,439,418
483,95,4,2,8,5,-56,-77,3,1,383,341
483,96,4,3,9,4,45,31,8,2,428,372
483,97,6,2,9,4,-37,22,1,4,391,394
483,98,4,2,9,4,45,22,6,6,436,416
483,99,3,3,6,7,33,-66,9,0,469,350
483,100,3,4,5,8,-68,44,1,4,401,394
483,101,3,3,7,6,34,33,5,7,435,427
483,102,3,3,6,7,33,-66,8,1,468,361
483,103,5,2,9,4,-46,22,2,3,422,383
483,104,5,2,7,6,52,24,4,7,474,407
483,105,4,2,7,6,43,-76,7,1,517,331
484,1,4,2,5,8,41,26,1,6,41,26
484,2,3,4,5,8,32,-56,3,0,73,-30
484,3,2,4,3,10,21,46,4,6,94,16
484,4,4,2,11,2,-53,20,1,6,41,36
484,5,3,4,7,6,34,42,5,8,75,78
484,6,4,3,10,3,-54,30,1,8,21,108
484,7,5,2,8,5,53,-77,4,1,74,31
484,8,3,4,4,9,31,45,5,6,105,76
484,9,3,4,7,6,34,42,9,8,139,118
484,10,3,4,7,6,-66,-58,3,0,73,60
484,11,2,5,3,10,21,55,4,5,94,115
484,12,3,3,5,8,32,-65,6,0,126,50
484,13,4,2,10,3,-54,21,2,1,72,71
484,14,4,3,6,7,42,34,4,5,114,105
484,15,2,6,3,10,21,64,5,9,135,169
484,16,3,5,3,10,30,-45,5,4,165,124
484,17,4,4,6,7,42,43,7,7,207,167
484,18,4,3,10,3,-54,30,3,7,153,197
484,19,4,3,10,3,46,30,9,7,199,227
484,20,4,3,6,7,-58,-66,1,1,141,161
484,21,5,2,9,4,54,22,5,3,195,183
484,22,5,2,8,5,53,23,8,6,248,206
484,23,4,3,8,5,-56,32,2,8,192,238
484,24,3,3,8,5,35,-68,7,0,227,170
484,25,3,4,7,6,-66,42,1,2,161,212
484,26,4,4,6,7,42,43,3,5,203,255
484,27,3,3,6,7,33,34,6,9,236,289
484,28,2,4,8,5,-74,-59,2,0,162,230
484,29,3,3,5,8,32,35,4,5,194,265
484,30,4,2,8,5,44,23,8,8,238,288
484,31,3,3,8,5,-65,-68,3,0,173,220
484,32,3,4,4,9,31,45,4,5,204,265
484,33,3,4,6,7,33,43,7,8,237,308
484,34,3,3,4,9,31,-64,8,4,268,244
484,35,2,4,5,8,-77,44,1,8,191,288
484,36,5,2,10,3,55,21,6,9,246,309
484,37,3,3,5,8,32,-65,8,4,278,244
484,38,4,2,8,5,-56,23,2,7,222,267
484,39,5,3,8,5,53,32,5,9,275,299
484,40,4,2,9,4,-55,-78,0,1,220,221
484,41,4,3,7,6,43,33,3,4,263,254
484,42,3,3,4,9,31,-64,4,0,294,190
484,43,2,4,3,10,21,46,5,6,315,236
484,44,3,4,4,9,31,-55,6,1,346,181
484,45,2,5,2,11,20,56,6,7,366,237
484,46,3,4,6,7,33,-57,9,0,399,180
484,47,4,3,7,6,-57,33,2,3,342,213
484,48,4,2,8,5,44,23,6,6,386,236
484,49,2,4,6,7,-76,43,0,9,310,279
484,50,5,2,10,3,55,-79,5,0,365,200
484,51,3,3,7,6,34,33,9,3,399,233
484,52,4,3,8,5,-56,32,3,5,343,265
484,53,2,6,3,10,21,64,4,9,364,329
484,54,3,3,7,6,34,-67,8,2,398,262
484,55,3,3,6,7,-67,34,1,6,331,296
484,56,3,3,4,9,31,-64,2,2,362,232
484,57,4,3,8,5,44,32,6,4,406,264
484,58,3,4,9,4,-64,40,2,4,342,304
484,59,2,5,4,9,22,54,4,8,364,358
484,60,4,2,9,4,45,-78,9,0,409,280
484,61,2,4,5,8,-77,44,2,4,332,324
484,62,4,2,9,4,45,22,7,6,377,346
484,63,2,4,8,5,-74,41,3,7,303,387
484,64,3,3,6,7,33,-66,6,1,336,321
484,65,3,4,5,8,32,44,8,5,368,365
484,66,4,2,7,6,-57,24,1,9,311,389
484,67,3,3,3,10,30,-63,1,6,341,326
484,68,4,3,4,9,40,-64,1,2,381,262
484,69,3,4,5,8,32,44,3,6,413,306
484,70,4,2,9,4,45,22,8,8,458,328
484,71,4,3,7,6,-57,-67,1,1,401,261
484,72,3,3,8,5,35,32,6,3,436,293
484,73,4,4,5,8,41,44,7,7,477,337
484,74,3,4,6,7,-67,-57,0,0,410,280
484,75,4,2,5,8,41,26,1,6,451,306
484,76,4,4,7,6,43,42,4,8,494,348
484,77,2,4,5,8,23,-56,7,2,517,292
485,1,3,4,7,6,34,42,4,2,34,42
485,2,2,5,6,7,24,52,8,4,58,94
485,3,2,5,3,10,21,55,9,9,79,149
485,4,3,3,7,6,-66,-67,3,2,13,82
485,5,3,4,9,4,36,40,9,2,49,122
485,6,4,2,6,7,-58,25,1,7,-9,147
485,7,5,2,9,4,54,22,5,9,45,169
485,8,4,3,8,5,44,-68,9,1,89,101
485,9,4,3,6,7,-58,34,1,5,31,135
485,10,5,2,7,6,52,24,3,9,83,159
485,11,3,3,6,7,33,-66,6,3,116,93
485,12,2,4,4,9,22,45,8,8,138,138
485,13,3,4,8,5,-65,41,3,9,73,179
485,14,5,2,9,4,54,-78,7,1,127,101
485,15,4,3,7,6,-57,33,0,4,70,134
485,16,3,3,7,6,34,33,4,7,104,167
485,17,3,4,4,9,31,-55,5,2,135,112
485,18,2,4,6,7,24,43,9,5,159,155
485,19,2,5,4,9,-78,54,1,9,81,209
485,20,3,3,9,4,36,-69,7,0,117,140
485,21,3,5,4,9,31,54,8,4,148,194
485,22,4,3,7,6,-57,33,1,7,91,227
485,23,3,3,6,7,33,-66,4,1,124,161
485,24,2,6,3,10,21,64,5,5,145,225
485,25,5,2,10,3,-45,21,0,6,100,246
485,26,3,4,7,6,34,42,4,8,134,288
485,27,3,3,7,6,34,-67,8,1,168,221
485,28,2,4,5,8,-77,44,1,5,91,265
485,29,3,4,5,8,32,44,3,9,123,309
485,30,3,3,6,7,33,-66,6,3,156,243
485,31,3,4,4,9,31,45,7,8,187,288
485,32,4,3,8,5,-56,-68,1,0,131,220
485,33,2,5,5,8,23,53,4,3,154,273
485,34,2,4,6,7,24,43,8,6,178,316
485,35,3,3,6,7,-67,-66,1,0,111,250
485,36,3,4,5,8,32,44,3,4,143,294
485,37,6,2,10,3,64,21,7,5,207,315
485,38,3,4,4,9,31,-55,8,0,238,260
485,39,2,4,5,8,-77,44,1,4,161,304
485,40,3,3,4,9,31,-64,2,0,192,240
485,41,2,4,7,6,25,42,7,2,217,282
485,42,2,5,4,9,22,54,9,6,239,336
485,43,5,2,9,4,-46,22,3,8,193,358
485,44,3,3,6,7,33,-66,6,2,226,292
485,45,5,2,9,4,-46,22,0,4,180,314
485,46,2,4,6,7,24,43,4,7,204,357
485,47,3,3,9,4,-64,31,0,8,140,388
485,48,4,3,7,6,43,-67,3,1,183,321
485,49,3,4,5,8,32,44,5,5,215,365
485,50,4,2,9,4,-55,22,0,7,160,387
485,51,2,5,4,9,22,-46,2,1,182,341
485,52,4,3,8,5,44,32,6,3,226,373
485,53,3,3,4,9,31,36,7,9,257,409
485,54,3,4,6,7,-67,-57,0,2,190,352
485,55,4,3,8,5,44,32,4,4,234,384
485,56,2,4,4,9,22,45,6,9,256,429
485,57,4,3,5,8,41,-65,7,4,297,364
485,58,4,3,8,5,-56,32,1,6,241,396
485,59,5,2,10,3,55,21,6,7,296,417
485,60,2,4,6,7,-76,-57,0,0,220,360
485,61,2,5,2,11,20,56,0,6,240,416
485,62,2,4,5,8,23,-56,3,0,263,360
485,63,4,2,9,4,45,22,8,2,308,382
485,64,2,5,4,9,-78,54,0,6,230,436
485,65,5,2,9,4,54,22,4,8,284,458
485,66,3,3,7,6,34,-67,8,1,318,391
485,67,4,3,10,3,-54,30,4,1,264,421
485,68,4,2,9,4,45,22,9,3,309,443
485,69,3,4,8,5,-65,41,4,4,244,484
485,70,4,4,6,7,42,43,6,7,286,527
486,1,3,4,8,5,35,41,5,1,35,41
486,2,3,5,6,7,33,52,8,3,68,93
486,3,5,2,8,5,-47,23,1,6,21,116
486,4,4,2,9,4,45,22,6,8,66,138
486,5,2,4,4,9,22,-55,8,3,88,83
486,6,5,2,9,4,-46,22,2,5,42,105
486,7,2,4,6,7,24,43,6,8,66,148
486,8,2,4,7,6,-75,-58,1,0,-9,90
486,9,3,3,5,8,32,35,3,5,23,125
486,10,4,2,8,5,44,23,7,8,67,148
486,11,3,3,7,6,-66,-67,1,1,1,81
486,12,4,3,6,7,42,34,3,5,43,115
486,13,5,2,9,4,54,22,7,7,97,137
486,14,4,2,7,6,-57,-76,0,1,40,61
486,15,4,3,9,4,45,31,5,2,85,92
486,16,4,3,6,7,42,34,7,6,127,126
486,17,2,4,5,8,-77,-56,0,0,50,70
486,18,3,4,7,6,34,42,4,2,84,112
486,19,4,3,5,8,41,35,5,7,125,147
486,20,2,5,4,9,22,-46,7,1,147,101
486,21,2,5,2,11,20,56,7,7,167,157
486,22,3,4,4,9,31,-55,8,2,198,102
486,23,2,4,6,7,-76,43,2,5,122,145
486,24,4,2,8,5,44,23,6,8,166,168
486,25,5,2,10,3,-45,21,1,9,121,189
486,26,3,4,4,9,31,-55,2,4,152,134
486,27,2,4,6,7,24,43,6,7,176,177
486,28,3,3,7,6,-66,-67,0,0,110,110
486,29,4,2,6,7,42,25,2,5,152,135
486,30,5,2,6,7,51,-75,3,0,203,60
486,31,3,4,7,6,34,42,7,2,237,102
486,32,5,2,10,3,-45,21,2,3,192,123
486,33,2,4,5,8,23,44,5,7,215,167
486,34,5,2,9,4,54,22,9,9,269,189
486,35,3,3,6,7,-67,-66,2,3,202,123
486,36,3,4,7,6,34,42,6,5,236,165
486,37,4,2,8,5,-56,23,0,8,180,188
486,38,2,5,2,11,20,-44,0,4,200,144
486,39,4,3,5,8,41,35,1,9,241,179
486,40,2,5,5,8,23,-47,4,2,264,132
486,41,2,5,3,10,21,55,5,7,285,187
486,42,3,3,7,6,34,-67,9,0,319,120
486,43,3,3,4,9,-69,36,0,6,250,156
486,44,5,2,9,4,54,22,4,8,304,178
486,45,3,4,5,8,32,-56,6,2,336,122
486,46,4,3,6,7,42,34,8,6,378,156
486,47,3,3,8,5,-65,32,3,8,313,188
486,48,5,2,9,4,54,-78,7,0,367,110
486,49,3,4,5,8,32,44,9,4,399,154
486,50,3,4,8,5,-65,41,4,5,334,195
486,51,2,5,3,10,21,-45,5,0,355,150
486,52,5,2,8,5,53,23,8,3,408,173
486,53,2,4,4,9,-78,45,0,8,330,218
486,54,4,4,5,8,41,-56,1,2,371,162
486,55,4,2,8,5,44,23,5,5,415,185
486,56,2,4,4,9,22,-55,7,0,437,130
486,57,3,3,7,6,-66,33,1,3,371,163
486,58,4,2,8,5,44,23,5,6,415,186
486,59,4,2,7,6,43,-76,8,0,458,110
486,60,2,4,8,5,-74,41,4,1,384,151
486,61,4,3,7,6,43,33,7,4,427,184
486,62,4,3,8,5,-56,32,1,6,371,216
486,63,3,4,8,5,35,41,6,7,406,257
486,64,3,3,9,4,-64,31,2,8,342,288
486,65,3,3,5,8,32,-65,4,3,374,223
486,66,2,4,3,10,21,46,5,9,395,269
486,67,3,4,7,6,34,-58,9,1,429,211
486,68,5,2,7,6,-48,24,1,5,381,235
486,69,3,3,6,7,33,34,4,9,414,269
486,70,3,4,4,9,31,-55,5,4,445,214
486,71,2,4,8,5,-74,41,1,5,371,255
486,72,4,2,7,6,43,24,4,9,414,279
486,73,3,3,7,6,34,-67,8,2,448,212
486,74,4,3,6,7,-58,34,0,6,390,246
486,75,4,3,8,5,44,32,4,8,434,278
486,76,4,2,5,8,41,-74,5,4,475,204
486,77,2,4,5,8,23,44,8,8,498,248
486,78,5,2,9,4,-46,-78,2,0,452,170
486,79,2,5,4,9,22,54,4,4,474,224
486,80,4,3,6,7,42,34,6,8,516,258
487,1,2,4,5,8,23,44,3,4,23,44
487,2,4,3,8,5,44,32,7,6,67,76
487,3,2,4,8,5,-74,41,3,7,-7,117
487,4,4,4,6,7,42,-57,5,0,35,60
487,5,4,3,7,6,43,33,8,3,78,93
487,6,2,5,5,8,-77,53,1,6,1,146
487,7,5,3,9,4,54,31,5,7,55,177
487,8,4,3,7,6,43,-67,8,0,98,110
487,9,4,2,8,5,-56,23,2,3,42,133
487,10,4,3,7,6,43,33,5,6,85,166
487,11,2,5,3,10,21,-45,6,1,106,121
487,12,2,4,5,8,23,44,9,5,129,165
487,13,5,2,8,5,-47,23,2,8,82,188
487,14,5,2,8,5,53,-77,5,1,135,111
487,15,3,5,4,9,31,54,6,5,166,165
487,16,4,2,7,6,43,24,9,9,209,189
487,17,3,5,5,8,-68,-47,1,2,141,142
487,18,2,5,5,8,23,53,4,5,164,195
487,19,4,4,7,6,43,42,7,7,207,237
487,20,5,2,10,3,-45,21,2,8,162,258
487,21,2,5,3,10,21,-45,3,3,183,213
487,22,4,2,8,5,44,23,7,6,227,236
487,23,3,4,6,7,-67,43,0,9,160,279
487,24,3,4,7,6,34,-58,4,1,194,221
487,25,4,3,9,4,45,31,9,2,239,252
487,26,3,4,8,5,-65,41,4,3,174,293
487,27,3,3,8,5,35,32,9,5,209,325
487,28,3,3,8,5,-65,32,4,7,144,357
487,29,3,4,8,5,35,41,9,8,179,398
487,30,4,4,5,8,-59,-56,0,2,120,342
487,31,3,4,5,8,32,44,2,6,152,386
487,32,4,2,8,5,44,23,6,9,196,409
487,33,4,3,6,7,42,-66,8,3,238,343
487,34,4,3,6,7,-58,34,0,7,180,377
487,35,3,3,6,7,33,-66,3,1,213,311
487,36,5,2,7,6,52,24,5,5,265,335
487,37,3,4,5,8,32,44,7,9,297,379
487,38,5,2,7,6,52,-76,9,3,349,303
487,39,3,4,6,7,-67,43,2,6,282,346
487,40,4,2,9,4,45,22,7,8,327,368
487,41,4,2,7,6,-57,-76,0,2,270,292
487,42,3,4,7,6,34,42,4,4,304,334
487,43,3,3,8,5,35,32,9,6,339,366
487,44,3,4,7,6,-66,42,3,8,273,408
487,45,3,4,6,7,33,-57,6,1,306,351
487,46,4,2,6,7,42,25,8,6,348,376
487,47,3,3,8,5,-65,32,3,8,283,408
487,48,5,2,10,3,55,21,8,9,338,429
487,49,3,4,3,10,30,-54,8,5,368,375
487,50,6,2,7,6,61,24,9,9,429,399
487,51,3,4,5,8,-68,-56,1,3,361,343
487,52,5,2,8,5,53,23,4,6,414,366
487,53,3,4,6,7,33,43,7,9,447,409
487,54,3,3,7,6,-66,-67,1,2,381,342
487,55,4,2,9,4,45,22,6,4,426,364
487,56,4,2,7,6,43,24,9,8,469,388
487,57,3,4,6,7,-67,-57,2,1,402,331
487,58,4,3,6,7,42,34,4,5,444,365
487,59,4,3,9,4,45,31,9,6,489,396
487,60,3,4,4,9,-69,-55,0,1,420,341
487,61,4,3,5,8,41,35,1,6,461,376
487,62,3,5,4,9,31,-46,2,0,492,330
487,63,2,4,4,9,22,45,4,5,514,375
488,1,3,4,7,6,34,42,4,2,34,42
488,2,4,3,8,5,44,32,8,4,78,74
488,3,3,4,6,7,-67,43,1,7,11,117
488,4,2,4,4,9,22,-55,3,2,33,62
488,5,4,2,9,4,45,22,8,4,78,84
488,6,2,5,4,9,-78,54,0,8,0,138
488,7,2,4,4,9,22,-55,2,3,22,83
488,8,4,3,5,8,41,35,3,8,63,118
488,9,2,6,3,10,21,-36,4,2,84,82
488,10,3,3,6,7,33,34,7,6,117,116
488,11,4,2,10,3,-54,21,3,7,63,137
488,12,3,4,4,9,31,-55,4,2,94,82
488,13,5,2,8,5,53,23,7,5,147,105
488,14,4,4,4,9,40,-55,7,0,187,50
488,15,2,5,5,8,-77,53,0,3,110,103
488,16,4,3,6,7,42,34,2,7,152,137
488,17,4,2,7,6,43,-76,5,1,195,61
488,18,5,2,8,5,53,23,8,4,248,84
488,19,3,4,4,9,31,45,9,9,279,129
488,20,3,3,6,7,-67,-66,2,3,212,63
488,21,5,2,10,3,55,21,7,4,267,84
488,22,3,3,8,5,-65,32,2,6,202,116
488,23,2,5,6,7,24,52,6,8,226,168
488,24,4,2,9,4,-55,-78,1,0,171,90
488,25,2,4,4,9,22,45,3,5,193,135
488,26,3,3,6,7,33,34,6,9,226,169
488,27,4,3,9,4,-55,-69,1,0,171,100
488,28,2,5,5,8,23,53,4,3,194,153
488,29,4,3,7,6,43,33,7,6,237,186
488,30,2,4,3,10,21,-54,8,2,258,132
488,31,3,4,7,6,-66,42,2,4,192,174
488,32,3,3,7,6,34,33,6,7,226,207
488,33,3,3,6,7,33,-66,9,1,259,141
488,34,2,4,6,7,-76,43,3,4,183,184
488,35,4,3,8,5,44,32,7,6,227,216
488,36,4,2,9,4,-55,22,2,8,172,238
488,37,3,4,4,9,31,-55,3,3,203,183
488,38,2,4,6,7,24,43,7,6,227,226
488,39,4,3,8,5,-56,32,1,8,171,258
488,40,3,4,4,9,31,-55,2,3,202,203
488,41,3,3,9,4,36,31,8,4,238,234
488,42,4,2,10,3,-54,21,4,5,184,255
488,43,3,4,5,8,32,44,6,9,216,299
488,44,3,4,6,7,33,-57,9,2,249,242
488,45,3,3,4,9,-69,36,0,8,180,278
488,46,3,3,6,7,33,-66,3,2,213,212
488,47,3,4,7,6,34,42,7,4,247,254
488,48,2,4,4,9,22,45,9,9,269,299
488,49,6,2,10,3,-36,-79,3,0,233,220
488,50,2,5,4,9,22,54,5,4,255,274
488,51,3,3,6,7,33,34,8,8,288,308
488,52,3,4,5,8,-68,-56,0,2,220,252
488,53,4,3,9,4,45,31,5,3,265,283
488,54,4,2,6,7,42,25,7,8,307,308
488,55,2,5,3,10,21,-45,8,3,328,263
488,56,3,4,7,6,-66,42,2,5,262,305
488,57,3,3,6,7,33,34,5,9,295,339
488,58,4,2,6,7,42,-75,7,4,337,264
488,59,3,5,6,7,-67,52,0,6,270,316
488,60,3,4,5,8,32,-56,2,0,302,260
488,61,3,4,7,6,34,42,6,2,336,302
488,62,3,3,8,5,-65,32,1,4,271,334
488,63,3,3,8,5,35,32,6,6,306,366
488,64,4,3,8,5,-56,32,0,8,250,398
488,65,3,3,7,6,34,-67,4,1,284,331
488,66,3,3,5,8,32,35,6,6,316,366
488,67,3,4,4,9,31,-55,7,1,347,311
488,68,3,4,7,6,-66,42,1,3,281,353
488,69,3,3,7,6,34,33,5,6,315,386
488,70,4,3,9,4,-55,31,0,7,260,417
488,71,4,3,7,6,43,-67,3,0,303,350
488,72,6,2,8,5,62,23,5,3,365,373
488,73,3,3,7,6,34,33,9,6,399,406
488,74,3,3,5,8,-68,-65,1,1,331,341
488,75,2,4,2,11,20,47,1,8,351,388
488,76,4,3,10,3,46,30,7,8,397,418
488,77,5,2,8,5,-47,-77,0,1,350,341
488,78,5,2,8,5,53,23,3,4,403,364
488,79,3,3,4,9,31,-64,4,0,434,300
488,80,2,5,6,7,24,52,8,2,458,352
488,81,2,4,6,7,-76,43,2,5,382,395
488,82,3,3,7,6,34,33,6,8,416,428
488,83,4,3,6,7,42,-66,8,2,458,362
488,84,4,3,9,4,-55,31,3,3,403,393
488,85,6,2,8,5,62,23,5,6,465,416
488,86,3,4,5,8,32,-56,7,0,497,360
488,87,4,3,8,5,-56,32,1,2,441,392
488,88,3,4,7,6,34,42,5,4,475,434
488,89,3,5,3,10,30,55,5,9,505,489
489,1,4,3,7,6,43,33,3,3,43,33
489,2,3,5,4,9,31,54,4,7,74,87
489,3,4,2,9,4,45,22,9,9,119,109
489,4,2,5,4,9,-78,-46,1,3,41,63
489,5,2,5,4,9,22,54,3,7,63,117
489,6,2,4,5,8,23,-56,6,1,86,61
489,7,3,4,6,7,33,43,9,4,119,104
489,8,3,4,5,8,-68,44,1,8,51,148
489,9,3,4,4,9,31,-55,2,3,82,93
489,10,4,3,6,7,42,34,4,7,124,127
489,11,3,4,3,10,30,-54,4,3,154,73
489,12,2,4,5,8,23,44,7,7,177,117
489,13,4,3,6,7,42,-66,9,1,219,51
489,14,3,4,7,6,-66,42,3,3,153,93
489,15,3,3,5,8,32,35,5,8,185,128
489,16,4,2,10,3,-54,21,1,9,131,149
489,17,3,3,7,6,34,-67,5,2,165,82
489,18,2,5,6,7,24,52,9,4,189,134
489,19,2,4,3,10,-79,-54,0,0,110,80
489,20,2,5,4,9,22,54,2,4,132,134
489,21,5,2,7,6,52,24,4,8,184,158
489,22,4,3,8,5,44,-68,8,0,228,90
489,23,2,6,4,9,-78,63,0,3,150,153
489,24,4,3,9,4,45,31,5,4,195,184
489,25,5,2,11,2,-44,20,1,4,151,204
489,26,4,3,9,4,45,31,6,5,196,235
489,27,4,2,10,3,-54,21,2,6,142,256
489,28,3,5,5,8,32,53,4,9,174,309
489,29,5,2,9,4,54,-78,8,1,228,231
489,30,2,5,4,9,-78,54,0,5,150,285
489,31,2,5,6,7,24,52,4,7,174,337
489,32,2,6,2,11,20,-35,4,2,194,302
489,33,3,4,8,5,35,41,9,3,229,343
489,34,4,2,8,5,-56,23,3,6,173,366
489,35,3,3,8,5,35,32,8,8,208,398
489,36,4,3,6,7,-58,-66,0,2,150,332
489,37,2,4,5,8,23,44,3,6,173,376
489,38,2,4,7,6,25,42,8,8,198,418
489,39,3,4,7,6,-66,-58,2,0,132,360
489,40,3,3,4,9,31,36,3,6,163,396
489,41,2,5,4,9,22,-46,5,0,185,350
489,42,3,3,6,7,33,34,8,4,218,384
489,43,3,4,7,6,-66,42,2,6,152,426
489,44,2,5,2,11,20,-44,2,2,172,382
489,45,5,2,8,5,53,23,5,5,225,405
489,46,3,4,7,6,34,42,9,7,259,447
489,47,4,3,8,5,-56,32,3,9,203,479
489,48,4,3,7,6,43,-67,6,2,246,412
489,49,4,2,10,3,-54,21,2,3,192,433
489,50,4,3,5,8,41,35,3,8,233,468
489,51,3,3,7,6,34,-67,7,1,267,401
489,52,5,2,10,3,-45,21,2,2,222,422
489,53,4,3,5,8,41,35,3,7,263,457
489,54,4,3,6,7,42,-66,5,1,305,391
489,55,3,4,6,7,33,43,8,4,338,434
489,56,3,3,7,6,-66,33,2,7,272,467
489,57,4,2,10,3,46,21,8,8,318,488
489,58,4,3,10,3,-54,30,4,8,264,518
490,1,5,2,10,3,55,21,5,1,55,21
490,2,2,5,4,9,22,54,7,5,77,75
490,3,4,3,8,5,-56,32,1,7,21,107
490,4,5,2,7,6,52,-76,3,1,73,31
490,5,4,2,7,6,43,24,6,5,116,55
490,6,5,2,7,6,52,24,8,9,168,79
490,7,5,2,9,4,-46,-78,2,1,122,1
490,8,4,3,8,5,44,32,6,3,166,33
490,9,6,2,11,2,-35,20,1,3,131,53
490,10,3,4,8,5,35,41,6,4,166,94
490,11,2,4,7,6,-75,42,1,6,91,136
490,12,3,3,7,6,34,33,5,9,125,169
490,13,4,2,7,6,43,-76,8,3,168,93
490,14,2,4,3,10,21,46,9,9,189,139
490,15,3,3,8,5,-65,-68,4,1,124,71
490,16,3,4,5,8,32,44,6,5,156,115
490,17,4,3,8,5,-56,32,0,7,100,147
490,18,2,4,5,8,23,-56,3,1,123,91
490,19,2,4,3,10,21,46,4,7,144,137
490,20,3,3,5,8,32,-65,6,2,176,72
490,21,4,3,9,4,-55,31,1,3,121,103
490,22,2,4,3,10,21,46,2,9,142,149
490,23,3,3,4,9,31,-64,3,5,173,85
490,24,2,5,5,8,23,53,6,8,196,138
490,25,4,3,7,6,43,-67,9,1,239,71
490,26,3,3,6,7,-67,34,2,5,172,105
490,27,2,4,6,7,24,43,6,8,196,148
490,28,5,2,8,5,53,-77,9,1,249,71
490,29,3,3,6,7,-67,34,2,5,182,105
490,30,3,4,8,5,35,41,7,6,217,146
490,31,3,4,8,5,-65,41,2,7,152,187
490,32,4,3,7,6,43,-67,5,0,195,120
490,33,3,3,3,10,30,37,5,7,225,157
490,34,7,2,9,4,72,22,7,9,297,179
490,35,3,4,6,7,-67,-57,0,2,230,122
490,36,3,3,7,6,34,33,4,5,264,155
490,37,3,3,6,7,33,34,7,9,297,189
490,38,2,4,5,8,-77,-56,0,3,220,133
490,39,2,5,3,10,21,55,1,8,241,188
490,40,4,2,9,4,45,-78,6,0,286,110
490,41,2,4,6,7,-76,43,0,3,210,153
490,42,5,2,8,5,53,23,3,6,263,176
490,43,2,5,3,10,21,-45,4,1,284,131
490,44,3,4,4,9,31,45,5,6,315,176
490,45,6,2,8,5,62,23,7,9,377,199
490,46,2,5,3,10,21,-45,8,4,398,154
490,47,2,6,5,8,-77,62,1,6,321,216
490,48,3,3,5,8,32,-65,3,1,353,151
490,49,3,3,8,5,35,32,8,3,388,183
490,50,4,3,5,8,41,35,9,8,429,218
490,51,2,4,2,11,20,-53,9,5,449,165
490,52,4,3,6,7,-58,34,1,9,391,199
490,53,5,2,10,3,55,-79,6,0,446,120
490,54,5,2,9,4,-46,22,0,2,400,142
490,55,4,3,6,7,42,34,2,6,442,176
490,56,5,2,10,3,55,21,7,7,497,197
490,57,3,3,3,10,30,-63,7,4,527,134
491,1,4,2,8,5,44,23,4,3,44,23
491,2,4,2,6,7,42,25,6,8,86,48
491,3,3,4,9,4,-64,40,2,8,22,88
491,4,5,2,8,5,53,-77,5,1,75,11
491,5,5,2,11,2,-44,20,1,1,31,31
491,6,3,3,6,7,33,34,4,5,64,65
491,7,2,5,2,11,20,-44,4,1,84,21
491,8,4,3,9,4,45,31,9,2,129,52
491,9,4,2,9,4,-55,22,4,4,74,74
491,10,3,3,8,5,35,32,9,6,109,106
491,11,3,3,6,7,-67,-66,2,0,42,40
491,12,3,4,6,7,33,43,5,3,75,83
491,13,3,3,6,7,33,34,8,7,108,117
491,14,3,3,6,7,-67,-66,1,1,41,51
491,15,3,4,8,5,35,41,6,2,76,92
491,16,5,2,5,8,50,26,6,8,126,118
491,17,3,3,7,6,-66,-67,0,1,60,51
491,18,2,4,4,9,22,45,2,6,82,96
491,19,6,2,11,2,65,20,7,6,147,116
491,20,2,4,8,5,-74,41,3,7,73,157
491,21,3,3,7,6,34,-67,7,0,107,90
491,22,5,2,10,3,-45,21,2,1,62,111
491,23,3,4,8,5,35,41,7,2,97,152
491,24,3,3,7,6,-66,33,1,5,31,185
491,25,2,5,5,8,23,53,4,8,54,238
491,26,5,2,8,5,53,-77,7,1,107,161
491,27,2,5,2,11,20,56,7,7,127,217
491,28,2,5,3,10,21,-45,8,2,148,172
491,29,3,4,7,6,-66,42,2,4,82,214
491,30,3,3,7,6,34,33,6,7,116,247
491,31,3,3,4,9,31,-64,7,3,147,183
491,32,3,3,4,9,31,36,8,9,178,219
491,33,3,3,7,6,-66,-67,2,2,112,152
491,34,3,4,6,7,33,43,5,5,145,195
491,35,3,4,7,6,34,42,9,7,179,237
491,36,3,3,8,5,-65,32,4,9,114,269
491,37,4,2,8,5,44,-77,8,2,158,192
491,38,2,4,8,5,-74,41,4,3,84,233
491,39,2,4,4,9,22,45,6,8,106,278
491,40,4,2,6,7,42,-75,8,3,148,203
491,41,3,3,8,5,-65,32,3,5,83,235
491,42,3,4,7,6,34,42,7,7,117,277
491,43,2,5,2,11,20,-44,7,3,137,233
491,44,4,3,9,4,-55,31,2,4,82,264
491,45,2,5,5,8,23,53,5,7,105,317
491,46,3,3,5,8,32,-65,7,2,137,252
491,47,3,3,5,8,32,35,9,7,169,287
491,48,3,3,7,6,-66,-67,3,0,103,220
491,49,5,2,11,2,56,20,9,0,159,240
491,50,4,2,7,6,-57,24,2,4,102,264
491,51,3,4,8,5,35,41,7,5,137,305
491,52,4,3,8,5,-56,32,1,7,81,337
491,53,3,3,9,4,36,31,7,8,117,368
491,54,5,2,8,5,-47,-77,0,1,70,291
491,55,4,2,6,7,42,25,2,6,112,316
491,56,2,5,5,8,23,53,5,9,135,369
491,57,2,5,4,9,22,-46,7,3,157,323
491,58,3,4,5,8,32,44,9,7,189,367
491,59,4,2,6,7,-58,-75,1,2,131,292
491,60,2,4,4,9,22,45,3,7,153,337
491,61,3,3,7,6,34,-67,7,0,187,270
491,62,4,3,6,7,42,34,9,4,229,304
491,63,2,4,6,7,-76,43,3,7,153,347
491,64,5,2,7,6,52,-76,5,1,205,271
491,65,3,4,4,9,31,45,6,6,236,316
491,66,2,4,4,9,22,-55,8,1,258,261
491,67,3,3,5,8,-68,35,0,6,190,296
491,68,3,4,6,7,33,43,3,9,223,339
491,69,3,3,4,9,31,-64,4,5,254,275
491,70,4,4,4,9,40,-55,4,0,294,220
491,71,5,2,8,5,53,23,7,3,347,243
491,72,5,2,9,4,-46,22,1,5,301,265
491,73,4,3,9,4,45,31,6,6,346,296
491,74,4,2,9,4,-55,22,1,8,291,318
491,75,3,4,6,7,33,-57,4,1,324,261
491,76,3,4,4,9,31,45,5,6,355,306
491,77,4,3,7,6,43,33,8,9,398,339
491,78,4,2,9,4,-55,-78,3,1,343,261
491,79,2,4,6,7,24,43,7,4,367,304
491,80,2,5,6,7,-76,52,1,6,291,356
491,81,2,5,3,10,21,-45,2,1,312,311
491,82,4,2,7,6,43,24,5,5,355,335
491,83,4,2,7,6,43,24,8,9,398,359
491,84,2,5,2,11,20,-44,8,5,418,315
491,85,3,3,8,5,-65,32,3,7,353,347
491,86,4,3,8,5,44,32,7,9,397,379
491,87,3,4,4,9,31,-55,8,4,428,324
491,88,4,2,6,7,-58,25,0,9,370,349
491,89,3,3,5,8,32,-65,2,4,402,284
491,90,5,2,9,4,54,22,6,6,456,306
491,91,3,3,8,5,-65,32,1,8,391,338
491,92,3,3,7,6,34,-67,5,1,425,271
491,93,2,5,4,9,22,54,7,5,447,325
491,94,4,2,10,3,-54,21,3,6,393,346
491,95,2,4,5,8,23,-56,6,0,416,290
491,96,3,4,4,9,31,45,7,5,447,335
491,97,2,4,5,8,-77,44,0,9,370,379
491,98,4,2,10,3,46,-79,6,0,416,300
491,99,2,4,4,9,22,45,8,5,438,345
491,100,5,2,10,3,-45,21,3,6,393,366
491,101,4,2,8,5,44,23,7,9,437,389
491,102,4,2,10,3,-54,-79,3,0,383,310
491,103,5,2,9,4,54,22,7,2,437,332
491,104,4,2,9,4,-55,22,2,4,382,354
491,105,2,4,5,8,23,44,5,8,405,398
491,106,5,2,11,2,-44,20,1,8,361,418
491,107,3,3,4,9,31,-64,2,4,392,354
491,108,5,2,9,4,54,22,6,6,446,376
491,109,4,3,8,5,-56,32,0,8,390,408
491,110,5,2,10,3,55,21,5,9,445,429
491,111,5,2,10,3,-45,-79,0,0,400,350
491,112,4,2,7,6,43,24,3,4,443,374
491,113,3,4,8,5,35,41,8,5,478,415
491,114,4,2,6,7,-58,-75,0,0,420,340
491,115,3,4,6,7,33,43,3,3,453,383
491,116,5,2,8,5,53,23,6,6,506,406
492,1,3,3,4,9,31,36,1,6,31,36
492,2,4,2,8,5,44,23,5,9,75,59
492,3,2,5,4,9,22,-46,7,3,97,13
492,4,3,5,6,7,-67,52,0,5,30,65
492,5,4,2,5,8,41,-74,1,1,71,-9
492,6,2,4,6,7,24,43,5,4,95,34
492,7,4,3,7,6,43,33,8,7,138,67
492,8,3,4,7,6,-66,42,2,9,72,109
492,9,2,4,6,7,24,-57,6,2,96,52
492,10,2,4,6,7,-76,43,0,5,20,95
492,11,3,4,5,8,32,44,2,9,52,139
492,12,3,4,8,5,35,-59,7,0,87,80
492,13,2,4,5,8,-77,44,0,4,10,124
492,14,4,2,6,7,42,25,2,9,52,149
492,15,4,3,6,7,42,-66,4,3,94,83
492,16,2,5,3,10,21,55,5,8,115,138
492,17,4,3,9,4,-55,31,0,9,60,169
492,18,3,3,6,7,33,-66,3,3,93,103
492,19,2,4,6,7,24,43,7,6,117,146
492,20,5,3,8,5,-47,32,0,8,70,178
492,21,2,4,7,6,25,-58,5,0,95,120
492,22,3,3,6,7,33,34,8,4,128,154
492,23,3,4,7,6,-66,42,2,6,62,196
492,24,5,3,9,4,54,31,6,7,116,227
492,25,2,5,6,7,-76,52,0,9,40,279
492,26,3,3,5,8,32,-65,2,4,72,214
492,27,4,3,5,8,41,35,3,9,113,249
492,28,4,3,8,5,44,-68,7,1,157,181
492,29,5,2,8,5,-47,23,0,4,110,204
492,30,3,3,7,6,34,33,4,7,144,237
492,31,5,2,9,4,54,22,8,9,198,259
492,32,2,5,5,8,-77,-47,1,2,121,212
492,33,4,3,7,6,43,33,4,5,164,245
492,34,2,4,4,9,22,-55,6,0,186,190
492,35,3,3,10,3,-63,30,3,0,123,220
492,36,4,3,8,5,44,32,7,2,167,252
492,37,4,3,7,6,-57,33,0,5,110,285
492,38,4,2,10,3,46,21,6,6,156,306
492,39,4,3,9,4,-55,31,1,7,101,337
492,40,2,4,4,9,22,-55,3,2,123,282
492,41,4,3,7,6,43,33,6,5,166,315
492,42,3,4,5,8,32,44,8,9,198,359
492,43,5,2,10,3,-45,-79,3,0,153,280
492,44,3,3,7,6,34,33,7,3,187,313
492,45,4,2,7,6,-57,24,0,7,130,337
492,46,5,2,9,4,54,22,4,9,184,359
492,47,5,2,9,4,54,-78,8,1,238,281
492,48,4,3,7,6,-57,33,1,4,181,314
492,49,4,4,6,7,42,43,3,7,223,357
492,50,4,3,9,4,45,31,8,8,268,388
492,51,4,4,6,7,-58,-57,0,1,210,331
492,52,3,3,9,4,36,31,6,2,246,362
492,53,4,4,8,5,-56,41,0,3,190,403
492,54,4,2,7,6,43,24,3,7,233,427
492,55,2,4,4,9,22,-55,5,2,255,372
492,56,2,5,3,10,21,55,6,7,276,427
492,57,4,3,6,7,42,-66,8,1,318,361
492,58,3,4,7,6,-66,42,2,3,252,403
492,59,3,3,7,6,34,33,6,6,286,436
492,60,3,3,7,6,-66,33,0,9,220,469
492,61,5,2,8,5,53,-77,3,2,273,392
492,62,4,3,6,7,42,34,5,6,315,426
492,63,2,5,2,11,20,-44,5,2,335,382
492,64,4,3,8,5,44,32,9,4,379,414
492,65,2,5,4,9,-78,54,1,8,301,468
492,66,2,4,7,6,25,-58,6,0,326,410
492,67,5,2,11,2,-44,20,2,0,282,430
492,68,4,3,8,5,44,32,6,2,326,462
492,69,5,2,10,3,-45,21,1,3,281,483
492,70,3,4,9,4,36,40,7,3,317,523
493,1,2,5,6,7,24,52,4,2,24,52
493,2,4,3,6,7,42,34,6,6,66,86
493,3,2,4,5,8,23,-56,9,0,89,30
493,4,4,2,6,7,-58,25,1,5,31,55
493,5,4,2,5,8,41,-74,2,1,72,-19
493,6,3,4,9,4,36,40,8,1,108,21
493,7,3,4,6,7,-67,43,1,4,41,64
493,8,3,4,5,8,32,44,3,8,73,108
493,9,3,4,7,6,34,-58,7,0,107,50
493,10,2,5,2,11,20,56,7,6,127,106
493,11,3,3,5,8,32,-65,9,1,159,41
493,12,4,3,6,7,-58,34,1,5,101,75
493,13,3,3,6,7,33,34,4,9,134,109
493,14,2,5,3,10,21,-45,5,4,155,64
493,15,3,3,7,6,34,33,9,7,189,97
493,16,5,2,6,7,-49,-75,0,2,140,22
493,17,4,2,7,6,43,24,3,6,183,46
493,18,4,3,6,7,42,-66,5,0,225,-20
493,19,3,3,8,5,-65,32,0,2,160,12
493,20,4,3,7,6,43,33,3,5,203,45
493,21,2,5,5,8,23,53,6,8,226,98
493,22,5,2,8,5,53,-77,9,1,279,21
493,23,2,5,4,9,-78,54,1,5,201,75
493,24,2,5,2,11,20,-44,1,1,221,31
493,25,2,4,5,8,23,44,4,5,244,75
493,26,2,5,4,9,22,54,6,9,266,129
493,27,3,4,4,9,31,-55,7,4,297,74
493,28,3,4,5,8,32,44,9,8,329,118
493,29,5,2,9,4,-46,-78,3,0,283,40
493,30,4,3,8,5,44,32,7,2,327,72
493,31,4,2,10,3,-54,21,3,3,273,93
493,32,4,2,8,5,44,23,7,6,317,116
493,33,2,4,7,6,-75,42,2,8,242,158
493,34,4,3,8,5,44,-68,6,0,286,90
493,35,3,4,5,8,32,44,8,4,318,134
493,36,4,3,8,5,-56,32,2,6,262,166
493,37,2,4,6,7,24,43,6,9,286,209
493,38,3,4,4,9,31,-55,7,4,317,154
493,39,3,3,6,7,-67,34,0,8,250,188
493,40,4,4,9,4,45,40,5,8,295,228
493,41,5,2,10,3,-45,21,0,9,250,249
493,42,5,2,8,5,53,-77,3,2,303,172
493,43,4,2,10,3,46,21,9,3,349,193
493,44,5,2,10,3,-45,21,4,4,304,214
493,45,4,2,8,5,44,23,8,7,348,237
493,46,3,4,9,4,-64,40,4,7,284,277
493,47,5,2,8,5,53,-77,7,0,337,200
493,48,2,5,6,7,-76,52,1,2,261,252
493,49,3,4,8,5,35,41,6,3,296,293
493,50,2,6,2,11,20,65,6,8,316,358
493,51,2,5,2,11,20,-44,6,4,336,314
493,52,4,2,8,5,-56,23,0,7,280,337
493,53,4,2,8,5,44,-77,4,0,324,260
493,54,4,3,8,5,44,32,8,2,368,292
493,55,2,4,5,8,-77,44,1,6,291,336
493,56,3,3,6,7,33,-66,4,0,324,270
493,57,3,3,4,9,31,36,5,6,355,306
493,58,3,3,5,8,32,-65,7,1,387,241
493,59,5,2,8,5,-47,23,0,4,340,264
493,60,4,2,7,6,43,24,3,8,383,288
493,61,3,4,7,6,34,-58,7,0,417,230
493,62,3,3,7,6,-66,33,1,3,351,263
493,63,3,4,7,6,34,42,5,5,385,305
493,64,3,3,9,4,-64,31,1,6,321,336
493,65,3,4,8,5,35,41,6,7,356,377
493,66,3,5,3,10,30,-45,6,2,386,332
493,67,2,4,6,7,-76,43,0,5,310,375
493,68,2,5,4,9,22,54,2,9,332,429
493,69,3,4,6,7,33,-57,5,2,365,372
493,70,3,4,6,7,33,43,8,5,398,415
493,71,3,5,5,8,-68,53,0,8,330,468
493,72,5,2,10,3,55,21,5,9,385,489
493,73,3,3,8,5,-65,-68,0,1,320,421
493,74,3,3,5,8,32,35,2,6,352,456
493,75,3,4,5,8,32,-56,4,0,384,400
493,76,2,5,5,8,23,53,7,3,407,453
493,77,5,2,8,5,-47,23,0,6,360,476
493,78,2,6,4,9,22,63,2,9,382,539
494,1,2,4,6,7,24,43,4,3,24,43
494,2,2,4,4,9,22,45,6,8,46,88
494,3,5,2,10,3,-45,21,1,9,1,109
494,4,3,3,10,3,37,30,8,9,38,139
494,5,2,5,6,7,-76,-48,2,1,-38,91
494,6,3,3,7,6,34,33,6,4,-4,124
494,7,5,3,7,6,52,33,8,7,48,157
494,8,3,4,7,6,-66,42,2,9,-18,199
494,9,3,3,4,9,31,-64,3,5,13,135
494,10,3,5,4,9,31,54,4,9,44,189
494,11,5,2,7,6,52,-76,6,3,96,113
494,12,2,5,6,7,-76,52,0,5,20,165
494,13,2,4,6,7,24,43,4,8,44,208
494,14,4,2,11,2,-53,20,1,8,-9,228
494,15,2,5,4,9,22,-46,3,2,13,182
494,16,5,2,10,3,55,21,8,3,68,203
494,17,5,2,9,4,-46,22,2,5,22,225
494,18,2,5,3,10,21,-45,3,0,43,180
494,19,2,4,6,7,24,43,7,3,67,223
494,20,4,3,8,5,-56,32,1,5,11,255
494,21,2,5,5,8,23,53,4,8,34,308
494,22,3,3,7,6,34,-67,8,1,68,241
494,23,4,2,7,6,-57,24,1,5,11,265
494,24,4,2,10,3,46,21,7,6,57,286
494,25,3,3,6,7,-67,-66,0,0,-10,220
494,26,2,5,4,9,22,54,2,4,12,274
494,27,2,5,6,7,24,52,6,6,36,326
494,28,4,2,9,4,-55,22,1,8,-19,348
494,29,2,5,4,9,22,-46,3,2,3,302
494,30,4,2,7,6,43,24,6,6,46,326
494,31,4,3,9,4,-55,31,1,7,-9,357
494,32,2,5,5,8,23,-47,4,0,14,310
494,33,4,3,9,4,45,31,9,1,59,341
494,34,4,2,7,6,-57,24,2,5,2,365
494,35,3,3,8,5,35,32,7,7,37,397
494,36,2,4,3,10,21,-54,8,3,58,343
494,37,2,5,2,11,20,56,8,9,78,399
494,38,4,4,9,4,-55,40,3,9,23,439
494,39,3,4,7,6,34,-58,7,1,57,381
494,40,3,3,9,4,-64,31,3,2,-7,412
494,41,5,3,10,3,55,30,8,2,48,442
494,42,4,2,8,5,-56,23,2,5,-8,465
494,43,4,3,7,6,43,33,5,8,35,498
494,44,2,5,4,9,22,-46,7,2,57,452
494,45,3,3,7,6,-66,33,1,5,-9,485
494,46,4,3,7,6,43,33,4,8,34,518
495,1,3,4,7,6,34,42,4,2,34,42
495,2,2,5,3,10,21,55,5,7,55,97
495,3,4,3,8,5,44,32,9,9,99,129
495,4,4,4,5,8,-59,-56,0,3,40,73
495,5,4,3,5,8,41,35,1,8,81,108
495,6,3,4,9,4,36,40,7,8,117,148
495,7,4,3,7,6,-57,-67,0,1,60,81
495,8,5,2,8,5,53,23,3,4,113,104
495,9,4,3,7,6,43,33,6,7,156,137
495,10,3,3,4,9,31,-64,7,3,187,73
495,11,3,3,5,8,32,35,9,8,219,108
495,12,2,5,3,10,-79,-45,0,3,140,63
495,13,4,2,8,5,44,23,4,6,184,86
495,14,3,4,7,6,34,42,8,8,218,128
495,15,2,4,4,9,-78,-55,0,3,140,73
495,16,3,3,8,5,35,32,5,5,175,105
495,17,4,3,6,7,42,34,7,9,217,139
495,18,3,4,3,10,30,-54,7,5,247,85
495,19,3,4,6,7,-67,43,0,8,180,128
495,20,3,4,4,9,31,-55,1,3,211,73
495,21,3,4,6,7,33,43,4,6,244,116
495,22,4,3,4,9,40,-64,4,2,284,52
495,23,4,3,6,7,42,34,6,6,326,86
495,24,2,5,3,10,21,-45,7,1,347,41
495,25,5,2,7,6,52,24,9,5,399,65
495,26,4,3,7,6,-57,33,2,8,342,98
495,27,4,2,8,5,44,-77,6,1,386,21
495,28,4,2,9,4,-55,22,1,3,331,43
495,29,3,4,5,8,32,44,3,7,363,87
495,30,4,3,8,5,44,32,7,9,407,119
495,31,3,3,6,7,-67,-66,0,3,340,53
495,32,2,5,4,9,22,54,2,7,362,107
495,33,5,2,11,2,56,20,8,7,418,127
495,34,3,4,3,10,30,-54,8,3,448,73
495,35,5,2,7,6,-48,24,0,7,400,97
495,36,3,3,7,6,34,-67,4,0,434,30
495,37,4,2,7,6,43,24,7,4,477,54
495,38,2,5,3,10,21,55,8,9,498,109
495,39,2,5,6,7,-76,-48,2,1,422,61
495,40,4,3,9,4,45,31,7,2,467,92
495,41,3,3,7,6,-66,33,1,5,401,125
495,42,3,3,8,5,35,32,6,7,436,157
495,43,2,5,4,9,22,-46,8,1,458,111
495,44,2,5,4,9,-78,54,0,5,380,165
495,45,4,2,6,7,42,-75,2,0,422,90
495,46,4,4,4,9,40,45,2,5,462,135
495,47,3,5,7,6,34,51,6,6,496,186
495,48,4,3,5,8,41,-65,7,1,537,121
496,1,3,4,6,7,33,43,3,3,33,43
496,2,3,4,5,8,32,44,5,7,65,87
496,3,4,2,7,6,43,-76,8,1,108,11
496,4,4,2,6,7,-58,25,0,6,50,36
496,5,5,2,7,6,52,-76,2,0,102,-40
496,6,3,4,6,7,33,43,5,3,135,3
496,7,5,2,10,3,-45,21,0,4,90,24
496,8,2,5,2,11,20,-44,0,0,110,-20
496,9,3,5,6,7,33,52,3,2,143,32
496,10,2,4,4,9,22,45,5,7,165,77
496,11,4,3,6,7,42,-66,7,1,207,11
496,12,4,3,9,4,-55,31,2,2,152,42
496,13,3,4,3,10,30,46,2,8,182,88
496,14,3,3,7,6,34,-67,6,1,216,21
496,15,3,4,6,7,33,43,9,4,249,64
496,16,4,3,6,7,-58,34,1,8,191,98
496,17,3,4,6,7,33,-57,4,1,224,41
496,18,3,3,4,9,31,36,5,7,255,77
496,19,3,3,9,4,-64,31,1,8,191,108
496,20,5,2,10,3,55,21,6,9,246,129
496,21,3,3,7,6,-66,-67,0,2,180,62
496,22,4,3,5,8,41,35,1,7,221,97
496,23,3,3,7,6,34,-67,5,0,255,30
496,24,5,2,11,2,-44,20,1,0,211,50
496,25,4,3,7,6,43,33,4,3,254,83
496,26,3,3,5,8,32,35,6,8,286,118
496,27,2,4,4,9,22,-55,8,3,308,63
496,28,4,3,9,4,-55,31,3,4,253,94
496,29,5,2,7,6,52,24,5,8,305,118
496,30,6,2,10,3,64,21,9,9,369,139
496,31,2,6,2,11,20,-35,9,4,389,104
496,32,3,3,7,6,-66,33,3,7,323,137
496,33,4,3,9,4,45,31,8,8,368,168
496,34,5,2,8,5,-47,-77,1,1,321,91
496,35,2,4,4,9,22,45,3,6,343,136
496,36,3,3,8,5,35,32,8,8,378,168
496,37,2,5,3,10,21,-45,9,3,399,123
496,38,2,5,4,9,-78,54,1,7,321,177
496,39,3,4,5,8,32,-56,3,1,353,121
496,40,3,3,8,5,35,32,8,3,388,153
496,41,5,3,9,4,-46,31,2,4,342,184
496,42,5,2,9,4,54,22,6,6,396,206
496,43,4,3,5,8,41,-65,7,1,437,141
496,44,2,4,5,8,-77,44,0,5,360,185
496,45,3,3,9,4,36,31,6,6,396,216
496,46,3,3,6,7,33,-66,9,0,429,150
496,47,4,3,10,3,-54,30,5,0,375,180
496,48,5,2,10,3,-45,21,0,1,330,201
496,49,5,2,10,3,55,21,5,2,385,222
496,50,3,4,6,7,33,43,8,5,418,265
496,51,5,2,9,4,-46,22,2,7,372,287
496,52,3,3,8,5,35,32,7,9,407,319
496,53,3,4,8,5,-65,-59,2,0,342,260
496,54,4,2,8,5,44,23,6,3,386,283
496,55,5,2,8,5,53,23,9,6,439,306
496,56,4,2,8,5,-56,23,3,9,383,329
496,57,6,2,11,2,65,20,8,9,448,349
496,58,4,3,8,5,-56,-68,2,1,392,281
496,59,3,4,7,6,34,42,6,3,426,323
496,60,2,4,7,6,-75,42,1,5,351,365
496,61,5,2,10,3,55,21,6,6,406,386
496,62,3,4,4,9,31,-55,7,1,437,331
496,63,3,4,7,6,-66,42,1,3,371,373
496,64,3,3,6,7,33,34,4,7,404,407
496,65,2,5,5,8,23,-47,7,0,427,360
496,66,2,4,6,7,-76,43,1,3,351,403
496,67,2,4,5,8,23,44,4,7,374,447
496,68,4,3,9,4,45,31,9,8,419,478
496,69,4,2,10,3,-54,21,5,9,365,499
496,70,4,3,10,3,-54,30,1,9,311,529
497,1,4,3,6,7,42,34,2,4,42,34
497,2,3,4,5,8,32,44,4,8,74,78
497,3,2,4,3,10,21,-54,5,4,95,24
497,4,4,3,7,6,43,33,8,7,138,57
497,5,5,3,9,4,-46,31,2,8,92,88
497,6,3,4,4,9,31,-55,3,3,123,33
497,7,3,3,6,7,33,34,6,7,156,67
497,8,4,2,10,3,-54,21,2,8,102,88
497,9,3,3,9,4,36,31,8,9,138,119
497,10,2,6,2,11,20,-35,8,4,158,84
497,11,4,3,6,7,-58,34,0,8,100,118
497,12,2,4,2,11,20,-53,0,5,120,65
497,13,4,4,8,5,44,41,4,6,164,106
497,14,4,2,7,6,43,-76,7,0,207,30
497,15,3,3,7,6,-66,33,1,3,141,63
497,16,4,3,6,7,42,34,3,7,183,97
497,17,2,5,4,9,22,-46,5,1,205,51
497,18,3,4,6,7,33,43,8,4,238,94
497,19,4,4,7,6,-57,42,1,6,181,136
497,20,3,3,5,8,32,-65,3,1,213,71
497,21,2,5,6,7,24,52,7,3,237,123
497,22,4,2,9,4,-55,22,2,5,182,145
497,23,2,6,2,11,20,-35,2,0,202,110
497,24,4,3,6,7,42,34,4,4,244,144
497,25,3,3,4,9,31,-64,5,0,275,80
497,26,2,4,5,8,23,44,8,4,298,124
497,27,3,3,6,7,-67,34,1,8,231,158
497,28,2,4,5,8,23,-56,4,2,254,102
497,29,3,4,5,8,32,44,6,6,286,146
497,30,3,3,7,6,-66,33,0,9,220,179
497,31,2,4,8,5,26,-59,6,0,246,120
497,32,4,2,9,4,-55,22,1,2,191,142
497,33,4,3,7,6,43,33,4,5,234,175
497,34,2,5,3,10,21,-45,5,0,255,130
497,35,3,3,6,7,33,34,8,4,288,164
497,36,4,3,9,4,-55,31,3,5,233,195
497,37,4,2,9,4,45,22,8,7,278,217
497,38,4,2,7,6,-57,-76,1,1,221,141
497,39,3,3,6,7,33,34,4,5,254,175
497,40,3,3,3,10,30,-63,4,2,284,112
497,41,3,4,7,6,34,42,8,4,318,154
497,42,4,3,7,6,-57,33,1,7,261,187
497,43,4,2,8,5,44,-77,5,0,305,110
497,44,3,3,5,8,32,35,7,5,337,145
497,45,5,2,9,4,-46,22,1,7,291,167
497,46,4,2,11,2,47,20,8,7,338,187
497,47,3,4,5,8,-68,-56,0,1,270,131
497,48,3,4,6,7,33,43,3,4,303,174
497,49,2,5,5,8,23,53,6,7,326,227
497,50,4,3,10,3,-54,30,2,7,272,257
497,51,3,3,7,6,34,-67,6,0,306,190
497,52,3,4,5,8,32,44,8,4,338,234
497,53,5,2,11,2,-44,20,4,4,294,254
497,54,4,3,7,6,43,33,7,7,337,287
497,55,6,2,11,2,-35,20,2,7,302,307
497,56,3,3,5,8,32,-65,4,2,334,242
497,57,5,2,6,7,51,25,5,7,385,267
497,58,5,2,9,4,54,22,9,9,439,289
497,59,3,4,4,9,-69,-55,0,4,370,234
497,60,3,3,6,7,33,34,3,8,403,268
497,61,3,4,6,7,33,-57,6,1,436,211
497,62,3,3,4,9,31,36,7,7,467,247
497,63,4,3,10,3,-54,30,3,7,413,277
497,64,3,3,6,7,33,-66,6,1,446,211
497,65,5,2,8,5,53,23,9,4,499,234
497,66,4,2,7,6,-57,24,2,8,442,258
497,67,2,5,2,11,20,-44,2,4,462,214
497,68,3,3,7,6,34,33,6,7,496,247
497,69,3,4,5,8,32,-56,8,1,528,191
498,1,3,4,8,5,35,41,5,1,35,41
498,2,4,3,6,7,42,34,7,5,77,75
498,3,3,3,7,6,-66,33,1,8,11,108
498,4,4,3,9,4,45,31,6,9,56,139
498,5,3,3,6,7,33,-66,9,3,89,73
498,6,4,2,7,6,-57,24,2,7,32,97
498,7,3,4,4,9,31,-55,3,2,63,42
498,8,5,2,7,6,52,24,5,6,115,66
498,9,3,3,6,7,33,-66,8,0,148,0
498,10,4,2,7,6,-57,24,1,4,91,24
498,11,5,2,7,6,52,24,3,8,143,48
498,12,4,2,7,6,43,-76,6,2,186,-28
498,13,2,5,4,9,22,54,8,6,208,26
498,14,3,4,5,8,-68,-56,0,0,140,-30
498,15,3,3,6,7,33,34,3,4,173,4
498,16,3,5,4,9,31,54,4,8,204,58
498,17,4,3,7,6,43,-67,7,1,247,-9
498,18,4,3,5,8,41,35,8,6,288,26
498,19,4,2,10,3,-54,21,4,7,234,47
498,20,5,2,7,6,52,-76,6,1,286,-29
498,21,4,3,8,5,-56,32,0,3,230,3
498,22,5,2,9,4,54,22,4,5,284,25
498,23,4,3,8,5,44,32,8,7,328,57
498,24,2,4,6,7,-76,-57,2,0,252,0
498,25,5,2,10,3,55,21,7,1,307,21
498,26,4,3,8,5,-56,32,1,3,251,53
498,27,4,2,7,6,43,24,4,7,294,77
498,28,3,3,7,6,34,-67,8,0,328,10
498,29,4,4,7,6,-57,42,1,2,271,52
498,30,3,4,8,5,35,41,6,3,306,93
498,31,4,3,7,6,43,33,9,6,349,126
498,32,6,2,11,2,-35,20,4,6,314,146
498,33,6,2,9,4,63,22,7,8,377,168
498,34,5,3,6,7,51,-66,8,2,428,102
498,35,3,4,7,6,-66,42,2,4,362,144
498,36,4,3,9,4,45,31,7,5,407,175
498,37,3,3,8,5,-65,32,2,7,342,207
498,38,2,6,3,10,21,-36,3,1,363,171
498,39,3,4,7,6,34,42,7,3,397,213
498,40,3,4,7,6,-66,42,1,5,331,255
498,41,5,2,10,3,55,21,6,6,386,276
498,42,4,3,8,5,-56,32,0,8,330,308
498,43,5,2,10,3,55,21,5,9,385,329
498,44,3,4,5,8,32,-56,7,3,417,273
498,45,3,3,7,6,-66,33,1,6,351,306
498,46,3,3,8,5,35,32,6,8,386,338
498,47,4,3,8,5,-56,-68,0,0,330,270
498,48,5,3,8,5,53,32,3,2,383,302
498,49,2,5,4,9,22,54,5,6,405,356
498,50,5,2,9,4,54,22,9,8,459,378
498,51,5,3,7,6,-48,-67,1,1,411,311
498,52,3,4,8,5,35,41,6,2,446,352
498,53,2,4,4,9,22,45,8,7,468,397
498,54,5,2,8,5,-47,-77,1,0,421,320
498,55,3,4,7,6,34,42,5,2,455,362
498,56,2,5,7,6,-75,51,0,3,380,413
498,57,3,4,3,10,30,46,0,9,410,459
498,58,6,2,10,3,64,-79,4,0,474,380
498,59,2,5,6,7,24,52,8,2,498,432
498,60,6,2,8,5,-38,23,0,5,460,455
498,61,5,2,7,6,52,24,2,9,512,479
499,1,2,4,8,5,26,41,6,1,26,41
499,2,3,3,6,7,33,34,9,5,59,75
499,3,5,3,7,6,-48,33,1,8,11,108
499,4,4,4,6,7,42,-57,3,1,53,51
499,5,5,2,9,4,54,22,7,3,107,73
499,6,3,3,9,4,-64,31,3,4,43,104
499,7,4,2,9,4,45,22,8,6,88,126
499,8,3,3,7,6,-66,33,2,9,22,159
499,9,3,4,8,5,35,-59,7,0,57,100
499,10,3,4,7,6,-66,42,1,2,-9,142
499,11,3,3,5,8,32,35,3,7,23,177
499,12,3,3,6,7,33,-66,6,1,56,111
499,13,3,4,6,7,33,43,9,4,89,154
499,14,2,5,5,8,-77,53,2,7,12,207
499,15,5,2,7,6,52,-76,4,1,64,131
499,16,4,3,9,4,45,31,9,2,109,162
499,17,2,4,6,7,-76,43,3,5,33,205
499,18,3,3,10,3,-63,30,0,5,-30,235
499,19,5,2,11,2,56,20,6,5,26,255
499,20,4,2,7,6,43,24,9,9,69,279
499,21,2,4,4,9,-78,-55,1,4,-9,224
499,22,4,2,6,7,42,25,3,9,33,249
499,23,3,4,6,7,33,-57,6,2,66,192
499,24,3,3,7,6,-66,33,0,5,0,225
499,25,3,3,6,7,33,34,3,9,33,259
499,26,3,3,4,9,31,-64,4,5,64,195
499,27,2,4,5,8,23,44,7,9,87,239
499,28,3,3,7,6,-66,-67,1,2,21,172
499,29,2,5,6,7,24,52,5,4,45,224
499,30,3,4,4,9,31,45,6,9,76,269
499,31,3,4,6,7,33,-57,9,2,109,212
499,32,4,3,7,6,-57,33,2,5,52,245
499,33,4,2,11,2,47,20,9,5,99,265
499,34,2,5,5,8,-77,53,2,8,22,318
499,35,3,3,6,7,33,-66,5,2,55,252
499,36,2,5,4,9,22,54,7,6,77,306
499,37,3,4,6,7,-67,43,0,9,10,349
499,38,3,4,6,7,33,-57,3,2,43,292
499,39,3,4,6,7,33,43,6,5,76,335
499,40,4,2,7,6,43,24,9,9,119,359
499,41,3,3,4,9,-69,-64,0,5,50,295
499,42,4,3,8,5,44,32,4,7,94,327
499,43,4,3,5,8,41,-65,5,2,135,262
499,44,4,3,10,3,-54,30,1,2,81,292
499,45,3,3,7,6,34,33,5,5,115,325
499,46,4,3,7,6,43,33,8,8,158,358
499,47,2,5,5,8,-77,-47,1,1,81,311
499,48,5,2,7,6,52,24,3,5,133,335
499,49,2,4,3,10,21,-54,4,1,154,281
499,50,4,3,7,6,43,33,7,4,197,314
499,51,2,4,5,8,-77,44,0,8,120,358
499,52,4,2,6,7,42,-75,2,3,162,283
499,53,4,2,8,5,44,23,6,6,206,306
499,54,3,4,6,7,33,43,9,9,239,349
499,55,3,4,8,5,-65,-59,4,0,174,290
499,56,3,4,6,7,33,43,7,3,207,333
499,57,4,3,6,7,42,34,9,7,249,367
499,58,4,3,7,6,-57,-67,2,0,192,300
499,59,2,5,4,9,22,54,4,4,214,354
499,60,2,4,5,8,23,44,7,8,237,398
499,61,5,2,7,6,52,-76,9,2,289,322
499,62,3,3,4,9,-69,36,0,8,220,358
499,63,2,5,3,10,21,-45,1,3,241,313
499,64,2,5,4,9,22,54,3,7,263,367
499,65,4,3,8,5,44,32,7,9,307,399
499,66,4,3,6,7,42,-66,9,3,349,333
499,67,2,4,6,7,-76,43,3,6,273,376
499,68,3,3,7,6,34,33,7,9,307,409
499,69,3,3,8,5,-65,-68,2,1,242,341
499,70,3,4,9,4,36,40,8,1,278,381
499,71,5,2,8,5,-47,23,1,4,231,404
499,72,2,5,6,7,24,52,5,6,255,456
499,73,4,3,6,7,42,-66,7,0,297,390
499,74,4,2,7,6,-57,24,0,4,240,414
499,75,2,4,6,7,24,43,4,7,264,457
499,76,3,4,3,10,30,-54,4,3,294,403
499,77,4,2,10,3,-54,21,0,4,240,424
499,78,4,3,7,6,43,33,3,7,283,457
499,79,4,2,6,7,42,-75,5,2,325,382
499,80,2,4,3,10,21,46,6,8,346,428
499,81,3,3,6,7,33,-66,9,2,379,362
499,82,2,5,5,8,-77,53,2,5,302,415
499,83,2,5,6,7,24,52,6,7,326,467
499,84,4,3,9,4,-55,31,1,8,271,498
499,85,2,4,7,6,25,-58,6,0,296,440
499,86,3,3,4,9,31,36,7,6,327,476
499,87,3,4,5,8,32,-56,9,0,359,420
499,88,4,3,7,6,-57,33,2,3,302,453
499,89,5,2,9,4,54,22,6,5,356,475
499,90,3,3,8,5,-65,32,1,7,291,507
500,1,3,3,5,8,32,35,2,5,32,35
500,2,2,4,8,5,26,41,8,6,58,76
500,3,4,2,10,3,-54,21,4,7,4,97
500,4,3,3,5,8,32,-65,6,2,36,32
500,5,3,3,4,9,31,36,7,8,67,68
500,6,2,5,6,7,-76,-48,1,0,-9,20
500,7,2,5,3,10,21,55,2,5,12,75
500,8,2,4,6,7,24,43,6,8,36,118
500,9,2,4,5,8,23,-56,9,2,59,62
500,10,2,5,4,9,-78,54,1,6,-19,116
500,11,3,3,4,9,31,-64,2,2,12,52
500,12,5,2,10,3,55,21,7,3,67,73
500,13,2,4,6,7,-76,43,1,6,-9,116
500,14,5,2,7,6,52,-76,3,0,43,40
500,15,2,4,6,7,24,43,7,3,67,83
500,16,3,3,3,10,30,-63,7,0,97,20
500,17,2,5,5,8,-77,53,0,3,20,73
500,18,5,2,9,4,54,22,4,5,74,95
500,19,3,3,7,6,34,33,8,8,108,128
500,20,3,4,7,6,-66,-58,2,0,42,70
500,21,5,2,7,6,52,24,4,4,94,94
500,22,2,4,6,7,24,43,8,7,118,137
500,23,4,3,9,4,-55,31,3,8,63,168
500,24,4,3,6,7,42,-66,5,2,105,102
500,25,4,3,6,7,42,34,7,6,147,136
500,26,3,4,5,8,32,-56,9,0,179,80
500,27,2,4,4,9,-78,45,1,5,101,125
500,28,3,5,4,9,31,54,2,9,132,179
500,29,4,3,8,5,44,-68,6,1,176,111
500,30,4,3,8,5,-56,32,0,3,120,143
500,31,4,3,8,5,44,32,4,5,164,175
500,32,4,2,6,7,42,-75,6,0,206,100
500,33,4,4,8,5,-56,41,0,1,150,141
500,34,3,3,6,7,33,34,3,5,183,175
500,35,2,4,5,8,23,44,6,9,206,219
500,36,4,3,7,6,43,-67,9,2,249,152
500,37,4,3,7,6,-57,33,2,5,192,185
500,38,4,3,9,4,45,31,7,6,237,216
500,39,6,2,11,2,-35,20,2,6,202,236
500,40,3,3,5,8,32,-65,4,1,234,171
500,41,3,4,6,7,33,43,7,4,267,214
500,42,3,4,6,7,-67,43,0,7,200,257
500,43,3,4,5,8,32,-56,2,1,232,201
500,44,4,3,6,7,42,34,4,5,274,235
500,45,5,3,6,7,51,34,5,9,325,269
500,46,3,3,9,4,-64,-69,1,0,261,200
500,47,4,3,7,6,43,33,4,3,304,233
500,48,3,3,7,6,34,33,8,6,338,266
500,49,2,6,2,11,20,-35,8,1,358,231
500,50,3,3,6,7,-67,34,1,5,291,265
500,51,4,2,7,6,43,24,4,9,334,289
500,52,4,2,9,4,45,-78,9,1,379,211
500,53,2,5,4,9,-78,54,1,5,301,265
500,54,5,3,10,3,55,30,6,5,356,295
500,55,4,2,7,6,43,24,9,9,399,319
500,56,4,3,7,6,-57,-67,2,2,342,252
500,57,3,3,6,7,33,34,5,6,375,286
500,58,4,2,8,5,44,23,9,9,419,309
500,59,3,3,9,4,-64,-69,5,0,355,240
500,60,3,3,7,6,34,33,9,3,389,273
500,61,4,3,7,6,-57,33,2,6,332,306
500,62,5,2,7,6,52,-76,4,0,384,230
500,63,3,3,9,4,-64,31,0,1,320,261
500,64,3,3,7,6,34,33,4,4,354,294
500,65,4,3,6,7,42,34,6,8,396,328
500,66,2,5,3,10,21,-45,7,3,417,283
500,67,3,3,6,7,-67,34,0,7,350,317
500,68,3,4,6,7,33,-57,3,0,383,260
500,69,4,2,8,5,44,23,7,3,427,283
500,70,4,2,10,3,-54,21,3,4,373,304
500,71,3,3,6,7,33,34,6,8,406,338
500,72,4,2,9,4,-55,-78,1,0,351,260
500,73,2,4,5,8,23,44,4,4,374,304
500,74,2,6,2,11,20,65,4,9,394,369
500,75,5,2,11,2,-44,20,0,9,350,389
500,76,5,2,9,4,54,-78,4,1,404,311
500,77,2,5,4,9,22,54,6,5,426,365
500,78,4,2,9,4,-55,22,1,7,371,387
500,79,3,4,7,6,34,42,5,9,405,429
500,80,3,3,6,7,33,-66,8,3,438,363
500,81,4,3,5,8,41,35,9,8,479,398
500,82,3,3,6,7,-67,-66,2,2,412,332
500,83,5,2,9,4,54,22,6,4,466,354
500,84,3,3,7,6,-66,33,0,7,400,387
500,85,4,3,8,5,44,32,4,9,444,419
500,86,3,3,5,8,32,-65,6,4,476,354
500,87,2,5,5,8,23,53,9,7,499,407
500,88,3,4,5,8,-68,-56,1,1,431,351
500,89,3,4,5,8,32,44,3,5,463,395
500,90,4,3,6,7,42,34,5,9,505,429
501,1,4,2,9,4,45,22,5,2,45,22
501,2,4,3,7,6,43,33,8,5,88,55
501,3,3,4,5,8,-68,44,0,9,20,99
501,4,2,4,5,8,23,-56,3,3,43,43
501,5,3,5,6,7,33,52,6,5,76,95
501,6,4,2,6,7,42,-75,8,0,118,20
501,7,2,4,6,7,-76,43,2,3,42,63
501,8,4,3,5,8,41,35,3,8,83,98
501,9,5,2,9,4,54,-78,7,0,137,20
501,10,2,5,3,10,21,55,8,5,158,75
501,11,3,4,7,6,-66,42,2,7,92,117
501,12,3,4,6,7,33,-57,5,0,125,60
501,13,3,3,6,7,33,34,8,4,158,94
501,14,2,4,6,7,-76,43,2,7,82,137
501,15,3,3,8,5,35,32,7,9,117,169
501,16,5,3,9,4,-46,-69,1,0,71,100
501,17,5,2,11,2,56,20,7,0,127,120
501,18,3,3,9,4,-64,31,3,1,63,151
501,19,3,3,8,5,35,32,8,3,98,183
501,20,4,3,8,5,-56,32,2,5,42,215
501,21,2,5,4,9,22,54,4,9,64,269
501,22,3,3,6,7,33,-66,7,3,97,203
501,23,2,5,2,11,20,56,7,9,117,259
501,24,4,3,5,8,41,-65,8,4,158,194
501,25,5,2,9,4,-46,22,2,6,112,216
501,26,2,4,5,8,23,-56,5,0,135,160
501,27,4,3,9,4,-55,31,0,1,80,191
501,28,2,4,5,8,23,44,3,5,103,235
501,29,2,5,5,8,23,53,6,8,126,288
501,30,3,3,8,5,-65,-68,1,0,61,220
501,31,3,5,7,6,34,51,5,1,95,271
501,32,5,2,9,4,54,22,9,3,149,293
501,33,3,4,5,8,-68,44,1,7,81,337
501,34,4,3,5,8,41,-65,2,2,122,272
501,35,4,4,5,8,41,44,3,6,163,316
501,36,4,2,6,7,42,-75,5,1,205,241
501,37,3,3,5,8,32,35,7,6,237,276
501,38,2,5,3,10,21,-45,8,1,258,231
501,39,2,4,6,7,-76,43,2,4,182,274
501,40,3,3,7,6,34,33,6,7,216,307
501,41,4,2,7,6,43,-76,9,1,259,231
501,42,4,2,7,6,-57,24,2,5,202,255
501,43,3,4,6,7,33,43,5,8,235,298
501,44,2,5,4,9,22,-46,7,2,257,252
501,45,4,3,7,6,-57,33,0,5,200,285
501,46,2,5,7,6,25,51,5,6,225,336
501,47,2,4,3,10,21,-54,6,2,246,282
501,48,2,4,5,8,23,44,9,6,269,326
501,49,5,2,10,3,-45,21,4,7,224,347
501,50,2,5,5,8,23,-47,7,0,247,300
501,51,4,3,9,4,-55,31,2,1,192,331
501,52,2,4,5,8,23,44,5,5,215,375
501,53,2,5,5,8,23,53,8,8,238,428
501,54,2,5,4,9,-78,-46,0,2,160,382
501,55,4,3,5,8,41,35,1,7,201,417
501,56,4,3,7,6,43,-67,4,0,244,350
501,57,3,3,8,5,35,32,9,2,279,382
501,58,3,4,4,9,-69,45,0,7,210,427
501,59,2,5,4,9,22,-46,2,1,232,381
501,60,6,2,10,3,64,21,6,2,296,402
501,61,4,3,8,5,-56,32,0,4,240,434
501,62,4,2,5,8,41,-74,1,0,281,360
501,63,2,5,6,7,24,52,5,2,305,412
501,64,3,4,7,6,34,42,9,4,339,454
501,65,4,3,8,5,-56,32,3,6,283,486
501,66,2,4,5,8,23,-56,6,0,306,430
501,67,5,2,8,5,53,23,9,3,359,453
501,68,4,3,8,5,-56,32,3,5,303,485
501,69,2,4,4,9,22,-55,5,0,325,430
501,70,4,3,8,5,44,32,9,2,369,462
501,71,2,6,3,10,-79,64,0,6,290,526
502,1,2,4,4,9,22,45,2,5,22,45
502,2,4,3,5,8,41,-65,3,0,63,-20
502,3,4,2,6,7,42,25,5,5,105,5
502,4,2,4,4,9,22,-55,7,0,127,-50
502,5,4,3,5,8,41,35,8,5,168,-15
502,6,2,5,6,7,-76,52,2,7,92,37
502,7,3,3,5,8,32,-65,4,2,124,-28
502,8,2,5,3,10,21,55,5,7,145,27
502,9,5,2,7,6,52,-76,7,1,197,-49
502,10,4,2,7,6,-57,24,0,5,140,-25
502,11,2,4,6,7,24,43,4,8,164,18
502,12,2,4,4,9,22,-55,6,3,186,-37
502,13,4,2,8,5,-56,23,0,6,130,-14
502,14,4,3,8,5,44,32,4,8,174,18
502,15,4,3,6,7,42,-66,6,2,216,-48
502,16,4,3,7,6,43,33,9,5,259,-15
502,17,4,3,5,8,-59,-65,0,0,200,-80
502,18,2,4,7,6,25,42,5,2,225,-38
502,19,3,3,7,6,34,33,9,5,259,-5
502,20,4,2,9,4,-55,22,4,7,204,17
502,21,5,2,7,6,52,-76,6,1,256,-59
502,22,2,5,7,6,-75,51,1,2,181,-8
502,23,3,3,6,7,33,34,4,6,214,26
502,24,4,2,6,7,42,-75,6,1,256,-49
502,25,2,4,2,11,20,47,6,8,276,-2
502,26,4,2,5,8,41,-74,7,4,317,-76
502,27,2,4,4,9,22,45,9,9,339,-31
502,28,3,3,7,6,-66,-67,3,2,273,-98
502,29,4,4,5,8,41,44,4,6,314,-54
502,30,3,4,6,7,33,43,7,9,347,-11
502,31,2,4,4,9,22,-55,9,4,369,-66
502,32,4,3,7,6,-57,33,2,7,312,-33
502,33,3,3,6,7,33,-66,5,1,345,-99
502,34,3,4,7,6,34,42,9,3,379,-57
502,35,4,3,7,6,-57,33,2,6,322,-24
502,36,3,3,5,8,32,-65,4,1,354,-89
502,37,4,3,7,6,43,33,7,4,397,-56
502,38,4,2,8,5,-56,23,1,7,341,-33
502,39,3,4,5,8,32,-56,3,1,373,-89
502,40,2,4,3,10,21,46,4,7,394,-43
502,41,4,3,9,4,45,31,9,8,439,-12
502,42,4,3,4,9,40,-64,9,4,479,-76
502,43,3,3,6,7,-67,34,2,8,412,-42
502,44,2,5,4,9,22,-46,4,2,434,-88
502,45,3,3,6,7,33,34,7,6,467,-54
502,46,3,3,5,8,32,-65,9,1,499,-119
502,47,2,6,5,8,-77,62,2,3,422,-57
502,48,4,3,10,3,46,30,8,3,468,-27
502,49,2,4,6,7,-76,43,2,6,392,16
502,50,3,4,7,6,34,42,6,8,426,58
502,51,4,2,11,2,-53,20,3,8,373,78
502,52,3,4,5,8,32,-56,5,2,405,22
502,53,3,3,6,7,33,34,8,6,438,56
502,54,3,4,5,8,-68,-56,0,0,370,0
502,55,2,4,5,8,23,44,3,4,393,44
502,56,3,3,8,5,35,32,8,6,428,76
502,57,3,3,4,9,31,-64,9,2,459,12
502,58,3,3,8,5,-65,32,4,4,394,44
502,59,4,2,6,7,42,25,6,9,436,69
502,60,2,4,5,8,23,-56,9,3,459,13
502,61,3,3,8,5,-65,32,4,5,394,45
502,62,4,3,9,4,45,31,9,6,439,76
502,63,3,4,6,7,-67,43,2,9,372,119
502,64,5,2,10,3,55,-79,7,0,427,40
502,65,3,4,6,7,-67,43,0,3,360,83
502,66,5,2,8,5,53,23,3,6,413,106
502,67,4,3,8,5,44,32,7,8,457,138
502,68,3,3,5,8,32,-65,9,3,489,73
502,69,4,2,6,7,-58,25,1,8,431,98
502,70,4,3,5,8,41,-65,2,3,472,33
502,71,2,4,3,10,21,46,3,9,493,79
502,72,3,3,6,7,33,-66,6,3,526,13
503,1,4,2,8,5,44,23,4,3,44,23
503,2,4,3,7,6,43,33,7,6,87,56
503,3,2,4,5,8,-77,-56,0,0,10,0
503,4,4,3,6,7,42,34,2,4,52,34
503,5,2,4,4,9,22,45,4,9,74,79
503,6,3,4,9,4,-64,40,0,9,10,119
503,7,4,2,8,5,44,-77,4,2,54,42
503,8,2,4,4,9,22,45,6,7,76,87
503,9,4,3,10,3,-54,30,2,7,22,117
503,10,3,4,6,7,33,-57,5,0,55,60
503,11,2,5,2,11,20,56,5,6,75,116
503,12,3,5,7,6,34,51,9,7,109,167
503,13,5,2,7,6,-48,-76,1,1,61,91
503,14,4,3,7,6,43,33,4,4,104,124
503,15,6,2,10,3,64,21,8,5,168,145
503,16,3,3,6,7,-67,34,1,9,101,179
503,17,3,3,7,6,34,-67,5,2,135,112
503,18,4,2,9,4,-55,22,0,4,80,134
503,19,3,4,4,9,31,45,1,9,111,179
503,20,5,2,10,3,55,-79,6,0,166,100
503,21,4,2,8,5,-56,23,0,3,110,123
503,22,5,2,7,6,52,24,2,7,162,147
503,23,5,2,8,5,53,-77,5,0,215,70
503,24,4,2,10,3,-54,21,1,1,161,91
503,25,5,2,9,4,54,22,5,3,215,113
503,26,3,4,4,9,31,45,6,8,246,158
503,27,4,2,5,8,41,-74,7,4,287,84
503,28,4,3,9,4,-55,31,2,5,232,115
503,29,4,3,8,5,44,32,6,7,276,147
503,30,3,3,6,7,33,-66,9,1,309,81
503,31,5,3,7,6,-48,33,1,4,261,114
503,32,2,5,4,9,22,54,3,8,283,168
503,33,2,5,5,8,23,-47,6,1,306,121
503,34,3,4,5,8,32,44,8,5,338,165
503,35,3,4,5,8,-68,44,0,9,270,209
503,36,4,2,10,3,46,-79,6,0,316,130
503,37,4,3,8,5,-56,32,0,2,260,162
503,38,4,2,8,5,44,23,4,5,304,185
503,39,4,3,8,5,44,32,8,7,348,217
503,40,3,5,4,9,31,-46,9,1,379,171
503,41,2,5,5,8,-77,53,2,4,302,224
503,42,3,3,6,7,33,34,5,8,335,258
503,43,4,2,7,6,43,-76,8,2,378,182
503,44,3,3,8,5,-65,32,3,4,313,214
503,45,6,2,10,3,64,21,7,5,377,235
503,46,3,3,6,7,-67,34,0,9,310,269
503,47,3,4,7,6,34,-58,4,1,344,211
503,48,5,2,7,6,52,24,6,5,396,235
503,49,2,5,4,9,22,54,8,9,418,289
503,50,4,3,8,5,-56,-68,2,1,362,221
503,51,3,3,7,6,34,33,6,4,396,254
503,52,4,2,6,7,42,25,8,9,438,279
503,53,4,3,4,9,40,-64,8,5,478,215
503,54,4,3,7,6,-57,33,1,8,421,248
503,55,3,3,7,6,34,-67,5,1,455,181
503,56,2,5,4,9,22,54,7,5,477,235
503,57,4,3,9,4,-55,31,2,6,422,266
503,58,3,3,7,6,34,33,6,9,456,299
503,59,2,4,6,7,-76,-57,0,2,380,242
503,60,2,4,4,9,22,45,2,7,402,287
503,61,3,3,8,5,35,32,7,9,437,319
503,62,3,4,4,9,31,-55,8,4,468,264
503,63,4,2,8,5,-56,23,2,7,412,287
503,64,5,2,8,5,53,-77,5,0,465,210
503,65,3,4,6,7,33,43,8,3,498,253
503,66,4,3,5,8,41,35,9,8,539,288
504,1,2,4,5,8,23,44,3,4,23,44
504,2,4,3,8,5,44,32,7,6,67,76
504,3,3,3,7,6,-66,33,1,9,1,109
504,4,2,5,5,8,23,-47,4,2,24,62
504,5,4,2,6,7,42,25,6,7,66,87
504,6,4,2,6,7,42,-75,8,2,108,12
504,7,3,4,5,8,-68,44,0,6,40,56
504,8,2,4,4,9,22,-55,2,1,62,1
504,9,3,4,7,6,34,42,6,3,96,43
504,10,4,2,10,3,-54,21,2,4,42,64
504,11,3,3,6,7,33,34,5,8,75,98
504,12,4,3,6,7,42,-66,7,2,117,32
504,13,2,4,2,11,20,47,7,9,137,79
504,14,3,3,7,6,-66,-67,1,2,71,12
504,15,4,2,10,3,46,21,7,3,117,33
504,16,3,3,4,9,31,36,8,9,148,69
504,17,5,2,9,4,-46,-78,2,1,102,-9
504,18,3,4,7,6,34,42,6,3,136,33
504,19,2,5,3,10,21,55,7,8,157,88
504,20,4,3,6,7,42,-66,9,2,199,22
504,21,2,4,4,9,-78,45,1,7,121,67
504,22,4,2,9,4,45,22,6,9,166,89
504,23,3,3,8,5,-65,-68,1,1,101,21
504,24,3,4,6,7,33,43,4,4,134,64
504,25,4,2,8,5,44,23,8,7,178,87
504,26,5,2,10,3,-45,21,3,8,133,108
504,27,3,3,10,3,-63,30,0,8,70,138
504,28,5,2,11,2,56,20,6,8,126,158
504,29,2,4,7,6,-75,-58,1,0,51,100
504,30,3,3,4,9,31,36,2,6,82,136
504,31,4,3,8,5,44,32,6,8,126,168
504,32,4,3,8,5,-56,-68,0,0,70,100
504,33,2,4,6,7,24,43,4,3,94,143
504,34,5,2,10,3,55,21,9,4,149,164
504,35,4,3,9,4,-55,31,4,5,94,195
504,36,4,3,7,6,43,33,7,8,137,228
504,37,4,2,8,5,-56,-77,1,1,81,151
504,38,5,2,11,2,56,20,7,1,137,171
504,39,2,5,3,10,21,55,8,6,158,226
504,40,3,4,5,8,-68,-56,0,0,90,170
504,41,5,2,9,4,54,22,4,2,144,192
504,42,2,4,4,9,22,45,6,7,166,237
504,43,3,3,7,6,-66,-67,0,0,100,170
504,44,3,4,7,6,34,42,4,2,134,212
504,45,4,2,4,9,40,27,4,9,174,239
504,46,3,3,4,9,31,-64,5,5,205,175
504,47,2,4,6,7,24,43,9,8,229,218
504,48,4,3,7,6,-57,-67,2,1,172,151
504,49,3,3,7,6,34,33,6,4,206,184
504,50,3,4,8,5,-65,41,1,5,141,225
504,51,3,3,4,9,31,-64,2,1,172,161
504,52,3,3,4,9,31,36,3,7,203,197
504,53,3,3,7,6,34,-67,7,0,237,130
504,54,3,4,5,8,32,44,9,4,269,174
504,55,3,3,6,7,-67,34,2,8,202,208
504,56,3,4,4,9,31,-55,3,3,233,153
504,57,2,5,6,7,24,52,7,5,257,205
504,58,2,4,4,9,22,-55,9,0,279,150
504,59,2,5,3,10,-79,55,0,5,200,205
504,60,4,4,5,8,41,44,1,9,241,249
504,61,5,2,6,7,51,-75,2,4,292,174
504,62,2,6,2,11,20,65,2,9,312,239
504,63,2,5,3,10,21,-45,3,4,333,194
504,64,4,2,5,8,41,-74,4,0,374,120
504,65,2,4,4,9,22,45,6,5,396,165
504,66,3,3,3,10,30,-63,6,2,426,102
504,67,4,3,6,7,42,34,8,6,468,136
504,68,2,4,4,9,-78,-55,0,1,390,81
504,69,3,3,9,4,36,31,6,2,426,112
504,70,3,4,8,5,-65,41,1,3,361,153
504,71,3,4,7,6,34,42,5,5,395,195
504,72,3,3,7,6,34,33,9,8,429,228
504,73,3,3,9,4,-64,31,5,9,365,259
504,74,4,3,7,6,43,-67,8,2,408,192
504,75,4,3,8,5,-56,32,2,4,352,224
504,76,3,3,6,7,33,34,5,8,385,258
504,77,4,3,4,9,40,-64,5,4,425,194
504,78,5,2,10,3,-45,21,0,5,380,215
504,79,2,5,7,6,25,51,5,6,405,266
504,80,4,3,8,5,44,32,9,8,449,298
504,81,3,3,7,6,-66,-67,3,1,383,231
504,82,3,4,7,6,34,42,7,3,417,273
504,83,2,4,5,8,-77,44,0,7,340,317
504,84,4,2,7,6,43,-76,3,1,383,241
504,85,3,3,8,5,35,32,8,3,418,273
504,86,3,4,6,7,-67,43,1,6,351,316
504,87,5,2,9,4,54,22,5,8,405,338
504,88,3,4,8,5,-65,41,0,9,340,379
504,89,3,4,4,9,31,-55,1,4,371,324
504,90,4,2,6,7,42,25,3,9,413,349
504,91,3,5,6,7,33,-48,6,1,446,301
504,92,4,3,8,5,-56,32,0,3,390,333
504,93,5,2,7,6,52,24,2,7,442,357
504,94,2,4,4,9,22,-55,4,2,464,302
504,95,3,3,7,6,34,33,8,5,498,335
504,96,3,4,6,7,-67,43,1,8,431,378
504,97,4,3,8,5,44,-68,5,0,475,310
504,98,4,2,9,4,-55,22,0,2,420,332
504,99,3,4,6,7,33,43,3,5,453,375
504,100,4,4,7,6,43,42,6,7,496,417
504,101,5,2,8,5,53,-77,9,0,549,340
505,1,3,4,6,7,33,43,3,3,33,43
505,2,2,4,7,6,25,42,8,5,58,85
505,3,5,3,8,5,-47,32,1,7,11,117
505,4,6,2,8,5,62,-77,3,0,73,40
505,5,4,3,7,6,43,33,6,3,116,73
505,6,3,4,4,9,31,45,7,8,147,118
505,7,3,3,8,5,-65,-68,2,0,82,50
505,8,3,3,8,5,35,32,7,2,117,82
505,9,2,4,3,10,21,46,8,8,138,128
505,10,2,5,4,9,-78,-46,0,2,60,82
505,11,5,2,8,5,53,23,3,5,113,105
505,12,3,4,5,8,32,44,5,9,145,149
505,13,3,3,7,6,34,-67,9,2,179,82
505,14,3,4,7,6,-66,42,3,4,113,124
505,15,3,3,7,6,34,33,7,7,147,157
505,16,4,3,6,7,42,-66,9,1,189,91
505,17,3,3,3,10,30,37,9,8,219,128
505,18,3,3,5,8,-68,-65,1,3,151,63
505,19,3,3,9,4,36,31,7,4,187,94
505,20,4,4,7,6,-57,42,0,6,130,136
505,21,3,3,5,8,32,-65,2,1,162,71
505,22,5,2,8,5,53,23,5,4,215,94
505,23,3,3,8,5,-65,32,0,6,150,126
505,24,2,4,7,6,25,42,5,8,175,168
505,25,3,3,8,5,-65,-68,0,0,110,100
505,26,3,3,4,9,31,36,1,6,141,136
505,27,2,5,2,11,20,-44,1,2,161,92
505,28,3,4,7,6,34,42,5,4,195,134
505,29,2,5,4,9,22,54,7,8,217,188
505,30,2,5,2,11,20,-44,7,4,237,144
505,31,2,4,6,7,-76,43,1,7,161,187
505,32,2,4,4,9,22,-55,3,2,183,132
505,33,2,4,2,11,20,47,3,9,203,179
505,34,3,4,5,8,32,-56,5,3,235,123
505,35,4,4,6,7,42,43,7,6,277,166
505,36,5,3,6,7,51,-66,8,0,328,100
505,37,3,3,7,6,-66,33,2,3,262,133
505,38,3,3,6,7,33,34,5,7,295,167
505,39,2,4,5,8,23,-56,8,1,318,111
505,40,2,4,4,9,-78,45,0,6,240,156
505,41,3,3,6,7,33,-66,3,0,273,90
505,42,4,2,9,4,45,22,8,2,318,112
505,43,4,2,11,2,-53,20,5,2,265,132
505,44,3,3,6,7,33,34,8,6,298,166
505,45,3,3,8,5,-65,32,3,8,233,198
505,46,4,3,8,5,44,-68,7,0,277,130
505,47,6,2,11,2,-35,20,2,0,242,150
505,48,3,4,5,8,32,44,4,4,274,194
505,49,3,4,7,6,34,42,8,6,308,236
505,50,2,5,6,7,-76,52,2,8,232,288
505,51,2,4,6,7,24,-57,6,1,256,231
505,52,2,6,3,10,21,64,7,5,277,295
505,53,2,4,5,8,-77,44,0,9,200,339
505,54,4,2,8,5,44,-77,4,2,244,262
505,55,4,2,7,6,43,24,7,6,287,286
505,56,3,4,8,5,-65,41,2,7,222,327
505,57,4,3,6,7,42,-66,4,1,264,261
505,58,4,2,10,3,-54,21,0,2,210,282
505,59,3,4,4,9,31,45,1,7,241,327
505,60,3,3,8,5,35,32,6,9,276,359
505,61,4,2,9,4,-55,-78,1,1,221,281
505,62,3,3,8,5,35,32,6,3,256,313
505,63,3,3,8,5,-65,32,1,5,191,345
505,64,5,3,8,5,53,32,4,7,244,377
505,65,3,3,7,6,34,-67,8,0,278,310
505,66,4,2,6,7,-58,25,0,5,220,335
505,67,3,3,7,6,34,33,4,8,254,368
505,68,4,3,5,8,41,-65,5,3,295,303
505,69,2,4,7,6,-75,42,0,5,220,345
505,70,3,3,7,6,34,33,4,8,254,378
505,71,3,3,4,9,31,-64,5,4,285,314
505,72,4,4,8,5,44,41,9,5,329,355
505,73,4,3,8,5,-56,32,3,7,273,387
505,74,4,3,10,3,46,30,9,7,319,417
505,75,4,2,9,4,-55,22,4,9,264,439
505,76,3,4,7,6,34,-58,8,1,298,381
505,77,4,3,8,5,-56,32,2,3,242,413
505,78,3,3,7,6,34,33,6,6,276,446
505,79,5,2,9,4,-46,22,0,8,230,468
505,80,3,3,6,7,33,-66,3,2,263,402
505,81,4,2,7,6,43,24,6,6,306,426
505,82,4,2,8,5,-56,23,0,9,250,449
505,83,3,4,4,9,31,-55,1,4,281,394
505,84,2,5,3,10,21,55,2,9,302,449
505,85,3,3,7,6,34,-67,6,2,336,382
505,86,2,5,4,9,22,54,8,6,358,436
505,87,4,2,7,6,-57,-76,1,0,301,360
505,88,4,4,5,8,41,44,2,4,342,404
505,89,4,2,7,6,43,24,5,8,385,428
505,90,4,3,7,6,43,-67,8,1,428,361
505,91,5,2,7,6,-48,24,0,5,380,385
505,92,5,2,10,3,55,21,5,6,435,406
505,93,4,2,7,6,43,-76,8,0,478,330
505,94,3,3,6,7,-67,34,1,4,411,364
505,95,3,5,4,9,31,54,2,8,442,418
505,96,4,3,9,4,45,31,7,9,487,449
505,97,4,2,7,6,-57,-76,0,3,430,373
505,98,2,5,6,7,24,52,4,5,454,425
505,99,3,4,5,8,32,44,6,9,486,469
505,100,5,2,10,3,-45,-79,1,0,441,390
505,101,3,4,7,6,34,42,5,2,475,432
505,102,3,4,6,7,33,43,8,5,508,475
506,1,3,3,7,6,34,33,4,3,34,33
506,2,2,4,6,7,24,43,8,6,58,76
506,3,3,3,7,6,-66,33,2,9,-8,109
506,4,2,4,5,8,23,-56,5,3,15,53
506,5,3,4,7,6,34,42,9,5,49,95
506,6,2,4,4,9,-78,-55,1,0,-29,40
506,7,4,3,6,7,42,34,3,4,13,74
506,8,3,3,7,6,34,33,7,7,47,107
506,9,3,3,6,7,-67,-66,0,1,-20,41
506,10,5,2,8,5,53,23,3,4,33,64
506,11,3,3,4,9,31,-64,4,0,64,0
506,12,2,5,4,9,22,54,6,4,86,54
506,13,2,4,4,9,22,45,8,9,108,99
506,14,3,4,7,6,-66,-58,2,1,42,41
506,15,3,3,7,6,34,33,6,4,76,74
506,16,2,4,5,8,23,44,9,8,99,118
506,17,4,2,8,5,-56,-77,3,1,43,41
506,18,3,3,7,6,34,33,7,4,77,74
506,19,3,3,7,6,-66,33,1,7,11,107
506,20,4,3,7,6,43,-67,4,0,54,40
506,21,3,3,6,7,33,34,7,4,87,74
506,22,3,4,4,9,31,45,8,9,118,119
506,23,4,3,10,3,-54,30,4,9,64,149
506,24,2,4,5,8,23,-56,7,3,87,93
506,25,3,4,4,9,31,45,8,8,118,138
506,26,3,4,4,9,31,-55,9,3,149,83
506,27,3,3,8,5,-65,32,4,5,84,115
506,28,5,2,9,4,54,22,8,7,138,137
506,29,3,4,5,8,-68,-56,0,1,70,81
506,30,3,3,7,6,34,33,4,4,104,114
506,31,5,2,8,5,53,23,7,7,157,137
506,32,3,4,7,6,-66,42,1,9,91,179
506,33,5,2,5,8,50,-74,1,5,141,105
506,34,3,3,6,7,33,34,4,9,174,139
506,35,3,3,3,10,30,-63,4,6,204,76
506,36,3,3,8,5,35,32,9,8,239,108
506,37,3,3,8,5,-65,-68,4,0,174,40
506,38,3,3,10,3,-63,30,1,0,111,70
506,39,3,3,6,7,33,34,4,4,144,104
506,40,2,4,4,9,22,45,6,9,166,149
506,41,2,6,2,11,20,-35,6,4,186,114
506,42,4,3,8,5,-56,32,0,6,130,146
506,43,3,3,8,5,35,32,5,8,165,178
506,44,2,4,6,7,24,-57,9,1,189,121
506,45,2,4,4,9,-78,45,1,6,111,166
506,46,3,3,5,8,32,-65,3,1,143,101
506,47,4,2,6,7,42,25,5,6,185,126
506,48,4,3,7,6,43,33,8,9,228,159
506,49,2,4,4,9,-78,-55,0,4,150,104
506,50,3,3,7,6,34,33,4,7,184,137
506,51,4,2,7,6,43,-76,7,1,227,61
506,52,3,4,5,8,32,44,9,5,259,105
506,53,4,2,11,2,-53,20,6,5,206,125
506,54,2,5,4,9,22,54,8,9,228,179
506,55,3,3,7,6,-66,-67,2,2,162,112
506,56,5,2,10,3,55,21,7,3,217,133
506,57,3,3,8,5,-65,32,2,5,152,165
506,58,3,4,5,8,32,44,4,9,184,209
506,59,3,3,6,7,33,-66,7,3,217,143
506,60,3,3,5,8,32,35,9,8,249,178
506,61,4,3,8,5,-56,-68,3,0,193,110
506,62,3,3,8,5,35,32,8,2,228,142
506,63,3,3,8,5,-65,32,3,4,163,174
506,64,3,4,5,8,32,44,5,8,195,218
506,65,5,2,10,3,-45,21,0,9,150,239
506,66,4,3,9,4,45,-69,5,0,195,170
506,67,4,3,7,6,43,33,8,3,238,203
506,68,4,2,6,7,-58,25,0,8,180,228
506,69,2,4,8,5,26,41,6,9,206,269
506,70,4,2,10,3,-54,-79,2,0,152,190
506,71,2,4,6,7,24,43,6,3,176,233
506,72,3,4,6,7,33,43,9,6,209,276
506,73,5,2,10,3,-45,21,4,7,164,297
506,74,3,4,7,6,34,42,8,9,198,339
506,75,4,3,8,5,-56,-68,2,1,142,271
506,76,4,3,5,8,41,35,3,6,183,306
506,77,2,4,5,8,23,-56,6,0,206,250
506,78,2,4,4,9,22,45,8,5,228,295
506,79,3,3,10,3,-63,30,5,5,165,325
506,80,3,4,4,9,31,-55,6,0,196,270
506,81,4,3,7,6,43,33,9,3,239,303
506,82,3,3,5,8,-68,35,1,8,171,338
506,83,3,3,8,5,35,-68,6,0,206,270
506,84,4,3,10,3,-54,30,2,0,152,300
506,85,3,4,5,8,32,44,4,4,184,344
506,86,3,4,3,10,30,-54,4,0,214,290
506,87,4,2,10,3,-54,21,0,1,160,311
506,88,2,4,5,8,23,44,3,5,183,355
506,89,5,2,10,3,55,21,8,6,238,376
506,90,4,3,5,8,41,-65,9,1,279,311
506,91,4,4,6,7,-58,43,1,4,221,354
506,92,2,5,4,9,22,54,3,8,243,408
506,93,4,3,7,6,43,-67,6,1,286,341
506,94,3,3,7,6,-66,33,0,4,220,374
506,95,4,2,8,5,44,23,4,7,264,397
506,96,5,2,8,5,53,-77,7,0,317,320
506,97,4,2,6,7,42,25,9,5,359,345
506,98,5,2,8,5,-47,23,2,8,312,368
506,99,4,3,7,6,43,-67,5,1,355,301
506,100,3,4,8,5,-65,41,0,2,290,342
506,101,4,4,5,8,41,44,1,6,331,386
506,102,2,6,4,9,22,63,3,9,353,449
506,103,3,3,8,5,35,-68,8,1,388,381
506,104,4,2,11,2,-53,20,5,1,335,401
506,105,2,5,3,10,21,55,6,6,356,456
506,106,3,3,5,8,32,-65,8,1,388,391
506,107,3,3,8,5,-65,32,3,3,323,423
506,108,3,3,8,5,35,32,8,5,358,455
506,109,2,4,4,9,-78,-55,0,0,280,400
506,110,4,2,9,4,45,22,5,2,325,422
506,111,3,3,5,8,32,35,7,7,357,457
506,112,6,2,8,5,62,-77,9,0,419,380
506,113,3,3,7,6,-66,33,3,3,353,413
506,114,2,4,4,9,22,45,5,8,375,458
506,115,3,4,4,9,31,-55,6,3,406,403
506,116,3,3,5,8,32,35,8,8,438,438
506,117,3,3,3,10,30,-63,8,5,468,375
506,118,3,4,4,9,31,-55,9,0,499,320
506,119,2,4,4,9,-78,45,1,5,421,365
506,120,3,3,5,8,32,-65,3,0,453,300
506,121,4,2,8,5,44,23,7,3,497,323
506,122,2,4,2,11,20,-53,7,0,517,270
507,1,2,4,8,5,26,41,6,1,26,41
507,2,4,3,8,5,-56,32,0,3,-30,73
507,3,4,3,8,5,44,32,4,5,14,105
507,4,4,3,6,7,42,34,6,9,56,139
507,5,3,4,5,8,32,-56,8,3,88,83
507,6,4,2,10,3,-54,21,4,4,34,104
507,7,3,3,7,6,34,33,8,7,68,137
507,8,2,4,6,7,-76,-57,2,0,-8,80
507,9,3,4,6,7,33,43,5,3,25,123
507,10,4,4,5,8,41,44,6,7,66,167
507,11,2,6,3,10,21,-36,7,1,87,131
507,12,5,2,8,5,-47,23,0,4,40,154
507,13,3,3,6,7,33,34,3,8,73,188
507,14,2,4,6,7,24,-57,7,1,97,131
507,15,2,4,5,8,-77,44,0,5,20,175
507,16,3,5,6,7,33,52,3,7,53,227
507,17,4,3,7,6,43,-67,6,0,96,160
507,18,3,5,5,8,32,53,8,3,128,213
507,19,3,3,9,4,-64,31,4,4,64,244
507,20,3,3,4,9,31,-64,5,0,95,180
507,21,3,3,6,7,33,34,8,4,128,214
507,22,3,3,4,9,31,-64,9,0,159,150
507,23,4,3,6,7,-58,34,1,4,101,184
507,24,4,2,8,5,44,23,5,7,145,207
507,25,3,4,3,10,30,-54,5,3,175,153
507,26,3,4,4,9,31,45,6,8,206,198
507,27,2,4,4,9,22,-55,8,3,228,143
507,28,3,3,3,10,30,-63,8,0,258,80
507,29,3,4,4,9,31,45,9,5,289,125
507,30,3,4,5,8,-68,44,1,9,221,169
507,31,2,5,3,10,21,-45,2,4,242,124
507,32,3,4,5,8,32,44,4,8,274,168
507,33,3,3,5,8,32,-65,6,3,306,103
507,34,4,2,7,6,43,24,9,7,349,127
507,35,4,3,9,4,-55,31,4,8,294,158
507,36,3,4,8,5,35,41,9,9,329,199
507,37,3,4,6,7,-67,-57,2,2,262,142
507,38,2,5,2,11,20,56,2,8,282,198
507,39,2,5,5,8,23,-47,5,1,305,151
507,40,3,3,4,9,31,36,6,7,336,187
507,41,3,4,4,9,31,-55,7,2,367,132
507,42,4,3,8,5,-56,32,1,4,311,164
507,43,3,4,3,10,30,-54,1,0,341,110
507,44,3,3,8,5,35,32,6,2,376,142
507,45,2,4,2,11,20,47,6,9,396,189
507,46,3,3,7,6,-66,-67,0,2,330,122
507,47,4,3,7,6,43,33,3,5,373,155
507,48,3,4,7,6,34,42,7,7,407,197
507,49,2,5,3,10,21,-45,8,2,428,152
507,50,3,3,6,7,-67,34,1,6,361,186
507,51,3,4,5,8,32,-56,3,0,393,130
507,52,4,2,7,6,43,24,6,4,436,154
507,53,5,2,7,6,52,24,8,8,488,178
507,54,4,3,7,6,-57,-67,1,1,431,111
507,55,3,4,5,8,32,44,3,5,463,155
507,56,3,4,6,7,33,43,6,8,496,198
507,57,5,3,8,5,53,-68,9,0,549,130
508,1,5,2,9,4,54,22,4,2,54,22
508,2,3,3,9,4,-64,31,0,3,-10,53
508,3,3,5,4,9,31,54,1,7,21,107
508,4,3,4,7,6,34,42,5,9,55,149
508,5,5,2,10,3,-45,-79,0,0,10,70
508,6,4,3,7,6,43,33,3,3,53,103
508,7,3,4,8,5,35,41,8,4,88,144
508,8,5,3,9,4,-46,31,2,5,42,175
508,9,3,5,5,8,32,53,4,8,74,228
508,10,5,2,9,4,54,-78,8,0,128,150
508,11,4,3,9,4,-55,31,3,1,73,181
508,12,4,2,6,7,42,25,5,6,115,206
508,13,4,2,8,5,44,23,9,9,159,229
508,14,3,3,5,8,-68,-65,1,4,91,164
508,15,4,3,8,5,44,32,5,6,135,196
508,16,5,2,10,3,-45,21,0,7,90,217
508,17,3,3,6,7,33,-66,3,1,123,151
508,18,4,2,7,6,43,24,6,5,166,175
508,19,3,4,7,6,-66,42,0,7,100,217
508,20,2,4,8,5,26,41,6,8,126,258
508,21,4,3,6,7,42,-66,8,2,168,192
508,22,4,2,9,4,-55,22,3,4,113,214
508,23,4,3,10,3,46,30,9,4,159,244
508,24,4,2,8,5,-56,23,3,7,103,267
508,25,3,3,7,6,34,-67,7,0,137,200
508,26,4,3,5,8,41,35,8,5,178,235
508,27,4,3,5,8,41,-65,9,0,219,170
508,28,3,4,8,5,-65,41,4,1,154,211
508,29,4,3,8,5,44,32,8,3,198,243
508,30,3,4,7,6,-66,42,2,5,132,285
508,31,2,5,3,10,21,-45,3,0,153,240
508,32,3,5,7,6,34,51,7,1,187,291
508,33,3,4,5,8,32,44,9,5,219,335
508,34,4,4,5,8,-59,44,0,9,160,379
508,35,3,4,8,5,35,-59,5,0,195,320
508,36,2,4,4,9,22,45,7,5,217,365
508,37,3,3,5,8,32,-65,9,0,249,300
508,38,2,4,5,8,-77,44,2,4,172,344
508,39,2,4,7,6,25,42,7,6,197,386
508,40,3,3,6,7,-67,-66,0,0,130,320
508,41,3,3,6,7,33,34,3,4,163,354
508,42,5,2,11,2,56,20,9,4,219,374
508,43,2,4,4,9,-78,45,1,9,141,419
508,44,2,4,5,8,23,-56,4,3,164,363
508,45,2,5,4,9,22,54,6,7,186,417
508,46,3,3,8,5,-65,32,1,9,121,449
508,47,3,4,5,8,32,-56,3,3,153,393
508,48,2,4,4,9,22,45,5,8,175,438
508,49,5,2,7,6,52,-76,7,2,227,362
508,50,2,4,7,6,-75,42,2,4,152,404
508,51,4,3,8,5,44,32,6,6,196,436
508,52,5,2,9,4,-46,22,0,8,150,458
508,53,3,4,4,9,31,-55,1,3,181,403
508,54,3,4,8,5,35,41,6,4,216,444
508,55,4,3,6,7,42,34,8,8,258,478
508,56,3,3,9,4,-64,31,4,9,194,509
509,1,3,4,7,6,34,42,4,2,34,42
509,2,3,3,9,4,-64,31,0,3,-30,73
509,3,4,2,9,4,45,22,5,5,15,95
509,4,3,4,4,9,31,-55,6,0,46,40
509,5,4,2,9,4,-55,22,1,2,-9,62
509,6,4,2,6,7,42,25,3,7,33,87
509,7,3,3,5,8,32,-65,5,2,65,22
509,8,3,4,4,9,31,45,6,7,96,67
509,9,4,3,7,6,43,-67,9,0,139,0
509,10,2,5,4,9,-78,54,1,4,61,54
509,11,4,3,8,5,44,32,5,6,105,86
509,12,3,3,6,7,33,-66,8,0,138,20
509,13,3,3,5,8,-68,35,0,5,70,55
509,14,3,3,8,5,35,32,5,7,105,87
509,15,3,3,5,8,32,-65,7,2,137,22
509,16,3,3,6,7,-67,34,0,6,70,56
509,17,3,3,8,5,35,32,5,8,105,88
509,18,4,3,8,5,44,-68,9,0,149,20
509,19,4,3,8,5,-56,32,3,2,93,52
509,20,5,2,8,5,53,23,6,5,146,75
509,21,3,4,4,9,31,-55,7,0,177,20
509,22,5,2,9,4,-46,22,1,2,131,42
509,23,2,4,8,5,26,41,7,3,157,83
509,24,4,2,5,8,41,26,8,9,198,109
509,25,2,5,5,8,-77,-47,1,2,121,62
509,26,4,2,4,9,40,27,1,9,161,89
509,27,4,4,4,9,40,-55,1,4,201,34
509,28,3,4,4,9,31,45,2,9,232,79
509,29,4,3,7,6,43,-67,5,2,275,12
509,30,2,4,4,9,22,45,7,7,297,57
509,31,3,4,7,6,-66,42,1,9,231,99
509,32,4,2,9,4,45,-78,6,1,276,21
509,33,2,4,7,6,-75,42,1,3,201,63
509,34,2,4,5,8,23,44,4,7,224,107
509,35,3,3,9,4,-64,31,0,8,160,138
509,36,3,4,4,9,31,-55,1,3,191,83
509,37,5,2,10,3,55,21,6,4,246,104
509,38,2,5,3,10,21,55,7,9,267,159
509,39,4,3,9,4,-55,-69,2,0,212,90
509,40,3,3,8,5,35,32,7,2,247,122
509,41,4,3,8,5,-56,32,1,4,191,154
509,42,2,4,7,6,25,42,6,6,216,196
509,43,2,4,4,9,22,-55,8,1,238,141
509,44,3,5,6,7,-67,52,1,3,171,193
509,45,4,2,9,4,45,22,6,5,216,215
509,46,4,3,5,8,41,-65,7,0,257,150
509,47,3,3,7,6,-66,33,1,3,191,183
509,48,3,3,4,9,31,36,2,9,222,219
509,49,2,5,5,8,23,-47,5,2,245,172
509,50,2,4,8,5,-74,41,1,3,171,213
509,51,5,3,9,4,54,31,5,4,225,244
509,52,5,2,9,4,54,22,9,6,279,266
509,53,3,5,7,6,-66,51,3,7,213,317
509,54,3,3,6,7,33,-66,6,1,246,251
509,55,2,4,4,9,22,45,8,6,268,296
509,56,5,2,8,5,-47,23,1,9,221,319
509,57,4,2,9,4,45,-78,6,1,266,241
509,58,4,4,5,8,41,44,7,5,307,285
509,59,4,3,6,7,42,34,9,9,349,319
509,60,3,3,6,7,-67,-66,2,3,282,253
509,61,4,2,8,5,44,23,6,6,326,276
509,62,3,3,7,6,-66,33,0,9,260,309
509,63,4,2,7,6,43,-76,3,3,303,233
509,64,2,5,3,10,21,55,4,8,324,288
509,65,2,4,5,8,23,-56,7,2,347,232
509,66,5,2,9,4,-46,22,1,4,301,254
509,67,2,4,7,6,25,42,6,6,326,296
509,68,5,2,8,5,53,23,9,9,379,319
509,69,2,4,4,9,-78,-55,1,4,301,264
509,70,4,2,8,5,44,23,5,7,345,287
509,71,4,3,6,7,42,-66,7,1,387,221
509,72,2,5,3,10,21,55,8,6,408,276
509,73,2,4,4,9,-78,-55,0,1,330,221
509,74,5,2,9,4,54,22,4,3,384,243
509,75,3,4,3,10,30,46,4,9,414,289
509,76,2,4,6,7,24,-57,8,2,438,232
509,77,6,2,10,3,-36,21,2,3,402,253
509,78,3,3,8,5,35,32,7,5,437,285
509,79,5,2,9,4,-46,22,1,7,391,307
509,80,5,2,8,5,53,-77,4,0,444,230
509,81,3,4,8,5,35,41,9,1,479,271
509,82,3,3,6,7,-67,34,2,5,412,305
509,83,2,4,3,10,21,-54,3,1,433,251
509,84,4,2,8,5,44,23,7,4,477,274
509,85,2,4,8,5,-74,41,3,5,403,315
509,86,4,3,8,5,44,32,7,7,447,347
509,87,2,4,4,9,22,-55,9,2,469,292
509,88,2,5,2,11,20,56,9,8,489,348
509,89,2,5,5,8,-77,-47,2,1,412,301
509,90,3,4,6,7,33,43,5,4,445,344
509,91,4,2,9,4,-55,22,0,6,390,366
509,92,3,4,3,10,30,-54,0,2,420,312
509,93,4,2,9,4,45,22,5,4,465,334
509,94,4,2,8,5,44,23,9,7,509,357
510,1,4,3,8,5,44,32,4,2,44,32
510,2,3,3,9,4,-64,31,0,3,-20,63
510,3,3,3,6,7,33,34,3,7,13,97
510,4,5,3,9,4,54,31,7,8,67,128
510,5,3,4,8,5,-65,41,2,9,2,169
510,6,2,5,6,7,24,-48,6,1,26,121
510,7,3,3,8,5,-65,32,1,3,-39,153
510,8,4,3,8,5,44,32,5,5,5,185
510,9,3,3,6,7,33,34,8,9,38,219
510,10,5,2,9,4,-46,-78,2,1,-8,141
510,11,3,4,6,7,33,43,5,4,25,184
510,12,3,3,8,5,-65,32,0,6,-40,216
510,13,2,5,4,9,22,-46,2,0,-18,170
510,14,2,4,3,10,21,46,3,6,3,216
510,15,4,3,8,5,44,32,7,8,47,248
510,16,3,3,9,4,-64,31,3,9,-17,279
510,17,3,4,6,7,33,-57,6,2,16,222
510,18,4,2,9,4,-55,22,1,4,-39,244
510,19,2,4,8,5,26,41,7,5,-13,285
510,20,4,2,11,2,-53,20,4,5,-66,305
510,21,4,2,5,8,41,-74,5,1,-25,231
510,22,4,3,6,7,42,34,7,5,17,265
510,23,2,4,5,8,-77,44,0,9,-60,309
510,24,2,5,4,9,22,-46,2,3,-38,263
510,25,3,3,6,7,33,34,5,7,-5,297
510,26,3,4,7,6,34,42,9,9,29,339
510,27,4,2,9,4,-55,-78,4,1,-26,261
510,28,4,3,8,5,44,32,8,3,18,293
510,29,3,4,5,8,-68,44,0,7,-50,337
510,30,4,3,7,6,43,-67,3,0,-7,270
510,31,2,6,4,9,22,63,5,3,15,333
510,32,4,4,7,6,43,42,8,5,58,375
510,33,3,3,8,5,-65,32,3,7,-7,407
510,34,2,5,5,8,23,-47,6,0,16,360
510,35,3,4,6,7,33,43,9,3,49,403
510,36,4,3,9,4,-55,31,4,4,-6,434
510,37,2,4,4,9,22,45,6,9,16,479
510,38,4,2,8,5,-56,-77,0,2,-40,402
510,39,4,3,6,7,42,34,2,6,2,436
510,40,4,3,5,8,41,-65,3,1,43,371
510,41,2,5,6,7,24,52,7,3,67,423
510,42,4,2,6,7,42,25,9,8,109,448
510,43,3,3,9,4,-64,31,5,9,45,479
510,44,2,5,5,8,23,-47,8,2,68,432
510,45,4,3,8,5,-56,32,2,4,12,464
510,46,4,3,5,8,41,35,3,9,53,499
510,47,3,3,7,6,34,-67,7,2,87,432
510,48,4,3,8,5,-56,32,1,4,31,464
510,49,2,5,5,8,23,53,4,7,54,517
511,1,4,3,7,6,43,33,3,3,43,33
511,2,2,4,3,10,21,46,4,9,64,79
511,3,4,3,7,6,43,-67,7,2,107,12
511,4,2,4,6,7,-76,43,1,5,31,55
511,5,2,4,8,5,26,41,7,6,57,96
511,6,3,3,8,5,-65,32,2,8,-8,128
511,7,3,3,8,5,35,-68,7,0,27,60
511,8,4,3,9,4,-55,31,2,1,-28,91
511,9,3,3,8,5,35,32,7,3,7,123
511,10,3,4,6,7,-67,43,0,6,-60,166
511,11,2,4,4,9,22,-55,2,1,-38,111
511,12,4,2,9,4,45,22,7,3,7,133
511,13,2,5,5,8,-77,53,0,6,-70,186
511,14,3,3,6,7,33,-66,3,0,-37,120
511,15,3,4,4,9,31,45,4,5,-6,165
511,16,2,5,4,9,22,54,6,9,16,219
511,17,4,3,8,5,-56,-68,0,1,-40,151
511,18,3,3,6,7,33,34,3,5,-7,185
511,19,5,2,11,2,56,20,9,5,49,205
511,20,3,4,7,6,-66,42,3,7,-17,247
511,21,3,4,5,8,32,-56,5,1,15,191
511,22,2,4,5,8,23,44,8,5,38,235
511,23,3,4,6,7,-67,43,1,8,-29,278
511,24,4,2,6,7,42,-75,3,3,13,203
511,25,3,3,5,8,32,35,5,8,45,238
511,26,3,4,4,9,31,-55,6,3,76,183
511,27,3,4,5,8,32,44,8,7,108,227
511,28,3,4,6,7,-67,-57,1,0,41,170
511,29,2,4,3,10,21,46,2,6,62,216
511,30,2,5,4,9,22,-46,4,0,84,170
511,31,3,3,6,7,33,34,7,4,117,204
511,32,4,3,8,5,-56,32,1,6,61,236
511,33,5,3,9,4,54,31,5,7,115,267
511,34,5,2,9,4,54,22,9,9,169,289
511,35,3,4,7,6,-66,-58,3,1,103,231
511,36,2,4,5,8,23,44,6,5,126,275
511,37,3,4,7,6,-66,42,0,7,60,317
511,38,3,3,5,8,32,-65,2,2,92,252
511,39,2,4,5,8,23,44,5,6,115,296
511,40,4,3,6,7,42,-66,7,0,157,230
511,41,4,3,7,6,-57,33,0,3,100,263
511,42,4,3,5,8,41,35,1,8,141,298
511,43,3,3,7,6,34,-67,5,1,175,231
511,44,4,2,7,6,43,24,8,5,218,255
511,45,3,4,7,6,-66,42,2,7,152,297
511,46,3,4,5,8,32,-56,4,1,184,241
511,47,3,3,6,7,33,34,7,5,217,275
511,48,2,6,4,9,22,63,9,8,239,338
511,49,4,3,8,5,-56,-68,3,0,183,270
511,50,3,4,7,6,34,42,7,2,217,312
511,51,3,3,6,7,-67,34,0,6,150,346
511,52,4,2,9,4,45,22,5,8,195,368
511,53,4,3,6,7,42,-66,7,2,237,302
511,54,2,5,3,10,21,55,8,7,258,357
511,55,3,3,7,6,-66,-67,2,0,192,290
511,56,3,3,4,9,31,36,3,6,223,326
511,57,4,2,9,4,45,22,8,8,268,348
511,58,4,3,8,5,-56,-68,2,0,212,280
511,59,4,3,8,5,44,32,6,2,256,312
511,60,2,6,2,11,20,65,6,7,276,377
511,61,5,2,9,4,-46,22,0,9,230,399
511,62,4,4,8,5,44,-59,4,0,274,340
511,63,3,4,6,7,33,43,7,3,307,383
511,64,3,4,3,10,30,46,7,9,337,429
511,65,2,5,4,9,22,-46,9,3,359,383
511,66,2,5,5,8,-77,53,2,6,282,436
511,67,3,3,6,7,33,-66,5,0,315,370
511,68,2,5,2,11,20,56,5,6,335,426
511,69,2,4,5,8,23,-56,8,0,358,370
511,70,4,2,10,3,-54,21,4,1,304,391
511,71,3,3,6,7,33,34,7,5,337,425
511,72,3,3,6,7,-67,34,0,9,270,459
511,73,4,3,7,6,43,-67,3,2,313,392
511,74,3,4,7,6,34,42,7,4,347,434
511,75,2,4,4,9,22,45,9,9,369,479
511,76,5,2,9,4,-46,-78,3,1,323,401
511,77,3,3,7,6,34,33,7,4,357,434
511,78,4,3,8,5,-56,32,1,6,301,466
511,79,5,2,6,7,51,-75,2,1,352,391
511,80,2,4,3,10,21,46,3,7,373,437
511,81,4,3,8,5,44,32,7,9,417,469
511,82,5,2,8,5,-47,-77,0,2,370,392
511,83,3,4,5,8,32,44,2,6,402,436
511,84,2,5,4,9,22,-46,4,0,424,390
511,85,4,2,8,5,44,23,8,3,468,413
511,86,4,3,8,5,-56,32,2,5,412,445
511,87,5,2,10,3,55,21,7,6,467,466
511,88,2,5,3,10,21,-45,8,1,488,421
511,89,5,2,11,2,-44,20,4,1,444,441
511,90,3,3,5,8,32,35,6,6,476,476
511,91,3,3,6,7,33,-66,9,0,509,410
512,1,4,3,7,6,43,33,3,3,43,33
512,2,3,4,6,7,33,43,6,6,76,76
512,3,3,4,6,7,33,43,9,9,109,119
512,4,4,2,11,2,-53,20,6,9,56,139
512,5,2,5,4,9,22,-46,8,3,78,93
512,6,3,3,7,6,-66,33,2,6,12,126
512,7,3,3,6,7,33,-66,5,0,45,60
512,8,2,5,2,11,20,56,5,6,65,116
512,9,3,3,8,5,-65,32,0,8,0,148
512,10,5,2,8,5,53,-77,3,1,53,71
512,11,4,2,10,3,46,21,9,2,99,92
512,12,2,4,4,9,-78,45,1,7,21,137
512,13,5,2,8,5,53,-77,4,0,74,60
512,14,3,4,3,10,30,46,4,6,104,106
512,15,4,3,8,5,44,32,8,8,148,138
512,16,4,3,7,6,-57,-67,1,1,91,71
512,17,3,3,5,8,32,35,3,6,123,106
512,18,4,2,11,2,-53,20,0,6,70,126
512,19,5,2,7,6,52,-76,2,0,122,50
512,20,2,4,7,6,25,42,7,2,147,92
512,21,2,6,4,9,22,63,9,5,169,155
512,22,3,3,8,5,-65,32,4,7,104,187
512,23,4,2,11,2,-53,20,1,7,51,207
512,24,3,3,7,6,34,-67,5,0,85,140
512,25,3,4,5,8,32,44,7,4,117,184
512,26,5,2,11,2,-44,20,3,4,73,204
512,27,2,5,5,8,23,53,6,7,96,257
512,28,2,4,7,6,-75,42,1,9,21,299
512,29,3,4,4,9,31,-55,2,4,52,244
512,30,3,3,8,5,35,32,7,6,87,276
512,31,4,2,9,4,-55,22,2,8,32,298
512,32,3,4,4,9,31,-55,3,3,63,243
512,33,3,3,4,9,31,36,4,9,94,279
512,34,3,4,4,9,31,-55,5,4,125,224
512,35,4,2,11,2,-53,20,2,4,72,244
512,36,2,5,3,10,21,55,3,9,93,299
512,37,3,4,6,7,33,-57,6,2,126,242
512,38,3,3,5,8,32,35,8,7,158,277
512,39,4,3,7,6,-57,-67,1,0,101,210
512,40,4,3,8,5,44,32,5,2,145,242
512,41,3,4,5,8,32,44,7,6,177,286
512,42,5,2,10,3,-45,21,2,7,132,307
512,43,4,3,8,5,44,32,6,9,176,339
512,44,3,3,7,6,-66,-67,0,2,110,272
512,45,2,5,4,9,22,54,2,6,132,326
512,46,2,4,7,6,25,42,7,8,157,368
512,47,5,2,9,4,-46,-78,1,0,111,290
512,48,2,4,5,8,23,44,4,4,134,334
512,49,4,4,6,7,42,43,6,7,176,377
512,50,3,3,5,8,32,-65,8,2,208,312
512,51,2,4,8,5,-74,41,4,3,134,353
512,52,5,2,7,6,52,24,6,7,186,377
512,53,2,5,6,7,-76,52,0,9,110,429
512,54,4,2,6,7,42,-75,2,4,152,354
512,55,5,2,11,2,56,20,8,4,208,374
512,56,3,3,8,5,-65,32,3,6,143,406
512,57,4,2,9,4,45,22,8,8,188,428
512,58,4,3,7,6,-57,-67,1,1,131,361
512,59,2,4,4,9,22,45,3,6,153,406
512,60,2,4,4,9,22,-55,5,1,175,351
512,61,3,4,6,7,33,43,8,4,208,394
512,62,2,4,4,9,-78,45,0,9,130,439
512,63,3,3,6,7,33,-66,3,3,163,373
512,64,3,3,8,5,35,32,8,5,198,405
512,65,3,4,5,8,-68,44,0,9,130,449
512,66,3,3,8,5,35,-68,5,1,165,381
512,67,2,5,5,8,23,53,8,4,188,434
512,68,4,2,8,5,-56,23,2,7,132,457
512,69,5,2,9,4,54,22,6,9,186,479
512,70,4,3,7,6,43,-67,9,2,229,412
512,71,3,4,7,6,-66,42,3,4,163,454
512,72,5,2,11,2,56,20,9,4,219,474
512,73,2,4,5,8,-77,44,2,8,142,518
513,1,3,4,7,6,34,42,4,2,34,42
513,2,2,5,3,10,21,55,5,7,55,97
513,3,3,4,3,10,30,-54,5,3,85,43
513,4,4,2,9,4,-55,22,0,5,30,65
513,5,4,3,8,5,44,32,4,7,74,97
513,6,2,5,3,10,21,-45,5,2,95,52
513,7,3,4,8,5,-65,41,0,3,30,93
513,8,4,3,7,6,43,33,3,6,73,126
513,9,4,4,5,8,41,-56,4,0,114,70
513,10,3,4,7,6,34,42,8,2,148,112
513,11,4,3,7,6,-57,33,1,5,91,145
513,12,3,3,6,7,33,34,4,9,124,179
513,13,4,3,8,5,44,-68,8,1,168,111
513,14,3,3,7,6,-66,33,2,4,102,144
513,15,3,3,6,7,33,34,5,8,135,178
513,16,6,2,8,5,62,-77,7,1,197,101
513,17,3,4,7,6,-66,42,1,3,131,143
513,18,3,3,8,5,35,32,6,5,166,175
513,19,3,3,5,8,32,-65,8,0,198,110
513,20,3,3,5,8,-68,35,0,5,130,145
513,21,3,3,7,6,34,33,4,8,164,178
513,22,3,3,9,4,-64,31,0,9,100,209
513,23,5,2,9,4,54,-78,4,1,154,131
513,24,3,3,7,6,34,33,8,4,188,164
513,25,2,4,7,6,-75,42,3,6,113,206
513,26,4,3,8,5,44,32,7,8,157,238
513,27,4,3,7,6,-57,-67,0,1,100,171
513,28,5,2,7,6,52,24,2,5,152,195
513,29,2,5,3,10,21,-45,3,0,173,150
513,30,3,4,7,6,34,42,7,2,207,192
513,31,3,3,4,9,31,36,8,8,238,228
513,32,3,3,5,8,-68,-65,0,3,170,163
513,33,3,3,8,5,35,32,5,5,205,195
513,34,4,3,7,6,43,33,8,8,248,228
513,35,3,5,6,7,-67,-48,1,0,181,180
513,36,4,2,9,4,45,22,6,2,226,202
513,37,3,3,7,6,-66,33,0,5,160,235
513,38,2,4,4,9,22,-55,2,0,182,180
513,39,3,3,7,6,34,33,6,3,216,213
513,40,4,3,5,8,41,35,7,8,257,248
513,41,5,2,7,6,52,-76,9,2,309,172
513,42,5,2,8,5,-47,23,2,5,262,195
513,43,3,3,7,6,34,33,6,8,296,228
513,44,2,5,5,8,23,-47,9,1,319,181
513,45,3,4,8,5,-65,41,4,2,254,222
513,46,4,2,7,6,43,24,7,6,297,246
513,47,3,3,6,7,-67,-66,0,0,230,180
513,48,5,2,8,5,53,23,3,3,283,203
513,49,4,3,9,4,45,31,8,4,328,234
513,50,2,4,4,9,-78,45,0,9,250,279
513,51,3,3,7,6,34,-67,4,2,284,212
513,52,3,4,6,7,33,43,7,5,317,255
513,53,2,5,2,11,20,-44,7,1,337,211
513,54,4,3,9,4,-55,31,2,2,282,242
513,55,2,4,3,10,21,46,3,8,303,288
513,56,4,4,4,9,40,-55,3,3,343,233
513,57,2,4,5,8,23,44,6,7,366,277
513,58,3,3,7,6,-66,-67,0,0,300,210
513,59,4,3,8,5,44,32,4,2,344,242
513,60,3,3,7,6,34,33,8,5,378,275
513,61,3,4,7,6,-66,42,2,7,312,317
513,62,4,3,9,4,45,31,7,8,357,348
513,63,5,2,9,4,-46,-78,1,0,311,270
513,64,4,3,10,3,46,30,7,0,357,300
513,65,3,3,7,6,-66,33,1,3,291,333
513,66,2,4,3,10,21,46,2,9,312,379
513,67,3,3,6,7,33,-66,5,3,345,313
513,68,4,3,7,6,43,33,8,6,388,346
513,69,4,2,8,5,-56,23,2,9,332,369
513,70,3,3,6,7,33,-66,5,3,365,303
513,71,5,2,11,2,-44,20,1,3,321,323
513,72,4,3,9,4,45,31,6,4,366,354
513,73,2,6,2,11,20,65,6,9,386,419
513,74,3,3,6,7,33,-66,9,3,419,353
513,75,2,4,4,9,-78,45,1,8,341,398
513,76,3,3,3,10,30,-63,1,5,371,335
513,77,3,4,6,7,33,43,4,8,404,378
513,78,4,2,6,7,42,-75,6,3,446,303
513,79,2,4,6,7,-76,43,0,6,370,346
513,80,3,4,9,4,36,40,6,6,406,386
513,81,4,2,6,7,42,-75,8,1,448,311
513,82,3,4,6,7,-67,43,1,4,381,354
513,83,3,3,7,6,34,33,5,7,415,387
513,84,4,3,4,9,40,-64,5,3,455,323
513,85,3,3,8,5,-65,32,0,5,390,355
513,86,3,3,6,7,33,34,3,9,423,389
513,87,2,5,4,9,22,-46,5,3,445,343
513,88,2,4,2,11,20,-53,5,0,465,290
513,89,3,5,5,8,32,53,7,3,497,343
513,90,4,3,5,8,41,35,8,8,538,378
514,1,3,3,4,9,31,36,1,6,31,36
514,2,5,2,10,3,55,21,6,7,86,57
514,3,3,3,6,7,33,-66,9,1,119,-9
514,4,3,4,3,10,30,46,9,7,149,37
514,5,6,2,11,2,-35,20,4,7,114,57
514,6,4,3,8,5,44,32,8,9,158,89
514,7,4,3,9,4,-55,-69,3,0,103,20
514,8,2,5,5,8,23,53,6,3,126,73
514,9,4,4,4,9,40,45,6,8,166,118
514,10,3,4,8,5,-65,41,1,9,101,159
514,11,3,3,5,8,32,-65,3,4,133,94
514,12,3,3,6,7,33,34,6,8,166,128
514,13,4,3,8,5,-56,-68,0,0,110,60
514,14,3,4,5,8,32,44,2,4,142,104
514,15,3,3,9,4,36,31,8,5,178,135
514,16,4,3,5,8,41,-65,9,0,219,70
514,17,2,4,6,7,-76,43,3,3,143,113
514,18,4,2,6,7,42,25,5,8,185,138
514,19,4,2,11,2,-53,20,2,8,132,158
514,20,4,2,7,6,43,-76,5,2,175,82
514,21,3,3,8,5,-65,32,0,4,110,114
514,22,3,3,8,5,35,32,5,6,145,146
514,23,3,4,5,8,32,-56,7,0,177,90
514,24,6,2,10,3,-36,21,1,1,141,111
514,25,4,2,10,3,46,21,7,2,187,132
514,26,3,3,5,8,32,35,9,7,219,167
514,27,3,4,4,9,-69,-55,0,2,150,112
514,28,3,3,9,4,36,31,6,3,186,143
514,29,4,2,8,5,-56,23,0,6,130,166
514,30,2,4,4,9,22,-55,2,1,152,111
514,31,2,4,3,10,21,46,3,7,173,157
514,32,4,3,8,5,44,32,7,9,217,189
514,33,3,3,7,6,-66,-67,1,2,151,122
514,34,2,4,5,8,23,44,4,6,174,166
514,35,4,3,8,5,44,32,8,8,218,198
514,36,5,2,11,2,-44,20,4,8,174,218
514,37,2,4,5,8,23,-56,7,2,197,162
514,38,3,3,5,8,32,35,9,7,229,197
514,39,2,4,4,9,-78,-55,1,2,151,142
514,40,3,3,4,9,31,36,2,8,182,178
514,41,4,3,9,4,45,31,7,9,227,209
514,42,3,4,6,7,-67,-57,0,2,160,152
514,43,4,2,9,4,45,22,5,4,205,174
514,44,5,2,11,2,-44,20,1,4,161,194
514,45,2,6,3,10,21,64,2,8,182,258
514,46,2,5,3,10,21,-45,3,3,203,213
514,47,3,3,3,10,30,-63,3,0,233,150
514,48,4,3,8,5,44,32,7,2,277,182
514,49,2,6,4,9,22,63,9,5,299,245
514,50,2,4,6,7,-76,43,3,8,223,288
514,51,4,2,7,6,43,-76,6,2,266,212
514,52,3,3,6,7,33,34,9,6,299,246
514,53,2,4,6,7,-76,43,3,9,223,289
514,54,4,3,9,4,45,-69,8,0,268,220
514,55,2,5,6,7,-76,52,2,2,192,272
514,56,3,3,3,10,30,37,2,9,222,309
514,57,5,2,9,4,54,-78,6,1,276,231
514,58,4,3,10,3,-54,30,2,1,222,261
514,59,3,3,8,5,35,32,7,3,257,293
514,60,4,3,9,4,-55,31,2,4,202,324
514,61,4,2,10,3,46,21,8,5,248,345
514,62,2,4,7,6,-75,42,3,7,173,387
514,63,5,2,7,6,52,-76,5,1,225,311
514,64,4,2,11,2,-53,20,2,1,172,331
514,65,2,4,4,9,22,45,4,6,194,376
514,66,3,4,7,6,34,42,8,8,228,418
514,67,3,3,8,5,-65,-68,3,0,163,350
514,68,3,3,8,5,35,32,8,2,198,382
514,69,2,6,3,10,21,64,9,6,219,446
514,70,3,3,6,7,-67,-66,2,0,152,380
514,71,4,3,8,5,44,32,6,2,196,412
514,72,2,5,4,9,22,54,8,6,218,466
514,73,3,4,5,8,-68,-56,0,0,150,410
514,74,3,4,6,7,33,43,3,3,183,453
514,75,2,5,3,10,21,55,4,8,204,508
515,1,4,3,9,4,45,31,5,1,45,31
515,2,5,2,9,4,54,22,9,3,99,53
515,3,2,5,5,8,-77,53,2,6,22,106
515,4,3,3,5,8,32,-65,4,1,54,41
515,5,3,4,4,9,31,45,5,6,85,86
515,6,2,4,4,9,22,-55,7,1,107,31
515,7,4,3,10,3,-54,30,3,1,53,61
515,8,3,3,8,5,35,32,8,3,88,93
515,9,4,2,8,5,-56,23,2,6,32,116
515,10,2,5,3,10,21,-45,3,1,53,71
515,11,2,6,3,10,21,64,4,5,74,135
515,12,2,4,4,9,22,-55,6,0,96,80
515,13,3,4,6,7,33,43,9,3,129,123
515,14,3,3,7,6,-66,33,3,6,63,156
515,15,3,4,7,6,34,42,7,8,97,198
515,16,2,6,3,10,21,-36,8,2,118,162
515,17,4,3,5,8,41,35,9,7,159,197
515,18,2,4,4,9,-78,-55,1,2,81,142
515,19,4,3,9,4,45,31,6,3,126,173
515,20,4,2,11,2,-53,20,3,3,73,193
515,21,2,5,6,7,24,52,7,5,97,245
515,22,4,2,7,6,-57,24,0,9,40,269
515,23,2,5,3,10,21,-45,1,4,61,224
515,24,3,3,9,4,36,31,7,5,97,255
515,25,2,4,7,6,-75,42,2,7,22,297
515,26,3,3,7,6,34,-67,6,0,56,230
515,27,3,3,6,7,33,34,9,4,89,264
515,28,4,2,9,4,-55,22,4,6,34,286
515,29,3,3,6,7,33,-66,7,0,67,220
515,30,6,2,8,5,62,23,9,3,129,243
515,31,5,2,10,3,-45,21,4,4,84,264
515,32,4,3,7,6,43,33,7,7,127,297
515,33,2,4,4,9,22,-55,9,2,149,242
515,34,2,4,7,6,-75,42,4,4,74,284
515,35,4,3,6,7,42,34,6,8,116,318
515,36,2,5,3,10,21,-45,7,3,137,273
515,37,3,3,6,7,-67,34,0,7,70,307
515,38,4,3,6,7,42,-66,2,1,112,241
515,39,3,4,5,8,32,44,4,5,144,285
515,40,3,4,9,4,-64,40,0,5,80,325
515,41,5,3,6,7,51,34,1,9,131,359
515,42,4,3,6,7,42,-66,3,3,173,293
515,43,2,4,4,9,22,45,5,8,195,338
515,44,5,2,10,3,-45,21,0,9,150,359
515,45,3,4,5,8,32,-56,2,3,182,303
515,46,3,3,8,5,35,32,7,5,217,335
515,47,4,3,6,7,42,34,9,9,259,369
515,48,2,4,4,9,-78,-55,1,4,181,314
515,49,4,2,7,6,43,24,4,8,224,338
515,50,3,4,6,7,33,-57,7,1,257,281
515,51,3,4,7,6,-66,42,1,3,191,323
515,52,4,3,8,5,44,32,5,5,235,355
515,53,3,3,6,7,33,34,8,9,268,389
515,54,3,3,7,6,-66,-67,2,2,202,322
515,55,2,4,4,9,22,45,4,7,224,367
515,56,4,3,8,5,44,32,8,9,268,399
515,57,3,4,6,7,-67,-57,1,2,201,342
515,58,2,5,3,10,21,55,2,7,222,397
515,59,4,2,10,3,46,21,8,8,268,418
515,60,3,5,5,8,-68,-47,0,1,200,371
515,61,3,3,4,9,31,36,1,7,231,407
515,62,4,3,7,6,43,-67,4,0,274,340
515,63,4,2,7,6,43,24,7,4,317,364
515,64,4,3,6,7,42,34,9,8,359,398
515,65,5,2,9,4,-46,-78,3,0,313,320
515,66,3,4,5,8,32,44,5,4,345,364
515,67,4,4,5,8,41,44,6,8,386,408
515,68,2,4,7,6,-75,-58,1,0,311,350
515,69,4,3,9,4,45,31,6,1,356,381
515,70,4,2,7,6,43,24,9,5,399,405
515,71,2,4,8,5,-74,41,5,6,325,446
515,72,4,3,6,7,42,-66,7,0,367,380
515,73,2,6,5,8,-77,62,0,2,290,442
515,74,3,4,4,9,31,45,1,7,321,487
515,75,3,3,8,5,35,32,6,9,356,519
516,1,5,2,10,3,55,21,5,1,55,21
516,2,4,2,7,6,43,24,8,5,98,45
516,3,3,4,5,8,-68,44,0,9,30,89
516,4,5,2,10,3,55,-79,5,0,85,10
516,5,4,2,8,5,44,23,9,3,129,33
516,6,3,3,4,9,-69,36,0,9,60,69
516,7,3,3,6,7,33,-66,3,3,93,3
516,8,2,4,5,8,23,44,6,7,116,47
516,9,5,2,10,3,-45,21,1,8,71,68
516,10,4,3,7,6,43,-67,4,1,114,1
516,11,4,3,5,8,41,35,5,6,155,36
516,12,3,4,5,8,32,-56,7,0,187,-20
516,13,2,4,5,8,-77,44,0,4,110,24
516,14,4,4,7,6,43,42,3,6,153,66
516,15,5,3,9,4,54,31,7,7,207,97
516,16,3,4,5,8,32,-56,9,1,239,41
516,17,4,3,10,3,-54,30,5,1,185,71
516,18,3,3,5,8,32,35,7,6,217,106
516,19,2,5,3,10,21,-45,8,1,238,61
516,20,2,4,5,8,-77,44,1,5,161,105
516,21,3,4,6,7,33,43,4,8,194,148
516,22,3,4,8,5,35,41,9,9,229,189
516,23,3,3,9,4,-64,-69,5,0,165,120
516,24,4,3,5,8,41,35,6,5,206,155
516,25,5,2,10,3,-45,21,1,6,161,176
516,26,3,4,6,7,33,43,4,9,194,219
516,27,2,5,7,6,25,-49,9,0,219,170
516,28,3,3,5,8,-68,35,1,5,151,205
516,29,3,3,8,5,35,32,6,7,186,237
516,30,3,3,6,7,33,-66,9,1,219,171
516,31,4,2,5,8,-59,26,0,7,160,197
516,32,2,4,5,8,23,-56,3,1,183,141
516,33,2,5,3,10,21,55,4,6,204,196
516,34,5,2,11,2,-44,20,0,6,160,216
516,35,2,5,2,11,20,-44,0,2,180,172
516,36,4,3,9,4,45,31,5,3,225,203
516,37,4,2,8,5,44,23,9,6,269,226
516,38,3,4,6,7,-67,43,2,9,202,269
516,39,5,2,10,3,55,-79,7,0,257,190
516,40,5,3,8,5,-47,32,0,2,210,222
516,41,3,4,4,9,31,45,1,7,241,267
516,42,5,2,9,4,54,22,5,9,295,289
516,43,4,3,6,7,42,-66,7,3,337,223
516,44,3,4,7,6,-66,42,1,5,271,265
516,45,2,5,3,10,21,-45,2,0,292,220
516,46,2,4,4,9,22,45,4,5,314,265
516,47,5,2,10,3,55,21,9,6,369,286
516,48,3,4,4,9,-69,-55,0,1,300,231
516,49,3,3,4,9,31,36,1,7,331,267
516,50,3,4,6,7,33,-57,4,0,364,210
516,51,3,4,7,6,34,42,8,2,398,252
516,52,4,2,7,6,-57,24,1,6,341,276
516,53,2,4,6,7,24,43,5,9,365,319
516,54,4,4,6,7,42,-57,7,2,407,262
516,55,2,4,4,9,22,45,9,7,429,307
516,56,4,3,6,7,-58,-66,1,1,371,241
516,57,3,3,8,5,35,32,6,3,406,273
516,58,3,4,5,8,32,44,8,7,438,317
516,59,5,2,11,2,-44,20,4,7,394,337
516,60,3,3,6,7,33,-66,7,1,427,271
516,61,2,4,4,9,22,45,9,6,449,316
516,62,4,3,9,4,-55,31,4,7,394,347
516,63,2,4,7,6,25,42,9,9,419,389
516,64,4,3,7,6,-57,-67,2,2,362,322
516,65,4,2,8,5,44,23,6,5,406,345
516,66,3,3,6,7,33,34,9,9,439,379
516,67,3,3,6,7,-67,-66,2,3,372,313
516,68,3,4,3,10,30,46,2,9,402,359
516,69,4,3,7,6,43,-67,5,2,445,292
516,70,3,3,9,4,-64,31,1,3,381,323
516,71,5,2,9,4,54,22,5,5,435,345
516,72,4,4,5,8,41,44,6,9,476,389
516,73,3,3,8,5,-65,-68,1,1,411,321
516,74,3,4,7,6,34,42,5,3,445,363
516,75,2,4,5,8,23,44,8,7,468,407
516,76,3,3,6,7,-67,-66,1,1,401,341
516,77,4,3,8,5,44,32,5,3,445,373
516,78,5,2,9,4,54,22,9,5,499,395
516,79,6,2,8,5,-38,23,1,8,461,418
516,80,3,4,5,8,32,-56,3,2,493,362
516,81,3,4,7,6,34,42,7,4,527,404
517,1,4,3,8,5,44,32,4,2,44,32
517,2,3,3,8,5,35,32,9,4,79,64
517,3,4,2,9,4,-55,22,4,6,24,86
517,4,5,2,8,5,53,23,7,9,77,109
517,5,2,5,5,8,-77,-47,0,2,0,62
517,6,4,2,7,6,43,24,3,6,43,86
517,7,3,4,7,6,34,42,7,8,77,128
517,8,5,2,8,5,-47,-77,0,1,30,51
517,9,4,3,8,5,44,32,4,3,74,83
517,10,3,3,7,6,34,33,8,6,108,116
517,11,4,3,9,4,-55,31,3,7,53,147
517,12,4,2,8,5,44,-77,7,0,97,70
517,13,4,3,5,8,41,35,8,5,138,105
517,14,2,4,4,9,-78,-55,0,0,60,50
517,15,2,5,6,7,24,52,4,2,84,102
517,16,2,6,4,9,22,63,6,5,106,165
517,17,3,5,5,8,32,53,8,8,138,218
517,18,3,4,5,8,-68,-56,0,2,70,162
517,19,2,4,5,8,23,44,3,6,93,206
517,20,2,5,6,7,24,52,7,8,117,258
517,21,4,2,7,6,-57,-76,0,2,60,182
517,22,3,4,7,6,34,42,4,4,94,224
517,23,6,2,11,2,65,20,9,4,159,244
517,24,2,5,3,10,-79,55,0,9,80,299
517,25,2,5,4,9,22,-46,2,3,102,253
517,26,4,4,8,5,44,41,6,4,146,294
517,27,2,4,4,9,22,45,8,9,168,339
517,28,2,5,6,7,-76,-48,2,1,92,291
517,29,2,5,2,11,20,56,2,7,112,347
517,30,2,5,3,10,21,-45,3,2,133,302
517,31,2,5,2,11,20,56,3,8,153,358
517,32,5,3,8,5,53,-68,6,0,206,290
517,33,2,5,6,7,-76,52,0,2,130,342
517,34,2,4,4,9,22,45,2,7,152,387
517,35,4,2,6,7,42,-75,4,2,194,312
517,36,4,2,9,4,45,22,9,4,239,334
517,37,3,3,8,5,-65,32,4,6,174,366
517,38,4,4,6,7,42,43,6,9,216,409
517,39,3,4,7,6,-66,-58,0,1,150,351
517,40,2,5,4,9,22,54,2,5,172,405
517,41,3,3,6,7,33,34,5,9,205,439
517,42,3,3,6,7,33,-66,8,3,238,373
517,43,2,4,8,5,-74,41,4,4,164,414
517,44,5,2,8,5,53,23,7,7,217,437
517,45,2,4,6,7,-76,-57,1,0,141,380
517,46,4,2,6,7,42,25,3,5,183,405
517,47,2,5,7,6,25,51,8,6,208,456
517,48,2,5,5,8,-77,53,1,9,131,509
518,1,4,2,9,4,45,22,5,2,45,22
518,2,4,3,8,5,44,32,9,4,89,54
518,3,5,2,8,5,-47,23,2,7,42,77
518,4,3,4,6,7,33,-57,5,0,75,20
518,5,3,3,8,5,-65,32,0,2,10,52
518,6,2,4,3,10,21,46,1,8,31,98
518,7,3,3,4,9,31,-64,2,4,62,34
518,8,3,3,6,7,33,34,5,8,95,68
518,9,3,4,7,6,34,-58,9,0,129,10
518,10,5,2,9,4,-46,22,3,2,83,32
518,11,2,4,5,8,23,44,6,6,106,76
518,12,2,4,5,8,23,-56,9,0,129,20
518,13,3,4,6,7,-67,43,2,3,62,63
518,14,4,3,7,6,43,33,5,6,105,96
518,15,3,5,4,9,31,-46,6,0,136,50
518,16,3,3,8,5,-65,32,1,2,71,82
518,17,3,4,5,8,32,44,3,6,103,126
518,18,2,6,3,10,21,-36,4,0,124,90
518,19,4,2,7,6,43,24,7,4,167,114
518,20,3,3,7,6,-66,33,1,7,101,147
518,21,3,4,3,10,30,-54,1,3,131,93
518,22,3,3,7,6,34,33,5,6,165,126
518,23,2,5,5,8,23,53,8,9,188,179
518,24,2,5,4,9,-78,-46,0,3,110,133
518,25,2,5,3,10,21,55,1,8,131,188
518,26,2,5,3,10,21,-45,2,3,152,143
518,27,2,5,3,10,21,55,3,8,173,198
518,28,2,4,4,9,22,-55,5,3,195,143
518,29,5,2,8,5,53,23,8,6,248,166
518,30,5,3,8,5,-47,32,1,8,201,198
518,31,6,2,8,5,62,-77,3,1,263,121
518,32,5,3,8,5,53,32,6,3,316,153
518,33,3,4,5,8,32,44,8,7,348,197
518,34,2,5,4,9,-78,-46,0,1,270,151
518,35,4,3,6,7,42,34,2,5,312,185
518,36,4,3,6,7,42,34,4,9,354,219
518,37,2,4,4,9,22,-55,6,4,376,164
518,38,3,4,4,9,31,45,7,9,407,209
518,39,5,2,9,4,-46,-78,1,1,361,131
518,40,3,3,9,4,36,31,7,2,397,162
518,41,5,2,10,3,-45,21,2,3,352,183
518,42,5,2,9,4,54,22,6,5,406,205
518,43,3,4,6,7,33,43,9,8,439,248
518,44,3,3,7,6,-66,-67,3,1,373,181
518,45,4,3,8,5,44,32,7,3,417,213
518,46,4,2,9,4,-55,22,2,5,362,235
518,47,3,3,8,5,35,32,7,7,397,267
518,48,3,4,8,5,-65,41,2,8,332,308
518,49,4,2,6,7,42,-75,4,3,374,233
518,50,4,3,8,5,44,32,8,5,418,265
518,51,5,2,8,5,-47,23,1,8,371,288
518,52,3,4,4,9,31,-55,2,3,402,233
518,53,3,4,4,9,31,45,3,8,433,278
518,54,3,4,8,5,35,41,8,9,468,319
518,55,3,4,7,6,-66,-58,2,1,402,261
518,56,2,5,3,10,21,55,3,6,423,316
518,57,2,4,6,7,24,43,7,9,447,359
518,58,3,4,8,5,-65,-59,2,0,382,300
518,59,4,2,6,7,42,25,4,5,424,325
518,60,3,4,6,7,33,43,7,8,457,368
518,61,5,2,9,4,-46,-78,1,0,411,290
518,62,3,4,4,9,31,45,2,5,442,335
518,63,5,2,10,3,55,21,7,6,497,356
518,64,4,2,7,6,-57,-76,0,0,440,280
518,65,2,4,4,9,22,45,2,5,462,325
518,66,4,2,9,4,45,22,7,7,507,347
519,1,3,3,7,6,34,33,4,3,34,33
519,2,2,4,4,9,22,45,6,8,56,78
519,3,5,2,7,6,52,-76,8,2,108,2
519,4,3,3,5,8,-68,35,0,7,40,37
519,5,3,4,8,5,35,41,5,8,75,78
519,6,3,3,6,7,33,-66,8,2,108,12
519,7,3,3,7,6,-66,33,2,5,42,45
519,8,3,4,4,9,31,-55,3,0,73,-10
519,9,4,2,9,4,45,22,8,2,118,12
519,10,2,4,7,6,-75,42,3,4,43,54
519,11,6,2,9,4,63,22,6,6,106,76
519,12,3,3,4,9,31,-64,7,2,137,12
519,13,3,3,5,8,32,35,9,7,169,47
519,14,4,3,6,7,-58,-66,1,1,111,-19
519,15,2,4,8,5,26,41,7,2,137,22
519,16,3,3,7,6,-66,33,1,5,71,55
519,17,3,4,4,9,31,-55,2,0,102,0
519,18,5,2,11,2,56,20,8,0,158,20
519,19,3,4,8,5,-65,41,3,1,93,61
519,20,4,2,9,4,45,22,8,3,138,83
519,21,4,3,7,6,-57,33,1,6,81,116
519,22,4,2,11,2,47,20,8,6,128,136
519,23,2,5,3,10,21,-45,9,1,149,91
519,24,3,3,6,7,-67,34,2,5,82,125
519,25,3,3,5,8,32,-65,4,0,114,60
519,26,3,4,4,9,31,45,5,5,145,105
519,27,3,4,4,9,31,-55,6,0,176,50
519,28,4,2,8,5,-56,23,0,3,120,73
519,29,3,4,6,7,33,43,3,6,153,116
519,30,3,3,6,7,33,-66,6,0,186,50
519,31,2,4,7,6,-75,42,1,2,111,92
519,32,3,3,6,7,33,34,4,6,144,126
519,33,3,4,5,8,32,-56,6,0,176,70
519,34,3,3,6,7,33,34,9,4,209,104
519,35,4,3,8,5,-56,32,3,6,153,136
519,36,3,4,7,6,34,42,7,8,187,178
519,37,3,3,5,8,32,-65,9,3,219,113
519,38,3,3,8,5,-65,32,4,5,154,145
519,39,2,5,5,8,23,53,7,8,177,198
519,40,3,4,5,8,32,-56,9,2,209,142
519,41,4,3,5,8,-59,35,0,7,150,177
519,42,4,3,6,7,42,-66,2,1,192,111
519,43,3,3,5,8,32,35,4,6,224,146
519,44,4,2,8,5,44,23,8,9,268,169
519,45,2,5,5,8,-77,-47,1,2,191,122
519,46,3,4,5,8,32,44,3,6,223,166
519,47,3,3,6,7,33,-66,6,0,256,100
519,48,4,3,9,4,-55,31,1,1,201,131
519,49,3,3,7,6,34,33,5,4,235,164
519,50,5,2,7,6,52,24,7,8,287,188
519,51,3,3,8,5,-65,-68,2,0,222,120
519,52,5,3,6,7,51,34,3,4,273,154
519,53,4,3,5,8,41,35,4,9,314,189
519,54,4,2,7,6,43,-76,7,3,357,113
519,55,4,3,6,7,42,34,9,7,399,147
519,56,4,3,9,4,-55,31,4,8,344,178
519,57,4,2,9,4,45,-78,9,0,389,100
519,58,2,4,5,8,-77,44,2,4,312,144
519,59,5,2,9,4,54,22,6,6,366,166
519,60,5,2,11,2,-44,20,2,6,322,186
519,61,3,4,6,7,33,43,5,9,355,229
519,62,3,4,8,5,-65,-59,0,0,290,170
519,63,3,3,6,7,33,34,3,4,323,204
519,64,3,3,7,6,34,33,7,7,357,237
519,65,2,4,3,10,21,-54,8,3,378,183
519,66,5,2,9,4,-46,22,2,5,332,205
519,67,4,3,7,6,43,33,5,8,375,238
519,68,4,3,7,6,43,-67,8,1,418,171
519,69,4,3,9,4,-55,31,3,2,363,202
519,70,4,2,7,6,43,24,6,6,406,226
519,71,3,3,7,6,-66,33,0,9,340,259
519,72,3,3,4,9,31,-64,1,5,371,195
519,73,3,3,7,6,34,33,5,8,405,228
519,74,2,5,3,10,21,-45,6,3,426,183
519,75,2,5,4,9,22,54,8,7,448,237
519,76,5,2,8,5,-47,-77,1,0,401,160
519,77,4,2,7,6,43,24,4,4,444,184
519,78,5,2,8,5,53,23,7,7,497,207
519,79,2,4,4,9,22,-55,9,2,519,152
520,1,3,3,7,6,34,33,4,3,34,33
520,2,2,4,2,11,20,-53,4,0,54,-20
520,3,3,3,8,5,35,32,9,2,89,12
520,4,3,4,5,8,-68,44,1,6,21,56
520,5,2,5,5,8,23,53,4,9,44,109
520,6,4,2,8,5,44,-77,8,2,88,32
520,7,5,2,6,7,51,25,9,7,139,57
520,8,3,4,7,6,-66,42,3,9,73,99
520,9,5,2,9,4,54,-78,7,1,127,21
520,10,3,3,4,9,31,36,8,7,158,57
520,11,4,2,8,5,-56,-77,2,0,102,-20
520,12,4,3,6,7,42,34,4,4,144,14
520,13,3,3,3,10,30,-63,4,1,174,-49
520,14,3,3,8,5,35,32,9,3,209,-17
520,15,3,3,4,9,-69,36,0,9,140,19
520,16,5,2,10,3,55,-79,5,0,195,-60
520,17,3,3,7,6,34,33,9,3,229,-27
520,18,2,4,2,11,20,-53,9,0,249,-80
520,19,3,3,8,5,-65,32,4,2,184,-48
520,20,2,5,4,9,22,54,6,6,206,6
520,21,3,3,5,8,32,-65,8,1,238,-59
520,22,5,2,10,3,-45,21,3,2,193,-38
520,23,5,2,10,3,55,21,8,3,248,-17
520,24,4,3,9,4,-55,31,3,4,193,14
520,25,3,3,7,6,34,33,7,7,227,47
520,26,3,4,4,9,31,-55,8,2,258,-8
520,27,4,3,6,7,-58,34,0,6,200,26
520,28,3,3,8,5,35,32,5,8,235,58
520,29,4,2,8,5,44,-77,9,1,279,-19
520,30,3,3,4,9,-69,36,0,7,210,17
520,31,3,3,6,7,33,-66,3,1,243,-49
520,32,3,3,6,7,33,34,6,5,276,-15
520,33,2,4,4,9,22,-55,8,0,298,-70
520,34,2,4,6,7,-76,43,2,3,222,-27
520,35,3,3,6,7,33,34,5,7,255,7
520,36,3,3,9,4,-64,31,1,8,191,38
520,37,6,2,10,3,64,21,5,9,255,59
520,38,2,4,5,8,23,-56,8,3,278,3
520,39,3,3,8,5,-65,32,3,5,213,35
520,40,2,5,5,8,23,53,6,8,236,88
520,41,2,4,4,9,22,-55,8,3,258,33
520,42,3,4,4,9,31,45,9,8,289,78
520,43,3,3,6,7,-67,-66,2,2,222,12
520,44,5,2,11,2,56,20,8,2,278,32
520,45,2,5,3,10,21,55,9,7,299,87
520,46,5,2,8,5,-47,-77,2,0,252,10
520,47,3,3,6,7,33,34,5,4,285,44
520,48,2,5,6,7,24,52,9,6,309,96
520,49,2,5,5,8,-77,53,2,9,232,149
520,50,2,5,6,7,24,-48,6,1,256,101
520,51,5,2,10,3,-45,21,1,2,211,122
520,52,4,2,5,8,41,26,2,8,252,148
520,53,3,4,3,10,30,-54,2,4,282,94
520,54,5,3,8,5,53,32,5,6,335,126
520,55,2,5,3,10,21,-45,6,1,356,81
520,56,3,3,6,7,33,34,9,5,389,115
520,57,3,3,7,6,-66,33,3,8,323,148
520,58,3,4,9,4,36,40,9,8,359,188
520,59,4,2,6,7,-58,-75,1,3,301,113
520,60,4,3,6,7,42,34,3,7,343,147
520,61,2,4,2,11,20,-53,3,4,363,94
520,62,4,3,8,5,44,32,7,6,407,126
520,63,2,5,6,7,-76,52,1,8,331,178
520,64,3,3,6,7,33,-66,4,2,364,112
520,65,4,2,7,6,43,24,7,6,407,136
520,66,2,5,4,9,22,-46,9,0,429,90
520,67,2,4,6,7,-76,43,3,3,353,133
520,68,2,5,7,6,25,51,8,4,378,184
520,69,3,4,6,7,-67,43,1,7,311,227
520,70,4,2,9,4,45,22,6,9,356,249
520,71,3,4,5,8,32,-56,8,3,388,193
520,72,4,3,9,4,-55,31,3,4,333,224
520,73,5,2,9,4,54,22,7,6,387,246
520,74,3,4,5,8,32,-56,9,0,419,190
520,75,2,5,5,8,-77,53,2,3,342,243
520,76,3,4,6,7,33,43,5,6,375,286
520,77,4,2,7,6,43,-76,8,0,418,210
520,78,4,3,7,6,-57,33,1,3,361,243
520,79,3,4,6,7,33,43,4,6,394,286
520,80,3,4,5,8,32,-56,6,0,426,230
520,81,4,3,6,7,42,34,8,4,468,264
520,82,2,4,4,9,-78,45,0,9,390,309
520,83,4,3,9,4,45,-69,5,0,435,240
520,84,2,4,7,6,-75,42,0,2,360,282
520,85,4,3,6,7,42,34,2,6,402,316
520,86,2,4,8,5,26,41,8,7,428,357
520,87,4,3,5,8,41,-65,9,2,469,292
520,88,3,3,5,8,-68,35,1,7,401,327
520,89,2,4,6,7,24,-57,5,0,425,270
520,90,3,4,8,5,-65,41,0,1,360,311
520,91,3,3,6,7,33,34,3,5,393,345
520,92,4,3,8,5,44,32,7,7,437,377
520,93,3,4,8,5,-65,41,2,8,372,418
520,94,2,4,5,8,23,-56,5,2,395,362
520,95,3,3,8,5,-65,32,0,4,330,394
520,96,4,3,7,6,43,33,3,7,373,427
520,97,4,3,8,5,44,32,7,9,417,459
520,98,4,3,7,6,-57,-67,0,2,360,392
520,99,2,4,5,8,23,44,3,6,383,436
520,100,3,3,7,6,34,33,7,9,417,469
520,101,4,3,5,8,41,-65,8,4,458,404
520,102,5,3,5,8,50,35,8,9,508,439
521,1,6,2,7,6,61,24,1,4,61,24
521,2,4,2,5,8,41,-74,2,0,102,-50
521,3,3,3,6,7,33,34,5,4,135,-16
521,4,3,3,8,5,-65,32,0,6,70,16
521,5,3,4,6,7,33,43,3,9,103,59
521,6,3,4,4,9,31,-55,4,4,134,4
521,7,3,3,6,7,33,34,7,8,167,38
521,8,3,4,6,7,-67,-57,0,1,100,-19
521,9,3,3,5,8,32,35,2,6,132,16
521,10,4,2,7,6,43,-76,5,0,175,-60
521,11,4,3,6,7,42,34,7,4,217,-26
521,12,3,4,4,9,31,45,8,9,248,19
521,13,3,3,6,7,-67,-66,1,3,181,-47
521,14,5,2,9,4,54,22,5,5,235,-25
521,15,2,6,4,9,22,63,7,8,257,38
521,16,3,3,6,7,-67,-66,0,2,190,-28
521,17,4,4,8,5,44,41,4,3,234,13
521,18,3,3,8,5,35,32,9,5,269,45
521,19,5,3,7,6,-48,33,1,8,221,78
521,20,6,2,10,3,64,21,5,9,285,99
521,21,3,4,7,6,34,-58,9,1,319,41
521,22,3,4,7,6,-66,42,3,3,253,83
521,23,5,3,7,6,52,33,5,6,305,116
521,24,4,3,8,5,44,32,9,8,349,148
521,25,5,2,8,5,-47,-77,2,1,302,71
521,26,3,3,9,4,36,31,8,2,338,102
521,27,5,2,10,3,-45,21,3,3,293,123
521,28,3,4,4,9,31,45,4,8,324,168
521,29,3,4,5,8,32,-56,6,2,356,112
521,30,3,4,5,8,32,44,8,6,388,156
521,31,5,2,9,4,-46,22,2,8,342,178
521,32,4,3,9,4,45,31,7,9,387,209
521,33,4,3,8,5,-56,-68,1,1,331,141
521,34,4,3,9,4,45,31,6,2,376,172
521,35,4,3,7,6,43,33,9,5,419,205
521,36,2,5,3,10,-79,-45,0,0,340,160
521,37,3,4,6,7,33,43,3,3,373,203
521,38,2,4,6,7,24,43,7,6,397,246
521,39,3,3,6,7,-67,-66,0,0,330,180
521,40,5,2,10,3,55,21,5,1,385,201
521,41,2,4,4,9,22,45,7,6,407,246
521,42,3,3,9,4,-64,31,3,7,343,277
521,43,2,5,4,9,22,-46,5,1,365,231
521,44,3,3,7,6,34,33,9,4,399,264
521,45,2,4,5,8,-77,44,2,8,322,308
521,46,3,3,8,5,35,-68,7,0,357,240
521,47,3,4,4,9,31,45,8,5,388,285
521,48,3,3,8,5,-65,32,3,7,323,317
521,49,3,4,8,5,35,41,8,8,358,358
521,50,2,4,4,9,-78,-55,0,3,280,303
521,51,3,3,8,5,35,32,5,5,315,335
521,52,4,2,6,7,42,-75,7,0,357,260
521,53,3,3,7,6,-66,33,1,3,291,293
521,54,4,3,8,5,44,32,5,5,335,325
521,55,2,4,5,8,23,44,8,9,358,369
521,56,3,3,4,9,31,-64,9,5,389,305
521,57,4,2,6,7,-58,-75,1,0,331,230
521,58,5,2,10,3,55,21,6,1,386,251
521,59,4,3,8,5,-56,32,0,3,330,283
521,60,3,3,5,8,32,35,2,8,362,318
521,61,4,2,9,4,45,-78,7,0,407,240
521,62,2,4,4,9,22,45,9,5,429,285
521,63,2,4,7,6,-75,42,4,7,354,327
521,64,4,3,4,9,40,-64,4,3,394,263
521,65,4,3,8,5,44,32,8,5,438,295
521,66,4,2,7,6,-57,24,1,9,381,319
521,67,4,2,8,5,44,-77,5,2,425,242
521,68,4,2,7,6,43,24,8,6,468,266
521,69,4,4,6,7,-58,43,0,9,410,309
521,70,3,3,4,9,31,-64,1,5,441,245
521,71,3,3,6,7,33,34,4,9,474,279
521,72,4,3,7,6,43,-67,7,2,517,212
522,1,3,4,5,8,32,44,2,4,32,44
522,2,4,3,6,7,42,34,4,8,74,78
522,3,4,2,8,5,44,-77,8,1,118,1
522,4,2,4,7,6,-75,42,3,3,43,43
522,5,5,2,9,4,54,22,7,5,97,65
522,6,3,3,7,6,-66,33,1,8,31,98
522,7,3,3,9,4,36,31,7,9,67,129
522,8,3,3,7,6,-66,-67,1,2,1,62
522,9,3,3,4,9,31,36,2,8,32,98
522,10,4,3,10,3,46,30,8,8,78,128
522,11,2,6,3,10,21,-36,9,2,99,92
522,12,3,3,6,7,-67,34,2,6,32,126
522,13,5,2,6,7,51,-75,3,1,83,51
522,14,3,3,5,8,32,35,5,6,115,86
522,15,4,2,5,8,41,-74,6,2,156,12
522,16,3,4,4,9,31,45,7,7,187,57
522,17,2,4,7,6,-75,42,2,9,112,99
522,18,5,2,8,5,53,-77,5,2,165,22
522,19,3,3,6,7,33,34,8,6,198,56
522,20,3,4,5,8,-68,-56,0,0,130,0
522,21,4,2,8,5,44,23,4,3,174,23
522,22,5,2,9,4,54,22,8,5,228,45
522,23,3,4,6,7,-67,43,1,8,161,88
522,24,5,2,10,3,55,21,6,9,216,109
522,25,2,4,5,8,23,-56,9,3,239,53
522,26,4,3,9,4,-55,31,4,4,184,84
522,27,4,3,7,6,43,33,7,7,227,117
522,28,2,4,5,8,-77,-56,0,1,150,61
522,29,4,3,5,8,41,35,1,6,191,96
522,30,2,5,4,9,22,-46,3,0,213,50
522,31,3,3,8,5,35,32,8,2,248,82
522,32,2,4,4,9,-78,45,0,7,170,127
522,33,3,3,6,7,33,-66,3,1,203,61
522,34,3,4,9,4,36,40,9,1,239,101
522,35,5,3,7,6,-48,33,1,4,191,134
522,36,4,3,9,4,45,31,6,5,236,165
522,37,2,4,5,8,23,44,9,9,259,209
522,38,4,3,6,7,-58,-66,1,3,201,143
522,39,5,2,9,4,54,22,5,5,255,165
522,40,2,4,6,7,24,43,9,8,279,208
522,41,2,4,6,7,-76,-57,3,1,203,151
522,42,4,3,9,4,45,31,8,2,248,182
522,43,4,2,6,7,-58,25,0,7,190,207
522,44,3,4,6,7,33,-57,3,0,223,150
522,45,2,6,2,11,20,65,3,5,243,215
522,46,3,3,7,6,34,33,7,8,277,248
522,47,2,4,8,5,-74,41,3,9,203,289
522,48,2,4,7,6,25,-58,8,1,228,231
522,49,5,2,9,4,-46,22,2,3,182,253
522,50,4,3,8,5,44,32,6,5,226,285
522,51,5,2,10,3,-45,21,1,6,181,306
522,52,4,2,7,6,43,-76,4,0,224,230
522,53,4,3,9,4,45,31,9,1,269,261
522,54,3,4,4,9,-69,45,0,6,200,306
522,55,4,2,8,5,44,23,4,9,244,329
522,56,3,4,4,9,31,-55,5,4,275,274
522,57,2,4,7,6,-75,42,0,6,200,316
522,58,2,5,4,9,22,-46,2,0,222,270
522,59,5,2,7,6,52,24,4,4,274,294
522,60,2,5,5,8,23,53,7,7,297,347
522,61,3,4,5,8,32,-56,9,1,329,291
522,62,3,3,5,8,-68,35,1,6,261,326
522,63,4,3,8,5,44,32,5,8,305,358
522,64,3,4,6,7,33,-57,8,1,338,301
522,65,3,5,6,7,-67,52,1,3,271,353
522,66,4,3,6,7,42,34,3,7,313,387
522,67,4,3,8,5,44,32,7,9,357,419
522,68,3,3,5,8,32,-65,9,4,389,354
522,69,3,3,5,8,-68,35,1,9,321,389
522,70,4,2,5,8,41,-74,2,5,362,315
522,71,4,2,6,7,42,-75,4,0,404,240
522,72,4,2,9,4,45,22,9,2,449,262
522,73,3,3,5,8,-68,35,1,7,381,297
522,74,5,2,7,6,52,-76,3,1,433,221
522,75,3,4,4,9,31,45,4,6,464,266
522,76,4,3,6,7,42,-66,6,0,506,200
523,1,5,2,7,6,52,24,2,4,52,24
523,2,4,2,7,6,43,24,5,8,95,48
523,3,5,2,10,3,-45,21,0,9,50,69
523,4,2,4,4,9,22,-55,2,4,72,14
523,5,5,2,8,5,53,23,5,7,125,37
523,6,3,4,8,5,-65,41,0,8,60,78
523,7,3,3,6,7,33,-66,3,2,93,12
523,8,4,3,9,4,45,31,8,3,138,43
523,9,3,4,5,8,-68,44,0,7,70,87
523,10,3,3,9,4,36,31,6,8,106,118
523,11,3,3,8,5,-65,-68,1,0,41,50
523,12,4,2,10,3,46,21,7,1,87,71
523,13,5,2,10,3,-45,21,2,2,42,92
523,14,3,3,5,8,32,35,4,7,74,127
523,15,5,3,7,6,52,-67,6,0,126,60
523,16,5,2,8,5,53,23,9,3,179,83
523,17,3,3,5,8,-68,35,1,8,111,118
523,18,6,2,10,3,64,21,5,9,175,139
523,19,4,3,6,7,42,-66,7,3,217,73
523,20,3,4,6,7,-67,43,0,6,150,116
523,21,4,3,8,5,44,32,4,8,194,148
523,22,3,3,8,5,35,-68,9,0,229,80
523,23,3,4,8,5,-65,41,4,1,164,121
523,24,3,3,9,4,-64,31,0,2,100,152
523,25,2,4,5,8,23,44,3,6,123,196
523,26,3,3,4,9,31,-64,4,2,154,132
523,27,3,4,7,6,34,42,8,4,188,174
523,28,4,2,9,4,-55,22,3,6,133,196
523,29,3,4,4,9,31,-55,4,1,164,141
523,30,5,2,7,6,52,24,6,5,216,165
523,31,4,3,6,7,42,34,8,9,258,199
523,32,2,5,3,10,21,-45,9,4,279,154
523,33,3,4,6,7,-67,43,2,7,212,197
523,34,4,2,8,5,44,-77,6,0,256,120
523,35,3,4,4,9,31,45,7,5,287,165
523,36,4,3,8,5,-56,32,1,7,231,197
523,37,3,4,6,7,33,-57,4,0,264,140
523,38,4,3,7,6,43,33,7,3,307,173
523,39,5,2,8,5,-47,23,0,6,260,196
523,40,3,3,9,4,36,31,6,7,296,227
523,41,2,4,6,7,-76,-57,0,0,220,170
523,42,2,5,3,10,21,55,1,5,241,225
523,43,4,2,10,3,46,21,7,6,287,246
523,44,3,4,6,7,-67,43,0,9,220,289
523,45,2,4,5,8,23,-56,3,3,243,233
523,46,4,2,10,3,46,21,9,4,289,254
523,47,4,3,8,5,-56,32,3,6,233,286
523,48,3,3,7,6,34,33,7,9,267,319
523,49,5,2,9,4,-46,-78,1,1,221,241
523,50,4,2,8,5,44,23,5,4,265,264
523,51,3,5,3,10,30,55,5,9,295,319
523,52,2,4,6,7,24,-57,9,2,319,262
523,53,3,4,6,7,-67,43,2,5,252,305
523,54,3,4,6,7,33,43,5,8,285,348
523,55,3,4,8,5,-65,41,0,9,220,389
523,56,2,6,3,10,21,-36,1,3,241,353
523,57,4,3,9,4,45,31,6,4,286,384
523,58,3,3,6,7,33,34,9,8,319,418
523,59,6,2,11,2,-35,20,4,8,284,438
523,60,3,3,5,8,32,-65,6,3,316,373
523,61,3,3,7,6,-66,33,0,6,250,406
523,62,4,3,7,6,43,33,3,9,293,439
523,63,3,3,6,7,33,-66,6,3,326,373
523,64,2,4,5,8,23,44,9,7,349,417
523,65,3,3,6,7,-67,-66,2,1,282,351
523,66,3,4,5,8,32,44,4,5,314,395
523,67,4,2,8,5,44,23,8,8,358,418
523,68,2,4,7,6,-75,-58,3,0,283,360
523,69,2,5,4,9,22,54,5,4,305,414
523,70,3,3,5,8,32,35,7,9,337,449
523,71,3,3,6,7,-67,-66,0,3,270,383
523,72,2,4,6,7,24,43,4,6,294,426
523,73,5,2,7,6,52,-76,6,0,346,350
523,74,3,3,7,6,-66,33,0,3,280,383
523,75,3,3,8,5,35,32,5,5,315,415
523,76,4,4,5,8,41,44,6,9,356,459
523,77,3,4,6,7,33,-57,9,2,389,402
523,78,3,4,3,10,30,46,9,8,419,448
523,79,3,4,6,7,-67,-57,2,1,352,391
523,80,3,3,4,9,31,36,3,7,383,427
523,81,4,2,10,3,46,21,9,8,429,448
523,82,3,3,7,6,-66,-67,3,1,363,381
523,83,4,2,9,4,45,22,8,3,408,403
523,84,4,3,5,8,41,35,9,8,449,438
523,85,3,3,8,5,-65,-68,4,0,384,370
523,86,2,5,3,10,21,55,5,5,405,425
523,87,3,3,7,6,34,33,9,8,439,458
523,88,4,2,10,3,-54,21,5,9,385,479
523,89,4,2,7,6,43,-76,8,3,428,403
523,90,2,4,6,7,-76,43,2,6,352,446
523,91,3,3,7,6,34,33,6,9,386,479
523,92,3,3,10,3,-63,30,3,9,323,509
524,1,5,2,7,6,52,24,2,4,52,24
524,2,5,2,8,5,53,23,5,7,105,47
524,3,4,2,9,4,-55,22,0,9,50,69
524,4,2,4,5,8,23,-56,3,3,73,13
524,5,4,2,7,6,43,24,6,7,116,37
524,6,4,3,7,6,43,-67,9,0,159,-30
524,7,4,3,7,6,-57,33,2,3,102,3
524,8,4,2,9,4,45,22,7,5,147,25
524,9,4,3,5,8,41,-65,8,0,188,-40
524,10,5,2,9,4,-46,22,2,2,142,-18
524,11,4,3,8,5,44,32,6,4,186,14
524,12,3,3,7,6,-66,33,0,7,120,47
524,13,5,2,9,4,54,22,4,9,174,69
524,14,3,3,7,6,34,-67,8,2,208,2
524,15,4,3,8,5,-56,32,2,4,152,34
524,16,3,5,3,10,30,55,2,9,182,89
524,17,3,3,3,10,30,-63,2,6,212,26
524,18,6,2,10,3,64,21,6,7,276,47
524,19,2,5,5,8,23,-47,9,0,299,0
524,20,3,4,4,9,-69,45,0,5,230,45
524,21,2,4,5,8,23,44,3,9,253,89
524,22,4,3,7,6,43,-67,6,2,296,22
524,23,3,4,3,10,30,46,6,8,326,68
524,24,2,4,8,5,-74,41,2,9,252,109
524,25,3,3,7,6,34,-67,6,2,286,42
524,26,6,2,9,4,63,22,9,4,349,64
524,27,5,3,7,6,-48,33,1,7,301,97
524,28,3,3,8,5,35,32,6,9,336,129
524,29,5,2,9,4,-46,-78,0,1,290,51
524,30,3,4,4,9,31,45,1,6,321,96
524,31,5,2,9,4,54,22,5,8,375,118
524,32,4,2,7,6,43,-76,8,2,418,42
524,33,5,2,10,3,-45,21,3,3,373,63
524,34,3,4,7,6,34,42,7,5,407,105
524,35,4,2,10,3,-54,21,3,6,353,126
524,36,4,2,9,4,45,22,8,8,398,148
524,37,3,4,5,8,-68,-56,0,2,330,92
524,38,5,2,9,4,54,22,4,4,384,114
524,39,3,3,6,7,33,34,7,8,417,148
524,40,3,3,7,6,-66,-67,1,1,351,81
524,41,4,3,4,9,40,36,1,7,391,117
524,42,3,4,6,7,33,-57,4,0,424,60
524,43,4,2,9,4,45,22,9,2,469,82
524,44,3,3,9,4,-64,31,5,3,405,113
524,45,5,2,8,5,53,23,8,6,458,136
524,46,4,3,9,4,-55,31,3,7,403,167
524,47,4,3,6,7,42,-66,5,1,445,101
524,48,4,3,5,8,41,35,6,6,486,136
524,49,4,2,9,4,-55,22,1,8,431,158
524,50,3,3,6,7,33,-66,4,2,464,92
524,51,3,4,5,8,32,44,6,6,496,136
524,52,2,5,6,7,-76,52,0,8,420,188
524,53,3,4,7,6,34,-58,4,0,454,130
524,54,3,3,4,9,31,36,5,6,485,166
524,55,3,3,6,7,33,-66,8,0,518,100
525,1,5,2,7,6,52,24,2,4,52,24
525,2,4,3,7,6,43,33,5,7,95,57
525,3,3,4,6,7,33,-57,8,0,128,0
525,4,3,3,4,9,31,36,9,6,159,36
525,5,4,3,5,8,-59,-65,0,1,100,-29
525,6,3,3,7,6,34,33,4,4,134,4
525,7,3,4,5,8,32,44,6,8,166,48
525,8,3,3,8,5,-65,-68,1,0,101,-20
525,9,2,5,3,10,21,55,2,5,122,35
525,10,4,2,8,5,44,23,6,8,166,58
525,11,3,3,8,5,-65,-68,1,0,101,-10
525,12,3,3,8,5,35,32,6,2,136,22
525,13,4,3,7,6,43,33,9,5,179,55
525,14,5,2,9,4,-46,22,3,7,133,77
525,15,4,3,9,4,45,31,8,8,178,108
525,16,2,5,2,11,20,-44,8,4,198,64
525,17,3,4,5,8,-68,44,0,8,130,108
525,18,4,3,7,6,43,-67,3,1,173,41
525,19,2,5,5,8,23,53,6,4,196,94
525,20,4,2,8,5,-56,23,0,7,140,117
525,21,3,4,5,8,32,-56,2,1,172,61
525,22,4,3,9,4,45,31,7,2,217,92
525,23,2,4,5,8,-77,44,0,6,140,136
525,24,4,2,7,6,43,-76,3,0,183,60
525,25,5,2,11,2,56,20,9,0,239,80
525,26,4,4,6,7,-58,43,1,3,181,123
525,27,4,3,6,7,42,34,3,7,223,157
525,28,3,3,5,8,32,-65,5,2,255,92
525,29,4,3,8,5,44,32,9,4,299,124
525,30,3,3,5,8,-68,35,1,9,231,159
525,31,4,3,9,4,45,-69,6,0,276,90
525,32,3,3,4,9,31,36,7,6,307,126
525,33,2,4,5,8,-77,-56,0,0,230,70
525,34,3,3,6,7,33,34,3,4,263,104
525,35,2,4,4,9,22,45,5,9,285,149
525,36,3,3,6,7,33,-66,8,3,318,83
525,37,2,4,6,7,-76,43,2,6,242,126
525,38,4,2,7,6,43,-76,5,0,285,50
525,39,4,3,9,4,-55,31,0,1,230,81
525,40,3,4,7,6,34,42,4,3,264,123
525,41,2,5,4,9,22,54,6,7,286,177
525,42,3,3,5,8,32,-65,8,2,318,112
525,43,2,5,3,10,21,55,9,7,339,167
525,44,2,5,3,10,-79,-45,0,2,260,122
525,45,2,4,5,8,23,44,3,6,283,166
525,46,3,4,5,8,32,-56,5,0,315,110
525,47,4,3,7,6,43,33,8,3,358,143
525,48,2,5,6,7,-76,52,2,5,282,195
525,49,4,2,7,6,43,24,5,9,325,219
525,50,2,5,3,10,21,-45,6,4,346,174
525,51,2,4,6,7,-76,43,0,7,270,217
525,52,4,2,6,7,42,-75,2,2,312,142
525,53,4,4,5,8,41,44,3,6,353,186
525,54,3,4,5,8,32,-56,5,0,385,130
525,55,4,3,8,5,44,32,9,2,429,162
525,56,3,3,8,5,-65,32,4,4,364,194
525,57,5,2,10,3,55,21,9,5,419,215
525,58,5,2,8,5,-47,23,2,8,372,238
525,59,3,3,5,8,32,-65,4,3,404,173
525,60,2,4,6,7,24,43,8,6,428,216
525,61,3,3,5,8,-68,-65,0,1,360,151
525,62,4,3,9,4,45,31,5,2,405,182
525,63,2,5,7,6,-75,51,0,3,330,233
525,64,4,2,8,5,44,23,4,6,374,256
525,65,3,4,8,5,35,41,9,7,409,297
525,66,5,2,10,3,-45,21,4,8,364,318
525,67,3,3,10,3,-63,30,1,8,301,348
525,68,2,6,4,9,22,-37,3,1,323,311
525,69,4,2,11,2,-53,20,0,1,270,331
525,70,4,2,9,4,45,22,5,3,315,353
525,71,4,2,7,6,43,24,8,7,358,377
525,72,4,3,7,6,-57,-67,1,0,301,310
525,73,3,3,5,8,32,35,3,5,333,345
525,74,3,3,4,9,31,-64,4,1,364,281
525,75,4,4,8,5,44,41,8,2,408,322
525,76,4,3,9,4,-55,31,3,3,353,353
525,77,3,3,7,6,34,33,7,6,387,386
525,78,3,4,6,7,-67,43,0,9,320,429
525,79,4,3,7,6,43,-67,3,2,363,362
525,80,2,4,7,6,25,42,8,4,388,404
525,81,2,4,5,8,-77,44,1,8,311,448
525,82,6,2,7,6,61,-76,2,2,372,372
525,83,3,4,5,8,32,44,4,6,404,416
525,84,2,4,5,8,23,-56,7,0,427,360
525,85,4,2,7,6,-57,24,0,4,370,384
525,86,3,3,6,7,33,34,3,8,403,418
525,87,3,4,3,10,30,-54,3,4,433,364
525,88,3,4,5,8,32,44,5,8,465,408
525,89,4,3,8,5,44,-68,9,0,509,340
526,1,3,4,6,7,33,43,3,3,33,43
526,2,3,4,7,6,34,42,7,5,67,85
526,3,4,2,6,7,42,-75,9,0,109,10
526,4,2,6,4,9,-78,63,1,3,31,73
526,5,2,5,6,7,24,52,5,5,55,125
526,6,3,3,5,8,32,-65,7,0,87,60
526,7,3,4,5,8,32,44,9,4,119,104
526,8,4,4,7,6,-57,42,2,6,62,146
526,9,2,5,4,9,22,-46,4,0,84,100
526,10,2,5,4,9,22,54,6,4,106,154
526,11,5,2,8,5,53,23,9,7,159,177
526,12,5,2,8,5,-47,-77,2,0,112,100
526,13,3,3,8,5,35,32,7,2,147,132
526,14,3,4,6,7,-67,43,0,5,80,175
526,15,4,3,9,4,45,31,5,6,125,206
526,16,2,4,8,5,-74,41,1,7,51,247
526,17,2,4,3,10,21,-54,2,3,72,193
526,18,3,3,7,6,34,33,6,6,106,226
526,19,4,2,9,4,-55,22,1,8,51,248
526,20,2,4,6,7,24,-57,5,1,75,191
526,21,3,3,6,7,33,34,8,5,108,225
526,22,2,5,5,8,-77,53,1,8,31,278
526,23,5,2,9,4,54,-78,5,0,85,200
526,24,2,4,6,7,24,43,9,3,109,243
526,25,3,4,4,9,-69,45,0,8,40,288
526,26,5,2,11,2,56,20,6,8,96,308
526,27,4,3,5,8,41,-65,7,3,137,243
526,28,4,3,8,5,-56,32,1,5,81,275
526,29,3,3,5,8,32,-65,3,0,113,210
526,30,4,3,7,6,43,33,6,3,156,243
526,31,4,3,5,8,41,35,7,8,197,278
526,32,4,4,6,7,42,-57,9,1,239,221
526,33,3,4,6,7,-67,43,2,4,172,264
526,34,3,4,7,6,34,42,6,6,206,306
526,35,3,3,8,5,-65,32,1,8,141,338
526,36,4,2,9,4,45,-78,6,0,186,260
526,37,4,3,8,5,-56,32,0,2,130,292
526,38,2,4,2,11,20,47,0,9,150,339
526,39,5,2,10,3,55,-79,5,0,205,260
526,40,4,4,5,8,41,44,6,4,246,304
526,41,2,4,6,7,-76,43,0,7,170,347
526,42,4,3,5,8,41,-65,1,2,211,282
526,43,5,2,9,4,54,22,5,4,265,304
526,44,3,4,7,6,34,42,9,6,299,346
526,45,4,2,9,4,-55,22,4,8,244,368
526,46,3,3,7,6,34,-67,8,1,278,301
526,47,2,4,4,9,-78,45,0,6,200,346
526,48,2,4,4,9,22,-55,2,1,222,291
526,49,4,3,8,5,44,32,6,3,266,323
526,50,4,2,8,5,-56,23,0,6,210,346
526,51,4,2,9,4,45,22,5,8,255,368
526,52,5,3,6,7,51,-66,6,2,306,302
526,53,2,4,6,7,-76,43,0,5,230,345
526,54,2,5,5,8,23,53,3,8,253,398
526,55,4,3,5,8,41,-65,4,3,294,333
526,56,3,3,8,5,35,32,9,5,329,365
526,57,5,2,11,2,-44,20,5,5,285,385
526,58,2,6,5,8,23,62,8,7,308,447
526,59,3,3,5,8,-68,-65,0,2,240,382
526,60,3,4,6,7,33,43,3,5,273,425
526,61,4,3,10,3,46,30,9,5,319,455
526,62,2,5,3,10,-79,-45,0,0,240,410
526,63,4,3,7,6,43,33,3,3,283,443
526,64,2,5,4,9,22,54,5,7,305,497
526,65,3,4,5,8,32,-56,7,1,337,441
526,66,3,3,5,8,32,35,9,6,369,476
526,67,3,3,3,10,30,-63,9,3,399,413
526,68,2,4,5,8,-77,44,2,7,322,457
526,69,3,4,5,8,32,-56,4,1,354,401
526,70,2,4,4,9,22,45,6,6,376,446
526,71,3,3,5,8,32,-65,8,1,408,381
526,72,3,3,8,5,-65,32,3,3,343,413
526,73,3,4,3,10,30,46,3,9,373,459
526,74,4,3,7,6,43,-67,6,2,416,392
526,75,3,4,7,6,-66,42,0,4,350,434
526,76,2,4,3,10,21,-54,1,0,371,380
526,77,4,2,8,5,44,23,5,3,415,403
526,78,5,2,7,6,52,24,7,7,467,427
526,79,4,2,9,4,-55,22,2,9,412,449
526,80,4,2,10,3,46,-79,8,0,458,370
526,81,3,3,8,5,-65,32,3,2,393,402
526,82,2,5,2,11,20,56,3,8,413,458
526,83,4,3,7,6,43,-67,6,1,456,391
526,84,5,2,10,3,-45,21,1,2,411,412
526,85,3,4,5,8,32,44,3,6,443,456
526,86,3,4,4,9,31,-55,4,1,474,401
526,87,2,5,5,8,23,53,7,4,497,454
526,88,2,5,2,11,20,-44,7,0,517,410
527,1,2,4,6,7,24,43,4,3,24,43
527,2,2,5,4,9,22,54,6,7,46,97
527,3,3,3,6,7,33,-66,9,1,79,31
527,4,3,3,7,6,-66,33,3,4,13,64
527,5,4,2,6,7,42,25,5,9,55,89
527,6,4,2,7,6,43,-76,8,3,98,13
527,7,2,5,4,9,-78,54,0,7,20,67
527,8,4,2,9,4,45,22,5,9,65,89
527,9,4,3,8,5,44,-68,9,1,109,21
527,10,3,4,7,6,-66,42,3,3,43,63
527,11,3,4,5,8,32,44,5,7,75,107
527,12,3,3,9,4,-64,31,1,8,11,138
527,13,3,4,3,10,30,-54,1,4,41,84
527,14,4,3,8,5,44,32,5,6,85,116
527,15,5,2,7,6,52,-76,7,0,137,40
527,16,3,3,4,9,31,36,8,6,168,76
527,17,3,3,7,6,-66,33,2,9,102,109
527,18,4,2,9,4,45,-78,7,1,147,31
527,19,2,5,3,10,21,55,8,6,168,86
527,20,3,3,6,7,-67,-66,1,0,101,20
527,21,4,2,7,6,43,24,4,4,144,44
527,22,5,2,7,6,52,24,6,8,196,68
527,23,4,3,8,5,-56,-68,0,0,140,0
527,24,4,3,7,6,43,33,3,3,183,33
527,25,4,3,9,4,45,31,8,4,228,64
527,26,2,4,3,10,21,-54,9,0,249,10
527,27,3,4,5,8,-68,44,1,4,181,54
527,28,3,4,5,8,32,44,3,8,213,98
527,29,2,5,3,10,21,-45,4,3,234,53
527,30,2,6,3,10,21,64,5,7,255,117
527,31,4,2,7,6,43,-76,8,1,298,41
527,32,4,3,10,3,-54,30,4,1,244,71
527,33,3,4,6,7,33,43,7,4,277,114
527,34,3,4,6,7,-67,43,0,7,210,157
527,35,2,5,6,7,24,52,4,9,234,209
527,36,2,4,5,8,23,-56,7,3,257,153
527,37,3,3,8,5,-65,32,2,5,192,185
527,38,3,4,5,8,32,44,4,9,224,229
527,39,2,4,6,7,24,-57,8,2,248,172
527,40,3,3,7,6,-66,33,2,5,182,205
527,41,4,2,9,4,45,22,7,7,227,227
527,42,4,3,6,7,42,-66,9,1,269,161
527,43,4,3,5,8,-59,35,0,6,210,196
527,44,3,3,8,5,35,32,5,8,245,228
527,45,2,5,4,9,22,-46,7,2,267,182
527,46,3,4,4,9,31,45,8,7,298,227
527,47,3,3,4,9,31,-64,9,3,329,163
527,48,4,2,7,6,-57,24,2,7,272,187
527,49,4,2,7,6,43,-76,5,1,315,111
527,50,3,3,7,6,34,33,9,4,349,144
527,51,5,2,10,3,-45,21,4,5,304,165
527,52,6,2,9,4,63,22,7,7,367,187
527,53,5,2,9,4,-46,22,1,9,321,209
527,54,3,3,5,8,32,-65,3,4,353,144
527,55,4,3,9,4,45,31,8,5,398,175
527,56,4,2,8,5,-56,23,2,8,342,198
527,57,2,5,4,9,22,-46,4,2,364,152
527,58,3,4,5,8,32,44,6,6,396,196
527,59,5,2,8,5,53,23,9,9,449,219
527,60,2,5,4,9,-78,-46,1,3,371,173
527,61,4,2,10,3,46,21,7,4,417,194
527,62,3,3,8,5,-65,32,2,6,352,226
527,63,2,4,6,7,24,43,6,9,376,269
527,64,4,2,7,6,43,-76,9,3,419,193
527,65,2,5,6,7,-76,52,3,5,343,245
527,66,3,4,4,9,31,-55,4,0,374,190
527,67,4,3,7,6,43,33,7,3,417,223
527,68,5,2,9,4,-46,22,1,5,371,245
527,69,4,3,8,5,44,32,5,7,415,277
527,70,3,3,7,6,34,-67,9,0,449,210
527,71,3,4,5,8,-68,44,1,4,381,254
527,72,3,3,7,6,34,33,5,7,415,287
527,73,2,4,5,8,23,-56,8,1,438,231
527,74,4,3,7,6,-57,33,1,4,381,264
527,75,4,3,9,4,45,31,6,5,426,295
527,76,2,5,7,6,-75,51,1,6,351,346
527,77,3,4,5,8,32,-56,3,0,383,290
527,78,4,3,6,7,42,34,5,4,425,324
527,79,4,3,6,7,42,34,7,8,467,358
527,80,5,2,10,3,-45,21,2,9,422,379
527,81,4,2,5,8,41,-74,3,5,463,305
527,82,4,4,6,7,42,43,5,8,505,348
528,1,2,4,5,8,23,44,3,4,23,44
528,2,4,4,8,5,44,41,7,5,67,85
528,3,4,4,6,7,42,43,9,8,109,128
528,4,5,3,7,6,-48,-67,1,1,61,61
528,5,2,5,2,11,20,56,1,7,81,117
528,6,4,3,6,7,42,-66,3,1,123,51
528,7,4,3,7,6,43,33,6,4,166,84
528,8,4,3,6,7,42,34,8,8,208,118
528,9,3,4,7,6,-66,-58,2,0,142,60
528,10,3,3,7,6,34,33,6,3,176,93
528,11,3,4,5,8,32,44,8,7,208,137
528,12,4,3,6,7,-58,-66,0,1,150,71
528,13,3,3,4,9,31,36,1,7,181,107
528,14,4,3,8,5,44,32,5,9,225,139
528,15,3,3,6,7,33,-66,8,3,258,73
528,16,3,3,7,6,-66,33,2,6,192,106
528,17,2,5,4,9,22,-46,4,0,214,60
528,18,5,2,8,5,53,23,7,3,267,83
528,19,2,4,5,8,-77,44,0,7,190,127
528,20,4,3,9,4,45,31,5,8,235,158
528,21,4,3,8,5,44,-68,9,0,279,90
528,22,2,4,5,8,-77,44,2,4,202,134
528,23,4,2,10,3,46,21,8,5,248,155
528,24,2,6,3,10,21,64,9,9,269,219
528,25,2,4,7,6,-75,-58,4,1,194,161
528,26,2,4,8,5,-74,41,0,2,120,202
528,27,4,2,8,5,44,23,4,5,164,225
528,28,3,3,4,9,31,-64,5,1,195,161
528,29,4,3,8,5,44,32,9,3,239,193
528,30,6,2,10,3,-36,21,3,4,203,214
528,31,3,3,5,8,32,35,5,9,235,249
528,32,2,4,3,10,21,-54,6,5,256,195
528,33,3,4,3,10,30,-54,6,1,286,141
528,34,2,5,4,9,22,54,8,5,308,195
528,35,2,4,6,7,-76,43,2,8,232,238
528,36,2,5,5,8,23,-47,5,1,255,191
528,37,5,2,8,5,53,23,8,4,308,214
528,38,4,3,7,6,-57,33,1,7,251,247
528,39,4,4,5,8,41,-56,2,1,292,191
528,40,2,4,5,8,23,44,5,5,315,235
528,41,2,5,5,8,23,53,8,8,338,288
528,42,2,4,3,10,21,-54,9,4,359,234
528,43,4,3,7,6,-57,33,2,7,302,267
528,44,6,2,9,4,63,22,5,9,365,289
528,45,4,3,5,8,41,-65,6,4,406,224
528,46,3,4,5,8,32,44,8,8,438,268
528,47,4,2,10,3,-54,21,4,9,384,289
528,48,2,5,2,11,20,-44,4,5,404,245
528,49,3,4,6,7,33,43,7,8,437,288
528,50,2,5,4,9,22,-46,9,2,459,242
528,51,3,4,3,10,30,46,9,8,489,288
528,52,3,5,9,4,-64,-50,5,8,425,238
528,53,3,3,8,5,-65,-68,0,0,360,170
528,54,3,4,5,8,32,44,2,4,392,214
528,55,3,3,6,7,33,34,5,8,425,248
528,56,5,2,11,2,-44,20,1,8,381,268
528,57,6,2,10,3,64,21,5,9,445,289
528,58,3,3,7,6,34,-67,9,2,479,222
528,59,3,4,3,10,30,46,9,8,509,268
529,1,3,3,4,9,31,36,1,6,31,36
529,2,6,2,10,3,64,21,5,7,95,57
529,3,2,4,6,7,24,-57,9,0,119,0
529,4,4,3,7,6,-57,33,2,3,62,33
529,5,4,3,8,5,44,32,6,5,106,65
529,6,3,4,5,8,32,44,8,9,138,109
529,7,4,2,10,3,-54,-79,4,0,84,30
529,8,3,4,6,7,33,43,7,3,117,73
529,9,3,3,6,7,-67,34,0,7,50,107
529,10,6,2,8,5,62,-77,2,0,112,30
529,11,2,5,4,9,22,54,4,4,134,84
529,12,3,4,5,8,32,44,6,8,166,128
529,13,3,3,7,6,-66,-67,0,1,100,61
529,14,4,3,7,6,43,33,3,4,143,94
529,15,4,4,8,5,44,41,7,5,187,135
529,16,3,4,5,8,32,44,9,9,219,179
529,17,2,5,4,9,-78,-46,1,3,141,133
529,18,3,4,6,7,33,43,4,6,174,176
529,19,3,3,4,9,31,-64,5,2,205,112
529,20,4,4,8,5,44,41,9,3,249,153
529,21,5,2,10,3,-45,21,4,4,204,174
529,22,2,5,3,10,21,55,5,9,225,229
529,23,3,4,6,7,33,-57,8,2,258,172
529,24,2,4,4,9,-78,45,0,7,180,217
529,25,3,3,7,6,34,-67,4,0,214,150
529,26,2,5,4,9,22,54,6,4,236,204
529,27,3,4,3,10,30,-54,6,0,266,150
529,28,3,3,7,6,-66,33,0,3,200,183
529,29,2,4,5,8,23,44,3,7,223,227
529,30,3,3,7,6,34,-67,7,0,257,160
529,31,4,2,8,5,-56,23,1,3,201,183
529,32,3,3,6,7,33,34,4,7,234,217
529,33,4,3,6,7,42,-66,6,1,276,151
529,34,4,2,9,4,-55,22,1,3,221,173
529,35,3,3,5,8,32,35,3,8,253,208
529,36,4,4,4,9,40,-55,3,3,293,153
529,37,3,4,6,7,33,43,6,6,326,196
529,38,4,3,5,8,41,-65,7,1,367,131
529,39,3,4,4,9,31,45,8,6,398,176
529,40,3,4,6,7,-67,43,1,9,331,219
529,41,6,2,8,5,62,-77,3,2,393,142
529,42,5,2,8,5,53,23,6,5,446,165
529,43,2,4,7,6,-75,42,1,7,371,207
529,44,3,3,6,7,33,-66,4,1,404,141
529,45,2,4,5,8,23,44,7,5,427,185
529,46,2,4,2,11,20,-53,7,2,447,132
529,47,3,3,7,6,-66,33,1,5,381,165
529,48,4,2,11,2,47,20,8,5,428,185
529,49,4,2,7,6,-57,24,1,9,371,209
529,50,4,3,7,6,43,-67,4,2,414,142
529,51,5,2,11,2,-44,20,0,2,370,162
529,52,4,3,8,5,44,32,4,4,414,194
529,53,2,6,5,8,23,62,7,6,437,256
529,54,3,4,6,7,-67,43,0,9,370,299
529,55,3,3,8,5,35,-68,5,1,405,231
529,56,2,5,3,10,21,55,6,6,426,286
529,57,3,3,8,5,-65,32,1,8,361,318
529,58,3,3,7,6,34,-67,5,1,395,251
529,59,4,2,8,5,44,23,9,4,439,274
529,60,5,2,9,4,-46,22,3,6,393,296
529,61,2,4,4,9,22,-55,5,1,415,241
529,62,5,2,11,2,-44,20,1,1,371,261
529,63,3,3,9,4,36,31,7,2,407,292
529,64,4,2,9,4,-55,22,2,4,352,314
529,65,3,3,6,7,33,34,5,8,385,348
529,66,2,4,5,8,23,-56,8,2,408,292
529,67,3,3,7,6,-66,33,2,5,342,325
529,68,4,3,7,6,43,33,5,8,385,358
529,69,2,5,5,8,23,-47,8,1,408,311
529,70,2,4,4,9,-78,45,0,6,330,356
529,71,4,3,9,4,45,31,5,7,375,387
529,72,2,5,5,8,23,-47,8,0,398,340
529,73,2,4,4,9,-78,45,0,5,320,385
529,74,4,3,9,4,45,31,5,6,365,416
529,75,3,3,7,6,34,33,9,9,399,449
529,76,3,5,5,8,-68,-47,1,2,331,402
529,77,4,2,6,7,42,25,3,7,373,427
529,78,3,3,7,6,34,-67,7,0,407,360
529,79,5,2,9,4,-46,22,1,2,361,382
529,80,4,3,5,8,41,35,2,7,402,417
529,81,4,4,9,4,45,40,7,7,447,457
529,82,4,3,6,7,42,-66,9,1,489,391
529,83,3,4,5,8,-68,44,1,5,421,435
529,84,2,4,3,10,21,-54,2,1,442,381
529,85,3,3,7,6,34,33,6,4,476,414
529,86,4,3,9,4,-55,31,1,5,421,445
529,87,3,3,7,6,34,33,5,8,455,478
529,88,4,3,6,7,42,-66,7,2,497,412
529,89,5,3,10,3,-45,30,2,2,452,442
529,90,5,2,8,5,53,23,5,5,505,465
530,1,3,3,4,9,31,36,1,6,31,36
530,2,2,5,2,11,20,-44,1,2,51,-8
530,3,4,3,7,6,43,33,4,5,94,25
530,4,2,4,7,6,25,42,9,7,119,67
530,5,2,4,2,11,20,-53,9,4,139,14
530,6,4,3,6,7,-58,34,1,8,81,48
530,7,3,3,7,6,34,-67,5,1,115,-19
530,8,4,2,11,2,-53,20,2,1,62,1
530,9,4,3,5,8,41,35,3,6,103,36
530,10,4,2,11,2,-53,20,0,6,50,56
530,11,3,4,4,9,31,-55,1,1,81,1
530,12,3,4,6,7,33,43,4,4,114,44
530,13,4,2,7,6,43,24,7,8,157,68
530,14,3,3,7,6,-66,-67,1,1,91,1
530,15,4,3,9,4,45,31,6,2,136,32
530,16,3,4,7,6,-66,42,0,4,70,74
530,17,4,2,5,8,41,-74,1,0,111,0
530,18,2,4,4,9,22,45,3,5,133,45
530,19,2,4,7,6,25,42,8,7,158,87
530,20,2,5,3,10,21,-45,9,2,179,42
530,21,6,2,10,3,-36,21,3,3,143,63
530,22,3,3,7,6,34,33,7,6,177,96
530,23,2,5,4,9,22,-46,9,0,199,50
530,24,4,3,7,6,-57,33,2,3,142,83
530,25,3,3,7,6,34,33,6,6,176,116
530,26,5,2,10,3,-45,21,1,7,131,137
530,27,3,3,7,6,34,-67,5,0,165,70
530,28,5,2,9,4,54,22,9,2,219,92
530,29,4,2,5,8,-59,26,0,8,160,118
530,30,3,3,6,7,33,-66,3,2,193,52
530,31,5,2,10,3,55,21,8,3,248,73
530,32,5,2,10,3,-45,21,3,4,203,94
530,33,2,4,7,6,25,42,8,6,228,136
530,34,4,3,4,9,40,-64,8,2,268,72
530,35,4,3,5,8,41,35,9,7,309,107
530,36,5,2,9,4,-46,22,3,9,263,129
530,37,5,2,10,3,55,-79,8,0,318,50
530,38,3,4,7,6,-66,42,2,2,252,92
530,39,5,2,10,3,55,21,7,3,307,113
530,40,3,3,5,8,32,35,9,8,339,148
530,41,2,5,6,7,-76,-48,3,0,263,100
530,42,2,5,3,10,21,55,4,5,284,155
530,43,3,4,6,7,33,43,7,8,317,198
530,44,2,5,5,8,-77,-47,0,1,240,151
530,45,3,3,7,6,34,33,4,4,274,184
530,46,3,3,6,7,33,34,7,8,307,218
530,47,4,3,6,7,42,-66,9,2,349,152
530,48,2,5,5,8,-77,53,2,5,272,205
530,49,2,4,6,7,24,43,6,8,296,248
530,50,2,5,4,9,22,-46,8,2,318,202
530,51,6,2,10,3,-36,21,2,3,282,223
530,52,4,2,7,6,43,24,5,7,325,247
530,53,2,5,3,10,21,-45,6,2,346,202
530,54,3,4,5,8,32,44,8,6,378,246
530,55,4,2,5,8,41,-74,9,2,419,172
530,56,3,4,6,7,-67,43,2,5,352,215
530,57,3,4,5,8,32,44,4,9,384,259
530,58,3,4,4,9,31,-55,5,4,415,204
530,59,4,3,9,4,-55,31,0,5,360,235
530,60,2,4,4,9,22,-55,2,0,382,180
530,61,3,3,5,8,32,35,4,5,414,215
530,62,4,2,8,5,44,23,8,8,458,238
530,63,5,2,8,5,-47,-77,1,1,411,161
530,64,3,3,9,4,36,31,7,2,447,192
530,65,3,3,6,7,-67,34,0,6,380,226
530,66,2,5,6,7,24,52,4,8,404,278
530,67,3,4,5,8,32,-56,6,2,436,222
530,68,4,3,7,6,43,33,9,5,479,255
530,69,2,4,2,11,20,-53,9,2,499,202
530,70,3,3,6,7,-67,34,2,6,432,236
530,71,2,4,7,6,25,42,7,8,457,278
530,72,3,3,9,4,-64,31,3,9,393,309
530,73,5,2,9,4,54,-78,7,1,447,231
530,74,2,6,3,10,21,64,8,5,468,295
530,75,3,3,5,8,-68,-65,0,0,400,230
530,76,4,3,4,9,40,36,0,6,440,266
530,77,3,4,7,6,34,42,4,8,474,308
530,78,4,4,5,8,41,-56,5,2,515,252
531,1,4,3,5,8,41,35,1,5,41,35
531,2,4,4,5,8,41,44,2,9,82,79
531,3,4,2,8,5,44,-77,6,2,126,2
531,4,5,2,10,3,-45,21,1,3,81,23
531,5,3,4,4,9,31,45,2,8,112,68
531,6,4,3,6,7,42,-66,4,2,154,2
531,7,5,2,7,6,52,24,6,6,206,26
531,8,4,2,9,4,-55,22,1,8,151,48
531,9,3,3,7,6,34,-67,5,1,185,-19
531,10,3,3,6,7,33,34,8,5,218,15
531,11,3,3,4,9,31,-64,9,1,249,-49
531,12,2,5,5,8,-77,53,2,4,172,4
531,13,5,2,11,2,56,20,8,4,228,24
531,14,5,2,9,4,-46,22,2,6,182,46
531,15,5,2,8,5,53,23,5,9,235,69
531,16,5,2,7,6,52,-76,7,3,287,-7
531,17,3,3,6,7,-67,34,0,7,220,27
531,18,4,3,7,6,43,-67,3,0,263,-40
531,19,4,3,8,5,44,32,7,2,307,-8
531,20,3,4,7,6,-66,42,1,4,241,34
531,21,2,5,6,7,24,52,5,6,265,86
531,22,3,4,7,6,34,42,9,8,299,128
531,23,4,4,4,9,40,-55,9,3,339,73
531,24,4,2,8,5,-56,23,3,6,283,96
531,25,4,2,6,7,42,-75,5,1,325,21
531,26,3,4,4,9,31,45,6,6,356,66
531,27,6,2,10,3,-36,21,0,7,320,87
531,28,3,4,4,9,31,-55,1,2,351,32
531,29,3,4,4,9,31,45,2,7,382,77
531,30,2,4,5,8,23,-56,5,1,405,21
531,31,2,6,3,10,21,64,6,5,426,85
531,32,4,2,8,5,-56,23,0,8,370,108
531,33,5,2,9,4,54,-78,4,0,424,30
531,34,4,3,9,4,45,31,9,1,469,61
531,35,4,3,7,6,-57,33,2,4,412,94
531,36,5,3,6,7,51,34,3,8,463,128
531,37,5,2,7,6,52,-76,5,2,515,52
532,1,3,3,5,8,32,35,2,5,32,35
532,2,3,3,6,7,33,34,5,9,65,69
532,3,2,4,4,9,22,-55,7,4,87,14
532,4,2,4,4,9,22,45,9,9,109,59
532,5,5,3,8,5,-47,-68,2,1,62,-9
532,6,4,3,5,8,41,35,3,6,103,26
532,7,3,3,5,8,32,-65,5,1,135,-39
532,8,3,3,4,9,31,36,6,7,166,-3
532,9,2,4,6,7,-76,-57,0,0,90,-60
532,10,2,5,5,8,23,53,3,3,113,-7
532,11,3,4,5,8,32,44,5,7,145,37
532,12,2,5,3,10,21,-45,6,2,166,-8
532,13,4,2,7,6,43,24,9,6,209,16
532,14,4,3,6,7,-58,-66,1,0,151,-50
532,15,4,2,9,4,45,22,6,2,196,-28
532,16,2,4,5,8,23,44,9,6,219,16
532,17,3,3,7,6,-66,33,3,9,153,49
532,18,4,3,6,7,42,-66,5,3,195,-17
532,19,4,2,10,3,-54,21,1,4,141,4
532,20,3,3,5,8,32,35,3,9,173,39
532,21,2,5,1,12,-20,-43,3,6,153,-4
532,22,2,4,3,10,21,-54,4,2,174,-58
532,23,4,2,5,8,41,26,5,8,215,-32
532,24,2,5,5,8,23,-47,8,1,238,-79
532,25,3,3,4,9,31,36,9,7,269,-43
532,26,3,4,5,8,-68,-56,1,1,201,-99
532,27,3,3,5,8,32,35,3,6,233,-64
532,28,4,2,7,6,43,-76,6,0,276,-140
532,29,2,4,4,9,22,45,8,5,298,-95
532,30,2,5,6,7,-76,52,2,7,222,-43
532,31,3,4,3,10,30,-54,2,3,252,-97
532,32,4,2,7,6,43,24,5,7,295,-73
532,33,3,4,4,9,31,-55,6,2,326,-128
532,34,3,4,7,6,-66,42,0,4,260,-86
532,35,4,3,7,6,43,33,3,7,303,-53
532,36,2,6,3,10,21,-36,4,1,324,-89
532,37,4,3,6,7,42,34,6,5,366,-55
532,38,2,5,5,8,23,53,9,8,389,-2
532,39,3,3,8,5,-65,-68,4,0,324,-70
532,40,3,3,5,8,32,35,6,5,356,-35
532,41,4,3,9,4,-55,31,1,6,301,-4
532,42,2,5,4,9,22,-46,3,0,323,-50
532,43,2,4,8,5,26,41,9,1,349,-9
532,44,3,3,7,6,-66,33,3,4,283,24
532,45,4,4,6,7,42,43,5,7,325,67
532,46,4,3,6,7,42,-66,7,1,367,1
532,47,2,4,8,5,-74,41,3,2,293,42
532,48,3,4,7,6,34,42,7,4,327,84
532,49,2,5,4,9,22,54,9,8,349,138
532,50,3,3,7,6,-66,-67,3,1,283,71
532,51,4,3,7,6,43,33,6,4,326,104
532,52,3,3,8,5,-65,32,1,6,261,136
532,53,4,2,6,7,42,-75,3,1,303,61
532,54,2,5,6,7,24,52,7,3,327,113
532,55,4,2,8,5,-56,23,1,6,271,136
532,56,4,3,6,7,42,-66,3,0,313,70
532,57,3,4,4,9,31,45,4,5,344,115
532,58,5,3,7,6,52,33,6,8,396,148
532,59,5,2,10,3,-45,21,1,9,351,169
532,60,4,3,4,9,40,-64,1,5,391,105
532,61,2,5,3,10,21,-45,2,0,412,60
532,62,3,4,6,7,33,43,5,3,445,103
532,63,2,4,2,11,20,-53,5,0,465,50
532,64,5,2,7,6,52,24,7,4,517,74
533,1,2,4,6,7,24,43,4,3,24,43
533,2,3,4,4,9,31,45,5,8,55,88
533,3,3,3,6,7,33,-66,8,2,88,22
533,4,3,3,7,6,-66,33,2,5,22,55
533,5,4,4,7,6,43,42,5,7,65,97
533,6,3,3,5,8,32,-65,7,2,97,32
533,7,4,2,11,2,-53,20,4,2,44,52
533,8,3,5,7,6,34,51,8,3,78,103
533,9,3,3,6,7,-67,34,1,7,11,137
533,10,6,2,9,4,63,22,4,9,74,159
533,11,3,3,7,6,34,-67,8,2,108,92
533,12,4,4,5,8,41,44,9,6,149,136
533,13,4,3,9,4,-55,31,4,7,94,167
533,14,2,4,7,6,25,42,9,9,119,209
533,15,4,3,8,5,-56,-68,3,1,63,141
533,16,3,3,9,4,36,31,9,2,99,172
533,17,4,2,9,4,-55,22,4,4,44,194
533,18,3,3,5,8,32,35,6,9,76,229
533,19,4,2,7,6,43,-76,9,3,119,153
533,20,4,4,4,9,40,45,9,8,159,198
533,21,3,3,7,6,-66,-67,3,1,93,131
533,22,4,3,8,5,44,32,7,3,137,163
533,23,4,3,8,5,-56,32,1,5,81,195
533,24,2,5,7,6,25,51,6,6,106,246
533,25,6,2,9,4,63,22,9,8,169,268
533,26,3,3,5,8,-68,-65,1,3,101,203
533,27,3,4,6,7,33,43,4,6,134,246
533,28,2,5,4,9,22,-46,6,0,156,200
533,29,4,2,7,6,43,24,9,4,199,224
533,30,4,3,6,7,-58,34,1,8,141,258
533,31,4,2,8,5,44,-77,5,1,185,181
533,32,3,3,7,6,34,33,9,4,219,214
533,33,3,3,7,6,-66,33,3,7,153,247
533,34,3,3,7,6,34,-67,7,0,187,180
533,35,2,5,3,10,21,55,8,5,208,235
533,36,3,3,7,6,-66,33,2,8,142,268
533,37,3,4,6,7,33,-57,5,1,175,211
533,38,3,3,8,5,-65,32,0,3,110,243
533,39,5,2,9,4,54,22,4,5,164,265
533,40,3,5,5,8,32,53,6,8,196,318
533,41,4,3,6,7,42,-66,8,2,238,252
533,42,4,3,5,8,41,35,9,7,279,287
533,43,5,2,7,6,-48,-76,1,1,231,211
533,44,5,2,10,3,55,21,6,2,286,232
533,45,3,3,7,6,-66,33,0,5,220,265
533,46,4,3,7,6,43,33,3,8,263,298
533,47,4,2,10,3,46,21,9,9,309,319
533,48,3,4,6,7,-67,-57,2,2,242,262
533,49,3,3,7,6,34,33,6,5,276,295
533,50,2,4,5,8,23,44,9,9,299,339
533,51,2,4,3,10,-79,-54,0,5,220,285
533,52,5,2,11,2,56,20,6,5,276,305
533,53,4,2,9,4,-55,22,1,7,221,327
533,54,4,3,6,7,42,-66,3,1,263,261
533,55,2,5,5,8,23,53,6,4,286,314
533,56,3,4,5,8,32,44,8,8,318,358
533,57,3,4,4,9,31,-55,9,3,349,303
533,58,4,2,8,5,-56,23,3,6,293,326
533,59,3,3,7,6,34,33,7,9,327,359
533,60,3,3,6,7,-67,-66,0,3,260,293
533,61,2,5,7,6,25,51,5,4,285,344
533,62,4,2,7,6,43,24,8,8,328,368
533,63,2,4,3,10,21,-54,9,4,349,314
533,64,3,3,10,3,-63,30,6,4,286,344
533,65,2,6,5,8,23,62,9,6,309,406
533,66,4,4,6,7,-58,43,1,9,251,449
533,67,3,4,5,8,32,-56,3,3,283,393
533,68,2,5,2,11,20,56,3,9,303,449
533,69,4,3,7,6,43,-67,6,2,346,382
533,70,3,3,6,7,33,34,9,6,379,416
533,71,4,2,8,5,-56,23,3,9,323,439
533,72,4,3,5,8,41,-65,4,4,364,374
533,73,2,4,4,9,22,45,6,9,386,419
533,74,3,3,5,8,32,-65,8,4,418,354
533,75,3,4,6,7,-67,43,1,7,351,397
533,76,2,6,2,11,20,-35,1,2,371,362
533,77,3,3,6,7,33,34,4,6,404,396
533,78,2,5,2,11,20,-44,4,2,424,352
533,79,4,3,9,4,45,31,9,3,469,383
533,80,3,3,9,4,-64,31,5,4,405,414
533,81,3,3,5,8,32,35,7,9,437,449
533,82,2,4,2,11,20,-53,7,6,457,396
533,83,3,4,4,9,31,-55,8,1,488,341
533,84,4,2,8,5,-56,23,2,4,432,364
533,85,2,4,8,5,26,41,8,5,458,405
533,86,3,4,4,9,31,-55,9,0,489,350
533,87,3,4,5,8,-68,44,1,4,421,394
533,88,3,4,4,9,31,45,2,9,452,439
533,89,3,3,9,4,36,-69,8,0,488,370
533,90,3,4,5,8,-68,44,0,4,420,414
533,91,3,3,7,6,34,33,4,7,454,447
533,92,3,3,6,7,33,-66,7,1,487,381
533,93,3,3,7,6,-66,33,1,4,421,414
533,94,4,3,7,6,43,33,4,7,464,447
533,95,3,4,6,7,33,-57,7,0,497,390
533,96,3,3,4,9,31,36,8,6,528,426
534,1,4,3,9,4,45,31,5,1,45,31
534,2,3,3,7,6,34,33,9,4,79,64
534,3,4,4,6,7,-58,43,1,7,21,107
534,4,4,2,8,5,44,-77,5,0,65,30
534,5,3,4,5,8,32,44,7,4,97,74
534,6,3,4,5,8,32,44,9,8,129,118
534,7,4,2,5,8,-59,-74,0,4,70,44
534,8,4,3,8,5,44,32,4,6,114,76
534,9,2,5,4,9,22,-46,6,0,136,30
534,10,4,2,11,2,-53,20,3,0,83,50
534,11,6,2,11,2,65,20,8,0,148,70
534,12,3,3,5,8,-68,35,0,5,80,105
534,13,4,2,8,5,44,23,4,8,124,128
534,14,3,3,8,5,35,-68,9,0,159,60
534,15,5,2,9,4,-46,22,3,2,113,82
534,16,3,3,5,8,32,35,5,7,145,117
534,17,4,3,8,5,44,32,9,9,189,149
534,18,3,4,7,6,-66,-58,3,1,123,91
534,19,4,3,8,5,44,32,7,3,167,123
534,20,2,5,4,9,22,54,9,7,189,177
534,21,2,4,7,6,-75,42,4,9,114,219
534,22,5,2,9,4,54,-78,8,1,168,141
534,23,4,4,6,7,-58,43,0,4,110,184
534,24,3,3,5,8,32,35,2,9,142,219
534,25,5,2,8,5,53,-77,5,2,195,142
534,26,5,3,10,3,-45,30,0,2,150,172
534,27,4,3,8,5,44,32,4,4,194,204
534,28,3,4,6,7,33,43,7,7,227,247
534,29,4,3,6,7,42,-66,9,1,269,181
534,30,4,3,7,6,-57,33,2,4,212,214
534,31,5,2,8,5,53,23,5,7,265,237
534,32,3,3,8,5,-65,32,0,9,200,269
534,33,4,3,5,8,41,-65,1,4,241,204
534,34,3,4,4,9,31,45,2,9,272,249
534,35,2,5,3,10,21,-45,3,4,293,204
534,36,2,5,3,10,21,55,4,9,314,259
534,37,3,4,6,7,33,-57,7,2,347,202
534,38,2,4,7,6,-75,42,2,4,272,244
534,39,5,2,9,4,54,22,6,6,326,266
534,40,5,2,9,4,-46,22,0,8,280,288
534,41,3,3,7,6,34,-67,4,1,314,221
534,42,3,3,8,5,35,32,9,3,349,253
534,43,2,5,3,10,-79,55,0,8,270,308
534,44,3,3,6,7,33,-66,3,2,303,242
534,45,3,4,5,8,32,44,5,6,335,286
534,46,3,3,6,7,33,-66,8,0,368,220
534,47,2,4,3,10,21,46,9,6,389,266
534,48,3,4,4,9,-69,-55,0,1,320,211
534,49,3,3,8,5,35,32,5,3,355,243
534,50,2,4,5,8,23,44,8,7,378,287
534,51,3,3,6,7,-67,-66,1,1,311,221
534,52,3,4,9,4,36,40,7,1,347,261
534,53,5,2,10,3,-45,21,2,2,302,282
534,54,3,3,8,5,35,32,7,4,337,314
534,55,4,2,9,4,-55,22,2,6,282,336
534,56,2,4,5,8,23,-56,5,0,305,280
534,57,3,3,7,6,34,33,9,3,339,313
534,58,5,2,9,4,-46,22,3,5,293,335
534,59,5,2,7,6,52,24,5,9,345,359
534,60,2,5,7,6,-75,-49,0,0,270,310
534,61,3,4,3,10,30,46,0,6,300,356
534,62,3,3,7,6,34,33,4,9,334,389
534,63,2,6,5,8,23,-38,7,1,357,351
534,64,5,2,10,3,-45,21,2,2,312,372
534,65,3,3,9,4,36,31,8,3,348,403
534,66,2,6,4,9,-78,63,0,6,270,466
534,67,2,5,3,10,21,-45,1,1,291,421
534,68,3,4,4,9,31,45,2,6,322,466
534,69,4,3,9,4,45,31,7,7,367,497
534,70,2,4,4,9,22,-55,9,2,389,442
534,71,2,4,5,8,-77,44,2,6,312,486
534,72,4,3,6,7,42,-66,4,0,354,420
534,73,4,2,8,5,44,23,8,3,398,443
534,74,5,2,8,5,-47,23,1,6,351,466
534,75,4,3,8,5,44,32,5,8,395,498
534,76,4,2,7,6,43,-76,8,2,438,422
534,77,4,3,6,7,-58,34,0,6,380,456
534,78,5,2,8,5,53,23,3,9,433,479
534,79,4,3,5,8,41,-65,4,4,474,414
534,80,3,4,7,6,34,42,8,6,508,456
535,1,2,4,5,8,23,44,3,4,23,44
535,2,3,3,8,5,35,32,8,6,58,76
535,3,3,3,8,5,-65,32,3,8,-7,108
535,4,4,3,5,8,41,-65,4,3,34,43
535,5,4,3,7,6,43,33,7,6,77,76
535,6,4,2,7,6,-57,-76,0,0,20,0
535,7,5,3,7,6,52,33,2,3,72,33
535,8,3,4,5,8,32,44,4,7,104,77
535,9,5,2,10,3,55,21,9,8,159,98
535,10,2,4,5,8,-77,-56,2,2,82,42
535,11,3,4,9,4,36,40,8,2,118,82
535,12,2,4,4,9,-78,45,0,7,40,127
535,13,2,5,4,9,22,-46,2,1,62,81
535,14,3,4,4,9,31,45,3,6,93,126
535,15,4,3,8,5,44,32,7,8,137,158
535,16,3,4,7,6,-66,-58,1,0,71,100
535,17,4,3,7,6,43,33,4,3,114,133
535,18,4,3,9,4,45,31,9,4,159,164
535,19,3,4,5,8,-68,44,1,8,91,208
535,20,4,2,9,4,45,-78,6,0,136,130
535,21,5,3,9,4,-46,31,0,1,90,161
535,22,4,4,7,6,43,42,3,3,133,203
535,23,2,5,3,10,21,55,4,8,154,258
535,24,3,5,4,9,31,-46,5,2,185,212
535,25,3,3,4,9,31,36,6,8,216,248
535,26,4,3,8,5,-56,-68,0,0,160,180
535,27,3,3,8,5,35,32,5,2,195,212
535,28,3,4,3,10,30,46,5,8,225,258
535,29,4,2,6,7,42,-75,7,3,267,183
535,30,5,2,7,6,52,24,9,7,319,207
535,31,2,5,5,8,-77,-47,2,0,242,160
535,32,2,4,6,7,24,43,6,3,266,203
535,33,2,4,6,7,-76,43,0,6,190,246
535,34,4,3,7,6,43,33,3,9,233,279
535,35,4,2,9,4,45,-78,8,1,278,201
535,36,3,5,3,10,30,55,8,6,308,256
535,37,3,3,8,5,-65,32,3,8,243,288
535,38,5,2,7,6,52,-76,5,2,295,212
535,39,4,3,9,4,-55,31,0,3,240,243
535,40,4,4,3,10,-40,46,0,9,200,289
535,41,2,4,8,5,26,-59,6,0,226,230
535,42,4,2,9,4,-55,22,1,2,171,252
535,43,5,2,8,5,53,23,4,5,224,275
535,44,3,4,8,5,35,41,9,6,259,316
535,45,4,2,7,6,-57,-76,2,0,202,240
535,46,3,3,5,8,32,35,4,5,234,275
535,47,2,4,6,7,24,43,8,8,258,318
535,48,3,3,5,8,-68,-65,0,3,190,253
535,49,3,3,8,5,35,32,5,5,225,285
535,50,4,2,8,5,44,23,9,8,269,308
535,51,2,4,4,9,-78,-55,1,3,191,253
535,52,3,4,5,8,32,44,3,7,223,297
535,53,3,3,6,7,33,-66,6,1,256,231
535,54,3,3,8,5,-65,32,1,3,191,263
535,55,3,4,4,9,31,45,2,8,222,308
535,56,4,3,8,5,44,-68,6,0,266,240
535,57,6,2,10,3,-36,21,0,1,230,261
535,58,2,6,2,11,20,65,0,6,250,326
535,59,4,2,6,7,42,-75,2,1,292,251
535,60,5,2,8,5,53,23,5,4,345,274
535,61,2,4,7,6,-75,42,0,6,270,316
535,62,4,3,5,8,41,-65,1,1,311,251
535,63,3,3,6,7,33,34,4,5,344,285
535,64,2,5,5,8,23,53,7,8,367,338
535,65,3,4,6,7,-67,-57,0,1,300,281
535,66,4,3,8,5,44,32,4,3,344,313
535,67,3,3,8,5,35,32,9,5,379,345
535,68,3,3,5,8,-68,-65,1,0,311,280
535,69,3,4,5,8,32,44,3,4,343,324
535,70,2,4,5,8,23,44,6,8,366,368
535,71,3,4,6,7,33,-57,9,1,399,311
535,72,3,3,7,6,-66,33,3,4,333,344
535,73,5,2,9,4,54,22,7,6,387,366
535,74,4,2,10,3,-54,21,3,7,333,387
535,75,3,4,5,8,32,-56,5,1,365,331
535,76,3,4,5,8,32,44,7,5,397,375
535,77,4,4,5,8,41,44,8,9,438,419
535,78,4,3,7,6,-57,-67,1,2,381,352
535,79,2,5,2,11,20,56,1,8,401,408
535,80,3,3,8,5,35,-68,6,0,436,340
535,81,2,6,3,10,21,64,7,4,457,404
535,82,4,3,6,7,42,34,9,8,499,438
535,83,3,3,10,3,-63,30,6,8,436,468
535,84,3,4,6,7,33,-57,9,1,469,411
535,85,4,2,8,5,-56,23,3,4,413,434
535,86,5,2,8,5,53,23,6,7,466,457
535,87,4,3,8,5,-56,32,0,9,410,489
535,88,3,3,7,6,34,-67,4,2,444,422
535,89,2,5,2,11,20,56,4,8,464,478
535,90,4,3,7,6,43,-67,7,1,507,411
536,1,5,2,9,4,54,22,4,2,54,22
536,2,4,2,9,4,45,22,9,4,99,44
536,3,2,5,3,10,-79,55,0,9,20,99
536,4,3,3,9,4,36,-69,6,0,56,30
536,5,2,5,4,9,22,54,8,4,78,84
536,6,3,4,7,6,-66,42,2,6,12,126
536,7,4,3,7,6,43,33,5,9,55,159
536,8,3,4,5,8,32,-56,7,3,87,103
536,9,3,4,7,6,-66,42,1,5,21,145
536,10,4,3,7,6,43,33,4,8,64,178
536,11,4,3,6,7,42,-66,6,2,106,112
536,12,4,2,6,7,42,25,8,7,148,137
536,13,2,4,5,8,-77,-56,1,1,71,81
536,14,4,3,8,5,44,32,5,3,115,113
536,15,4,2,7,6,43,24,8,7,158,137
536,16,3,4,6,7,-67,-57,1,0,91,80
536,17,5,2,9,4,54,22,5,2,145,102
536,18,4,3,9,4,-55,31,0,3,90,133
536,19,4,2,8,5,44,23,4,6,134,156
536,20,3,4,4,9,31,-55,5,1,165,101
536,21,3,3,9,4,-64,31,1,2,101,132
536,22,5,2,8,5,53,23,4,5,154,155
536,23,3,4,5,8,32,44,6,9,186,199
536,24,2,4,6,7,-76,-57,0,2,110,142
536,25,3,3,6,7,33,34,3,6,143,176
536,26,3,3,5,8,32,-65,5,1,175,111
536,27,2,4,5,8,23,44,8,5,198,155
536,28,2,4,5,8,-77,44,1,9,121,199
536,29,5,2,9,4,54,-78,5,1,175,121
536,30,3,4,7,6,34,42,9,3,209,163
536,31,3,3,8,5,-65,32,4,5,144,195
536,32,4,3,5,8,41,-65,5,0,185,130
536,33,3,4,6,7,33,43,8,3,218,173
536,34,4,3,8,5,-56,32,2,5,162,205
536,35,3,3,6,7,33,34,5,9,195,239
536,36,5,2,10,3,-45,-79,0,0,150,160
536,37,3,4,6,7,33,43,3,3,183,203
536,38,3,3,7,6,34,33,7,6,217,236
536,39,3,4,6,7,-67,43,0,9,150,279
536,40,4,2,8,5,44,-77,4,2,194,202
536,41,4,3,8,5,44,32,8,4,238,234
536,42,5,2,8,5,-47,23,1,7,191,257
536,43,3,4,9,4,36,40,7,7,227,297
536,44,2,4,4,9,22,-55,9,2,249,242
536,45,3,4,4,9,-69,45,0,7,180,287
536,46,5,2,7,6,52,-76,2,1,232,211
536,47,3,3,7,6,34,33,6,4,266,244
536,48,2,5,4,9,22,54,8,8,288,298
536,49,4,3,7,6,-57,-67,1,1,231,231
536,50,3,4,6,7,33,43,4,4,264,274
536,51,5,2,10,3,55,21,9,5,319,295
536,52,4,2,9,4,-55,22,4,7,264,317
536,53,2,5,2,11,20,-44,4,3,284,273
536,54,3,4,7,6,34,42,8,5,318,315
536,55,2,4,3,10,21,-54,9,1,339,261
536,56,3,4,5,8,-68,44,1,5,271,305
536,57,4,2,9,4,45,22,6,7,316,327
536,58,3,3,9,4,-64,31,2,8,252,358
536,59,3,4,4,9,31,-55,3,3,283,303
536,60,3,3,6,7,33,34,6,7,316,337
536,61,2,4,6,7,-76,-57,0,0,240,280
536,62,6,2,7,6,61,24,1,4,301,304
536,63,2,5,5,8,23,53,4,7,324,357
536,64,4,3,6,7,42,-66,6,1,366,291
536,65,4,2,11,2,-53,20,3,1,313,311
536,66,5,2,10,3,55,21,8,2,368,332
536,67,5,2,8,5,-47,23,1,5,321,355
536,68,2,5,3,10,21,-45,2,0,342,310
536,69,3,3,7,6,34,33,6,3,376,343
536,70,2,4,6,7,-76,43,0,6,300,386
536,71,4,3,6,7,42,-66,2,0,342,320
536,72,3,4,4,9,31,45,3,5,373,365
536,73,3,4,5,8,32,44,5,9,405,409
536,74,5,2,8,5,53,-77,8,2,458,332
536,75,3,4,6,7,-67,43,1,5,391,375
536,76,3,3,8,5,35,32,6,7,426,407
536,77,3,3,8,5,-65,32,1,9,361,439
536,78,2,4,5,8,23,-56,4,3,384,383
536,79,5,2,9,4,54,22,8,5,438,405
536,80,4,2,10,3,-54,21,4,6,384,426
536,81,4,3,9,4,45,31,9,7,429,457
536,82,3,3,7,6,-66,-67,3,0,363,390
536,83,4,3,6,7,42,34,5,4,405,424
536,84,4,3,5,8,41,35,6,9,446,459
536,85,3,4,5,8,32,-56,8,3,478,403
536,86,4,2,7,6,-57,24,1,7,421,427
536,87,3,3,8,5,35,32,6,9,456,459
536,88,4,3,8,5,-56,-68,0,1,400,391
536,89,4,4,6,7,42,43,2,4,442,434
536,90,2,4,7,6,25,42,7,6,467,476
536,91,4,3,8,5,-56,32,1,8,411,508
537,1,3,3,5,8,32,35,2,5,32,35
537,2,5,2,9,4,54,22,6,7,86,57
537,3,4,3,8,5,-56,32,0,9,30,89
537,4,3,4,6,7,33,-57,3,2,63,32
537,5,2,4,4,9,22,45,5,7,85,77
537,6,5,2,11,2,-44,20,1,7,41,97
537,7,4,3,9,4,45,31,6,8,86,128
537,8,4,3,5,8,41,-65,7,3,127,63
537,9,5,2,7,6,52,24,9,7,179,87
537,10,2,5,5,8,-77,-47,2,0,102,40
537,11,4,2,6,7,42,25,4,5,144,65
537,12,3,4,7,6,34,42,8,7,178,107
537,13,5,2,10,3,-45,21,3,8,133,128
537,14,4,2,6,7,42,-75,5,3,175,53
537,15,3,3,4,9,31,36,6,9,206,89
537,16,3,3,6,7,33,-66,9,3,239,23
537,17,3,4,8,5,-65,41,4,4,174,64
537,18,3,3,10,3,-63,30,1,4,111,94
537,19,2,5,4,9,22,54,3,8,133,148
537,20,2,5,4,9,22,-46,5,2,155,102
537,21,4,3,8,5,44,32,9,4,199,134
537,22,3,4,4,9,-69,45,0,9,130,179
537,23,2,5,7,6,25,-49,5,0,155,130
537,24,2,5,5,8,23,53,8,3,178,183
537,25,2,5,4,9,-78,54,0,7,100,237
537,26,5,2,10,3,55,21,5,8,155,258
537,27,5,2,7,6,52,-76,7,2,207,182
537,28,2,6,5,8,-77,62,0,4,130,244
537,29,3,3,5,8,32,35,2,9,162,279
537,30,4,2,6,7,42,-75,4,4,204,204
537,31,5,2,10,3,55,21,9,5,259,225
537,32,3,4,7,6,-66,42,3,7,193,267
537,33,4,2,10,3,46,21,9,8,239,288
537,34,3,3,7,6,-66,-67,3,1,173,221
537,35,4,3,9,4,45,31,8,2,218,252
537,36,2,4,5,8,-77,44,1,6,141,296
537,37,6,2,10,3,64,21,5,7,205,317
537,38,2,5,3,10,21,-45,6,2,226,272
537,39,4,2,10,3,-54,21,2,3,172,293
537,40,3,4,8,5,35,41,7,4,207,334
537,41,2,4,5,8,-77,44,0,8,130,378
537,42,3,4,6,7,33,-57,3,1,163,321
537,43,5,2,10,3,55,21,8,2,218,342
537,44,4,2,8,5,-56,23,2,5,162,365
537,45,4,3,9,4,45,31,7,6,207,396
537,46,3,4,5,8,32,-56,9,0,239,340
537,47,4,2,11,2,-53,20,6,0,186,360
537,48,3,3,5,8,32,35,8,5,218,395
537,49,3,4,7,6,-66,42,2,7,152,437
537,50,2,5,4,9,22,-46,4,1,174,391
537,51,4,4,9,4,45,40,9,1,219,431
537,52,2,4,5,8,-77,44,2,5,142,475
537,53,5,2,7,6,52,24,4,9,194,499
537,54,2,5,5,8,23,-47,7,2,217,452
537,55,4,3,6,7,42,34,9,6,259,486
537,56,2,4,6,7,-76,43,3,9,183,529
538,1,3,3,8,5,35,32,5,2,35,32
538,2,4,2,6,7,42,25,7,7,77,57
538,3,4,4,9,4,-55,40,2,7,22,97
538,4,4,2,6,7,42,-75,4,2,64,22
538,5,5,2,11,2,-44,20,0,2,20,42
538,6,3,3,8,5,35,32,5,4,55,74
538,7,2,4,3,10,21,-54,6,0,76,20
538,8,4,3,8,5,-56,32,0,2,20,52
538,9,2,4,5,8,23,44,3,6,43,96
538,10,3,3,6,7,33,-66,6,0,76,30
538,11,4,4,8,5,-56,41,0,1,20,71
538,12,3,4,5,8,32,44,2,5,52,115
538,13,4,2,8,5,44,23,6,8,96,138
538,14,6,2,9,4,63,-78,9,0,159,60
538,15,4,2,7,6,-57,24,2,4,102,84
538,16,3,3,7,6,34,33,6,7,136,117
538,17,4,2,9,4,-55,22,1,9,81,139
538,18,4,2,6,7,42,-75,3,4,123,64
538,19,5,2,8,5,53,23,6,7,176,87
538,20,4,2,8,5,-56,-77,0,0,120,10
538,21,4,3,8,5,44,32,4,2,164,42
538,22,4,2,9,4,45,22,9,4,209,64
538,23,2,4,2,11,20,-53,9,1,229,11
538,24,2,5,6,7,-76,52,3,3,153,63
538,25,3,3,7,6,34,33,7,6,187,96
538,26,4,3,8,5,-56,32,1,8,131,128
538,27,4,3,6,7,42,-66,3,2,173,62
538,28,3,3,7,6,34,33,7,5,207,95
538,29,2,5,5,8,-77,53,0,8,130,148
538,30,4,3,7,6,43,-67,3,1,173,81
538,31,2,5,4,9,22,54,5,5,195,135
538,32,4,2,6,7,42,-75,7,0,237,60
538,33,5,3,6,7,51,34,8,4,288,94
538,34,4,3,8,5,-56,32,2,6,232,126
538,35,4,2,8,5,44,23,6,9,276,149
538,36,3,4,7,6,-66,-58,0,1,210,91
538,37,4,3,6,7,42,34,2,5,252,125
538,38,4,3,6,7,42,34,4,9,294,159
538,39,4,3,8,5,44,-68,8,1,338,91
538,40,5,2,9,4,-46,22,2,3,292,113
538,41,2,4,4,9,22,45,4,8,314,158
538,42,4,2,7,6,43,-76,7,2,357,82
538,43,3,3,9,4,-64,31,3,3,293,113
538,44,3,3,6,7,33,34,6,7,326,147
538,45,2,4,5,8,23,-56,9,1,349,91
538,46,4,2,8,5,-56,23,3,4,293,114
538,47,2,4,5,8,23,44,6,8,316,158
538,48,4,2,7,6,43,-76,9,2,359,82
538,49,3,4,6,7,-67,43,2,5,292,125
538,50,3,3,4,9,31,-64,3,1,323,61
538,51,2,4,4,9,22,45,5,6,345,106
538,52,3,3,7,6,34,33,9,9,379,139
538,53,4,3,8,5,-56,-68,3,1,323,71
538,54,3,4,4,9,31,45,4,6,354,116
538,55,4,3,6,7,42,-66,6,0,396,50
538,56,3,4,5,8,32,44,8,4,428,94
538,57,3,4,8,5,-65,41,3,5,363,135
538,58,4,2,7,6,43,24,6,9,406,159
538,59,3,4,4,9,31,-55,7,4,437,104
538,60,2,4,6,7,-76,43,1,7,361,147
538,61,4,3,6,7,42,-66,3,1,403,81
538,62,3,4,8,5,35,41,8,2,438,122
538,63,3,4,4,9,31,45,9,7,469,167
538,64,5,2,9,4,-46,22,3,9,423,189
538,65,4,3,7,6,43,-67,6,2,466,122
538,66,4,3,6,7,42,34,8,6,508,156
539,1,3,4,3,10,30,46,0,6,30,46
539,2,5,2,10,3,55,21,5,7,85,67
539,3,3,3,8,5,-65,32,0,9,20,99
539,4,4,3,8,5,44,-68,4,1,64,31
539,5,3,3,6,7,33,34,7,5,97,65
539,6,2,5,5,8,-77,53,0,8,20,118
539,7,3,3,8,5,35,-68,5,0,55,50
539,8,4,4,4,9,40,45,5,5,95,95
539,9,4,3,5,8,41,-65,6,0,136,30
539,10,2,4,3,10,21,46,7,6,157,76
539,11,2,5,5,8,-77,53,0,9,80,129
539,12,2,4,4,9,22,-55,2,4,102,74
539,13,3,3,4,9,31,-64,3,0,133,10
539,14,3,3,7,6,34,33,7,3,167,43
539,15,4,2,9,4,-55,22,2,5,112,65
539,16,4,3,6,7,42,34,4,9,154,99
539,17,5,2,11,2,-44,20,0,9,110,119
539,18,4,2,6,7,42,-75,2,4,152,44
539,19,4,3,8,5,44,32,6,6,196,76
539,20,2,4,5,8,23,-56,9,0,219,20
539,21,3,3,4,9,-69,36,0,6,150,56
539,22,5,2,10,3,55,21,5,7,205,77
539,23,2,4,6,7,24,-57,9,0,229,20
539,24,3,3,7,6,-66,33,3,3,163,53
539,25,3,3,6,7,33,34,6,7,196,87
539,26,3,3,8,5,-65,32,1,9,131,119
539,27,5,2,7,6,52,-76,3,3,183,43
539,28,3,4,3,10,30,46,3,9,213,89
539,29,2,4,4,9,22,-55,5,4,235,34
539,30,5,2,10,3,-45,21,0,5,190,55
539,31,3,4,7,6,34,42,4,7,224,97
539,32,4,3,6,7,42,-66,6,1,266,31
539,33,4,2,7,6,43,24,9,5,309,55
539,34,4,3,9,4,-55,31,4,6,254,86
539,35,3,4,6,7,33,43,7,9,287,129
539,36,5,2,9,4,-46,-78,1,1,241,51
539,37,4,3,9,4,45,31,6,2,286,82
539,38,3,3,6,7,33,34,9,6,319,116
539,39,5,2,8,5,-47,23,2,9,272,139
539,40,2,5,6,7,24,-48,6,1,296,91
539,41,3,4,4,9,31,45,7,6,327,136
539,42,4,3,7,6,-57,33,0,9,270,169
539,43,4,3,9,4,45,-69,5,0,315,100
539,44,5,2,10,3,-45,21,0,1,270,121
539,45,4,2,8,5,44,23,4,4,314,144
539,46,5,2,7,6,52,24,6,8,366,168
539,47,2,5,5,8,23,-47,9,1,389,121
539,48,4,3,8,5,-56,32,3,3,333,153
539,49,4,4,7,6,43,42,6,5,376,195
539,50,3,3,8,5,-65,32,1,7,311,227
539,51,2,5,3,10,21,-45,2,2,332,182
539,52,3,3,7,6,34,33,6,5,366,215
539,53,3,3,8,5,-65,32,1,7,301,247
539,54,2,4,2,11,20,-53,1,4,321,194
539,55,2,5,3,10,21,55,2,9,342,249
539,56,2,6,4,9,22,-37,4,2,364,212
539,57,3,3,4,9,31,36,5,8,395,248
539,58,2,5,6,7,24,-48,9,0,419,200
539,59,3,3,5,8,-68,35,1,5,351,235
539,60,2,5,4,9,22,54,3,9,373,289
539,61,2,6,2,11,20,-35,3,4,393,254
539,62,3,4,9,4,36,40,9,4,429,294
539,63,3,4,6,7,-67,43,2,7,362,337
539,64,4,3,8,5,44,32,6,9,406,369
539,65,3,4,4,9,31,-55,7,4,437,314
539,66,3,4,4,9,31,45,8,9,468,359
539,67,3,5,5,8,-68,-47,0,2,400,312
539,68,2,4,4,9,22,45,2,7,422,357
539,69,3,3,7,6,34,-67,6,0,456,290
539,70,2,4,6,7,-76,43,0,3,380,333
539,71,3,3,7,6,34,33,4,6,414,366
539,72,4,2,9,4,45,22,9,8,459,388
539,73,2,5,3,10,-79,-45,0,3,380,343
539,74,4,3,7,6,43,33,3,6,423,376
539,75,6,2,11,2,65,20,8,6,488,396
539,76,4,3,6,7,-58,-66,0,0,430,330
539,77,4,3,5,8,41,35,1,5,471,365
539,78,2,4,6,7,24,43,5,8,495,408
539,79,5,2,10,3,-45,21,0,9,450,429
539,80,4,3,10,3,46,30,6,9,496,459
539,81,4,3,7,6,43,-67,9,2,539,392
540,1,3,4,5,8,32,44,2,4,32,44
540,2,6,2,10,3,64,21,6,5,96,65
540,3,3,4,4,9,31,-55,7,0,127,10
540,4,2,4,3,10,21,46,8,6,148,56
540,5,3,3,5,8,-68,-65,0,1,80,-9
540,6,3,3,7,6,34,33,4,4,114,24
540,7,4,2,7,6,43,24,7,8,157,48
540,8,3,4,5,8,32,-56,9,2,189,-8
540,9,4,3,6,7,-58,34,1,6,131,26
540,10,3,3,7,6,34,33,5,9,165,59
540,11,2,5,6,7,24,-48,9,1,189,11
540,12,4,3,7,6,-57,33,2,4,132,44
540,13,2,4,4,9,22,45,4,9,154,89
540,14,6,2,10,3,64,-79,8,0,218,10
540,15,2,5,3,10,21,55,9,5,239,65
540,16,4,2,10,3,-54,21,5,6,185,86
540,17,3,4,7,6,34,42,9,8,219,128
540,18,4,3,6,7,-58,-66,1,2,161,62
540,19,2,5,4,9,22,54,3,6,183,116
540,20,3,3,8,5,35,32,8,8,218,148
540,21,4,3,6,7,-58,-66,0,2,160,82
540,22,3,4,5,8,32,44,2,6,192,126
540,23,3,4,5,8,32,-56,4,0,224,70
540,24,5,2,10,3,55,21,9,1,279,91
540,25,4,3,8,5,-56,32,3,3,223,123
540,26,3,3,8,5,35,32,8,5,258,155
540,27,5,2,7,6,-48,24,0,9,210,179
540,28,3,3,7,6,34,-67,4,2,244,112
540,29,5,2,9,4,54,22,8,4,298,134
540,30,3,4,7,6,-66,42,2,6,232,176
540,31,4,2,10,3,46,21,8,7,278,197
540,32,3,4,8,5,-65,41,3,8,213,238
540,33,5,2,8,5,53,-77,6,1,266,161
540,34,4,3,5,8,41,35,7,6,307,196
540,35,4,3,7,6,-57,33,0,9,250,229
540,36,3,4,7,6,34,-58,4,1,284,171
540,37,3,4,8,5,35,41,9,2,319,212
540,38,3,4,7,6,-66,42,3,4,253,254
540,39,3,3,5,8,32,35,5,9,285,289
540,40,4,4,8,5,44,-59,9,0,329,230
540,41,4,3,8,5,-56,32,3,2,273,262
540,42,4,2,8,5,44,23,7,5,317,285
540,43,3,4,8,5,-65,41,2,6,252,326
540,44,3,4,5,8,32,-56,4,0,284,270
540,45,3,4,7,6,34,42,8,2,318,312
540,46,4,2,10,3,-54,21,4,3,264,333
540,47,4,3,5,8,41,35,5,8,305,368
540,48,2,4,7,6,-75,-58,0,0,230,310
540,49,3,3,8,5,35,32,5,2,265,342
540,50,6,2,10,3,64,21,9,3,329,363
540,51,2,6,2,11,20,65,9,8,349,428
540,52,3,3,5,8,-68,-65,1,3,281,363
540,53,2,5,5,8,23,53,4,6,304,416
540,54,6,2,10,3,64,21,8,7,368,437
540,55,2,5,3,10,21,-45,9,2,389,392
540,56,3,3,8,5,-65,32,4,4,324,424
540,57,3,3,8,5,35,32,9,6,359,456
540,58,5,2,10,3,-45,21,4,7,314,477
540,59,4,3,10,3,-54,30,0,7,260,507
541,1,3,4,5,8,32,44,2,4,32,44
541,2,3,4,8,5,35,41,7,5,67,85
541,3,2,5,4,9,22,54,9,9,89,139
541,4,4,2,7,6,-57,-76,2,3,32,63
541,5,6,2,9,4,63,22,5,5,95,85
541,6,3,4,4,9,31,-55,6,0,126,30
541,7,4,2,7,6,43,24,9,4,169,54
541,8,5,2,9,4,-46,22,3,6,123,76
541,9,2,4,4,9,22,-55,5,1,145,21
541,10,2,6,3,10,21,64,6,5,166,85
541,11,4,3,8,5,-56,32,0,7,110,117
541,12,2,4,6,7,24,-57,4,0,134,60
541,13,4,2,7,6,43,24,7,4,177,84
541,14,2,5,2,11,20,-44,7,0,197,40
541,15,3,3,7,6,-66,33,1,3,131,73
541,16,3,4,5,8,32,44,3,7,163,117
541,17,4,3,6,7,42,-66,5,1,205,51
541,18,2,4,2,11,20,47,5,8,225,98
541,19,2,4,6,7,24,-57,9,1,249,41
541,20,3,4,5,8,-68,44,1,5,181,85
541,21,3,3,8,5,35,32,6,7,216,117
541,22,3,4,6,7,33,-57,9,0,249,60
541,23,3,4,5,8,-68,44,1,4,181,104
541,24,4,2,8,5,44,23,5,7,225,127
541,25,4,3,8,5,44,32,9,9,269,159
541,26,2,5,4,9,-78,-46,1,3,191,113
541,27,2,5,3,10,21,55,2,8,212,168
541,28,3,4,6,7,33,-57,5,1,245,111
541,29,4,3,6,7,42,34,7,5,287,145
541,30,2,5,6,7,-76,52,1,7,211,197
541,31,4,3,7,6,43,-67,4,0,254,130
541,32,4,3,10,3,-54,30,0,0,200,160
541,33,3,4,6,7,33,43,3,3,233,203
541,34,3,3,6,7,33,34,6,7,266,237
541,35,3,4,7,6,-66,42,0,9,200,279
541,36,3,4,3,10,30,-54,0,5,230,225
541,37,3,3,6,7,33,34,3,9,263,259
541,38,3,3,6,7,33,-66,6,3,296,193
541,39,3,3,6,7,33,34,9,7,329,227
541,40,2,5,6,7,-76,52,3,9,253,279
541,41,3,4,4,9,31,-55,4,4,284,224
541,42,4,2,8,5,44,23,8,7,328,247
541,43,2,5,3,10,21,-45,9,2,349,202
541,44,2,4,3,10,-79,46,0,8,270,248
541,45,3,4,6,7,33,-57,3,1,303,191
541,46,2,5,4,9,22,54,5,5,325,245
541,47,3,4,9,4,-64,40,1,5,261,285
541,48,3,4,5,8,32,44,3,9,293,329
541,49,3,3,7,6,34,-67,7,2,327,262
541,50,4,3,4,9,40,36,7,8,367,298
541,51,3,3,7,6,-66,-67,1,1,301,231
541,52,5,2,9,4,54,22,5,3,355,253
541,53,4,3,8,5,44,32,9,5,399,285
541,54,4,3,6,7,-58,34,1,9,341,319
541,55,4,2,10,3,46,-79,7,0,387,240
541,56,2,4,5,8,-77,44,0,4,310,284
541,57,5,2,11,2,56,20,6,4,366,304
541,58,2,5,5,8,23,53,9,7,389,357
541,59,4,2,9,4,-55,22,4,9,334,379
541,60,5,3,7,6,52,-67,6,2,386,312
541,61,3,4,7,6,-66,42,0,4,320,354
541,62,3,4,8,5,35,41,5,5,355,395
541,63,5,2,7,6,52,24,7,9,407,419
541,64,3,3,5,8,32,-65,9,4,439,354
541,65,3,4,4,9,-69,45,0,9,370,399
541,66,3,4,6,7,33,-57,3,2,403,342
541,67,2,4,6,7,24,43,7,5,427,385
541,68,3,3,5,8,32,-65,9,0,459,320
541,69,3,4,7,6,-66,42,3,2,393,362
541,70,3,3,5,8,32,35,5,7,425,397
541,71,3,4,5,8,32,-56,7,1,457,341
541,72,5,2,10,3,-45,21,2,2,412,362
541,73,5,2,9,4,54,22,6,4,466,384
541,74,3,3,7,6,-66,33,0,7,400,417
541,75,3,3,6,7,33,-66,3,1,433,351
541,76,3,4,8,5,35,41,8,2,468,392
541,77,4,3,9,4,-55,31,3,3,413,423
541,78,4,3,8,5,44,32,7,5,457,455
541,79,2,5,4,9,22,54,9,9,479,509
542,1,3,3,8,5,35,32,5,2,35,32
542,2,2,5,3,10,21,55,6,7,56,87
542,3,3,3,10,3,-63,30,3,7,-7,117
542,4,3,4,8,5,35,41,8,8,28,158
542,5,2,4,3,10,21,-54,9,4,49,104
542,6,5,2,7,6,-48,24,1,8,1,128
542,7,3,3,9,4,36,31,7,9,37,159
542,8,3,3,4,9,31,-64,8,5,68,95
542,9,4,3,6,7,-58,34,0,9,10,129
542,10,4,2,8,5,44,-77,4,2,54,52
542,11,3,3,7,6,34,33,8,5,88,85
542,12,2,6,3,10,21,64,9,9,109,149
542,13,2,4,6,7,-76,-57,3,2,33,92
542,14,2,5,7,6,25,51,8,3,58,143
542,15,3,3,4,9,31,36,9,9,89,179
542,16,6,2,9,4,-37,-78,2,1,52,101
542,17,4,3,7,6,43,33,5,4,95,134
542,18,2,5,6,7,24,52,9,6,119,186
542,19,3,3,6,7,-67,-66,2,0,52,120
542,20,3,3,5,8,32,35,4,5,84,155
542,21,3,3,6,7,33,34,7,9,117,189
542,22,2,5,4,9,22,-46,9,3,139,143
542,23,2,4,5,8,-77,44,2,7,62,187
542,24,2,5,3,10,21,-45,3,2,83,142
542,25,3,4,5,8,32,44,5,6,115,186
542,26,3,3,6,7,33,-66,8,0,148,120
542,27,4,2,9,4,-55,22,3,2,93,142
542,28,3,3,5,8,32,35,5,7,125,177
542,29,2,5,2,11,20,-44,5,3,145,133
542,30,4,2,11,2,-53,20,2,3,92,153
542,31,4,2,7,6,43,24,5,7,135,177
542,32,2,5,4,9,22,-46,7,1,157,131
542,33,4,3,7,6,-57,33,0,4,100,164
542,34,4,3,9,4,45,31,5,5,145,195
542,35,3,3,5,8,32,-65,7,0,177,130
542,36,4,3,6,7,42,34,9,4,219,164
542,37,2,4,7,6,-75,42,4,6,144,206
542,38,3,3,9,4,-64,31,0,7,80,237
542,39,6,2,10,3,64,21,4,8,144,258
542,40,3,3,7,6,34,-67,8,1,178,191
542,41,3,3,6,7,-67,34,1,5,111,225
542,42,3,4,7,6,34,42,5,7,145,267
542,43,3,4,7,6,34,42,9,9,179,309
542,44,2,4,6,7,-76,-57,3,2,103,252
542,45,3,3,6,7,33,34,6,6,136,286
542,46,4,3,8,5,-56,32,0,8,80,318
542,47,3,3,6,7,33,-66,3,2,113,252
542,48,4,2,7,6,43,24,6,6,156,276
542,49,5,2,9,4,-46,22,0,8,110,298
542,50,3,4,6,7,33,-57,3,1,143,241
542,51,3,3,8,5,35,32,8,3,178,273
542,52,4,2,10,3,-54,21,4,4,124,294
542,53,3,3,4,9,31,-64,5,0,155,230
542,54,4,2,8,5,44,23,9,3,199,253
542,55,3,3,7,6,-66,33,3,6,133,286
542,56,4,3,7,6,43,33,6,9,176,319
542,57,3,4,3,10,30,-54,6,5,206,265
542,58,4,2,8,5,-56,23,0,8,150,288
542,59,4,2,8,5,44,-77,4,1,194,211
542,60,2,4,3,10,21,46,5,7,215,257
542,61,2,5,4,9,22,-46,7,1,237,211
542,62,4,2,7,6,-57,24,0,5,180,235
542,63,4,4,6,7,42,43,2,8,222,278
542,64,3,3,6,7,33,-66,5,2,255,212
542,65,4,3,6,7,42,34,7,6,297,246
542,66,2,4,5,8,-77,-56,0,0,220,190
542,67,4,3,7,6,43,33,3,3,263,223
542,68,5,2,9,4,54,22,7,5,317,245
542,69,4,4,8,5,-56,41,1,6,261,286
542,70,3,3,8,5,35,32,6,8,296,318
542,71,2,4,5,8,23,-56,9,2,319,262
542,72,3,3,6,7,-67,34,2,6,252,296
542,73,4,3,6,7,42,-66,4,0,294,230
542,74,3,3,9,4,-64,31,0,1,230,261
542,75,4,3,7,6,43,33,3,4,273,294
542,76,4,2,8,5,44,23,7,7,317,317
542,77,4,2,8,5,-56,-77,1,0,261,240
542,78,2,5,3,10,21,55,2,5,282,295
542,79,2,5,5,8,23,53,5,8,305,348
542,80,3,4,5,8,32,-56,7,2,337,292
542,81,4,3,6,7,42,34,9,6,379,326
542,82,4,2,8,5,-56,23,3,9,323,349
542,83,4,2,8,5,44,-77,7,2,367,272
542,84,2,5,2,11,20,56,7,8,387,328
542,85,3,3,7,6,-66,-67,1,1,321,261
542,86,3,3,7,6,34,33,5,4,355,294
542,87,4,3,9,4,-55,31,0,5,300,325
542,88,5,2,8,5,53,23,3,8,353,348
542,89,2,4,4,9,22,-55,5,3,375,293
542,90,4,2,10,3,-54,21,1,4,321,314
542,91,3,5,4,9,31,54,2,8,352,368
542,92,3,4,6,7,33,-57,5,1,385,311
542,93,4,3,8,5,44,32,9,3,429,343
542,94,2,4,4,9,-78,45,1,8,351,388
542,95,3,4,4,9,31,-55,2,3,382,333
542,96,3,4,6,7,33,43,5,6,415,376
542,97,5,2,10,3,-45,21,0,7,370,397
542,98,3,4,6,7,33,-57,3,0,403,340
542,99,4,4,8,5,44,41,7,1,447,381
542,100,3,3,6,7,-67,34,0,5,380,415
542,101,2,5,6,7,24,52,4,7,404,467
542,102,3,4,7,6,34,42,8,9,438,509
543,1,3,4,5,8,32,44,2,4,32,44
543,2,4,3,8,5,44,32,6,6,76,76
543,3,4,2,10,3,-54,21,2,7,22,97
543,4,2,4,6,7,24,-57,6,0,46,40
543,5,2,5,4,9,22,54,8,4,68,94
543,6,3,3,7,6,-66,33,2,7,2,127
543,7,4,3,9,4,45,31,7,8,47,158
543,8,5,2,10,3,-45,21,2,9,2,179
543,9,4,3,9,4,45,-69,7,0,47,110
543,10,3,3,6,7,-67,34,0,4,-20,144
543,11,4,2,7,6,43,24,3,8,23,168
543,12,4,3,5,8,41,-65,4,3,64,103
543,13,2,4,6,7,24,43,8,6,88,146
543,14,3,4,7,6,-66,42,2,8,22,188
543,15,3,4,4,9,31,-55,3,3,53,133
543,16,2,5,5,8,23,53,6,6,76,186
543,17,2,5,4,9,22,-46,8,0,98,140
543,18,4,2,10,3,-54,21,4,1,44,161
543,19,3,3,7,6,34,33,8,4,78,194
543,20,4,3,7,6,-57,33,1,7,21,227
543,21,5,2,8,5,53,-77,4,0,74,150
543,22,3,3,7,6,34,33,8,3,108,183
543,23,4,2,8,5,-56,23,2,6,52,206
543,24,2,5,8,5,26,50,8,6,78,256
543,25,3,4,8,5,-65,41,3,7,13,297
543,26,3,3,8,5,35,32,8,9,48,329
543,27,3,3,6,7,-67,-66,1,3,-19,263
543,28,2,5,4,9,22,54,3,7,3,317
543,29,3,3,6,7,33,-66,6,1,36,251
543,30,3,3,6,7,33,34,9,5,69,285
543,31,4,2,9,4,-55,22,4,7,14,307
543,32,3,3,7,6,34,-67,8,0,48,240
543,33,4,3,8,5,-56,32,2,2,-8,272
543,34,3,4,5,8,32,44,4,6,24,316
543,35,3,3,5,8,32,-65,6,1,56,251
543,36,6,2,10,3,-36,21,0,2,20,272
543,37,4,2,8,5,44,23,4,5,64,295
543,38,5,2,9,4,54,22,8,7,118,317
543,39,5,2,9,4,-46,22,2,9,72,339
543,40,3,4,6,7,33,-57,5,2,105,282
543,41,3,3,6,7,33,34,8,6,138,316
543,42,3,3,7,6,-66,33,2,9,72,349
543,43,4,2,10,3,46,-79,8,0,118,270
543,44,2,4,3,10,21,46,9,6,139,316
543,45,4,3,7,6,-57,33,2,9,82,349
543,46,4,3,7,6,43,-67,5,2,125,282
543,47,3,4,9,4,-64,40,1,2,61,322
543,48,2,6,3,10,21,64,2,6,82,386
543,49,4,3,6,7,42,-66,4,0,124,320
543,50,3,3,6,7,33,34,7,4,157,354
543,51,2,4,7,6,-75,42,2,6,82,396
543,52,3,3,8,5,35,32,7,8,117,428
543,53,4,2,10,3,-54,21,3,9,63,449
543,54,4,3,10,3,46,30,9,9,109,479
543,55,2,5,4,9,-78,-46,1,3,31,433
543,56,2,5,6,7,24,52,5,5,55,485
543,57,3,4,6,7,33,43,8,8,88,528
544,1,3,3,6,7,33,34,3,4,33,34
544,2,2,5,3,10,21,55,4,9,54,89
544,3,2,4,6,7,24,-57,8,2,78,32
544,4,2,4,5,8,-77,44,1,6,1,76
544,5,3,4,5,8,32,-56,3,0,33,20
544,6,3,4,6,7,33,43,6,3,66,63
544,7,2,5,4,9,22,54,8,7,88,117
544,8,2,4,5,8,-77,-56,1,1,11,61
544,9,2,5,3,10,21,55,2,6,32,116
544,10,4,2,10,3,46,21,8,7,78,137
544,11,2,5,2,11,20,-44,8,3,98,93
544,12,3,3,10,3,-63,30,5,3,35,123
544,13,3,4,5,8,32,44,7,7,67,167
544,14,4,3,8,5,-56,32,1,9,11,199
544,15,4,3,9,4,45,-69,6,0,56,130
544,16,5,2,8,5,53,23,9,3,109,153
544,17,4,3,7,6,-57,33,2,6,52,186
544,18,2,4,5,8,23,-56,5,0,75,130
544,19,4,3,9,4,-55,31,0,1,20,161
544,20,2,5,3,10,21,55,1,6,41,216
544,21,5,2,7,6,52,-76,3,0,93,140
544,22,2,5,7,6,25,51,8,1,118,191
544,23,3,3,5,8,-68,35,0,6,50,226
544,24,2,4,5,8,23,-56,3,0,73,170
544,25,2,5,3,10,21,55,4,5,94,225
544,26,4,2,6,7,42,-75,6,0,136,150
544,27,2,6,3,10,21,64,7,4,157,214
544,28,4,3,7,6,-57,33,0,7,100,247
544,29,3,3,4,9,31,-64,1,3,131,183
544,30,2,4,5,8,23,44,4,7,154,227
544,31,4,2,6,7,42,-75,6,2,196,152
544,32,5,2,8,5,53,23,9,5,249,175
544,33,2,4,5,8,-77,44,2,9,172,219
544,34,3,3,9,4,36,-69,8,0,208,150
544,35,2,4,6,7,-76,43,2,3,132,193
544,36,3,3,8,5,35,32,7,5,167,225
544,37,3,3,4,9,31,-64,8,1,198,161
544,38,3,4,8,5,-65,41,3,2,133,202
544,39,2,5,5,8,23,53,6,5,156,255
544,40,4,3,9,4,-55,31,1,6,101,286
544,41,3,3,8,5,35,32,6,8,136,318
544,42,3,4,4,9,31,-55,7,3,167,263
544,43,4,3,7,6,-57,33,0,6,110,296
544,44,2,4,4,9,22,-55,2,1,132,241
544,45,3,4,5,8,32,44,4,5,164,285
544,46,5,2,10,3,55,21,9,6,219,306
544,47,3,4,4,9,-69,-55,0,1,150,251
544,48,6,2,10,3,64,21,4,2,214,272
544,49,5,2,10,3,55,21,9,3,269,293
544,50,4,3,6,7,-58,34,1,7,211,327
544,51,3,3,9,4,36,31,7,8,247,358
544,52,2,4,4,9,22,-55,9,3,269,303
544,53,2,4,4,9,-78,45,1,8,191,348
544,54,4,3,7,6,43,-67,4,1,234,281
544,55,3,3,6,7,33,34,7,5,267,315
544,56,4,3,7,6,-57,33,0,8,210,348
544,57,2,5,4,9,22,-46,2,2,232,302
544,58,3,4,4,9,31,45,3,7,263,347
544,59,2,5,4,9,22,-46,5,1,285,301
544,60,3,3,7,6,34,33,9,4,319,334
544,61,5,3,8,5,-47,32,2,6,272,366
544,62,2,4,4,9,22,-55,4,1,294,311
544,63,4,3,7,6,43,33,7,4,337,344
544,64,2,5,3,10,21,55,8,9,358,399
544,65,2,4,4,9,-78,-55,0,4,280,344
544,66,2,5,4,9,22,54,2,8,302,398
544,67,3,3,7,6,34,-67,6,1,336,331
544,68,4,3,9,4,-55,31,1,2,281,362
544,69,2,5,3,10,21,55,2,7,302,417
544,70,4,3,8,5,44,32,6,9,346,449
544,71,4,2,9,4,-55,-78,1,1,291,371
544,72,2,4,6,7,24,43,5,4,315,414
544,73,3,3,4,9,31,-64,6,0,346,350
544,74,3,4,4,9,31,45,7,5,377,395
544,75,5,3,8,5,-47,32,0,7,330,427
544,76,5,2,9,4,54,22,4,9,384,449
544,77,2,4,6,7,24,-57,8,2,408,392
544,78,5,2,6,7,51,25,9,7,459,417
544,79,2,5,3,10,-79,-45,0,2,380,372
544,80,3,3,6,7,33,34,3,6,413,406
544,81,3,3,4,9,31,-64,4,2,444,342
544,82,3,3,8,5,35,32,9,4,479,374
544,83,4,4,6,7,-58,43,1,7,421,417
544,84,6,2,9,4,63,22,4,9,484,439
544,85,6,2,10,3,64,-79,8,0,548,360
545,1,3,4,6,7,33,43,3,3,33,43
545,2,2,5,4,9,22,54,5,7,55,97
545,3,4,2,8,5,44,-77,9,0,99,20
545,4,3,3,4,9,-69,36,0,6,30,56
545,5,3,3,3,10,30,-63,0,3,60,-7
545,6,4,3,5,8,41,35,1,8,101,28
545,7,2,5,7,6,25,51,6,9,126,79
545,8,2,4,6,7,-76,-57,0,2,50,22
545,9,2,5,2,11,20,56,0,8,70,78
545,10,3,4,6,7,33,-57,3,1,103,21
545,11,2,5,6,7,24,52,7,3,127,73
545,12,4,3,6,7,42,34,9,7,169,107
545,13,4,3,8,5,-56,32,3,9,113,139
545,14,2,4,5,8,23,-56,6,3,136,83
545,15,3,4,3,10,30,46,6,9,166,129
545,16,5,2,10,3,-45,-79,1,0,121,50
545,17,3,3,5,8,32,35,3,5,153,85
545,18,4,2,7,6,43,24,6,9,196,109
545,19,3,4,6,7,33,-57,9,2,229,52
545,20,5,2,10,3,-45,21,4,3,184,73
545,21,2,4,4,9,22,45,6,8,206,118
545,22,4,2,9,4,-55,-78,1,0,151,40
545,23,4,3,7,6,43,33,4,3,194,73
545,24,3,3,7,6,34,33,8,6,228,106
545,25,3,5,6,7,-67,52,1,8,161,158
545,26,3,3,7,6,34,-67,5,1,195,91
545,27,4,2,9,4,-55,22,0,3,140,113
545,28,3,3,6,7,33,34,3,7,173,147
545,29,4,4,5,8,41,-56,4,1,214,91
545,30,2,5,4,9,22,54,6,5,236,145
545,31,3,3,6,7,33,34,9,9,269,179
545,32,5,2,11,2,-44,20,5,9,225,199
545,33,2,5,3,10,21,-45,6,4,246,154
545,34,3,3,5,8,32,35,8,9,278,189
545,35,2,4,6,7,-76,-57,2,2,202,132
545,36,4,3,8,5,44,32,6,4,246,164
545,37,4,3,9,4,-55,31,1,5,191,195
545,38,3,3,6,7,33,34,4,9,224,229
545,39,4,4,8,5,44,-59,8,0,268,170
545,40,4,3,6,7,-58,34,0,4,210,204
545,41,3,3,8,5,35,32,5,6,245,236
545,42,4,2,9,4,-55,22,0,8,190,258
545,43,2,5,5,8,23,-47,3,1,213,211
545,44,4,2,8,5,44,23,7,4,257,234
545,45,4,3,6,7,42,34,9,8,299,268
545,46,4,3,8,5,-56,-68,3,0,243,200
545,47,5,2,7,6,52,24,5,4,295,224
545,48,2,5,3,10,21,55,6,9,316,279
545,49,5,2,8,5,53,-77,9,2,369,202
545,50,4,3,9,4,-55,31,4,3,314,233
545,51,3,4,5,8,32,44,6,7,346,277
545,52,4,4,6,7,42,-57,8,0,388,220
545,53,4,3,8,5,-56,32,2,2,332,252
545,54,4,2,8,5,44,23,6,5,376,275
545,55,3,4,6,7,33,43,9,8,409,318
545,56,3,3,6,7,-67,-66,2,2,342,252
545,57,3,3,5,8,32,35,4,7,374,287
545,58,3,3,7,6,34,-67,8,0,408,220
545,59,5,3,8,5,-47,32,1,2,361,252
545,60,2,4,6,7,24,43,5,5,385,295
545,61,5,2,8,5,53,23,8,8,438,318
545,62,4,3,7,6,-57,-67,1,1,381,251
545,63,2,4,5,8,23,44,4,5,404,295
545,64,4,3,6,7,42,34,6,9,446,329
545,65,3,4,6,7,33,-57,9,2,479,272
545,66,4,3,10,3,-54,30,5,2,425,302
545,67,2,4,5,8,23,44,8,6,448,346
545,68,3,4,5,8,-68,-56,0,0,380,290
545,69,3,3,10,3,37,30,7,0,417,320
545,70,3,3,4,9,31,36,8,6,448,356
545,71,3,3,7,6,-66,33,2,9,382,389
545,72,3,3,9,4,36,-69,8,0,418,320
545,73,3,4,7,6,-66,42,2,2,352,362
545,74,2,5,5,8,23,53,5,5,375,415
545,75,4,2,11,2,-53,20,2,5,322,435
545,76,6,2,10,3,64,21,6,6,386,456
545,77,2,4,5,8,23,-56,9,0,409,400
545,78,3,4,4,9,-69,45,0,5,340,445
545,79,2,4,5,8,23,44,3,9,363,489
545,80,4,2,6,7,42,-75,5,4,405,414
545,81,3,4,6,7,33,43,8,7,438,457
545,82,3,4,4,9,31,-55,9,2,469,402
545,83,4,3,6,7,-58,34,1,6,411,436
545,84,3,4,4,9,31,-55,2,1,442,381
545,85,2,6,6,7,24,61,6,2,466,442
545,86,3,4,9,4,-64,40,2,2,402,482
545,87,3,3,8,5,35,32,7,4,437,514
546,1,4,3,8,5,44,32,4,2,44,32
546,2,3,4,4,9,31,45,5,7,75,77
546,3,3,4,5,8,32,-56,7,1,107,21
546,4,3,3,8,5,-65,32,2,3,42,53
546,5,2,5,3,10,21,55,3,8,63,108
546,6,2,4,5,8,23,-56,6,2,86,52
546,7,4,3,6,7,42,34,8,6,128,86
546,8,4,3,5,8,41,-65,9,1,169,21
546,9,2,4,7,6,-75,42,4,3,94,63
546,10,3,3,5,8,32,35,6,8,126,98
546,11,4,2,6,7,42,-75,8,3,168,23
546,12,5,2,11,2,-44,20,4,3,124,43
546,13,5,2,10,3,55,21,9,4,179,64
546,14,4,4,6,7,-58,43,1,7,121,107
546,15,2,4,7,6,25,42,6,9,146,149
546,16,3,3,8,5,-65,-68,1,1,81,81
546,17,5,2,9,4,54,22,5,3,135,103
546,18,3,4,9,4,-64,40,1,3,71,143
546,19,3,3,9,4,36,31,7,4,107,174
546,20,3,3,6,7,-67,34,0,8,40,208
546,21,2,5,4,9,22,-46,2,2,62,162
546,22,2,4,7,6,25,42,7,4,87,204
546,23,3,3,6,7,-67,34,0,8,20,238
546,24,4,2,10,3,46,21,6,9,66,259
546,25,2,4,3,10,21,-54,7,5,87,205
546,26,4,3,8,5,-56,32,1,7,31,237
546,27,2,5,3,10,21,-45,2,2,52,192
546,28,2,6,3,10,21,64,3,6,73,256
546,29,2,5,5,8,23,53,6,9,96,309
546,30,4,3,7,6,43,-67,9,2,139,242
546,31,3,3,7,6,-66,33,3,5,73,275
546,32,3,3,9,4,36,31,9,6,109,306
546,33,3,5,4,9,-69,-46,0,0,40,260
546,34,3,4,6,7,33,43,3,3,73,303
546,35,3,3,7,6,34,33,7,6,107,336
546,36,4,3,8,5,-56,32,1,8,51,368
546,37,3,4,3,10,30,-54,1,4,81,314
546,38,4,3,8,5,44,32,5,6,125,346
546,39,2,4,5,8,23,-56,8,0,148,290
546,40,4,2,5,8,41,26,9,6,189,316
546,41,3,4,4,9,-69,-55,0,1,120,261
546,42,3,3,5,8,32,35,2,6,152,296
546,43,3,3,9,4,36,31,8,7,188,327
546,44,3,4,8,5,-65,41,3,8,123,368
546,45,3,4,7,6,34,-58,7,0,157,310
546,46,2,4,4,9,22,45,9,5,179,355
546,47,2,4,7,6,-75,42,4,7,104,397
546,48,2,4,4,9,22,-55,6,2,126,342
546,49,3,4,3,10,30,46,6,8,156,388
546,50,5,2,8,5,53,-77,9,1,209,311
546,51,3,4,3,10,30,46,9,7,239,357
546,52,2,4,4,9,-78,-55,1,2,161,302
546,53,3,4,3,10,30,46,1,8,191,348
546,54,3,4,4,9,31,-55,2,3,222,293
546,55,2,5,4,9,22,54,4,7,244,347
546,56,3,3,7,6,34,-67,8,0,278,280
546,57,2,4,6,7,-76,43,2,3,202,323
546,58,2,4,8,5,26,41,8,4,228,364
546,59,2,5,4,9,-78,54,0,8,150,418
546,60,5,2,7,6,52,-76,2,2,202,342
546,61,3,4,8,5,35,41,7,3,237,383
546,62,3,4,4,9,31,45,8,8,268,428
546,63,4,3,8,5,-56,-68,2,0,212,360
546,64,2,5,2,11,20,56,2,6,232,416
546,65,3,4,8,5,35,41,7,7,267,457
546,66,3,3,5,8,32,-65,9,2,299,392
546,67,3,4,5,8,-68,44,1,6,231,436
546,68,3,4,6,7,33,43,4,9,264,479
546,69,3,3,7,6,34,-67,8,2,298,412
546,70,3,4,6,7,-67,43,1,5,231,455
546,71,2,5,2,11,20,-44,1,1,251,411
546,72,5,2,11,2,56,20,7,1,307,431
546,73,3,3,8,5,-65,32,2,3,242,463
546,74,5,2,8,5,53,23,5,6,295,486
546,75,3,3,7,6,34,33,9,9,329,519
547,1,2,5,5,8,23,53,3,3,23,53
547,2,2,5,3,10,21,55,4,8,44,108
547,3,5,2,9,4,54,-78,8,0,98,30
547,4,4,3,8,5,-56,32,2,2,42,62
547,5,3,4,5,8,32,44,4,6,74,106
547,6,3,3,6,7,33,-66,7,0,107,40
547,7,3,3,5,8,32,35,9,5,139,75
547,8,2,5,5,8,-77,53,2,8,62,128
547,9,3,3,5,8,32,-65,4,3,94,63
547,10,4,3,7,6,43,33,7,6,137,96
547,11,2,4,6,7,-76,43,1,9,61,139
547,12,4,3,7,6,43,-67,4,2,104,72
547,13,2,4,5,8,23,44,7,6,127,116
547,14,4,2,9,4,-55,22,2,8,72,138
547,15,3,3,8,5,35,-68,7,0,107,70
547,16,3,3,8,5,-65,32,2,2,42,102
547,17,3,4,4,9,31,45,3,7,73,147
547,18,4,2,10,3,46,21,9,8,119,168
547,19,4,3,8,5,-56,-68,3,0,63,100
547,20,4,2,7,6,43,24,6,4,106,124
547,21,3,4,8,5,-65,41,1,5,41,165
547,22,4,2,6,7,42,-75,3,0,83,90
547,23,2,5,4,9,22,54,5,4,105,144
547,24,4,3,11,2,-53,-30,2,4,52,114
547,25,4,3,5,8,41,35,3,9,93,149
547,26,3,3,6,7,33,-66,6,3,126,83
547,27,5,2,10,3,-45,21,1,4,81,104
547,28,4,3,9,4,45,31,6,5,126,135
547,29,2,4,2,11,20,-53,6,2,146,82
547,30,3,3,6,7,33,34,9,6,179,116
547,31,4,3,9,4,-55,31,4,7,124,147
547,32,4,2,9,4,45,22,9,9,169,169
547,33,2,5,5,8,-77,-47,2,2,92,122
547,34,3,4,7,6,34,42,6,4,126,164
547,35,2,5,4,9,22,54,8,8,148,218
547,36,4,3,8,5,-56,-68,2,0,92,150
547,37,3,4,5,8,32,44,4,4,124,194
547,38,4,2,9,4,45,22,9,6,169,216
547,39,5,3,8,5,-47,32,2,8,122,248
547,40,5,3,9,4,54,31,6,9,176,279
547,41,4,3,9,4,-55,-69,1,0,121,210
547,42,4,2,9,4,45,22,6,2,166,232
547,43,3,3,7,6,-66,33,0,5,100,265
547,44,4,2,8,5,44,23,4,8,144,288
547,45,3,3,5,8,32,-65,6,3,176,223
547,46,3,4,8,5,-65,41,1,4,111,264
547,47,3,3,7,6,34,33,5,7,145,297
547,48,3,3,8,5,-65,32,0,9,80,329
547,49,2,5,3,10,21,-45,1,4,101,284
547,50,2,5,4,9,22,54,3,8,123,338
547,51,4,3,9,4,45,31,8,9,168,369
547,52,2,4,6,7,-76,-57,2,2,92,312
547,53,2,4,4,9,22,45,4,7,114,357
547,54,6,2,8,5,62,-77,6,0,176,280
547,55,2,5,4,9,22,54,8,4,198,334
547,56,5,2,10,3,-45,21,3,5,153,355
547,57,2,4,2,11,20,-53,3,2,173,302
547,58,4,3,8,5,44,32,7,4,217,334
547,59,2,4,7,6,-75,42,2,6,142,376
547,60,3,3,4,9,31,-64,3,2,173,312
547,61,5,2,7,6,52,24,5,6,225,336
547,62,4,3,6,7,42,-66,7,0,267,270
547,63,2,5,2,11,20,56,7,6,287,326
547,64,4,2,9,4,-55,22,2,8,232,348
547,65,5,3,5,8,50,-65,2,3,282,283
547,66,4,3,9,4,45,31,7,4,327,314
547,67,3,4,5,8,32,44,9,8,359,358
547,68,4,2,9,4,-55,-78,4,0,304,280
547,69,4,3,7,6,43,33,7,3,347,313
547,70,5,3,5,8,50,35,7,8,397,348
547,71,2,4,6,7,-76,-57,1,1,321,291
547,72,3,4,5,8,32,44,3,5,353,335
547,73,4,3,7,6,43,33,6,8,396,368
547,74,5,3,10,3,-45,30,1,8,351,398
547,75,2,4,3,10,21,-54,2,4,372,344
547,76,3,3,6,7,33,34,5,8,405,378
547,77,3,3,6,7,33,-66,8,2,438,312
547,78,3,3,6,7,-67,34,1,6,371,346
547,79,6,2,11,2,65,20,6,6,436,366
547,80,6,2,10,3,-36,21,0,7,400,387
547,81,3,3,6,7,33,-66,3,1,433,321
547,82,4,2,8,5,44,23,7,4,477,344
547,83,5,2,10,3,-45,21,2,5,432,365
547,84,5,2,8,5,53,23,5,8,485,388
547,85,4,3,7,6,43,-67,8,1,528,321
548,1,3,3,7,6,34,33,4,3,34,33
548,2,3,3,7,6,34,33,8,6,68,66
548,3,4,2,8,5,-56,23,2,9,12,89
548,4,3,3,7,6,34,-67,6,2,46,22
548,5,5,2,10,3,-45,21,1,3,1,43
548,6,4,3,8,5,44,32,5,5,45,75
548,7,2,6,3,10,21,64,6,9,66,139
548,8,3,3,5,8,32,-65,8,4,98,74
548,9,3,4,9,4,-64,40,4,4,34,114
548,10,2,4,3,10,21,-54,5,0,55,60
548,11,4,2,6,7,42,25,7,5,97,85
548,12,2,4,5,8,-77,44,0,9,20,129
548,13,3,3,3,10,30,-63,0,6,50,66
548,14,5,2,9,4,54,22,4,8,104,88
548,15,3,4,5,8,32,-56,6,2,136,32
548,16,4,3,5,8,41,35,7,7,177,67
548,17,3,4,5,8,32,-56,9,1,209,11
548,18,4,2,6,7,-58,25,1,6,151,36
548,19,3,3,8,5,35,32,6,8,186,68
548,20,3,4,6,7,33,-57,9,1,219,11
548,21,5,2,9,4,-46,22,3,3,173,33
548,22,3,3,7,6,34,33,7,6,207,66
548,23,4,3,9,4,-55,31,2,7,152,97
548,24,5,2,9,4,54,22,6,9,206,119
548,25,5,2,10,3,-45,-79,1,0,161,40
548,26,4,3,6,7,42,34,3,4,203,74
548,27,4,3,9,4,45,31,8,5,248,105
548,28,4,3,6,7,-58,34,0,9,190,139
548,29,4,3,8,5,44,-68,4,1,234,71
548,30,2,4,3,10,21,46,5,7,255,117
548,31,4,3,4,9,40,-64,5,3,295,53
548,32,5,2,8,5,53,23,8,6,348,76
548,33,3,4,6,7,-67,43,1,9,281,119
548,34,3,3,6,7,33,-66,4,3,314,53
548,35,3,4,6,7,33,43,7,6,347,96
548,36,6,2,9,4,-37,22,0,8,310,118
548,37,3,3,6,7,33,-66,3,2,343,52
548,38,3,5,4,9,31,54,4,6,374,106
548,39,2,4,7,6,25,42,9,8,399,148
548,40,3,3,7,6,-66,-67,3,1,333,81
548,41,3,3,8,5,35,32,8,3,368,113
548,42,4,3,8,5,-56,32,2,5,312,145
548,43,2,5,4,9,22,54,4,9,334,199
548,44,4,2,7,6,43,-76,7,3,377,123
548,45,3,4,7,6,-66,42,1,5,311,165
548,46,4,3,8,5,44,32,5,7,355,197
548,47,4,2,5,8,41,-74,6,3,396,123
548,48,5,2,7,6,52,24,8,7,448,147
548,49,4,3,7,6,-57,-67,1,0,391,80
548,50,3,4,5,8,32,44,3,4,423,124
548,51,3,3,8,5,35,32,8,6,458,156
548,52,3,3,5,8,-68,-65,0,1,390,91
548,53,4,2,6,7,42,25,2,6,432,116
548,54,5,2,9,4,54,22,6,8,486,138
548,55,5,3,8,5,53,-68,9,0,539,70
549,1,4,3,6,7,42,34,2,4,42,34
549,2,3,4,5,8,32,44,4,8,74,78
549,3,4,3,7,6,43,-67,7,1,117,11
549,4,3,3,5,8,32,35,9,6,149,46
549,5,2,4,7,6,-75,42,4,8,74,88
549,6,4,3,6,7,42,-66,6,2,116,22
549,7,4,3,5,8,41,35,7,7,157,57
549,8,3,4,7,6,-66,42,1,9,91,99
549,9,3,3,6,7,33,-66,4,3,124,33
549,10,4,3,7,6,43,33,7,6,167,66
549,11,2,4,7,6,-75,42,2,8,92,108
549,12,3,3,6,7,33,-66,5,2,125,42
549,13,4,3,8,5,44,32,9,4,169,74
549,14,2,4,7,6,-75,42,4,6,94,116
549,15,3,3,8,5,35,32,9,8,129,148
549,16,2,5,5,8,-77,-47,2,1,52,101
549,17,3,3,5,8,32,35,4,6,84,136
549,18,3,3,4,9,31,-64,5,2,115,72
549,19,3,3,8,5,-65,32,0,4,50,104
549,20,4,2,8,5,44,23,4,7,94,127
549,21,3,3,7,6,34,-67,8,0,128,60
549,22,2,5,6,7,-76,52,2,2,52,112
549,23,3,4,6,7,33,43,5,5,85,155
549,24,3,3,8,5,-65,32,0,7,20,187
549,25,4,3,8,5,44,32,4,9,64,219
549,26,3,3,7,6,34,-67,8,2,98,152
549,27,2,4,3,10,21,46,9,8,119,198
549,28,3,3,6,7,-67,-66,2,2,52,132
549,29,2,5,4,9,22,54,4,6,74,186
549,30,3,3,5,8,32,-65,6,1,106,121
549,31,4,3,4,9,40,36,6,7,146,157
549,32,2,5,3,10,21,-45,7,2,167,112
549,33,3,4,5,8,32,44,9,6,199,156
549,34,3,4,3,10,30,-54,9,2,229,102
549,35,3,4,8,5,-65,41,4,3,164,143
549,36,3,3,6,7,33,34,7,7,197,177
549,37,3,4,7,6,-66,42,1,9,131,219
549,38,4,3,5,8,41,-65,2,4,172,154
549,39,3,4,6,7,33,43,5,7,205,197
549,40,4,3,5,8,41,-65,6,2,246,132
549,41,3,4,8,5,-65,41,1,3,181,173
549,42,2,4,7,6,25,42,6,5,206,215
549,43,3,3,5,8,32,-65,8,0,238,150
549,44,4,3,6,7,-58,34,0,4,180,184
549,45,3,4,6,7,33,43,3,7,213,227
549,46,6,2,10,3,64,21,7,8,277,248
549,47,2,5,3,10,21,-45,8,3,298,203
549,48,3,4,4,9,31,45,9,8,329,248
549,49,2,4,3,10,-79,-54,0,4,250,194
549,50,4,3,8,5,44,32,4,6,294,226
549,51,4,2,9,4,45,22,9,8,339,248
549,52,5,2,7,6,-48,-76,1,2,291,172
549,53,3,4,5,8,32,44,3,6,323,216
549,54,4,3,8,5,44,32,7,8,367,248
549,55,3,4,7,6,-66,-58,1,0,301,190
549,56,4,3,7,6,43,33,4,3,344,223
549,57,4,2,6,7,42,25,6,8,386,248
549,58,3,3,6,7,33,-66,9,2,419,182
549,59,3,4,6,7,-67,43,2,5,352,225
549,60,2,4,3,10,21,-54,3,1,373,171
549,61,4,3,6,7,42,34,5,5,415,205
549,62,6,2,9,4,63,22,8,7,478,227
549,63,2,4,7,6,-75,42,3,9,403,269
549,64,4,3,8,5,44,-68,7,1,447,201
549,65,4,3,6,7,42,34,9,5,489,235
549,66,2,4,5,8,-77,44,2,9,412,279
549,67,2,5,4,9,22,-46,4,3,434,233
549,68,3,4,4,9,31,45,5,8,465,278
549,69,3,3,8,5,-65,-68,0,0,400,210
549,70,4,3,8,5,44,32,4,2,444,242
549,71,3,3,8,5,35,32,9,4,479,274
549,72,3,4,4,9,-69,45,0,9,410,319
549,73,5,2,11,2,56,20,6,9,466,339
549,74,2,4,6,7,-76,-57,0,2,390,282
549,75,4,4,4,9,40,45,0,7,430,327
549,76,4,2,10,3,46,21,6,8,476,348
549,77,5,2,9,4,-46,-78,0,0,430,270
549,78,5,2,11,2,56,20,6,0,486,290
549,79,2,4,5,8,23,44,9,4,509,334
550,1,4,2,9,4,45,22,5,2,45,22
550,2,5,2,7,6,52,24,7,6,97,46
550,3,5,2,9,4,-46,22,1,8,51,68
550,4,4,3,10,3,46,30,7,8,97,98
550,5,3,4,7,6,-66,-58,1,0,31,40
550,6,4,2,8,5,44,23,5,3,75,63
550,7,3,3,6,7,33,34,8,7,108,97
550,8,2,4,7,6,-75,42,3,9,33,139
550,9,2,5,4,9,22,-46,5,3,55,93
550,10,2,4,4,9,22,45,7,8,77,138
550,11,3,3,10,3,-63,30,4,8,14,168
550,12,4,3,7,6,43,-67,7,1,57,101
550,13,3,5,5,8,32,53,9,4,89,154
550,14,4,3,5,8,-59,35,0,9,30,189
550,15,3,4,5,8,32,-56,2,3,62,133
550,16,4,3,6,7,42,34,4,7,104,167
550,17,2,4,5,8,23,-56,7,1,127,111
550,18,3,3,10,3,-63,30,4,1,64,141
550,19,2,4,4,9,22,45,6,6,86,186
550,20,3,3,5,8,32,-65,8,1,118,121
550,21,5,2,9,4,-46,22,2,3,72,143
550,22,3,3,7,6,34,33,6,6,106,176
550,23,4,3,7,6,43,33,9,9,149,209
550,24,4,2,8,5,-56,-77,3,2,93,132
550,25,2,5,3,10,21,55,4,7,114,187
550,26,2,5,6,7,24,52,8,9,138,239
550,27,2,5,5,8,-77,-47,1,2,61,192
550,28,3,4,7,6,34,42,5,4,95,234
550,29,3,4,6,7,33,43,8,7,128,277
550,30,4,2,8,5,-56,-77,2,0,72,200
550,31,3,4,8,5,35,41,7,1,107,241
550,32,5,2,8,5,-47,23,0,4,60,264
550,33,5,2,6,7,51,25,1,9,111,289
550,34,2,4,6,7,24,-57,5,2,135,232
550,35,5,2,9,4,54,22,9,4,189,254
550,36,5,2,10,3,-45,21,4,5,144,275
550,37,3,3,9,4,-64,31,0,6,80,306
550,38,3,4,6,7,33,43,3,9,113,349
550,39,4,4,4,9,40,-55,3,4,153,294
550,40,4,3,5,8,41,35,4,9,194,329
550,41,3,4,7,6,34,-58,8,1,228,271
550,42,3,4,4,9,31,45,9,6,259,316
550,43,2,4,4,9,-78,-55,1,1,181,261
550,44,3,4,5,8,32,44,3,5,213,305
550,45,3,4,3,10,30,-54,3,1,243,251
550,46,4,2,9,4,45,22,8,3,288,273
550,47,2,4,4,9,-78,45,0,8,210,318
550,48,4,3,9,4,45,31,5,9,255,349
550,49,4,3,6,7,42,-66,7,3,297,283
550,50,2,4,7,6,-75,42,2,5,222,325
550,51,4,3,8,5,44,32,6,7,266,357
550,52,4,3,7,6,43,-67,9,0,309,290
550,53,3,3,4,9,-69,36,0,6,240,326
550,54,5,3,9,4,54,31,4,7,294,357
550,55,3,4,7,6,34,42,8,9,328,399
550,56,5,2,7,6,-48,-76,0,3,280,323
550,57,4,2,8,5,44,23,4,6,324,346
550,58,3,3,6,7,33,-66,7,0,357,280
550,59,5,2,8,5,-47,23,0,3,310,303
550,60,4,2,10,3,46,21,6,4,356,324
550,61,3,4,4,9,31,45,7,9,387,369
550,62,4,2,7,6,-57,-76,0,3,330,293
550,63,4,2,7,6,43,24,3,7,373,317
550,64,3,4,4,9,31,-55,4,2,404,262
550,65,3,3,9,4,-64,31,0,3,340,293
550,66,3,4,4,9,31,45,1,8,371,338
550,67,4,3,9,4,45,31,6,9,416,369
550,68,2,4,8,5,-74,-59,2,0,342,310
550,69,2,5,4,9,22,54,4,4,364,364
550,70,4,2,11,2,-53,20,1,4,311,384
550,71,3,3,4,9,31,-64,2,0,342,320
550,72,4,3,8,5,44,32,6,2,386,352
550,73,2,5,4,9,22,54,8,6,408,406
550,74,5,2,7,6,-48,-76,0,0,360,330
550,75,3,4,6,7,33,43,3,3,393,373
550,76,5,2,8,5,53,23,6,6,446,396
550,77,4,2,9,4,-55,22,1,8,391,418
550,78,3,3,5,8,32,-65,3,3,423,353
550,79,3,3,5,8,32,35,5,8,455,388
550,80,5,2,10,3,-45,21,0,9,410,409
550,81,3,4,5,8,32,-56,2,3,442,353
550,82,4,2,8,5,44,23,6,6,486,376
550,83,4,2,10,3,-54,21,2,7,432,397
550,84,3,4,8,5,35,41,7,8,467,438
550,85,5,2,9,4,-46,-78,1,0,421,360
550,86,3,4,7,6,34,42,5,2,455,402
550,87,5,2,9,4,54,22,9,4,509,424
551,1,3,3,5,8,32,35,2,5,32,35
551,2,4,3,8,5,44,32,6,7,76,67
551,3,5,2,10,3,-45,21,1,8,31,88
551,4,3,3,8,5,35,-68,6,0,66,20
551,5,3,3,6,7,33,34,9,4,99,54
551,6,3,4,7,6,-66,42,3,6,33,96
551,7,4,2,8,5,44,23,7,9,77,119
551,8,4,2,10,3,-54,-79,3,0,23,40
551,9,3,3,7,6,34,33,7,3,57,73
551,10,4,3,8,5,-56,32,1,5,1,105
551,11,3,4,6,7,33,43,4,8,34,148
551,12,4,3,7,6,43,-67,7,1,77,81
551,13,3,3,6,7,-67,34,0,5,10,115
551,14,4,3,8,5,44,32,4,7,54,147
551,15,5,2,11,2,-44,20,0,7,10,167
551,16,2,5,4,9,22,-46,2,1,32,121
551,17,5,2,9,4,54,22,6,3,86,143
551,18,3,3,4,9,31,36,7,9,117,179
551,19,5,2,8,5,-47,-77,0,2,70,102
551,20,3,4,5,8,32,44,2,6,102,146
551,21,3,4,4,9,31,-55,3,1,133,91
551,22,3,4,5,8,32,44,5,5,165,135
551,23,2,5,5,8,23,53,8,8,188,188
551,24,4,4,5,8,41,-56,9,2,229,132
551,25,5,2,11,2,-44,20,5,2,185,152
551,26,4,3,9,4,-55,31,0,3,130,183
551,27,4,3,8,5,44,32,4,5,174,215
551,28,3,3,8,5,35,32,9,7,209,247
551,29,2,4,4,9,-78,-55,1,2,131,192
551,30,3,4,6,7,33,43,4,5,164,235
551,31,5,2,9,4,54,22,8,7,218,257
551,32,3,3,5,8,-68,-65,0,2,150,192
551,33,3,4,6,7,33,43,3,5,183,235
551,34,5,2,11,2,56,20,9,5,239,255
551,35,4,3,6,7,-58,34,1,9,181,289
551,36,4,2,10,3,46,-79,7,0,227,210
551,37,3,3,5,8,32,35,9,5,259,245
551,38,4,3,4,9,40,-64,9,1,299,181
551,39,2,5,5,8,-77,53,2,4,222,234
551,40,2,5,2,11,20,-44,2,0,242,190
551,41,2,5,4,9,22,54,4,4,264,244
551,42,4,3,8,5,44,32,8,6,308,276
551,43,3,3,5,8,-68,-65,0,1,240,211
551,44,3,3,8,5,35,32,5,3,275,243
551,45,2,5,6,7,24,52,9,5,299,295
551,46,3,3,6,7,-67,34,2,9,232,329
551,47,5,2,7,6,52,-76,4,3,284,253
551,48,4,2,8,5,44,23,8,6,328,276
551,49,3,3,5,8,-68,-65,0,1,260,211
551,50,3,3,6,7,33,34,3,5,293,245
551,51,2,5,5,8,23,53,6,8,316,298
551,52,4,3,7,6,43,-67,9,1,359,231
551,53,3,4,5,8,-68,44,1,5,291,275
551,54,4,2,5,8,41,-74,2,1,332,201
551,55,3,3,4,9,31,36,3,7,363,237
551,56,4,3,9,4,45,31,8,8,408,268
551,57,3,5,4,9,31,-46,9,2,439,222
551,58,3,4,6,7,-67,43,2,5,372,265
551,59,4,2,6,7,42,-75,4,0,414,190
551,60,2,4,4,9,22,45,6,5,436,235
551,61,3,4,7,6,-66,42,0,7,370,277
551,62,3,4,5,8,32,-56,2,1,402,221
551,63,3,3,6,7,33,34,5,5,435,255
551,64,3,3,8,5,-65,32,0,7,370,287
551,65,4,2,7,6,43,-76,3,1,413,211
551,66,2,4,6,7,24,43,7,4,437,254
551,67,4,3,8,5,-56,32,1,6,381,286
551,68,4,4,6,7,42,43,3,9,423,329
551,69,2,5,5,8,23,-47,6,2,446,282
551,70,3,3,4,9,31,36,7,8,477,318
551,71,2,4,7,6,-75,-58,2,0,402,260
551,72,4,3,8,5,44,32,6,2,446,292
551,73,5,3,9,4,-46,31,0,3,400,323
551,74,5,2,10,3,55,21,5,4,455,344
551,75,3,4,3,10,30,-54,5,0,485,290
551,76,3,3,5,8,32,35,7,5,517,325
552,1,2,4,3,10,21,46,1,6,21,46
552,2,6,2,11,2,65,20,6,6,86,66
552,3,3,3,4,9,31,-64,7,2,117,2
552,4,4,2,8,5,-56,23,1,5,61,25
552,5,2,5,5,8,23,53,4,8,84,78
552,6,4,3,6,7,42,-66,6,2,126,12
552,7,3,3,6,7,33,34,9,6,159,46
552,8,2,5,6,7,-76,52,3,8,83,98
552,9,2,4,3,10,21,-54,4,4,104,44
552,10,4,2,6,7,42,25,6,9,146,69
552,11,3,3,8,5,-65,-68,1,1,81,1
552,12,4,2,6,7,42,25,3,6,123,26
552,13,3,3,9,4,36,31,9,7,159,57
552,14,4,3,9,4,-55,31,4,8,104,88
552,15,3,4,7,6,34,-58,8,0,138,30
552,16,3,3,4,9,31,36,9,6,169,66
552,17,4,4,6,7,-58,43,1,9,111,109
552,18,4,2,8,5,44,-77,5,2,155,32
552,19,3,4,6,7,33,43,8,5,188,75
552,20,6,2,8,5,-38,23,0,8,150,98
552,21,3,4,4,9,31,-55,1,3,181,43
552,22,4,2,7,6,43,24,4,7,224,67
552,23,3,4,6,7,33,-57,7,0,257,10
552,24,6,2,10,3,-36,21,1,1,221,31
552,25,3,3,6,7,33,34,4,5,254,65
552,26,3,4,6,7,33,43,7,8,287,108
552,27,2,4,5,8,-77,-56,0,2,210,52
552,28,3,4,7,6,34,42,4,4,244,94
552,29,2,5,5,8,23,53,7,7,267,147
552,30,2,5,2,11,20,-44,7,3,287,103
552,31,2,5,4,9,22,54,9,7,309,157
552,32,3,3,7,6,-66,-67,3,0,243,90
552,33,3,3,6,7,33,34,6,4,276,124
552,34,3,3,8,5,-65,32,1,6,211,156
552,35,3,4,6,7,33,43,4,9,244,199
552,36,2,4,6,7,24,-57,8,2,268,142
552,37,4,2,7,6,-57,24,1,6,211,166
552,38,4,3,6,7,42,-66,3,0,253,100
552,39,4,3,7,6,43,33,6,3,296,133
552,40,4,3,6,7,42,34,8,7,338,167
552,41,4,2,7,6,-57,-76,1,1,281,91
552,42,3,3,9,4,36,31,7,2,317,122
552,43,4,3,10,3,-54,30,3,2,263,152
552,44,4,3,9,4,45,31,8,3,308,183
552,45,3,3,6,7,-67,34,1,7,241,217
552,46,3,4,6,7,33,-57,4,0,274,160
552,47,3,3,8,5,35,32,9,2,309,192
552,48,2,5,5,8,-77,53,2,5,232,245
552,49,3,4,6,7,33,43,5,8,265,288
552,50,4,2,7,6,43,-76,8,2,308,212
552,51,2,4,7,6,-75,42,3,4,233,254
552,52,6,2,10,3,64,21,7,5,297,275
552,53,3,4,6,7,-67,43,0,8,230,318
552,54,2,5,5,8,23,-47,3,1,253,271
552,55,2,4,5,8,23,44,6,5,276,315
552,56,2,4,4,9,22,-55,8,0,298,260
552,57,3,4,4,9,31,45,9,5,329,305
552,58,4,2,11,2,-53,20,6,5,276,325
552,59,3,3,7,6,-66,33,0,8,210,358
552,60,5,2,10,3,55,21,5,9,265,379
552,61,2,4,5,8,23,-56,8,3,288,323
552,62,2,4,4,9,-78,45,0,8,210,368
552,63,5,2,7,6,52,-76,2,2,262,292
552,64,4,3,6,7,42,34,4,6,304,326
552,65,4,4,6,7,42,43,6,9,346,369
552,66,3,4,6,7,33,-57,9,2,379,312
552,67,4,4,6,7,-58,43,1,5,321,355
552,68,4,3,7,6,43,33,4,8,364,388
552,69,3,4,7,6,34,-58,8,0,398,330
552,70,5,3,8,5,-47,32,1,2,351,362
552,71,3,3,7,6,34,33,5,5,385,395
552,72,3,3,4,9,31,-64,6,1,416,331
552,73,5,2,11,2,-44,20,2,1,372,351
552,74,3,3,7,6,34,33,6,4,406,384
552,75,4,2,10,3,-54,21,2,5,352,405
552,76,4,3,8,5,44,32,6,7,396,437
552,77,3,4,7,6,-66,42,0,9,330,479
552,78,3,3,6,7,33,-66,3,3,363,413
552,79,3,3,10,3,-63,30,0,3,300,443
552,80,3,3,7,6,34,33,4,6,334,476
552,81,5,2,9,4,54,22,8,8,388,498
552,82,4,2,8,5,-56,-77,2,1,332,421
552,83,3,3,5,8,32,35,4,6,364,456
552,84,3,3,5,8,32,-65,6,1,396,391
552,85,2,5,4,9,22,54,8,5,418,445
552,86,2,5,4,9,-78,54,0,9,340,499
552,87,3,3,7,6,34,-67,4,2,374,432
552,88,4,2,9,4,45,22,9,4,419,454
552,89,5,2,7,6,-48,24,1,8,371,478
552,90,3,3,4,9,31,-64,2,4,402,414
552,91,3,3,6,7,33,34,5,8,435,448
552,92,3,4,5,8,32,-56,7,2,467,392
552,93,2,4,4,9,22,45,9,7,489,437
552,94,3,4,4,9,-69,-55,0,2,420,382
552,95,2,6,3,10,21,64,1,6,441,446
552,96,3,4,4,9,31,-55,2,1,472,391
552,97,2,5,5,8,23,53,5,4,495,444
552,98,4,2,10,3,-54,21,1,5,441,465
552,99,2,5,2,11,20,-44,1,1,461,421
552,100,3,3,5,8,32,35,3,6,493,456
552,101,3,4,7,6,34,42,7,8,527,498
553,1,3,3,9,4,36,31,6,1,36,31
553,2,3,4,4,9,31,45,7,6,67,76
553,3,3,4,5,8,32,-56,9,0,99,20
553,4,3,4,4,9,-69,45,0,5,30,65
553,5,3,3,8,5,35,32,5,7,65,97
553,6,3,4,5,8,32,-56,7,1,97,41
553,7,3,4,6,7,-67,43,0,4,30,84
553,8,3,4,6,7,33,43,3,7,63,127
553,9,2,4,5,8,23,-56,6,1,86,71
553,10,4,2,9,4,-55,22,1,3,31,93
553,11,3,4,4,9,31,45,2,8,62,138
553,12,3,4,6,7,33,-57,5,1,95,81
553,13,3,3,7,6,34,33,9,4,129,114
553,14,2,4,2,11,20,-53,9,1,149,61
553,15,4,3,7,6,-57,33,2,4,92,94
553,16,3,3,6,7,33,34,5,8,125,128
553,17,3,3,5,8,32,-65,7,3,157,63
553,18,3,3,6,7,-67,34,0,7,90,97
553,19,2,4,6,7,24,-57,4,0,114,40
553,20,3,3,6,7,33,34,7,4,147,74
553,21,4,3,8,5,-56,32,1,6,91,106
553,22,3,3,5,8,32,-65,3,1,123,41
553,23,4,3,9,4,45,31,8,2,168,72
553,24,3,3,7,6,-66,33,2,5,102,105
553,25,5,2,9,4,54,22,6,7,156,127
553,26,6,2,11,2,-35,20,1,7,121,147
553,27,5,2,11,2,56,20,7,7,177,167
553,28,4,3,9,4,-55,31,2,8,122,198
553,29,4,4,5,8,41,-56,3,2,163,142
553,30,3,3,7,6,34,33,7,5,197,175
553,31,3,3,6,7,-67,34,0,9,130,209
553,32,3,4,4,9,31,-55,1,4,161,154
553,33,3,3,4,9,31,-64,2,0,192,90
553,34,2,4,3,10,21,46,3,6,213,136
553,35,3,3,6,7,33,-66,6,0,246,70
553,36,3,5,7,6,-66,51,0,1,180,121
553,37,4,3,7,6,43,33,3,4,223,154
553,38,4,2,9,4,45,22,8,6,268,176
553,39,4,4,5,8,41,-56,9,0,309,120
553,40,3,4,5,8,-68,44,1,4,241,164
553,41,4,3,8,5,44,32,5,6,285,196
553,42,2,4,7,6,-75,42,0,8,210,238
553,43,3,5,7,6,34,51,4,9,244,289
553,44,2,5,2,11,20,-44,4,5,264,245
553,45,4,2,5,8,41,-74,5,1,305,171
553,46,5,2,9,4,54,22,9,3,359,193
553,47,3,3,7,6,-66,33,3,6,293,226
553,48,2,4,6,7,24,43,7,9,317,269
553,49,3,3,7,6,-66,-67,1,2,251,202
553,50,2,4,4,9,22,45,3,7,273,247
553,51,3,4,4,9,31,-55,4,2,304,192
553,52,4,2,9,4,45,22,9,4,349,214
553,53,3,4,7,6,-66,42,3,6,283,256
553,54,4,3,5,8,41,-65,4,1,324,191
553,55,3,4,5,8,32,44,6,5,356,235
553,56,3,3,8,5,-65,32,1,7,291,267
553,57,5,2,9,4,54,22,5,9,345,289
553,58,3,4,7,6,34,-58,9,1,379,231
553,59,4,3,7,6,-57,33,2,4,322,264
553,60,3,4,7,6,34,42,6,6,356,306
553,61,3,4,3,10,30,-54,6,2,386,252
553,62,3,3,7,6,-66,33,0,5,320,285
553,63,5,2,8,5,53,23,3,8,373,308
553,64,2,5,3,10,21,-45,4,3,394,263
553,65,3,4,4,9,31,45,5,8,425,308
553,66,4,3,9,4,-55,31,0,9,370,339
553,67,4,3,8,5,44,-68,4,1,414,271
553,68,3,3,8,5,35,32,9,3,449,303
553,69,2,5,3,10,-79,55,0,8,370,358
553,70,3,4,6,7,33,-57,3,1,403,301
553,71,3,4,5,8,32,44,5,5,435,345
553,72,3,4,8,5,-65,41,0,6,370,386
553,73,4,2,6,7,42,-75,2,1,412,311
553,74,4,3,7,6,43,33,5,4,455,344
553,75,3,4,6,7,33,43,8,7,488,387
553,76,2,5,3,10,21,-45,9,2,509,342
554,1,4,2,4,9,40,27,0,7,40,27
554,2,4,3,7,6,43,-67,3,0,83,-40
554,3,2,4,6,7,24,43,7,3,107,3
554,4,3,3,6,7,-67,34,0,7,40,37
554,5,4,3,7,6,43,-67,3,0,83,-30
554,6,6,2,11,2,65,20,8,0,148,-10
554,7,2,4,7,6,-75,42,3,2,73,32
554,8,3,3,7,6,34,33,7,5,107,65
554,9,3,5,5,8,32,53,9,8,139,118
554,10,4,3,9,4,-55,31,4,9,84,149
554,11,3,3,6,7,33,-66,7,3,117,83
554,12,4,2,9,4,-55,22,2,5,62,105
554,13,3,3,9,4,36,31,8,6,98,136
554,14,4,3,8,5,-56,32,2,8,42,168
554,15,2,4,5,8,23,-56,5,2,65,112
554,16,3,3,4,9,31,36,6,8,96,148
554,17,3,5,3,10,30,-45,6,3,126,103
554,18,3,4,6,7,33,43,9,6,159,146
554,19,4,2,10,3,-54,21,5,7,105,167
554,20,4,2,10,3,-54,21,1,8,51,188
554,21,3,3,8,5,35,-68,6,0,86,120
554,22,3,4,6,7,33,43,9,3,119,163
554,23,4,3,7,6,-57,33,2,6,62,196
554,24,6,2,10,3,64,21,6,7,126,217
554,25,5,2,8,5,53,-77,9,0,179,140
554,26,4,2,9,4,-55,22,4,2,124,162
554,27,3,3,9,4,-64,31,0,3,60,193
554,28,4,3,8,5,44,32,4,5,104,225
554,29,5,2,6,7,51,-75,5,0,155,150
554,30,2,5,4,9,22,54,7,4,177,204
554,31,2,4,3,10,21,-54,8,0,198,150
554,32,2,4,6,7,-76,43,2,3,122,193
554,33,3,4,7,6,34,42,6,5,156,235
554,34,3,4,7,6,-66,42,0,7,90,277
554,35,3,3,7,6,34,-67,4,0,124,210
554,36,4,3,9,4,45,31,9,1,169,241
554,37,2,4,7,6,-75,42,4,3,94,283
554,38,3,3,7,6,34,33,8,6,128,316
554,39,4,3,6,7,-58,-66,0,0,70,250
554,40,3,3,6,7,33,34,3,4,103,284
554,41,6,2,10,3,64,21,7,5,167,305
554,42,2,5,5,8,-77,53,0,8,90,358
554,43,3,4,6,7,33,-57,3,1,123,301
554,44,3,3,7,6,34,33,7,4,157,334
554,45,3,3,5,8,32,35,9,9,189,369
554,46,5,2,10,3,-45,-79,4,0,144,290
554,47,2,5,6,7,24,52,8,2,168,342
554,48,2,5,3,10,21,55,9,7,189,397
554,49,5,3,9,4,-46,31,3,8,143,428
554,50,2,5,6,7,24,-48,7,0,167,380
554,51,3,4,7,6,-66,42,1,2,101,422
554,52,4,2,10,3,46,21,7,3,147,443
554,53,4,3,8,5,-56,32,1,5,91,475
554,54,4,2,8,5,44,23,5,8,135,498
554,55,4,3,7,6,43,-67,8,1,178,431
554,56,5,2,9,4,-46,22,2,3,132,453
554,57,2,6,2,11,20,65,2,8,152,518
555,1,2,5,4,9,22,54,2,4,22,54
555,2,3,4,3,10,30,-54,2,0,52,0
555,3,4,2,7,6,43,24,5,4,95,24
555,4,4,3,6,7,42,34,7,8,137,58
555,5,5,2,10,3,-45,21,2,9,92,79
555,6,4,2,6,7,42,-75,4,4,134,4
555,7,4,3,7,6,43,33,7,7,177,37
555,8,3,3,7,6,-66,-67,1,0,111,-30
555,9,2,4,3,10,21,46,2,6,132,16
555,10,3,3,9,4,36,31,8,7,168,47
555,11,3,3,8,5,-65,32,3,9,103,79
555,12,2,4,7,6,25,-58,8,1,128,21
555,13,3,3,6,7,-67,34,1,5,61,55
555,14,2,5,3,10,21,-45,2,0,82,10
555,15,6,2,9,4,63,22,5,2,145,32
555,16,3,4,5,8,32,44,7,6,177,76
555,17,3,4,4,9,31,-55,8,1,208,21
555,18,3,3,5,8,-68,35,0,6,140,56
555,19,2,4,7,6,25,42,5,8,165,98
555,20,4,2,9,4,-55,-78,0,0,110,20
555,21,3,4,7,6,34,42,4,2,144,62
555,22,2,5,5,8,23,53,7,5,167,115
555,23,3,4,6,7,-67,43,0,8,100,158
555,24,4,3,7,6,43,-67,3,1,143,91
555,25,3,3,4,9,31,36,4,7,174,127
555,26,4,2,9,4,45,22,9,9,219,149
555,27,5,2,7,6,-48,-76,1,3,171,73
555,28,3,3,9,4,36,31,7,4,207,104
555,29,3,3,6,7,-67,34,0,8,140,138
555,30,4,3,6,7,42,-66,2,2,182,72
555,31,3,3,7,6,34,33,6,5,216,105
555,32,3,3,6,7,33,34,9,9,249,139
555,33,4,2,6,7,-58,-75,1,4,191,64
555,34,4,3,9,4,45,31,6,5,236,95
555,35,4,3,6,7,42,34,8,9,278,129
555,36,3,3,7,6,-66,-67,2,2,212,62
555,37,5,2,9,4,54,22,6,4,266,84
555,38,2,5,4,9,22,54,8,8,288,138
555,39,4,3,6,7,-58,-66,0,2,230,72
555,40,3,4,6,7,33,43,3,5,263,115
555,41,3,3,8,5,35,32,8,7,298,147
555,42,4,3,9,4,-55,31,3,8,243,178
555,43,4,2,6,7,42,-75,5,3,285,103
555,44,2,5,6,7,24,52,9,5,309,155
555,45,5,3,9,4,-46,31,3,6,263,186
555,46,2,5,5,8,23,53,6,9,286,239
555,47,3,3,6,7,33,-66,9,3,319,173
555,48,5,2,9,4,-46,22,3,5,273,195
555,49,2,4,4,9,22,-55,5,0,295,140
555,50,5,2,11,2,-44,20,1,0,251,160
555,51,5,2,7,6,52,24,3,4,303,184
555,52,2,4,5,8,23,44,6,8,326,228
555,53,2,4,3,10,21,-54,7,4,347,174
555,54,3,4,8,5,-65,41,2,5,282,215
555,55,3,3,7,6,34,33,6,8,316,248
555,56,4,3,8,5,-56,-68,0,0,260,180
555,57,3,3,8,5,35,32,5,2,295,212
555,58,6,2,9,4,63,22,8,4,358,234
555,59,3,4,6,7,-67,43,1,7,291,277
555,60,3,4,5,8,32,-56,3,1,323,221
555,61,3,3,6,7,33,34,6,5,356,255
555,62,5,2,10,3,-45,21,1,6,311,276
555,63,6,2,7,6,61,-76,2,0,372,200
555,64,3,3,8,5,35,32,7,2,407,232
555,65,4,2,10,3,-54,21,3,3,353,253
555,66,3,3,5,8,32,35,5,8,385,288
555,67,4,3,6,7,42,-66,7,2,427,222
555,68,5,2,9,4,-46,22,1,4,381,244
555,69,2,6,3,10,21,64,2,8,402,308
555,70,5,3,10,3,55,30,7,8,457,338
555,71,2,4,5,8,-77,-56,0,2,380,282
555,72,3,4,5,8,32,44,2,6,412,326
555,73,5,2,8,5,53,23,5,9,465,349
555,74,3,3,9,4,-64,-69,1,0,401,280
555,75,4,2,6,7,42,25,3,5,443,305
555,76,2,5,6,7,24,52,7,7,467,357
555,77,3,3,8,5,-65,32,2,9,402,389
555,78,3,3,6,7,33,-66,5,3,435,323
555,79,5,2,7,6,52,24,7,7,487,347
555,80,2,4,5,8,-77,-56,0,1,410,291
555,81,5,2,9,4,54,22,4,3,464,313
555,82,4,3,9,4,45,31,9,4,509,344
556,1,3,3,7,6,34,33,4,3,34,33
556,2,3,3,8,5,35,32,9,5,69,65
556,3,4,3,9,4,-55,31,4,6,14,96
556,4,3,5,6,7,33,52,7,8,47,148
556,5,4,3,8,5,-56,-68,1,0,-9,80
556,6,2,6,4,9,22,63,3,3,13,143
556,7,5,2,8,5,53,23,6,6,66,166
556,8,5,3,8,5,53,32,9,8,119,198
556,9,2,5,3,10,-79,-45,0,3,40,153
556,10,4,3,8,5,44,32,4,5,84,185
556,11,3,4,7,6,34,42,8,7,118,227
556,12,2,4,5,8,-77,-56,1,1,41,171
556,13,4,3,5,8,41,35,2,6,82,206
556,14,4,4,6,7,42,43,4,9,124,249
556,15,2,4,5,8,23,-56,7,3,147,193
556,16,3,4,7,6,-66,42,1,5,81,235
556,17,2,4,6,7,24,43,5,8,105,278
556,18,4,3,8,5,44,-68,9,0,149,210
556,19,2,4,8,5,-74,41,5,1,75,251
556,20,3,4,4,9,31,45,6,6,106,296
556,21,2,6,3,10,21,-36,7,0,127,260
556,22,5,3,7,6,52,33,9,3,179,293
556,23,3,3,3,10,30,-63,9,0,209,230
556,24,5,2,10,3,-45,21,4,1,164,251
556,25,3,4,5,8,32,44,6,5,196,295
556,26,3,4,7,6,-66,42,0,7,130,337
556,27,3,4,4,9,31,-55,1,2,161,282
556,28,4,2,7,6,43,24,4,6,204,306
556,29,3,4,5,8,32,-56,6,0,236,250
556,30,4,3,6,7,42,34,8,4,278,284
556,31,4,3,6,7,-58,34,0,8,220,318
556,32,3,3,8,5,35,-68,5,0,255,250
556,33,3,4,7,6,34,42,9,2,289,292
556,34,3,3,6,7,-67,34,2,6,222,326
556,35,5,2,11,2,56,20,8,6,278,346
556,36,2,5,6,7,-76,52,2,8,202,398
556,37,4,3,7,6,43,-67,5,1,245,331
556,38,4,3,9,4,-55,31,0,2,190,362
556,39,2,4,4,9,22,45,2,7,212,407
556,40,2,4,5,8,23,-56,5,1,235,351
556,41,5,2,9,4,54,22,9,3,289,373
556,42,3,4,5,8,-68,44,1,7,221,417
556,43,3,3,7,6,34,-67,5,0,255,350
556,44,3,3,6,7,33,34,8,4,288,384
556,45,2,4,4,9,-78,45,0,9,210,429
556,46,3,3,3,10,30,-63,0,6,240,366
556,47,4,2,6,7,42,-75,2,1,282,291
556,48,4,2,7,6,43,24,5,5,325,315
556,49,2,4,6,7,24,43,9,8,349,358
556,50,4,4,8,5,-56,41,3,9,293,399
556,51,3,3,3,10,30,-63,3,6,323,336
556,52,2,5,5,8,23,53,6,9,346,389
556,53,3,3,8,5,-65,-68,1,1,281,321
556,54,2,4,5,8,23,44,4,5,304,365
556,55,2,4,6,7,24,43,8,8,328,408
556,56,2,5,2,11,20,-44,8,4,348,364
556,57,3,5,4,9,31,54,9,8,379,418
556,58,4,3,8,5,-56,-68,3,0,323,350
556,59,3,4,4,9,31,45,4,5,354,395
556,60,3,3,5,8,32,-65,6,0,386,330
556,61,4,2,8,5,-56,23,0,3,330,353
556,62,4,2,8,5,44,23,4,6,374,376
556,63,2,4,3,10,21,-54,5,2,395,322
556,64,3,4,4,9,31,45,6,7,426,367
556,65,4,2,6,7,42,-75,8,2,468,292
556,66,4,2,9,4,-55,22,3,4,413,314
556,67,3,3,6,7,33,34,6,8,446,348
556,68,3,4,5,8,32,-56,8,2,478,292
556,69,2,4,5,8,-77,44,1,6,401,336
556,70,4,3,7,6,43,33,4,9,444,369
556,71,3,3,7,6,34,-67,8,2,478,302
556,72,5,2,10,3,-45,21,3,3,433,323
556,73,3,3,8,5,35,32,8,5,468,355
556,74,3,3,7,6,-66,33,2,8,402,388
556,75,5,2,7,6,52,-76,4,2,454,312
556,76,3,3,6,7,33,34,7,6,487,346
556,77,3,3,6,7,-67,-66,0,0,420,280
556,78,4,3,8,5,44,32,4,2,464,312
556,79,4,2,7,6,43,24,7,6,507,336
557,1,3,3,6,7,33,34,3,4,33,34
557,2,4,2,7,6,43,24,6,8,76,58
557,3,2,5,3,10,21,-45,7,3,97,13
557,4,3,3,4,9,31,36,8,9,128,49
557,5,3,4,7,6,-66,-58,2,1,62,-9
557,6,3,3,6,7,33,34,5,5,95,25
557,7,3,3,7,6,34,33,9,8,129,58
557,8,3,3,6,7,-67,-66,2,2,62,-8
557,9,2,6,4,9,22,63,4,5,84,55
557,10,2,4,6,7,24,43,8,8,108,98
557,11,2,5,4,9,-78,-46,0,2,30,52
557,12,2,5,3,10,21,55,1,7,51,107
557,13,2,5,3,10,21,-45,2,2,72,62
557,14,3,4,6,7,33,43,5,5,105,105
557,15,3,4,4,9,31,-55,6,0,136,50
557,16,2,5,3,10,21,55,7,5,157,105
557,17,3,4,8,5,-65,41,2,6,92,146
557,18,4,3,7,6,43,33,5,9,135,179
557,19,3,3,8,5,-65,-68,0,1,70,111
557,20,4,3,7,6,43,33,3,4,113,144
557,21,3,3,9,4,36,31,9,5,149,175
557,22,4,3,5,8,-59,-65,0,0,90,110
557,23,4,2,8,5,44,23,4,3,134,133
557,24,3,4,7,6,34,42,8,5,168,175
557,25,5,2,11,2,-44,20,4,5,124,195
557,26,4,4,5,8,41,44,5,9,165,239
557,27,2,5,7,6,-75,-49,0,0,90,190
557,28,4,3,8,5,44,32,4,2,134,222
557,29,4,3,6,7,42,34,6,6,176,256
557,30,4,3,9,4,-55,31,1,7,121,287
557,31,6,2,11,2,65,20,6,7,186,307
557,32,3,4,4,9,31,-55,7,2,217,252
557,33,5,2,10,3,-45,21,2,3,172,273
557,34,3,4,6,7,33,43,5,6,205,316
557,35,4,3,7,6,43,33,8,9,248,349
557,36,4,3,8,5,-56,-68,2,1,192,281
557,37,4,3,8,5,44,32,6,3,236,313
557,38,3,3,6,7,33,34,9,7,269,347
557,39,3,4,6,7,-67,-57,2,0,202,290
557,40,3,4,5,8,32,44,4,4,234,334
557,41,3,3,6,7,33,34,7,8,267,368
557,42,3,3,5,8,32,-65,9,3,299,303
557,43,2,4,2,11,20,-53,9,0,319,250
557,44,3,3,8,5,-65,32,4,2,254,282
557,45,2,5,5,8,23,53,7,5,277,335
557,46,4,3,5,8,41,-65,8,0,318,270
557,47,5,2,8,5,-47,23,1,3,271,293
557,48,2,5,4,9,22,54,3,7,293,347
557,49,4,2,7,6,43,-76,6,1,336,271
557,50,2,5,4,9,22,54,8,5,358,325
557,51,2,4,6,7,-76,43,2,8,282,368
557,52,2,4,5,8,23,-56,5,2,305,312
557,53,2,5,3,10,21,55,6,7,326,367
557,54,4,2,7,6,43,-76,9,1,369,291
557,55,3,4,5,8,-68,44,1,5,301,335
557,56,2,4,4,9,22,-55,3,0,323,280
557,57,3,3,7,6,34,33,7,3,357,313
557,58,6,2,8,5,62,23,9,6,419,336
557,59,4,2,7,6,-57,-76,2,0,362,260
557,60,5,2,8,5,53,23,5,3,415,283
557,61,4,3,4,9,40,36,5,9,455,319
557,62,3,4,5,8,32,-56,7,3,487,263
557,63,4,3,7,6,-57,33,0,6,430,296
557,64,5,2,10,3,55,21,5,7,485,317
557,65,2,6,3,10,21,-36,6,1,506,281
558,1,5,2,10,3,55,21,5,1,55,21
558,2,3,3,7,6,34,33,9,4,89,54
558,3,4,3,7,6,-57,33,2,7,32,87
558,4,3,4,4,9,31,-55,3,2,63,32
558,5,2,5,4,9,22,54,5,6,85,86
558,6,4,4,9,4,-55,40,0,6,30,126
558,7,2,4,4,9,22,-55,2,1,52,71
558,8,3,4,6,7,33,43,5,4,85,114
558,9,4,2,8,5,44,23,9,7,129,137
558,10,3,3,7,6,-66,-67,3,0,63,70
558,11,4,3,7,6,43,33,6,3,106,103
558,12,4,3,6,7,42,34,8,7,148,137
558,13,4,3,6,7,-58,-66,0,1,90,71
558,14,5,2,10,3,55,21,5,2,145,92
558,15,3,3,6,7,33,34,8,6,178,126
558,16,4,3,7,6,-57,33,1,9,121,159
558,17,3,4,3,10,30,-54,1,5,151,105
558,18,2,4,7,6,25,42,6,7,176,147
558,19,4,2,9,4,-55,22,1,9,121,169
558,20,4,3,9,4,45,-69,6,0,166,100
558,21,4,2,10,3,-54,21,2,1,112,121
558,22,2,4,4,9,22,45,4,6,134,166
558,23,4,2,8,5,44,23,8,9,178,189
558,24,5,2,8,5,-47,-77,1,2,131,112
558,25,3,4,7,6,34,42,5,4,165,154
558,26,2,4,7,6,-75,42,0,6,90,196
558,27,3,3,8,5,35,32,5,8,125,228
558,28,2,6,4,9,22,-37,7,1,147,191
558,29,2,4,3,10,21,46,8,7,168,237
558,30,3,3,9,4,-64,31,4,8,104,268
558,31,4,4,6,7,42,-57,6,1,146,211
558,32,4,3,8,5,-56,32,0,3,90,243
558,33,4,3,7,6,43,33,3,6,133,276
558,34,5,3,6,7,51,-66,4,0,184,210
558,35,3,3,8,5,35,32,9,2,219,242
558,36,4,2,11,2,-53,20,6,2,166,262
558,37,3,3,6,7,33,34,9,6,199,296
558,38,3,3,7,6,-66,33,3,9,133,329
558,39,3,3,7,6,34,-67,7,2,167,262
558,40,5,2,9,4,-46,22,1,4,121,284
558,41,3,4,8,5,35,41,6,5,156,325
558,42,2,4,5,8,23,44,9,9,179,369
558,43,2,5,5,8,-77,-47,2,2,102,322
558,44,2,4,7,6,25,42,7,4,127,364
558,45,5,2,8,5,-47,23,0,7,80,387
558,46,3,3,8,5,35,32,5,9,115,419
558,47,5,2,10,3,-45,-79,0,0,70,340
558,48,3,3,6,7,33,34,3,4,103,374
558,49,3,4,4,9,31,45,4,9,134,419
558,50,2,5,4,9,22,-46,6,3,156,373
558,51,4,2,9,4,-55,22,1,5,101,395
558,52,4,3,8,5,44,32,5,7,145,427
558,53,3,3,6,7,33,-66,8,1,178,361
558,54,5,2,10,3,-45,21,3,2,133,382
558,55,4,2,9,4,45,22,8,4,178,404
558,56,2,5,3,10,21,55,9,9,199,459
558,57,3,3,7,6,-66,-67,3,2,133,392
558,58,2,5,7,6,25,51,8,3,158,443
558,59,5,2,8,5,-47,23,1,6,111,466
558,60,2,6,2,11,20,-35,1,1,131,431
558,61,3,3,5,8,32,35,3,6,163,466
558,62,2,4,5,8,23,-56,6,0,186,410
558,63,4,2,10,3,-54,21,2,1,132,431
558,64,2,4,4,9,22,45,4,6,154,476
558,65,2,5,3,10,21,-45,5,1,175,431
558,66,5,2,9,4,54,22,9,3,229,453
558,67,4,3,8,5,-56,32,3,5,173,485
558,68,4,2,8,5,44,23,7,8,217,508
559,1,2,5,5,8,23,53,3,3,23,53
559,2,5,2,9,4,54,22,7,5,77,75
559,3,4,2,5,8,41,-74,8,1,118,1
559,4,2,4,4,9,-78,45,0,6,40,46
559,5,3,3,6,7,33,-66,3,0,73,-20
559,6,3,4,5,8,32,44,5,4,105,24
559,7,2,5,2,11,20,-44,5,0,125,-20
559,8,3,3,7,6,34,33,9,3,159,13
559,9,3,3,7,6,-66,33,3,6,93,46
559,10,2,4,5,8,23,-56,6,0,116,-10
559,11,2,5,4,9,22,54,8,4,138,44
559,12,3,4,5,8,-68,44,0,8,70,88
559,13,4,3,7,6,43,-67,3,1,113,21
559,14,2,6,4,9,22,63,5,4,135,84
559,15,4,2,8,5,44,23,9,7,179,107
559,16,2,6,2,11,20,-35,9,2,199,72
559,17,5,2,11,2,-44,20,5,2,155,92
559,18,3,4,7,6,34,42,9,4,189,134
559,19,5,2,10,3,-45,21,4,5,144,155
559,20,3,4,6,7,33,43,7,8,177,198
559,21,3,3,5,8,32,-65,9,3,209,133
559,22,2,4,7,6,-75,42,4,5,134,175
559,23,6,2,11,2,65,20,9,5,199,195
559,24,2,5,2,11,20,-44,9,1,219,151
559,25,2,5,5,8,-77,53,2,4,142,204
559,26,3,4,5,8,32,44,4,8,174,248
559,27,5,3,10,3,55,30,9,8,229,278
559,28,3,3,7,6,-66,-67,3,1,163,211
559,29,3,3,7,6,34,33,7,4,197,244
559,30,2,5,3,10,21,55,8,9,218,299
559,31,4,2,8,5,-56,-77,2,2,162,222
559,32,3,4,7,6,34,42,6,4,196,264
559,33,6,2,8,5,62,23,8,7,258,287
559,34,2,4,6,7,-76,-57,2,0,182,230
559,35,3,4,5,8,32,44,4,4,214,274
559,36,4,3,8,5,44,32,8,6,258,306
559,37,3,3,9,4,-64,31,4,7,194,337
559,38,4,2,9,4,45,22,9,9,239,359
559,39,3,4,5,8,-68,-56,1,3,171,303
559,40,4,2,7,6,43,24,4,7,214,327
559,41,3,4,4,9,31,-55,5,2,245,272
559,42,3,4,7,6,34,42,9,4,279,314
559,43,3,4,6,7,-67,43,2,7,212,357
559,44,4,2,10,3,46,21,8,8,258,378
559,45,2,4,6,7,-76,-57,2,1,182,321
559,46,3,4,6,7,33,43,5,4,215,364
559,47,4,3,9,4,-55,31,0,5,160,395
559,48,2,5,3,10,21,-45,1,0,181,350
559,49,4,2,9,4,45,22,6,2,226,372
559,50,2,5,4,9,22,54,8,6,248,426
559,51,4,2,5,8,41,-74,9,2,289,352
559,52,3,3,4,9,-69,36,0,8,220,388
559,53,3,3,6,7,33,-66,3,2,253,322
559,54,4,3,9,4,45,31,8,3,298,353
559,55,3,3,5,8,-68,35,0,8,230,388
559,56,3,3,6,7,33,-66,3,2,263,322
559,57,4,2,8,5,44,23,7,5,307,345
559,58,4,3,8,5,-56,32,1,7,251,377
559,59,2,4,4,9,22,-55,3,2,273,322
559,60,4,2,8,5,44,23,7,5,317,345
559,61,3,3,5,8,32,-65,9,0,349,280
559,62,2,5,3,10,-79,55,0,5,270,335
559,63,2,5,7,6,25,51,5,6,295,386
559,64,3,3,6,7,33,-66,8,0,328,320
559,65,2,6,3,10,21,64,9,4,349,384
559,66,5,2,9,4,-46,22,3,6,303,406
559,67,3,3,8,5,35,32,8,8,338,438
559,68,3,3,5,8,-68,-65,0,3,270,373
559,69,2,4,6,7,24,43,4,6,294,416
559,70,2,6,2,11,20,-35,4,1,314,381
559,71,3,4,4,9,31,45,5,6,345,426
559,72,3,3,8,5,-65,32,0,8,280,458
559,73,3,3,6,7,33,-66,3,2,313,392
559,74,4,3,7,6,43,33,6,5,356,425
559,75,2,4,4,9,22,-55,8,0,378,370
559,76,3,4,9,4,-64,40,4,0,314,410
559,77,3,4,9,4,-64,40,0,0,250,450
559,78,4,3,7,6,43,33,3,3,293,483
559,79,4,3,8,5,44,32,7,5,337,515
560,1,4,2,9,4,45,22,5,2,45,22
560,2,3,3,7,6,34,33,9,5,79,55
560,3,3,3,6,7,-67,34,2,9,12,89
560,4,4,3,7,6,43,-67,5,2,55,22
560,5,4,3,6,7,42,34,7,6,97,56
560,6,2,4,4,9,22,-55,9,1,119,1
560,7,5,2,11,2,-44,20,5,1,75,21
560,8,2,5,6,7,24,52,9,3,99,73
560,9,2,5,2,11,20,56,9,9,119,129
560,10,4,3,5,8,-59,-65,0,4,60,64
560,11,3,3,5,8,32,35,2,9,92,99
560,12,4,3,6,7,42,-66,4,3,134,33
560,13,5,2,10,3,55,21,9,4,189,54
560,14,3,3,6,7,-67,34,2,8,122,88
560,15,2,4,5,8,23,-56,5,2,145,32
560,16,2,5,5,8,23,53,8,5,168,85
560,17,3,3,3,10,30,-63,8,2,198,22
560,18,5,2,8,5,-47,23,1,5,151,45
560,19,4,3,6,7,42,34,3,9,193,79
560,20,4,2,8,5,44,-77,7,2,237,2
560,21,4,2,8,5,-56,23,1,5,181,25
560,22,4,3,6,7,42,34,3,9,223,59
560,23,2,4,7,6,25,-58,8,1,248,1
560,24,3,4,5,8,-68,44,0,5,180,45
560,25,3,3,7,6,34,33,4,8,214,78
560,26,4,3,8,5,44,-68,8,0,258,10
560,27,5,2,9,4,-46,22,2,2,212,32
560,28,3,4,7,6,34,42,6,4,246,74
560,29,2,4,4,9,22,45,8,9,268,119
560,30,6,2,9,4,-37,-78,1,1,231,41
560,31,6,2,10,3,64,21,5,2,295,62
560,32,5,2,9,4,54,22,9,4,349,84
560,33,4,2,10,3,-54,21,5,5,295,105
560,34,3,4,8,5,-65,41,0,6,230,146
560,35,4,3,5,8,41,-65,1,1,271,81
560,36,2,4,3,10,21,46,2,7,292,127
560,37,6,2,11,2,65,20,7,7,357,147
560,38,2,5,3,10,21,-45,8,2,378,102
560,39,3,3,8,5,-65,32,3,4,313,134
560,40,5,2,10,3,55,21,8,5,368,155
560,41,3,3,5,8,-68,-65,0,0,300,90
560,42,4,3,10,3,46,30,6,0,346,120
560,43,3,4,3,10,30,46,6,6,376,166
560,44,3,3,10,3,-63,30,3,6,313,196
560,45,3,4,5,8,32,-56,5,0,345,140
560,46,2,4,5,8,23,44,8,4,368,184
560,47,3,3,9,4,-64,31,4,5,304,215
560,48,4,4,6,7,42,43,6,8,346,258
560,49,2,4,4,9,22,-55,8,3,368,203
560,50,2,5,6,7,-76,52,2,5,292,255
560,51,3,4,4,9,31,-55,3,0,323,200
560,52,2,4,4,9,22,45,5,5,345,245
560,53,3,4,6,7,33,43,8,8,378,288
560,54,3,3,6,7,-67,-66,1,2,311,222
560,55,3,3,7,6,34,33,5,5,345,255
560,56,3,4,4,9,31,-55,6,0,376,200
560,57,2,4,3,10,21,46,7,6,397,246
560,58,2,4,3,10,21,-54,8,2,418,192
560,59,4,2,9,4,-55,22,3,4,363,214
560,60,2,4,7,6,25,42,8,6,388,256
560,61,4,3,6,7,-58,-66,0,0,330,190
560,62,3,3,4,9,31,36,1,6,361,226
560,63,4,3,8,5,44,32,5,8,405,258
560,64,5,2,9,4,54,-78,9,0,459,180
560,65,3,5,7,6,-66,51,3,1,393,231
560,66,4,3,9,4,45,31,8,2,438,262
560,67,4,3,6,7,-58,34,0,6,380,296
560,68,4,3,10,3,46,30,6,6,426,326
560,69,3,4,4,9,31,-55,7,1,457,271
560,70,3,4,5,8,32,44,9,5,489,315
560,71,4,3,5,8,-59,-65,0,0,430,250
560,72,4,3,7,6,43,33,3,3,473,283
560,73,3,3,7,6,34,33,7,6,507,316
561,1,5,2,9,4,54,22,4,2,54,22
561,2,3,4,3,10,30,46,4,8,84,68
561,3,3,3,8,5,35,-68,9,0,119,0
561,4,2,5,5,8,-77,53,2,3,42,53
561,5,2,5,3,10,21,55,3,8,63,108
561,6,3,4,8,5,35,41,8,9,98,149
561,7,4,2,9,4,-55,-78,3,1,43,71
561,8,3,3,4,9,31,36,4,7,74,107
561,9,4,3,6,7,42,-66,6,1,116,41
561,10,4,3,6,7,42,34,8,5,158,75
561,11,3,3,6,7,-67,34,1,9,91,109
561,12,4,2,9,4,45,-78,6,1,136,31
561,13,3,3,6,7,33,34,9,5,169,65
561,14,3,4,7,6,-66,42,3,7,103,107
561,15,3,3,5,8,32,-65,5,2,135,42
561,16,2,5,3,10,21,55,6,7,156,97
561,17,3,4,5,8,32,-56,8,1,188,41
561,18,4,2,8,5,-56,23,2,4,132,64
561,19,2,5,5,8,23,53,5,7,155,117
561,20,3,4,7,6,34,42,9,9,189,159
561,21,3,3,6,7,-67,-66,2,3,122,93
561,22,2,4,5,8,23,44,5,7,145,137
561,23,3,3,8,5,-65,32,0,9,80,169
561,24,4,3,9,4,45,-69,5,0,125,100
561,25,4,2,7,6,43,24,8,4,168,124
561,26,2,5,5,8,-77,53,1,7,91,177
561,27,3,3,6,7,33,-66,4,1,124,111
561,28,2,4,5,8,23,44,7,5,147,155
561,29,4,3,6,7,42,34,9,9,189,189
561,30,4,4,7,6,-57,-58,2,1,132,131
561,31,3,4,4,9,31,45,3,6,163,176
561,32,4,2,9,4,45,22,8,8,208,198
561,33,3,3,5,8,-68,-65,0,3,140,133
561,34,4,2,6,7,42,25,2,8,182,158
561,35,2,4,4,9,22,-55,4,3,204,103
561,36,3,3,7,6,34,33,8,6,238,136
561,37,3,3,7,6,-66,33,2,9,172,169
561,38,2,5,3,10,21,-45,3,4,193,124
561,39,4,3,6,7,42,34,5,8,235,158
561,40,2,4,5,8,23,-56,8,2,258,102
561,41,2,6,4,9,-78,63,0,5,180,165
561,42,3,3,5,8,32,-65,2,0,212,100
561,43,3,3,7,6,34,33,6,3,246,133
561,44,3,3,8,5,-65,32,1,5,181,165
561,45,2,4,3,10,21,-54,2,1,202,111
561,46,3,3,6,7,33,34,5,5,235,145
561,47,4,2,8,5,44,23,9,8,279,168
561,48,3,3,9,4,-64,31,5,9,215,199
561,49,3,3,8,5,-65,-68,0,1,150,131
561,50,5,2,9,4,54,22,4,3,204,153
561,51,4,2,6,7,42,25,6,8,246,178
561,52,2,4,5,8,23,-56,9,2,269,122
561,53,2,5,4,9,-78,54,1,6,191,176
561,54,3,4,7,6,34,42,5,8,225,218
561,55,5,2,8,5,53,-77,8,1,278,141
561,56,4,3,9,4,-55,31,3,2,223,172
561,57,3,4,5,8,32,44,5,6,255,216
561,58,4,2,8,5,44,23,9,9,299,239
561,59,2,4,6,7,-76,-57,3,2,223,182
561,60,4,3,6,7,42,34,5,6,265,216
561,61,3,4,5,8,32,-56,7,0,297,160
561,62,2,4,7,6,-75,42,2,2,222,202
561,63,3,3,5,8,32,35,4,7,254,237
561,64,4,3,5,8,41,-65,5,2,295,172
561,65,5,2,9,4,54,22,9,4,349,194
561,66,3,4,4,9,-69,45,0,9,280,239
561,67,5,2,9,4,54,-78,4,1,334,161
561,68,2,4,8,5,-74,41,0,2,260,202
561,69,3,3,8,5,35,32,5,4,295,234
561,70,4,3,9,4,-55,31,0,5,240,265
561,71,4,2,9,4,45,22,5,7,285,287
561,72,2,4,6,7,24,-57,9,0,309,230
561,73,3,4,4,9,-69,45,0,5,240,275
561,74,3,3,5,8,32,-65,2,0,272,210
561,75,3,4,9,4,36,40,8,0,308,250
561,76,5,2,9,4,-46,22,2,2,262,272
561,77,4,2,9,4,45,22,7,4,307,294
561,78,3,3,6,7,-67,34,0,8,240,328
561,79,5,2,9,4,54,-78,4,0,294,250
561,80,4,3,7,6,43,33,7,3,337,283
561,81,3,4,6,7,-67,43,0,6,270,326
561,82,3,4,8,5,35,41,5,7,305,367
561,83,3,4,6,7,33,-57,8,0,338,310
561,84,3,3,9,4,-64,31,4,1,274,341
561,85,3,4,5,8,32,44,6,5,306,385
561,86,3,3,8,5,-65,32,1,7,241,417
561,87,5,3,7,6,52,-67,3,0,293,350
561,88,3,4,6,7,33,43,6,3,326,393
561,89,5,3,8,5,53,32,9,5,379,425
561,90,2,4,7,6,-75,42,4,7,304,467
561,91,4,3,8,5,44,32,8,9,348,499
561,92,4,3,9,4,-55,-69,3,0,293,430
561,93,4,3,7,6,43,33,6,3,336,463
561,94,5,2,8,5,53,23,9,6,389,486
561,95,3,3,6,7,-67,-66,2,0,322,420
561,96,3,3,5,8,32,35,4,5,354,455
561,97,4,3,7,6,43,33,7,8,397,488
561,98,2,5,7,6,-75,51,2,9,322,539
562,1,4,2,7,6,43,24,3,4,43,24
562,2,2,5,3,10,21,55,4,9,64,79
562,3,4,3,7,6,43,-67,7,2,107,12
562,4,2,5,5,8,-77,53,0,5,30,65
562,5,4,3,6,7,42,34,2,9,72,99
562,6,3,3,6,7,33,-66,5,3,105,33
562,7,3,3,7,6,34,33,9,6,139,66
562,8,3,4,3,10,30,-54,9,2,169,12
562,9,3,3,10,3,-63,30,6,2,106,42
562,10,2,4,5,8,23,44,9,6,129,86
562,11,4,3,9,4,-55,31,4,7,74,117
562,12,3,4,4,9,31,-55,5,2,105,62
562,13,3,4,8,5,-65,41,0,3,40,103
562,14,2,6,3,10,21,64,1,7,61,167
562,15,4,3,6,7,42,-66,3,1,103,101
562,16,5,2,7,6,52,24,5,5,155,125
562,17,3,4,4,9,31,-55,6,0,186,70
562,18,4,3,6,7,42,34,8,4,228,104
562,19,3,3,8,5,-65,32,3,6,163,136
562,20,2,4,9,4,-73,40,0,6,90,176
562,21,3,4,6,7,33,43,3,9,123,219
562,22,3,4,5,8,32,-56,5,3,155,163
562,23,3,3,8,5,-65,32,0,5,90,195
562,24,3,3,7,6,34,33,4,8,124,228
562,25,2,4,5,8,23,-56,7,2,147,172
562,26,5,2,9,4,-46,22,1,4,101,194
562,27,3,4,4,9,31,45,2,9,132,239
562,28,4,3,5,8,41,-65,3,4,173,174
562,29,6,2,9,4,63,22,6,6,236,196
562,30,3,4,8,5,-65,41,1,7,171,237
562,31,3,3,6,7,33,-66,4,1,204,171
562,32,3,3,8,5,35,32,9,3,239,203
562,33,4,3,7,6,-57,33,2,6,182,236
562,34,3,3,7,6,34,33,6,9,216,269
562,35,5,2,9,4,-46,-78,0,1,170,191
562,36,3,4,4,9,31,45,1,6,201,236
562,37,2,5,7,6,25,51,6,7,226,287
562,38,5,2,11,2,-44,20,2,7,182,307
562,39,3,4,6,7,33,-57,5,0,215,250
562,40,3,4,7,6,34,42,9,2,249,292
562,41,3,3,7,6,-66,33,3,5,183,325
562,42,3,3,6,7,33,34,6,9,216,359
562,43,2,5,3,10,21,-45,7,4,237,314
562,44,3,3,9,4,-64,31,3,5,173,345
562,45,3,4,6,7,33,43,6,8,206,388
562,46,3,3,8,5,-65,-68,1,0,141,320
562,47,4,2,7,6,43,24,4,4,184,344
562,48,4,2,9,4,45,22,9,6,229,366
562,49,5,3,6,7,-49,-66,0,0,180,300
562,50,3,4,7,6,34,42,4,2,214,342
562,51,4,2,10,3,-54,21,0,3,160,363
562,52,2,4,6,7,24,43,4,6,184,406
562,53,2,6,6,7,24,61,8,7,208,467
562,54,5,2,10,3,-45,21,3,8,163,488
562,55,3,3,5,8,32,-65,5,3,195,423
562,56,4,2,5,8,41,26,6,9,236,449
562,57,3,3,6,7,33,-66,9,3,269,383
562,58,3,3,7,6,-66,33,3,6,203,416
562,59,2,5,3,10,21,-45,4,1,224,371
562,60,3,4,4,9,31,45,5,6,255,416
562,61,3,3,6,7,33,-66,8,0,288,350
562,62,3,3,5,8,-68,35,0,5,220,385
562,63,3,3,7,6,34,33,4,8,254,418
562,64,4,3,8,5,44,-68,8,0,298,350
562,65,3,3,7,6,-66,33,2,3,232,383
562,66,2,5,3,10,21,55,3,8,253,438
562,67,3,3,4,9,31,-64,4,4,284,374
562,68,4,3,6,7,42,34,6,8,326,408
562,69,2,5,4,9,22,-46,8,2,348,362
562,70,4,2,8,5,-56,23,2,5,292,385
562,71,3,4,6,7,33,43,5,8,325,428
562,72,4,3,5,8,41,-65,6,3,366,363
562,73,3,4,6,7,33,43,9,6,399,406
562,74,3,3,5,8,-68,-65,1,1,331,341
562,75,2,4,6,7,24,43,5,4,355,384
562,76,4,2,8,5,44,23,9,7,399,407
562,77,3,4,7,6,-66,42,3,9,333,449
562,78,4,3,5,8,41,-65,4,4,374,384
562,79,2,4,3,10,21,-54,5,0,395,330
562,80,5,2,9,4,54,22,9,2,449,352
562,81,3,5,6,7,-67,52,2,4,382,404
562,82,5,2,9,4,54,22,6,6,436,426
562,83,2,4,5,8,23,-56,9,0,459,370
562,84,5,2,11,2,-44,20,5,0,415,390
562,85,2,5,2,11,20,56,5,6,435,446
562,86,3,4,5,8,32,-56,7,0,467,390
562,87,3,3,9,4,-64,31,3,1,403,421
562,88,3,3,6,7,33,34,6,5,436,455
562,89,2,4,5,8,23,44,9,9,459,499
562,90,5,2,11,2,-44,20,5,9,415,519
563,1,3,3,7,6,34,33,4,3,34,33
563,2,4,2,8,5,44,23,8,6,78,56
563,3,3,3,8,5,-65,32,3,8,13,88
563,4,3,4,6,7,33,-57,6,1,46,31
563,5,3,4,5,8,32,44,8,5,78,75
563,6,3,3,7,6,-66,33,2,8,12,108
563,7,4,3,7,6,43,-67,5,1,55,41
563,8,4,2,5,8,41,26,6,7,96,67
563,9,3,4,7,6,-66,42,0,9,30,109
563,10,4,3,6,7,42,-66,2,3,72,43
563,11,5,2,7,6,52,24,4,7,124,67
563,12,3,3,8,5,35,32,9,9,159,99
563,13,2,5,5,8,-77,-47,2,2,82,52
563,14,4,2,9,4,45,22,7,4,127,74
563,15,2,4,5,8,-77,44,0,8,50,118
563,16,2,5,4,9,22,-46,2,2,72,72
563,17,4,2,8,5,44,23,6,5,116,95
563,18,2,5,2,11,20,-44,6,1,136,51
563,19,2,4,8,5,-74,41,2,2,62,92
563,20,4,2,6,7,42,25,4,7,104,117
563,21,4,2,8,5,44,-77,8,0,148,40
563,22,2,4,6,7,-76,43,2,3,72,83
563,23,3,3,9,4,36,31,8,4,108,114
563,24,5,3,9,4,-46,31,2,5,62,145
563,25,2,5,5,8,23,53,5,8,85,198
563,26,2,4,4,9,22,-55,7,3,107,143
563,27,5,3,10,3,-45,30,2,3,62,173
563,28,2,5,4,9,22,54,4,7,84,227
563,29,3,3,7,6,34,-67,8,0,118,160
563,30,4,3,8,5,-56,32,2,2,62,192
563,31,5,2,8,5,53,23,5,5,115,215
563,32,2,4,7,6,-75,42,0,7,40,257
563,33,4,3,9,4,45,31,5,8,85,288
563,34,2,5,3,10,21,-45,6,3,106,243
563,35,3,3,5,8,32,35,8,8,138,278
563,36,3,3,6,7,-67,-66,1,2,71,212
563,37,3,4,4,9,31,45,2,7,102,257
563,38,4,3,7,6,43,-67,5,0,145,190
563,39,4,3,8,5,44,32,9,2,189,222
563,40,3,4,7,6,-66,42,3,4,123,264
563,41,3,3,8,5,35,32,8,6,158,296
563,42,4,4,5,8,41,-56,9,0,199,240
563,43,5,3,8,5,-47,32,2,2,152,272
563,44,4,3,8,5,44,32,6,4,196,304
563,45,2,4,4,9,22,45,8,9,218,349
563,46,3,3,5,8,-68,-65,0,4,150,284
563,47,4,3,5,8,41,35,1,9,191,319
563,48,4,2,10,3,46,-79,7,0,237,240
563,49,3,3,8,5,-65,32,2,2,172,272
563,50,3,3,8,5,35,32,7,4,207,304
563,51,5,2,11,2,-44,20,3,4,163,324
563,52,4,3,8,5,44,32,7,6,207,356
563,53,2,4,3,10,21,-54,8,2,228,302
563,54,3,3,7,6,-66,33,2,5,162,335
563,55,2,4,3,10,21,-54,3,1,183,281
563,56,4,3,8,5,44,32,7,3,227,313
563,57,5,3,8,5,-47,32,0,5,180,345
563,58,2,4,7,6,25,42,5,7,205,387
563,59,4,3,6,7,42,-66,7,1,247,321
563,60,4,3,8,5,-56,32,1,3,191,353
563,61,5,2,9,4,54,22,5,5,245,375
563,62,4,2,5,8,41,-74,6,1,286,301
563,63,4,3,7,6,43,33,9,4,329,334
563,64,6,2,11,2,-35,20,4,4,294,354
563,65,3,3,8,5,35,32,9,6,329,386
563,66,3,3,5,8,-68,-65,1,1,261,321
563,67,4,3,9,4,45,31,6,2,306,352
563,68,5,2,11,2,-44,20,2,2,262,372
563,69,4,3,7,6,43,33,5,5,305,405
563,70,5,2,10,3,-45,21,0,6,260,426
563,71,5,2,9,4,54,22,4,8,314,448
563,72,3,4,7,6,34,-58,8,0,348,390
563,73,2,4,5,8,-77,44,1,4,271,434
563,74,3,4,4,9,31,45,2,9,302,479
563,75,2,5,6,7,24,-48,6,1,326,431
563,76,5,2,9,4,-46,22,0,3,280,453
563,77,3,4,5,8,32,44,2,7,312,497
563,78,3,4,6,7,33,-57,5,0,345,440
563,79,4,3,9,4,-55,31,0,1,290,471
563,80,3,4,5,8,32,44,2,5,322,515
564,1,4,3,6,7,42,34,2,4,42,34
564,2,2,5,2,11,20,-44,2,0,62,-10
564,3,4,2,10,3,46,21,8,1,108,11
564,4,4,3,4,9,40,36,8,7,148,47
564,5,3,4,6,7,-67,-57,1,0,81,-10
564,6,4,2,8,5,44,23,5,3,125,13
564,7,3,3,8,5,-65,32,0,5,60,45
564,8,5,3,10,3,55,30,5,5,115,75
564,9,3,4,5,8,32,44,7,9,147,119
564,10,4,2,7,6,-57,-76,0,3,90,43
564,11,4,2,6,7,42,25,2,8,132,68
564,12,3,3,7,6,34,-67,6,1,166,1
564,13,2,4,5,8,23,44,9,5,189,45
564,14,3,3,8,5,-65,32,4,7,124,77
564,15,2,5,2,11,20,-44,4,3,144,33
564,16,4,4,9,4,45,40,9,3,189,73
564,17,3,3,5,8,-68,35,1,8,121,108
564,18,4,3,8,5,44,-68,5,0,165,40
564,19,3,3,5,8,32,35,7,5,197,75
564,20,3,3,5,8,32,-65,9,0,229,10
564,21,6,2,10,3,-36,21,3,1,193,31
564,22,3,4,6,7,33,43,6,4,226,74
564,23,2,4,4,9,22,45,8,9,248,119
564,24,4,3,6,7,-58,-66,0,3,190,53
564,25,3,3,6,7,33,34,3,7,223,87
564,26,4,2,8,5,44,-77,7,0,267,10
564,27,3,4,7,6,-66,42,1,2,201,52
564,28,2,4,5,8,23,44,4,6,224,96
564,29,4,2,10,3,-54,21,0,7,170,117
564,30,2,4,4,9,22,-55,2,2,192,62
564,31,3,3,7,6,34,33,6,5,226,95
564,32,3,4,6,7,33,43,9,8,259,138
564,33,3,3,7,6,-66,-67,3,1,193,71
564,34,5,2,10,3,55,21,8,2,248,92
564,35,4,2,9,4,-55,22,3,4,193,114
564,36,5,2,9,4,54,22,7,6,247,136
564,37,2,4,4,9,22,-55,9,1,269,81
564,38,2,5,5,8,-77,53,2,4,192,134
564,39,4,2,5,8,41,-74,3,0,233,60
564,40,3,3,7,6,34,33,7,3,267,93
564,41,3,4,5,8,32,44,9,7,299,137
564,42,2,6,3,10,-79,-36,0,1,220,101
564,43,3,3,5,8,32,35,2,6,252,136
564,44,3,3,6,7,33,-66,5,0,285,70
564,45,3,3,5,8,32,35,7,5,317,105
564,46,5,2,8,5,-47,23,0,8,270,128
564,47,3,3,6,7,33,-66,3,2,303,62
564,48,4,2,11,2,-53,20,0,2,250,82
564,49,4,3,7,6,43,33,3,5,293,115
564,50,4,3,6,7,42,34,5,9,335,149
564,51,4,3,10,3,-54,30,1,9,281,179
564,52,2,4,5,8,23,-56,4,3,304,123
564,53,2,4,5,8,23,44,7,7,327,167
564,54,5,2,7,6,52,-76,9,1,379,91
564,55,5,2,9,4,-46,22,3,3,333,113
564,56,2,6,5,8,23,62,6,5,356,175
564,57,2,6,1,12,-20,-34,6,1,336,141
564,58,3,3,10,3,-63,30,3,1,273,171
564,59,5,2,11,2,56,20,9,1,329,191
564,60,2,6,2,11,20,65,9,6,349,256
564,61,4,2,7,6,-57,-76,2,0,292,180
564,62,3,4,6,7,33,43,5,3,325,223
564,63,3,4,4,9,31,45,6,8,356,268
564,64,2,4,6,7,-76,-57,0,1,280,211
564,65,3,4,6,7,33,43,3,4,313,254
564,66,3,4,7,6,34,42,7,6,347,296
564,67,4,2,5,8,41,-74,8,2,388,222
564,68,3,3,8,5,-65,32,3,4,323,254
564,69,4,3,7,6,43,33,6,7,366,287
564,70,4,3,5,8,41,-65,7,2,407,222
564,71,2,5,4,9,22,54,9,6,429,276
564,72,3,4,6,7,-67,43,2,9,362,319
564,73,4,2,7,6,43,-76,5,3,405,243
564,74,3,3,5,8,32,35,7,8,437,278
564,75,3,3,6,7,-67,-66,0,2,370,212
564,76,4,2,9,4,45,22,5,4,415,234
564,77,4,2,6,7,42,25,7,9,457,259
564,78,4,2,8,5,-56,-77,1,2,401,182
564,79,2,5,7,6,25,51,6,3,426,233
564,80,3,4,4,9,31,45,7,8,457,278
564,81,4,3,9,4,-55,31,2,9,402,309
564,82,2,6,3,10,21,-36,3,3,423,273
564,83,4,2,10,3,46,21,9,4,469,294
564,84,4,3,7,6,-57,33,2,7,412,327
564,85,2,5,3,10,21,-45,3,2,433,282
564,86,3,3,4,9,31,36,4,8,464,318
564,87,3,3,5,8,32,-65,6,3,496,253
564,88,3,3,7,6,-66,33,0,6,430,286
564,89,3,3,6,7,33,-66,3,0,463,220
564,90,3,4,8,5,35,41,8,1,498,261
564,91,5,2,6,7,51,25,9,6,549,286
565,1,2,4,7,6,25,42,5,2,25,42
565,2,3,4,6,7,33,43,8,5,58,85
565,3,3,4,7,6,-66,42,2,7,-8,127
565,4,2,5,3,10,21,-45,3,2,13,82
565,5,3,4,7,6,34,42,7,4,47,124
565,6,2,5,3,10,21,55,8,9,68,179
565,7,4,4,7,6,-57,-58,1,1,11,121
565,8,3,3,9,4,36,31,7,2,47,152
565,9,4,3,6,7,42,34,9,6,89,186
565,10,3,4,5,8,-68,-56,1,0,21,130
565,11,4,3,9,4,45,31,6,1,66,161
565,12,3,3,5,8,32,35,8,6,98,196
565,13,3,4,6,7,-67,43,1,9,31,239
565,14,3,3,5,8,32,-65,3,4,63,174
565,15,3,4,6,7,33,43,6,7,96,217
565,16,2,4,5,8,23,-56,9,1,119,161
565,17,3,4,6,7,-67,43,2,4,52,204
565,18,3,4,6,7,33,43,5,7,85,247
565,19,4,3,8,5,44,32,9,9,129,279
565,20,2,5,4,9,-78,-46,1,3,51,233
565,21,6,2,11,2,65,20,6,3,116,253
565,22,3,4,4,9,31,45,7,8,147,298
565,23,3,4,5,8,32,-56,9,2,179,242
565,24,5,3,9,4,-46,31,3,3,133,273
565,25,4,3,10,3,46,30,9,3,179,303
565,26,6,2,9,4,-37,22,2,5,142,325
565,27,4,4,4,9,40,-55,2,0,182,270
565,28,5,2,9,4,54,22,6,2,236,292
565,29,2,5,6,7,-76,52,0,4,160,344
565,30,4,2,7,6,43,24,3,8,203,368
565,31,3,4,7,6,34,-58,7,0,237,310
565,32,2,4,2,11,20,47,7,7,257,357
565,33,3,3,8,5,-65,32,2,9,192,389
565,34,4,2,8,5,44,-77,6,2,236,312
565,35,4,2,6,7,42,25,8,7,278,337
565,36,2,4,7,6,-75,42,3,9,203,379
565,37,4,2,9,4,45,-78,8,1,248,301
565,38,4,4,9,4,-55,40,3,1,193,341
565,39,3,4,6,7,33,43,6,4,226,384
565,40,5,2,10,3,-45,21,1,5,181,405
565,41,4,2,9,4,45,22,6,7,226,427
565,42,5,2,7,6,52,-76,8,1,278,351
565,43,4,3,5,8,41,35,9,6,319,386
565,44,2,4,6,7,-76,43,3,9,243,429
565,45,3,3,8,5,35,-68,8,1,278,361
565,46,4,2,8,5,-56,23,2,4,222,384
565,47,3,4,6,7,33,43,5,7,255,427
565,48,2,5,4,9,22,-46,7,1,277,381
565,49,4,2,7,6,-57,24,0,5,220,405
565,50,3,3,9,4,36,31,6,6,256,436
565,51,3,3,6,7,33,-66,9,0,289,370
565,52,3,3,6,7,-67,34,2,4,222,404
565,53,3,3,5,8,32,35,4,9,254,439
565,54,4,3,8,5,44,-68,8,1,298,371
565,55,4,2,8,5,-56,23,2,4,242,394
565,56,3,3,5,8,32,35,4,9,274,429
565,57,5,2,9,4,54,-78,8,1,328,351
565,58,3,3,6,7,-67,34,1,5,261,385
565,59,2,4,5,8,23,44,4,9,284,429
565,60,4,2,9,4,45,-78,9,1,329,351
565,61,3,4,5,8,-68,44,1,5,261,395
565,62,4,3,8,5,44,32,5,7,305,427
565,63,2,5,2,11,20,-44,5,3,325,383
565,64,2,4,4,9,22,45,7,8,347,428
565,65,4,2,9,4,-55,-78,2,0,292,350
565,66,3,4,5,8,32,44,4,4,324,394
565,67,5,2,10,3,55,21,9,5,379,415
565,68,3,3,9,4,-64,31,5,6,315,446
565,69,4,3,6,7,42,-66,7,0,357,380
565,70,3,3,8,5,-65,32,2,2,292,412
565,71,3,3,6,7,33,34,5,6,325,446
565,72,5,2,8,5,53,23,8,9,378,469
565,73,2,4,5,8,-77,-56,1,3,301,413
565,74,3,4,7,6,34,42,5,5,335,455
565,75,2,4,6,7,24,43,9,8,359,498
565,76,4,4,6,7,-58,-57,1,1,301,441
565,77,2,5,6,7,24,52,5,3,325,493
565,78,5,2,6,7,51,25,6,8,376,518
566,1,2,5,4,9,22,54,2,4,22,54
566,2,3,3,9,4,36,31,8,5,58,85
566,3,2,6,2,11,20,-35,8,0,78,50
566,4,3,4,8,5,-65,41,3,1,13,91
566,5,3,3,8,5,35,32,8,3,48,123
566,6,3,4,8,5,-65,41,3,4,-17,164
566,7,5,2,7,6,52,24,5,8,35,188
566,8,3,5,6,7,33,-48,8,0,68,140
566,9,2,4,5,8,-77,44,1,4,-9,184
566,10,3,5,4,9,31,54,2,8,22,238
566,11,3,5,4,9,31,-46,3,2,53,192
566,12,2,6,3,10,21,64,4,6,74,256
566,13,3,3,3,10,30,-63,4,3,104,193
566,14,3,4,4,9,31,45,5,8,135,238
566,15,4,3,7,6,43,-67,8,1,178,171
566,16,2,4,4,9,-78,45,0,6,100,216
566,17,2,4,4,9,22,-55,2,1,122,161
566,18,5,2,9,4,54,22,6,3,176,183
566,19,3,3,8,5,-65,32,1,5,111,215
566,20,4,2,7,6,43,24,4,9,154,239
566,21,3,4,8,5,35,-59,9,0,189,180
566,22,4,3,9,4,-55,31,4,1,134,211
566,23,4,4,8,5,44,41,8,2,178,252
566,24,3,3,7,6,-66,33,2,5,112,285
566,25,3,4,6,7,33,43,5,8,145,328
566,26,3,4,6,7,33,-57,8,1,178,271
566,27,3,4,4,9,31,45,9,6,209,316
566,28,4,3,6,7,-58,-66,1,0,151,250
566,29,3,3,4,9,31,36,2,6,182,286
566,30,3,3,7,6,34,33,6,9,216,319
566,31,2,4,3,10,21,-54,7,5,237,265
566,32,3,3,6,7,-67,34,0,9,170,299
566,33,4,4,6,7,42,-57,2,2,212,242
566,34,5,2,10,3,55,21,7,3,267,263
566,35,4,3,8,5,-56,32,1,5,211,295
566,36,3,3,8,5,35,32,6,7,246,327
566,37,4,3,8,5,-56,32,0,9,190,359
566,38,3,4,7,6,34,-58,4,1,224,301
566,39,3,3,5,8,32,35,6,6,256,336
566,40,2,5,5,8,23,53,9,9,279,389
566,41,4,2,9,4,-55,-78,4,1,224,311
566,42,2,5,7,6,25,51,9,2,249,362
566,43,4,3,8,5,-56,32,3,4,193,394
566,44,4,3,5,8,41,35,4,9,234,429
566,45,3,3,4,9,31,-64,5,5,265,365
566,46,3,4,7,6,34,42,9,7,299,407
566,47,3,3,6,7,-67,-66,2,1,232,341
566,48,4,3,8,5,44,32,6,3,276,373
566,49,3,4,5,8,32,44,8,7,308,417
566,50,3,5,5,8,-68,-47,0,0,240,370
566,51,5,2,9,4,54,22,4,2,294,392
566,52,4,2,9,4,45,22,9,4,339,414
566,53,3,3,8,5,-65,32,4,6,274,446
566,54,4,2,7,6,43,-76,7,0,317,370
566,55,2,5,4,9,22,54,9,4,339,424
566,56,3,4,3,10,30,-54,9,0,369,370
566,57,3,4,5,8,-68,44,1,4,301,414
566,58,4,3,9,4,45,31,6,5,346,445
566,59,2,5,2,11,20,-44,6,1,366,401
566,60,3,4,5,8,32,44,8,5,398,445
566,61,2,4,4,9,-78,-55,0,0,320,390
566,62,3,3,7,6,34,33,4,3,354,423
566,63,4,3,6,7,42,34,6,7,396,457
566,64,3,3,3,10,30,-63,6,4,426,394
566,65,3,3,4,9,31,-64,7,0,457,330
566,66,3,4,4,9,31,45,8,5,488,375
566,67,2,4,5,8,-77,44,1,9,411,419
566,68,5,2,9,4,54,-78,5,1,465,341
566,69,4,3,7,6,43,33,8,4,508,374
567,1,4,3,5,8,41,35,1,5,41,35
567,2,3,3,8,5,35,32,6,7,76,67
567,3,3,4,4,9,31,-55,7,2,107,12
567,4,2,5,3,10,21,55,8,7,128,67
567,5,4,3,8,5,-56,32,2,9,72,99
567,6,3,3,9,4,36,-69,8,0,108,30
567,7,2,6,3,10,21,64,9,4,129,94
567,8,3,4,7,6,-66,42,3,6,63,136
567,9,4,2,7,6,43,-76,6,0,106,60
567,10,4,3,9,4,-55,31,1,1,51,91
567,11,4,2,4,9,40,27,1,8,91,118
567,12,4,2,8,5,44,-77,5,1,135,41
567,13,3,4,5,8,32,44,7,5,167,85
567,14,3,4,8,5,-65,41,2,6,102,126
567,15,5,2,9,4,54,22,6,8,156,148
567,16,2,4,7,6,-75,-58,1,0,81,90
567,17,5,3,9,4,54,31,5,1,135,121
567,18,2,4,6,7,24,43,9,4,159,164
567,19,3,3,8,5,-65,32,4,6,94,196
567,20,3,4,7,6,34,42,8,8,128,238
567,21,4,3,8,5,-56,-68,2,0,72,170
567,22,3,4,5,8,32,44,4,4,104,214
567,23,2,4,5,8,23,44,7,8,127,258
567,24,3,3,6,7,-67,-66,0,2,60,192
567,25,3,4,7,6,34,42,4,4,94,234
567,26,2,6,2,11,20,65,4,9,114,299
567,27,3,3,5,8,32,-65,6,4,146,234
567,28,5,2,9,4,-46,22,0,6,100,256
567,29,3,3,6,7,33,-66,3,0,133,190
567,30,3,3,6,7,33,34,6,4,166,224
567,31,3,3,6,7,33,34,9,8,199,258
567,32,3,3,6,7,-67,-66,2,2,132,192
567,33,3,3,7,6,34,33,6,5,166,225
567,34,3,4,5,8,32,44,8,9,198,269
567,35,5,3,9,4,-46,-69,2,0,152,200
567,36,4,3,10,3,46,30,8,0,198,230
567,37,3,4,4,9,31,45,9,5,229,275
567,38,5,3,8,5,-47,32,2,7,182,307
567,39,3,4,9,4,36,40,8,7,218,347
567,40,2,4,8,5,-74,41,4,8,144,388
567,41,2,4,4,9,22,-55,6,3,166,333
567,42,6,2,10,3,-36,21,0,4,130,354
567,43,4,3,7,6,43,33,3,7,173,387
567,44,4,2,7,6,43,-76,6,1,216,311
567,45,3,3,9,4,-64,31,2,2,152,342
567,46,5,3,8,5,53,32,5,4,205,374
567,47,5,2,8,5,53,23,8,7,258,397
567,48,6,2,11,2,-35,20,3,7,223,417
567,49,2,6,5,8,23,62,6,9,246,479
567,50,3,4,7,6,-66,-58,0,1,180,421
567,51,3,3,7,6,34,33,4,4,214,454
567,52,4,3,5,8,41,35,5,9,255,489
567,53,2,5,5,8,23,-47,8,2,278,442
567,54,4,3,8,5,-56,32,2,4,222,474
567,55,2,5,3,10,21,55,3,9,243,529
568,1,3,3,6,7,33,34,3,4,33,34
568,2,3,3,7,6,34,33,7,7,67,67
568,3,2,5,5,8,-77,-47,0,0,-10,20
568,4,3,3,9,4,36,31,6,1,26,51
568,5,4,3,7,6,43,33,9,4,69,84
568,6,4,3,8,5,-56,32,3,6,13,116
568,7,3,4,5,8,32,-56,5,0,45,60
568,8,3,3,5,8,32,35,7,5,77,95
568,9,3,3,4,9,31,-64,8,1,108,31
568,10,4,2,8,5,-56,23,2,4,52,54
568,11,6,2,9,4,63,22,5,6,115,76
568,12,5,2,8,5,53,23,8,9,168,99
568,13,3,4,4,9,31,-55,9,4,199,44
568,14,2,4,5,8,-77,44,2,8,122,88
568,15,2,5,4,9,22,-46,4,2,144,42
568,16,5,2,9,4,54,22,8,4,198,64
568,17,2,4,4,9,-78,45,0,9,120,109
568,18,3,4,3,10,30,-54,0,5,150,55
568,19,4,3,9,4,45,31,5,6,195,86
568,20,3,3,5,8,32,-65,7,1,227,21
568,21,5,2,8,5,-47,23,0,4,180,44
568,22,5,2,7,6,52,24,2,8,232,68
568,23,2,5,2,11,20,-44,2,4,252,24
568,24,2,5,4,9,22,54,4,8,274,78
568,25,3,3,5,8,32,-65,6,3,306,13
568,26,2,5,6,7,-76,52,0,5,230,65
568,27,4,3,7,6,43,33,3,8,273,98
568,28,3,3,5,8,32,-65,5,3,305,33
568,29,2,5,4,9,22,54,7,7,327,87
568,30,5,2,9,4,-46,22,1,9,281,109
568,31,3,3,5,8,32,-65,3,4,313,44
568,32,3,4,7,6,34,42,7,6,347,86
568,33,3,3,7,6,-66,33,1,9,281,119
568,34,3,4,7,6,34,-58,5,1,315,61
568,35,3,3,6,7,33,34,8,5,348,95
568,36,2,4,4,9,-78,-55,0,0,270,40
568,37,4,3,8,5,44,32,4,2,314,72
568,38,3,4,5,8,32,44,6,6,346,116
568,39,3,3,6,7,33,-66,9,0,379,50
568,40,5,2,8,5,-47,23,2,3,332,73
568,41,3,4,4,9,31,45,3,8,363,118
568,42,3,3,6,7,33,-66,6,2,396,52
568,43,3,3,7,6,-66,33,0,5,330,85
568,44,2,5,4,9,22,54,2,9,352,139
568,45,4,3,4,9,40,-64,2,5,392,75
568,46,2,4,5,8,23,44,5,9,415,119
568,47,3,3,7,6,34,-67,9,2,449,52
568,48,4,3,6,7,-58,34,1,6,391,86
568,49,2,5,4,9,22,-46,3,0,413,40
568,50,5,2,7,6,52,24,5,4,465,64
568,51,3,3,4,9,31,-64,6,0,496,0
568,52,2,4,6,7,-76,43,0,3,420,43
568,53,4,2,7,6,43,24,3,7,463,67
568,54,4,3,7,6,43,-67,6,0,506,0
569,1,2,4,4,9,22,45,2,5,22,45
569,2,3,3,6,7,33,34,5,9,55,79
569,3,4,2,8,5,44,-77,9,2,99,2
569,4,5,2,7,6,-48,24,1,6,51,26
569,5,3,3,9,4,36,31,7,7,87,57
569,6,3,4,3,10,30,-54,7,3,117,3
569,7,2,5,5,8,-77,53,0,6,40,56
569,8,3,4,4,9,31,-55,1,1,71,1
569,9,3,4,5,8,32,44,3,5,103,45
569,10,2,5,4,9,22,54,5,9,125,99
569,11,3,3,7,6,34,-67,9,2,159,32
569,12,5,2,10,3,-45,21,4,3,114,53
569,13,3,4,6,7,33,43,7,6,147,96
569,14,5,2,8,5,-47,23,0,9,100,119
569,15,2,4,4,9,22,-55,2,4,122,64
569,16,2,5,4,9,22,54,4,8,144,118
569,17,3,4,8,5,35,41,9,9,179,159
569,18,2,4,7,6,-75,-58,4,1,104,101
569,19,3,3,6,7,33,34,7,5,137,135
569,20,2,6,3,10,21,64,8,9,158,199
569,21,2,4,6,7,-76,-57,2,2,82,142
569,22,4,4,7,6,43,42,5,4,125,184
569,23,2,5,3,10,21,55,6,9,146,239
569,24,4,4,8,5,-56,-59,0,0,90,180
569,25,4,3,6,7,42,34,2,4,132,214
569,26,4,3,8,5,44,32,6,6,176,246
569,27,5,2,10,3,-45,21,1,7,131,267
569,28,3,4,5,8,32,-56,3,1,163,211
569,29,2,5,3,10,21,55,4,6,184,266
569,30,4,3,10,3,-54,30,0,6,130,296
569,31,2,5,3,10,21,-45,1,1,151,251
569,32,2,5,5,8,23,53,4,4,174,304
569,33,5,2,9,4,54,22,8,6,228,326
569,34,2,5,6,7,-76,52,2,8,152,378
569,35,3,3,9,4,36,31,8,9,188,409
569,36,3,3,8,5,-65,-68,3,1,123,341
569,37,5,2,9,4,54,22,7,3,177,363
569,38,3,3,6,7,-67,34,0,7,110,397
569,39,2,4,6,7,24,-57,4,0,134,340
569,40,2,4,4,9,22,45,6,5,156,385
569,41,2,4,7,6,-75,42,1,7,81,427
569,42,3,4,3,10,30,-54,1,3,111,373
569,43,3,3,7,6,34,33,5,6,145,406
569,44,4,3,4,9,40,-64,5,2,185,342
569,45,4,2,9,4,-55,22,0,4,130,364
569,46,4,3,6,7,42,34,2,8,172,398
569,47,3,4,5,8,32,-56,4,2,204,342
569,48,2,4,3,10,21,46,5,8,225,388
569,49,3,3,10,3,-63,30,2,8,162,418
569,50,5,2,11,2,56,20,8,8,218,438
569,51,2,4,6,7,-76,-57,2,1,142,381
569,52,3,3,5,8,32,35,4,6,174,416
569,53,2,4,5,8,23,-56,7,0,197,360
569,54,4,3,6,7,42,34,9,4,239,394
569,55,3,4,5,8,-68,44,1,8,171,438
569,56,3,3,8,5,35,-68,6,0,206,370
569,57,2,5,3,10,21,55,7,5,227,425
569,58,4,3,8,5,-56,32,1,7,171,457
569,59,2,5,2,11,20,-44,1,3,191,413
569,60,3,4,5,8,32,44,3,7,223,457
569,61,4,3,9,4,45,31,8,8,268,488
569,62,4,3,7,6,-57,-67,1,1,211,421
569,63,5,2,9,4,54,22,5,3,265,443
569,64,4,3,8,5,44,32,9,5,309,475
569,65,4,2,8,5,-56,23,3,8,253,498
569,66,4,3,6,7,42,-66,5,2,295,432
569,67,3,3,3,10,30,37,5,9,325,469
569,68,2,4,6,7,24,-57,9,2,349,412
569,69,4,2,8,5,-56,23,3,5,293,435
569,70,5,2,10,3,55,21,8,6,348,456
569,71,3,3,6,7,-67,-66,1,0,281,390
569,72,4,2,10,3,46,21,7,1,327,411
569,73,4,3,8,5,-56,32,1,3,271,443
569,74,2,4,5,8,23,44,4,7,294,487
569,75,4,3,6,7,42,-66,6,1,336,421
569,76,5,2,8,5,53,23,9,4,389,444
569,77,4,3,7,6,-57,33,2,7,332,477
569,78,2,4,4,9,22,-55,4,2,354,422
569,79,2,4,4,9,22,45,6,7,376,467
569,80,3,4,7,6,-66,42,0,9,310,509
570,1,3,3,6,7,33,34,3,4,33,34
570,2,5,3,9,4,54,31,7,5,87,65
570,3,6,2,8,5,62,23,9,8,149,88
570,4,2,4,3,10,-79,-54,0,4,70,34
570,5,3,3,5,8,32,35,2,9,102,69
570,6,5,2,8,5,53,-77,5,2,155,-8
570,7,4,3,8,5,44,32,9,4,199,24
570,8,3,3,5,8,-68,35,1,9,131,59
570,9,2,4,7,6,25,-58,6,1,156,1
570,10,2,4,2,11,20,47,6,8,176,48
570,11,2,5,2,11,20,-44,6,4,196,4
570,12,5,2,10,3,-45,21,1,5,151,25
570,13,3,3,5,8,32,-65,3,0,183,-40
570,14,2,4,4,9,22,45,5,5,205,5
570,15,4,3,8,5,44,32,9,7,249,37
570,16,3,4,8,5,-65,41,4,8,184,78
570,17,3,5,6,7,33,-48,7,0,217,30
570,18,4,3,9,4,-55,31,2,1,162,61
570,19,4,2,7,6,43,24,5,5,205,85
570,20,3,4,8,5,-65,41,0,6,140,126
570,21,2,4,3,10,21,-54,1,2,161,72
570,22,3,3,8,5,35,32,6,4,196,104
570,23,4,3,6,7,42,34,8,8,238,138
570,24,4,2,8,5,-56,-77,2,1,182,61
570,25,4,3,9,4,45,31,7,2,227,92
570,26,5,2,10,3,-45,21,2,3,182,113
570,27,4,3,6,7,42,34,4,7,224,147
570,28,3,4,4,9,31,-55,5,2,255,92
570,29,5,2,9,4,54,22,9,4,309,114
570,30,2,4,4,9,-78,45,1,9,231,159
570,31,3,3,8,5,35,-68,6,1,266,91
570,32,3,4,7,6,-66,42,0,3,200,133
570,33,3,3,5,8,32,35,2,8,232,168
570,34,3,3,6,7,33,-66,5,2,265,102
570,35,3,3,8,5,-65,32,0,4,200,134
570,36,2,4,5,8,23,44,3,8,223,178
570,37,4,2,9,4,45,-78,8,0,268,100
570,38,2,5,3,10,21,55,9,5,289,155
570,39,3,4,4,9,-69,-55,0,0,220,100
570,40,2,5,4,9,22,54,2,4,242,154
570,41,2,4,4,9,22,45,4,9,264,199
570,42,4,2,7,6,43,-76,7,3,307,123
570,43,4,3,7,6,-57,33,0,6,250,156
570,44,4,2,10,3,46,21,6,7,296,177
570,45,5,2,8,5,53,-77,9,0,349,100
570,46,4,4,8,5,-56,41,3,1,293,141
570,47,4,2,7,6,43,24,6,5,336,165
570,48,3,3,8,5,-65,32,1,7,271,197
570,49,2,5,2,11,20,-44,1,3,291,153
570,50,3,4,5,8,32,44,3,7,323,197
570,51,3,3,6,7,33,-66,6,1,356,131
570,52,4,4,5,8,41,44,7,5,397,175
570,53,3,4,3,10,30,-54,7,1,427,121
570,54,4,2,10,3,-54,21,3,2,373,142
570,55,5,2,7,6,52,24,5,6,425,166
570,56,3,3,6,7,33,-66,8,0,458,100
570,57,3,3,6,7,-67,34,1,4,391,134
570,58,3,3,8,5,35,32,6,6,426,166
570,59,4,2,9,4,-55,22,1,8,371,188
570,60,3,3,8,5,35,-68,6,0,406,120
570,61,2,5,5,8,23,53,9,3,429,173
570,62,5,3,8,5,-47,32,2,5,382,205
570,63,3,4,6,7,33,43,5,8,415,248
570,64,4,2,9,4,-55,-78,0,0,360,170
570,65,4,3,7,6,43,33,3,3,403,203
570,66,4,2,9,4,45,22,8,5,448,225
570,67,5,2,8,5,-47,23,1,8,401,248
570,68,3,5,5,8,32,-47,3,1,433,201
570,69,4,3,7,6,43,33,6,4,476,234
570,70,5,2,8,5,53,23,9,7,529,257
571,1,2,5,4,9,22,54,2,4,22,54
571,2,5,2,7,6,52,24,4,8,74,78
571,3,2,5,5,8,23,-47,7,1,97,31
571,4,3,4,5,8,32,44,9,5,129,75
571,5,2,5,5,8,-77,53,2,8,52,128
571,6,3,4,6,7,33,-57,5,1,85,71
571,7,3,3,9,4,-64,31,1,2,21,102
571,8,4,2,10,3,46,21,7,3,67,123
571,9,5,2,8,5,-47,23,0,6,20,146
571,10,2,4,9,4,27,40,7,6,47,186
571,11,3,4,7,6,-66,42,1,8,-19,228
571,12,3,3,8,5,35,-68,6,0,16,160
571,13,4,3,10,3,-54,30,2,0,-38,190
571,14,4,2,9,4,45,22,7,2,7,212
571,15,4,2,9,4,-55,22,2,4,-48,234
571,16,3,4,6,7,33,43,5,7,-15,277
571,17,2,4,6,7,24,-57,9,0,9,220
571,18,4,3,7,6,-57,33,2,3,-48,253
571,19,3,4,6,7,33,43,5,6,-15,296
571,20,3,4,6,7,33,43,8,9,18,339
571,21,4,2,7,6,-57,-76,1,3,-39,263
571,22,4,3,8,5,44,32,5,5,5,295
571,23,3,4,5,8,32,44,7,9,37,339
571,24,5,2,7,6,52,-76,9,3,89,263
571,25,6,2,12,1,-34,-20,5,3,55,243
571,26,5,2,10,3,-45,21,0,4,10,264
571,27,3,3,7,6,34,33,4,7,44,297
571,28,3,4,7,6,34,42,8,9,78,339
571,29,4,2,8,5,-56,-77,2,2,22,262
571,30,3,4,6,7,33,43,5,5,55,305
571,31,5,2,10,3,-45,21,0,6,10,326
571,32,5,2,10,3,55,21,5,7,65,347
571,33,4,2,9,4,-55,22,0,9,10,369
571,34,2,5,6,7,24,-48,4,1,34,321
571,35,2,4,7,6,25,42,9,3,59,363
571,36,4,3,10,3,-54,30,5,3,5,393
571,37,2,5,5,8,23,53,8,6,28,446
571,38,2,5,6,7,-76,52,2,8,-48,498
571,39,3,4,5,8,32,-56,4,2,-16,442
571,40,3,3,8,5,35,32,9,4,19,474
571,41,3,3,4,9,-69,-64,0,0,-50,410
571,42,3,3,7,6,34,33,4,3,-16,443
571,43,4,3,6,7,42,34,6,7,26,477
571,44,2,5,5,8,23,-47,9,0,49,430
571,45,2,5,3,10,-79,55,0,5,-30,485
571,46,3,4,8,5,35,41,5,6,5,526
572,1,3,3,6,7,33,34,3,4,33,34
572,2,2,4,6,7,24,43,7,7,57,77
572,3,4,3,8,5,-56,32,1,9,1,109
572,4,4,3,9,4,45,-69,6,0,46,40
572,5,3,4,6,7,33,43,9,3,79,83
572,6,2,4,4,9,-78,45,1,8,1,128
572,7,4,4,5,8,41,-56,2,2,42,72
572,8,3,3,7,6,34,33,6,5,76,105
572,9,2,4,8,5,-74,41,2,6,2,146
572,10,3,4,7,6,34,42,6,8,36,188
572,11,3,3,9,4,-64,31,2,9,-28,219
572,12,4,3,9,4,45,-69,7,0,17,150
572,13,4,2,8,5,-56,23,1,3,-39,173
572,14,4,3,8,5,44,32,5,5,5,205
572,15,2,4,3,10,21,-54,6,1,26,151
572,16,4,2,7,6,43,24,9,5,69,175
572,17,4,2,8,5,-56,23,3,8,13,198
572,18,2,5,7,6,25,51,8,9,38,249
572,19,4,2,7,6,-57,-76,1,3,-19,173
572,20,4,3,8,5,44,32,5,5,25,205
572,21,5,2,6,7,51,-75,6,0,76,130
572,22,4,3,8,5,-56,32,0,2,20,162
572,23,3,4,5,8,32,44,2,6,52,206
572,24,6,2,8,5,62,23,4,9,114,229
572,25,5,2,9,4,54,-78,8,1,168,151
572,26,3,4,6,7,-67,43,1,4,101,194
572,27,5,2,10,3,55,21,6,5,156,215
572,28,3,3,8,5,-65,32,1,7,91,247
572,29,2,4,4,9,22,-55,3,2,113,192
572,30,3,4,7,6,34,42,7,4,147,234
572,31,2,5,4,9,22,54,9,8,169,288
572,32,3,3,8,5,-65,-68,4,0,104,220
572,33,3,3,7,6,34,33,8,3,138,253
572,34,4,2,7,6,-57,24,1,7,81,277
572,35,3,4,5,8,32,-56,3,1,113,221
572,36,3,3,9,4,36,31,9,2,149,252
572,37,3,4,6,7,-67,43,2,5,82,295
572,38,3,3,5,8,32,-65,4,0,114,230
572,39,3,5,6,7,33,52,7,2,147,282
572,40,2,5,5,8,-77,53,0,5,70,335
572,41,3,3,4,9,31,-64,1,1,101,271
572,42,3,4,5,8,32,44,3,5,133,315
572,43,4,3,9,4,45,31,8,6,178,346
572,44,3,3,6,7,-67,-66,1,0,111,280
572,45,4,3,8,5,44,32,5,2,155,312
572,46,2,4,5,8,23,44,8,6,178,356
572,47,4,4,7,6,-57,42,1,8,121,398
572,48,4,2,8,5,44,-77,5,1,165,321
572,49,2,6,3,10,21,64,6,5,186,385
572,50,2,5,5,8,23,53,9,8,209,438
572,51,4,2,6,7,-58,-75,1,3,151,363
572,52,3,3,9,4,36,31,7,4,187,394
572,53,3,4,8,5,-65,41,2,5,122,435
572,54,4,3,8,5,44,32,6,7,166,467
572,55,4,3,6,7,42,-66,8,1,208,401
572,56,4,3,5,8,41,35,9,6,249,436
572,57,3,4,5,8,-68,-56,1,0,181,380
572,58,2,4,5,8,23,44,4,4,204,424
572,59,3,3,8,5,35,32,9,6,239,456
572,60,3,3,3,10,30,-63,9,3,269,393
572,61,2,4,7,6,-75,42,4,5,194,435
572,62,3,3,6,7,33,34,7,9,227,469
572,63,4,3,7,6,-57,-67,0,2,170,402
572,64,2,5,4,9,22,54,2,6,192,456
572,65,4,2,7,6,43,-76,5,0,235,380
572,66,4,2,8,5,44,23,9,3,279,403
572,67,4,2,6,7,-58,25,1,8,221,428
572,68,3,4,7,6,34,-58,5,0,255,370
572,69,3,4,7,6,34,42,9,2,289,412
572,70,3,4,7,6,-66,42,3,4,223,454
572,71,3,3,6,7,33,34,6,8,256,488
572,72,2,4,4,9,22,-55,8,3,278,433
572,73,5,2,9,4,-46,22,2,5,232,455
572,74,3,3,5,8,32,-65,4,0,264,390
572,75,2,5,2,11,20,56,4,6,284,446
572,76,5,2,7,6,52,-76,6,0,336,370
572,77,4,3,9,4,-55,31,1,1,281,401
572,78,3,3,7,6,34,33,5,4,315,434
572,79,3,3,5,8,32,35,7,9,347,469
572,80,3,3,7,6,-66,-67,1,2,281,402
572,81,3,4,6,7,33,43,4,5,314,445
572,82,4,2,10,3,-54,21,0,6,260,466
572,83,3,4,7,6,34,42,4,8,294,508
573,1,4,3,9,4,45,31,5,1,45,31
573,2,3,4,5,8,32,44,7,5,77,75
573,3,5,2,11,2,-44,20,3,5,33,95
573,4,5,2,8,5,53,23,6,8,86,118
573,5,4,3,6,7,42,-66,8,2,128,52
573,6,4,3,7,6,-57,33,1,5,71,85
573,7,4,3,9,4,45,31,6,6,116,116
573,8,2,4,4,9,22,-55,8,1,138,61
573,9,2,4,5,8,-77,44,1,5,61,105
573,10,2,5,4,9,22,54,3,9,83,159
573,11,3,4,7,6,34,-58,7,1,117,101
573,12,5,2,9,4,-46,22,1,3,71,123
573,13,2,4,5,8,23,44,4,7,94,167
573,14,3,4,7,6,34,42,8,9,128,209
573,15,3,3,7,6,-66,-67,2,2,62,142
573,16,4,2,8,5,44,23,6,5,106,165
573,17,5,2,9,4,-46,22,0,7,60,187
573,18,4,3,8,5,44,32,4,9,104,219
573,19,4,4,6,7,42,-57,6,2,146,162
573,20,4,4,7,6,43,42,9,4,189,204
573,21,3,4,4,9,-69,45,0,9,120,249
573,22,4,2,6,7,42,-75,2,4,162,174
573,23,4,3,7,6,43,33,5,7,205,207
573,24,4,3,9,4,-55,31,0,8,150,238
573,25,5,2,7,6,52,-76,2,2,202,162
573,26,3,3,6,7,33,34,5,6,235,196
573,27,4,2,10,3,-54,21,1,7,181,217
573,28,4,3,9,4,45,31,6,8,226,248
573,29,3,3,7,6,-66,-67,0,1,160,181
573,30,3,4,5,8,32,44,2,5,192,225
573,31,4,2,11,2,47,20,9,5,239,245
573,32,3,4,6,7,-67,43,2,8,172,288
573,33,3,4,6,7,33,-57,5,1,205,231
573,34,3,3,7,6,34,33,9,4,239,264
573,35,2,4,6,7,-76,43,3,7,163,307
573,36,2,4,5,8,23,-56,6,1,186,251
573,37,3,4,7,6,-66,42,0,3,120,293
573,38,3,3,6,7,33,34,3,7,153,327
573,39,2,5,6,7,24,52,7,9,177,379
573,40,3,4,3,10,30,-54,7,5,207,325
573,41,2,4,5,8,-77,44,0,9,130,369
573,42,5,2,9,4,54,-78,4,1,184,291
573,43,4,2,5,8,41,26,5,7,225,317
573,44,4,3,8,5,44,32,9,9,269,349
573,45,2,5,5,8,-77,-47,2,2,192,302
573,46,2,4,3,10,21,46,3,8,213,348
573,47,4,3,7,6,43,-67,6,1,256,281
573,48,3,3,3,10,30,37,6,8,286,318
573,49,2,5,3,10,21,-45,7,3,307,273
573,50,3,4,5,8,32,44,9,7,339,317
573,51,3,4,5,8,-68,-56,1,1,271,261
573,52,3,4,4,9,31,45,2,6,302,306
573,53,3,4,7,6,34,42,6,8,336,348
573,54,2,4,6,7,-76,-57,0,1,260,291
573,55,3,5,5,8,32,53,2,4,292,344
573,56,4,3,8,5,44,32,6,6,336,376
573,57,2,6,4,9,22,63,8,9,358,439
573,58,4,2,7,6,-57,-76,1,3,301,363
573,59,2,5,7,6,25,51,6,4,326,414
573,60,4,2,7,6,43,24,9,8,369,438
573,61,3,4,8,5,-65,41,4,9,304,479
573,62,5,2,10,3,55,-79,9,0,359,400
573,63,4,3,7,6,-57,33,2,3,302,433
573,64,4,2,8,5,44,23,6,6,346,456
573,65,4,3,10,3,-54,30,2,6,292,486
573,66,5,2,8,5,53,23,5,9,345,509
574,1,3,3,9,4,36,31,6,1,36,31
574,2,4,3,8,5,-56,32,0,3,-20,63
574,3,4,3,4,9,40,36,0,9,20,99
574,4,4,2,8,5,44,-77,4,2,64,22
574,5,6,2,11,2,65,20,9,2,129,42
574,6,3,3,5,8,-68,35,1,7,61,77
574,7,4,2,10,3,46,21,7,8,107,98
574,8,3,3,8,5,-65,-68,2,0,42,30
574,9,2,5,4,9,22,54,4,4,64,84
574,10,2,4,6,7,24,43,8,7,88,127
574,11,2,5,5,8,-77,-47,1,0,11,80
574,12,3,3,5,8,32,35,3,5,43,115
574,13,2,5,2,11,20,-44,3,1,63,71
574,14,2,4,3,10,21,46,4,7,84,117
574,15,5,2,8,5,53,-77,7,0,137,40
574,16,3,4,4,9,31,45,8,5,168,85
574,17,3,4,3,10,30,-54,8,1,198,31
574,18,4,3,9,4,-55,31,3,2,143,62
574,19,2,4,5,8,23,44,6,6,166,106
574,20,3,3,7,6,-66,33,0,9,100,139
574,21,3,4,3,10,30,-54,0,5,130,85
574,22,6,2,10,3,64,21,4,6,194,106
574,23,2,5,5,8,23,53,7,9,217,159
574,24,4,2,6,7,42,-75,9,4,259,84
574,25,2,4,6,7,-76,43,3,7,183,127
574,26,3,4,4,9,31,-55,4,2,214,72
574,27,3,4,6,7,33,43,7,5,247,115
574,28,3,4,6,7,-67,43,0,8,180,158
574,29,4,3,7,6,43,-67,3,1,223,91
574,30,3,4,5,8,32,44,5,5,255,135
574,31,4,3,9,4,-55,31,0,6,200,166
574,32,3,3,9,4,36,31,6,7,236,197
574,33,4,2,8,5,-56,-77,0,0,180,120
574,34,3,4,8,5,35,41,5,1,215,161
574,35,3,3,4,9,31,36,6,7,246,197
574,36,2,5,6,7,-76,52,0,9,170,249
574,37,5,2,9,4,54,-78,4,1,224,171
574,38,2,5,3,10,21,55,5,6,245,226
574,39,5,2,10,3,-45,21,0,7,200,247
574,40,4,3,8,5,44,32,4,9,244,279
574,41,3,4,5,8,32,-56,6,3,276,223
574,42,3,4,3,10,30,46,6,9,306,269
574,43,4,2,8,5,-56,-77,0,2,250,192
574,44,3,3,7,6,34,33,4,5,284,225
574,45,4,3,5,8,41,-65,5,0,325,160
574,46,2,5,5,8,23,53,8,3,348,213
574,47,4,2,9,4,-55,22,3,5,293,235
574,48,4,3,7,6,43,33,6,8,336,268
574,49,2,4,7,6,-75,-58,1,0,261,210
574,50,3,3,6,7,33,34,4,4,294,244
574,51,4,2,9,4,45,22,9,6,339,266
574,52,3,3,4,9,-69,-64,0,2,270,202
574,53,5,2,8,5,53,23,3,5,323,225
574,54,3,4,8,5,35,41,8,6,358,266
574,55,4,3,7,6,-57,33,1,9,301,299
574,56,3,3,4,9,31,-64,2,5,332,235
574,57,4,3,9,4,45,31,7,6,377,266
574,58,4,3,9,4,-55,31,2,7,322,297
574,59,2,5,3,10,21,-45,3,2,343,252
574,60,4,3,8,5,44,32,7,4,387,284
574,61,4,3,7,6,-57,33,0,7,330,317
574,62,5,2,11,2,56,20,6,7,386,337
574,63,5,3,5,8,50,-65,6,2,436,272
574,64,4,3,6,7,42,34,8,6,478,306
574,65,3,4,5,8,-68,-56,0,0,410,250
574,66,5,2,7,6,52,24,2,4,462,274
574,67,3,3,6,7,33,34,5,8,495,308
574,68,3,4,5,8,32,-56,7,2,527,252
575,1,4,3,7,6,43,33,3,3,43,33
575,2,4,3,8,5,44,32,7,5,87,65
575,3,4,2,7,6,-57,24,0,9,30,89
575,4,2,4,5,8,23,-56,3,3,53,33
575,5,4,3,7,6,43,33,6,6,96,66
575,6,2,4,3,10,21,-54,7,2,117,12
575,7,3,4,6,7,-67,43,0,5,50,55
575,8,4,2,5,8,41,-74,1,1,91,-19
575,9,3,4,6,7,33,43,4,4,124,24
575,10,4,3,6,7,42,34,6,8,166,58
575,11,4,3,8,5,-56,-68,0,0,110,-10
575,12,3,3,4,9,31,36,1,6,141,26
575,13,3,4,6,7,33,43,4,9,174,69
575,14,3,3,5,8,32,-65,6,4,206,4
575,15,3,4,7,6,-66,42,0,6,140,46
575,16,3,3,7,6,34,33,4,9,174,79
575,17,3,4,4,9,31,-55,5,4,205,24
575,18,2,4,6,7,24,43,9,7,229,67
575,19,3,4,6,7,-67,-57,2,0,162,10
575,20,4,2,6,7,42,25,4,5,204,35
575,21,5,2,8,5,53,23,7,8,257,58
575,22,4,3,5,8,41,-65,8,3,298,-7
575,23,4,3,6,7,-58,34,0,7,240,27
575,24,3,4,5,8,32,-56,2,1,272,-29
575,25,3,4,5,8,32,44,4,5,304,15
575,26,5,3,9,4,54,31,8,6,358,46
575,27,3,3,7,6,-66,33,2,9,292,79
575,28,3,5,5,8,32,-47,4,2,324,32
575,29,6,2,10,3,64,21,8,3,388,53
575,30,2,4,7,6,-75,42,3,5,313,95
575,31,2,4,6,7,24,43,7,8,337,138
575,32,4,3,8,5,-56,-68,1,0,281,70
575,33,3,3,7,6,34,33,5,3,315,103
575,34,5,3,6,7,51,34,6,7,366,137
575,35,2,4,4,9,22,-55,8,2,388,82
575,36,4,3,7,6,-57,33,1,5,331,115
575,37,2,4,6,7,24,43,5,8,355,158
575,38,3,3,6,7,33,-66,8,2,388,92
575,39,4,3,5,8,41,35,9,7,429,127
575,40,3,4,8,5,-65,41,4,8,364,168
575,41,2,4,5,8,23,-56,7,2,387,112
575,42,2,5,3,10,21,55,8,7,408,167
575,43,5,2,7,6,-48,-76,0,1,360,91
575,44,3,4,5,8,32,44,2,5,392,135
575,45,2,4,2,11,20,-53,2,2,412,82
575,46,3,3,6,7,33,34,5,6,445,116
575,47,3,4,4,9,31,-55,6,1,476,61
575,48,4,3,6,7,42,34,8,5,518,95
576,1,5,2,9,4,54,22,4,2,54,22
576,2,2,4,5,8,23,44,7,6,77,66
576,3,4,3,6,7,42,-66,9,0,119,0
576,4,2,5,3,10,-79,55,0,5,40,55
576,5,4,2,9,4,45,22,5,7,85,77
576,6,5,2,7,6,52,-76,7,1,137,1
576,7,3,4,5,8,32,44,9,5,169,45
576,8,4,3,6,7,-58,34,1,9,111,79
576,9,6,2,11,2,65,20,6,9,176,99
576,10,3,3,7,6,-66,-67,0,2,110,32
576,11,2,4,5,8,23,44,3,6,133,76
576,12,2,6,3,10,21,-36,4,0,154,40
576,13,4,2,11,2,-53,20,1,0,101,60
576,14,3,3,6,7,33,34,4,4,134,94
576,15,2,5,6,7,24,52,8,6,158,146
576,16,6,2,9,4,-37,22,1,8,121,168
576,17,2,4,5,8,23,-56,4,2,144,112
576,18,3,3,7,6,34,33,8,5,178,145
576,19,4,2,6,7,-58,-75,0,0,120,70
576,20,4,3,8,5,44,32,4,2,164,102
576,21,3,4,6,7,33,43,7,5,197,145
576,22,3,4,6,7,-67,43,0,8,130,188
576,23,3,3,8,5,35,-68,5,0,165,120
576,24,5,2,11,2,-44,20,1,0,121,140
576,25,2,6,4,9,22,63,3,3,143,203
576,26,5,3,8,5,53,32,6,5,196,235
576,27,4,4,5,8,41,44,7,9,237,279
576,28,3,3,8,5,-65,-68,2,1,172,211
576,29,4,2,8,5,44,23,6,4,216,234
576,30,3,4,5,8,32,44,8,8,248,278
576,31,5,2,7,6,-48,-76,0,2,200,202
576,32,3,3,7,6,34,33,4,5,234,235
576,33,4,3,6,7,42,34,6,9,276,269
576,34,4,2,9,4,-55,-78,1,1,221,191
576,35,4,3,9,4,45,31,6,2,266,222
576,36,3,4,6,7,33,43,9,5,299,265
576,37,2,5,4,9,-78,54,1,9,221,319
576,38,3,3,7,6,34,-67,5,2,255,252
576,39,4,3,8,5,44,32,9,4,299,284
576,40,5,3,7,6,-48,33,1,7,251,317
576,41,2,5,4,9,22,-46,3,1,273,271
576,42,5,2,8,5,53,23,6,4,326,294
576,43,3,3,6,7,33,34,9,8,359,328
576,44,5,2,10,3,-45,21,4,9,314,349
576,45,4,3,7,6,43,-67,7,2,357,282
576,46,4,3,6,7,42,34,9,6,399,316
576,47,3,3,5,8,-68,-65,1,1,331,251
576,48,3,3,8,5,35,32,6,3,366,283
576,49,4,2,9,4,-55,22,1,5,311,305
576,50,4,2,5,8,41,-74,2,1,352,231
576,51,5,2,7,6,52,24,4,5,404,255
576,52,3,3,9,4,-64,31,0,6,340,286
576,53,2,4,2,11,20,-53,0,3,360,233
576,54,3,3,6,7,33,34,3,7,393,267
576,55,3,3,7,6,34,-67,7,0,427,200
576,56,3,3,8,5,-65,32,2,2,362,232
576,57,4,2,5,8,41,26,3,8,403,258
576,58,2,4,5,8,23,-56,6,2,426,202
576,59,5,2,10,3,-45,21,1,3,381,223
576,60,4,3,6,7,42,34,3,7,423,257
576,61,4,2,7,6,43,-76,6,1,466,181
576,62,3,3,8,5,-65,32,1,3,401,213
576,63,3,4,7,6,34,42,5,5,435,255
576,64,2,5,6,7,24,52,9,7,459,307
576,65,3,4,4,9,-69,-55,0,2,390,252
576,66,4,2,7,6,43,24,3,6,433,276
576,67,3,3,3,10,30,-63,3,3,463,213
576,68,2,5,3,10,21,55,4,8,484,268
576,69,4,3,8,5,44,-68,8,0,528,200
577,1,3,3,6,7,33,34,3,4,33,34
577,2,5,3,10,3,55,30,8,4,88,64
577,3,3,3,9,4,-64,31,4,5,24,95
577,4,2,4,7,6,25,42,9,7,49,137
577,5,3,5,6,7,-67,52,2,9,-18,189
577,6,3,4,5,8,32,-56,4,3,14,133
577,7,3,4,3,10,30,46,4,9,44,179
577,8,4,3,8,5,44,-68,8,1,88,111
577,9,4,3,8,5,-56,32,2,3,32,143
577,10,5,2,8,5,53,23,5,6,85,166
577,11,2,5,3,10,21,-45,6,1,106,121
577,12,3,4,6,7,33,43,9,4,139,164
577,13,3,4,5,8,-68,44,1,8,71,208
577,14,4,3,9,4,45,31,6,9,116,239
577,15,5,3,9,4,-46,-69,0,0,70,170
577,16,3,4,7,6,34,42,4,2,104,212
577,17,2,4,7,6,25,42,9,4,129,254
577,18,3,4,3,10,30,-54,9,0,159,200
577,19,2,4,4,9,-78,45,1,5,81,245
577,20,2,5,3,10,21,-45,2,0,102,200
577,21,4,3,8,5,44,32,6,2,146,232
577,22,4,3,6,7,42,34,8,6,188,266
577,23,3,4,6,7,-67,43,1,9,121,309
577,24,2,5,4,9,22,-46,3,3,143,263
577,25,2,4,4,9,22,45,5,8,165,308
577,26,3,4,3,10,30,-54,5,4,195,254
577,27,4,3,10,3,-54,30,1,4,141,284
577,28,3,4,7,6,34,42,5,6,175,326
577,29,3,4,7,6,34,42,9,8,209,368
577,30,4,3,8,5,-56,-68,3,0,153,300
577,31,3,3,6,7,33,34,6,4,186,334
577,32,3,3,5,8,32,35,8,9,218,369
577,33,2,5,6,7,-76,-48,2,1,142,321
577,34,4,2,5,8,41,26,3,7,183,347
577,35,5,2,9,4,54,22,7,9,237,369
577,36,6,2,9,4,-37,-78,0,1,200,291
577,37,5,2,10,3,55,21,5,2,255,312
577,38,3,3,3,10,30,37,5,9,285,349
577,39,2,5,6,7,24,-48,9,1,309,301
577,40,4,3,5,8,-59,35,0,6,250,336
577,41,4,4,7,6,43,42,3,8,293,378
577,42,2,5,2,11,20,-44,3,4,313,334
577,43,3,3,6,7,33,34,6,8,346,368
577,44,3,3,4,9,31,-64,7,4,377,304
577,45,2,4,4,9,22,45,9,9,399,349
577,46,3,3,6,7,-67,-66,2,3,332,283
577,47,2,4,5,8,23,44,5,7,355,327
577,48,2,4,4,9,22,-55,7,2,377,272
577,49,3,4,5,8,32,44,9,6,409,316
577,50,3,4,5,8,-68,-56,1,0,341,260
577,51,5,2,9,4,54,22,5,2,395,282
577,52,3,3,6,7,33,34,8,6,428,316
577,53,3,4,4,9,31,-55,9,1,459,261
577,54,4,3,7,6,-57,33,2,4,402,294
577,55,4,3,10,3,46,30,8,4,448,324
577,56,4,3,9,4,-55,31,3,5,393,355
577,57,3,3,5,8,32,-65,5,0,425,290
577,58,4,3,8,5,44,32,9,2,469,322
577,59,4,2,9,4,-55,22,4,4,414,344
577,60,2,4,4,9,22,45,6,9,436,389
577,61,3,4,7,6,-66,-58,0,1,370,331
577,62,3,3,8,5,35,32,5,3,405,363
577,63,3,4,6,7,33,43,8,6,438,406
577,64,4,3,8,5,-56,32,2,8,382,438
577,65,4,2,7,6,43,-76,5,2,425,362
577,66,4,4,6,7,42,43,7,5,467,405
577,67,3,3,7,6,-66,33,1,8,401,438
577,68,2,6,5,8,23,-38,4,0,424,400
577,69,3,4,8,5,35,41,9,1,459,441
577,70,2,4,6,7,-76,43,3,4,383,484
577,71,4,2,9,4,45,22,8,6,428,506
578,1,4,2,8,5,44,23,4,3,44,23
578,2,4,3,6,7,42,34,6,7,86,57
578,3,3,4,4,9,31,-55,7,2,117,2
578,4,4,4,6,7,42,43,9,5,159,45
578,5,3,4,4,9,-69,-55,0,0,90,-10
578,6,3,4,5,8,32,44,2,4,122,34
578,7,3,4,8,5,35,41,7,5,157,75
578,8,3,5,7,6,-66,51,1,6,91,126
578,9,3,4,3,10,30,-54,1,2,121,72
578,10,3,3,10,3,37,30,8,2,158,102
578,11,3,3,6,7,-67,34,1,6,91,136
578,12,4,2,9,4,45,22,6,8,136,158
578,13,4,3,6,7,42,-66,8,2,178,92
578,14,2,5,3,10,21,55,9,7,199,147
578,15,2,5,3,10,-79,-45,0,2,120,102
578,16,3,4,7,6,34,42,4,4,154,144
578,17,3,4,7,6,34,42,8,6,188,186
578,18,2,4,4,9,-78,-55,0,1,110,131
578,19,4,2,8,5,44,23,4,4,154,154
578,20,2,4,6,7,24,43,8,7,178,197
578,21,6,2,10,3,-36,21,2,8,142,218
578,22,3,3,7,6,34,-67,6,1,176,151
578,23,3,3,6,7,33,34,9,5,209,185
578,24,3,4,7,6,-66,42,3,7,143,227
578,25,2,5,3,10,21,-45,4,2,164,182
578,26,3,3,6,7,33,34,7,6,197,216
578,27,3,3,8,5,-65,32,2,8,132,248
578,28,3,3,8,5,35,-68,7,0,167,180
578,29,4,2,9,4,-55,22,2,2,112,202
578,30,4,3,8,5,44,32,6,4,156,234
578,31,4,3,8,5,-56,32,0,6,100,266
578,32,3,3,7,6,34,33,4,9,134,299
578,33,3,4,7,6,34,-58,8,1,168,241
578,34,5,2,10,3,-45,21,3,2,123,262
578,35,4,3,9,4,45,31,8,3,168,293
578,36,4,2,10,3,-54,21,4,4,114,314
578,37,3,4,4,9,31,45,5,9,145,359
578,38,5,2,10,3,-45,-79,0,0,100,280
578,39,4,3,9,4,45,31,5,1,145,311
578,40,5,2,10,3,-45,21,0,2,100,332
578,41,4,2,8,5,44,23,4,5,144,355
578,42,3,3,5,8,32,-65,6,0,176,290
578,43,2,5,3,10,21,55,7,5,197,345
578,44,3,3,5,8,32,-65,9,0,229,280
578,45,2,5,5,8,-77,53,2,3,152,333
578,46,5,2,8,5,53,23,5,6,205,356
578,47,4,3,6,7,42,-66,7,0,247,290
578,48,3,4,5,8,32,44,9,4,279,334
578,49,4,2,8,5,-56,23,3,7,223,357
578,50,4,2,9,4,45,22,8,9,268,379
578,51,2,5,6,7,-76,-48,2,1,192,331
578,52,3,3,7,6,34,33,6,4,226,364
578,53,3,4,4,9,31,45,7,9,257,409
578,54,2,4,4,9,22,-55,9,4,279,354
578,55,3,3,6,7,-67,34,2,8,212,388
578,56,2,4,4,9,22,-55,4,3,234,333
578,57,4,2,8,5,44,23,8,6,278,356
578,58,3,4,6,7,-67,43,1,9,211,399
578,59,2,5,4,9,22,-46,3,3,233,353
578,60,3,3,6,7,33,34,6,7,266,387
578,61,2,5,4,9,22,-46,8,1,288,341
578,62,4,2,9,4,-55,22,3,3,233,363
578,63,5,2,10,3,55,21,8,4,288,384
578,64,3,3,8,5,-65,32,3,6,223,416
578,65,2,5,5,8,23,53,6,9,246,469
578,66,2,5,4,9,22,-46,8,3,268,423
578,67,4,3,10,3,-54,30,4,3,214,453
578,68,2,4,5,8,23,44,7,7,237,497
578,69,2,4,6,7,-76,-57,1,0,161,440
578,70,2,4,4,9,22,45,3,5,183,485
578,71,2,5,6,7,24,52,7,7,207,537
579,1,3,5,3,10,30,55,0,5,30,55
579,2,3,4,8,5,35,41,5,6,65,96
579,3,2,6,4,9,22,63,7,9,87,159
579,4,3,4,6,7,-67,-57,0,2,20,102
579,5,3,3,8,5,35,32,5,4,55,134
579,6,3,4,8,5,-65,41,0,5,-10,175
579,7,2,4,5,8,23,44,3,9,13,219
579,8,3,3,9,4,36,-69,9,0,49,150
579,9,4,4,7,6,-57,42,2,2,-8,192
579,10,4,2,7,6,43,24,5,6,35,216
579,11,3,4,3,10,30,-54,5,2,65,162
579,12,3,3,7,6,34,33,9,5,99,195
579,13,2,5,3,10,-79,-45,0,0,20,150
579,14,2,5,6,7,24,52,4,2,44,202
579,15,4,3,10,3,-54,30,0,2,-10,232
579,16,4,2,8,5,44,23,4,5,34,255
579,17,3,4,8,5,35,41,9,6,69,296
579,18,2,4,3,10,-79,-54,0,2,-10,242
579,19,2,5,4,9,22,54,2,6,12,296
579,20,4,3,6,7,42,-66,4,0,54,230
579,21,4,2,8,5,44,23,8,3,98,253
579,22,3,5,3,10,30,55,8,8,128,308
579,23,3,3,7,6,-66,-67,2,1,62,241
579,24,2,4,4,9,22,45,4,6,84,286
579,25,4,2,7,6,43,-76,7,0,127,210
579,26,3,4,3,10,30,46,7,6,157,256
579,27,4,3,8,5,-56,32,1,8,101,288
579,28,4,3,9,4,45,31,6,9,146,319
579,29,6,2,9,4,63,-78,9,1,209,241
579,30,2,4,4,9,-78,45,1,6,131,286
579,31,4,3,9,4,45,31,6,7,176,317
579,32,2,5,4,9,22,-46,8,1,198,271
579,33,2,6,4,9,-78,63,0,4,120,334
579,34,4,3,8,5,44,32,4,6,164,366
579,35,3,3,7,6,34,33,8,9,198,399
579,36,4,3,10,3,-54,30,4,9,144,429
579,37,4,2,8,5,44,-77,8,2,188,352
579,38,2,4,5,8,-77,44,1,6,111,396
579,39,4,3,9,4,45,31,6,7,156,427
579,40,3,3,5,8,32,-65,8,2,188,362
579,41,4,3,6,7,-58,34,0,6,130,396
579,42,2,5,4,9,22,-46,2,0,152,350
579,43,3,3,6,7,33,34,5,4,185,384
579,44,5,2,8,5,53,23,8,7,238,407
579,45,2,4,5,8,-77,-56,1,1,161,351
579,46,4,3,9,4,45,31,6,2,206,382
579,47,3,4,6,7,33,43,9,5,239,425
579,48,2,4,5,8,-77,44,2,9,162,469
579,49,2,6,3,10,21,-36,3,3,183,433
579,50,4,2,9,4,45,22,8,5,228,455
579,51,4,3,5,8,41,-65,9,0,269,390
579,52,4,3,8,5,-56,32,3,2,213,422
579,53,5,2,10,3,55,21,8,3,268,443
579,54,3,4,6,7,-67,43,1,6,201,486
579,55,4,3,8,5,44,32,5,8,245,518
580,1,4,2,9,4,45,22,5,2,45,22
580,2,2,5,5,8,23,53,8,5,68,75
580,3,2,4,4,9,-78,-55,0,0,-10,20
580,4,5,2,10,3,55,21,5,1,45,41
580,5,2,5,4,9,22,54,7,5,67,95
580,6,5,2,6,7,51,-75,8,0,118,20
580,7,2,4,5,8,-77,44,1,4,41,64
580,8,4,2,4,9,40,-73,1,1,81,-9
580,9,4,2,6,7,42,25,3,6,123,16
580,10,2,4,6,7,24,43,7,9,147,59
580,11,2,5,4,9,22,-46,9,3,169,13
580,12,4,4,4,9,40,45,9,8,209,58
580,13,4,2,8,5,-56,-77,3,1,153,-19
580,14,3,5,6,7,33,52,6,3,186,33
580,15,3,3,7,6,-66,33,0,6,120,66
580,16,4,3,8,5,44,32,4,8,164,98
580,17,3,3,9,4,-64,31,0,9,100,129
580,18,2,5,4,9,22,-46,2,3,122,83
580,19,4,2,7,6,43,24,5,7,165,107
580,20,2,4,5,8,23,-56,8,1,188,51
580,21,5,2,10,3,-45,21,3,2,143,72
580,22,3,3,8,5,35,32,8,4,178,104
580,23,4,3,5,8,41,35,9,9,219,139
580,24,6,2,10,3,-36,-79,3,0,183,60
580,25,3,3,5,8,32,35,5,5,215,95
580,26,3,4,5,8,32,44,7,9,247,139
580,27,4,3,9,4,-55,-69,2,0,192,70
580,28,4,3,8,5,44,32,6,2,236,102
580,29,3,4,8,5,-65,41,1,3,171,143
580,30,2,4,4,9,22,45,3,8,193,188
580,31,3,3,5,8,32,-65,5,3,225,123
580,32,4,2,6,7,42,25,7,8,267,148
580,33,4,3,7,6,-57,-67,0,1,210,81
580,34,5,2,9,4,54,22,4,3,264,103
580,35,3,3,5,8,32,35,6,8,296,138
580,36,3,3,7,6,-66,-67,0,1,230,71
580,37,3,4,7,6,34,42,4,3,264,113
580,38,4,3,6,7,42,34,6,7,306,147
580,39,4,3,7,6,43,-67,9,0,349,80
580,40,4,2,10,3,-54,21,5,1,295,101
580,41,4,2,5,8,41,26,6,7,336,127
580,42,3,3,8,5,-65,32,1,9,271,159
580,43,4,2,9,4,45,-78,6,1,316,81
580,44,2,6,3,10,21,64,7,5,337,145
580,45,2,5,3,10,21,-45,8,0,358,100
580,46,2,6,5,8,-77,62,1,2,281,162
580,47,5,2,8,5,53,23,4,5,334,185
580,48,5,2,9,4,54,22,8,7,388,207
580,49,2,5,2,11,20,-44,8,3,408,163
580,50,5,2,7,6,-48,24,0,7,360,187
580,51,3,4,7,6,34,42,4,9,394,229
580,52,5,2,8,5,53,-77,7,2,447,152
580,53,3,4,8,5,-65,41,2,3,382,193
580,54,3,3,6,7,33,34,5,7,415,227
580,55,2,4,4,9,22,-55,7,2,437,172
580,56,5,2,11,2,-44,20,3,2,393,192
580,57,2,5,3,10,21,55,4,7,414,247
580,58,2,4,4,9,22,-55,6,2,436,192
580,59,4,2,8,5,-56,23,0,5,380,215
580,60,2,6,4,9,22,63,2,8,402,278
580,61,2,4,7,6,25,-58,7,0,427,220
580,62,2,5,4,9,22,54,9,4,449,274
580,63,4,2,6,7,-58,25,1,9,391,299
580,64,4,3,6,7,42,-66,3,3,433,233
580,65,6,2,11,2,65,20,8,3,498,253
580,66,2,4,4,9,-78,45,0,8,420,298
580,67,3,3,4,9,31,-64,1,4,451,234
580,68,2,4,7,6,25,42,6,6,476,276
580,69,2,5,4,9,22,-46,8,0,498,230
580,70,3,4,5,8,-68,44,0,4,430,274
580,71,3,4,3,10,30,-54,0,0,460,220
580,72,5,2,9,4,54,22,4,2,514,242
581,1,2,4,7,6,25,42,5,2,25,42
581,2,3,4,4,9,31,45,6,7,56,87
581,3,3,3,6,7,33,-66,9,1,89,21
581,4,3,3,6,7,-67,34,2,5,22,55
581,5,3,4,5,8,32,44,4,9,54,99
581,6,4,3,7,6,43,-67,7,2,97,32
581,7,3,3,6,7,-67,34,0,6,30,66
581,8,4,4,5,8,41,-56,1,0,71,10
581,9,4,2,7,6,43,24,4,4,114,34
581,10,3,3,5,8,32,35,6,9,146,69
581,11,2,4,5,8,23,-56,9,3,169,13
581,12,4,3,10,3,-54,30,5,3,115,43
581,13,5,2,9,4,54,22,9,5,169,65
581,14,4,2,8,5,-56,23,3,8,113,88
581,15,4,2,7,6,43,-76,6,2,156,12
581,16,3,3,5,8,32,35,8,7,188,47
581,17,2,5,6,7,-76,52,2,9,112,99
581,18,4,3,8,5,44,-68,6,1,156,31
581,19,3,3,5,8,32,35,8,6,188,66
581,20,4,3,9,4,-55,31,3,7,133,97
581,21,3,4,5,8,32,-56,5,1,165,41
581,22,4,3,5,8,41,35,6,6,206,76
581,23,2,5,3,10,21,-45,7,1,227,31
581,24,2,4,7,6,-75,42,2,3,152,73
581,25,3,3,9,4,36,31,8,4,188,104
581,26,2,4,5,8,-77,44,1,8,111,148
581,27,3,3,7,6,34,-67,5,1,145,81
581,28,3,4,7,6,34,42,9,3,179,123
581,29,6,2,10,3,-36,21,3,4,143,144
581,30,5,2,8,5,53,23,6,7,196,167
581,31,2,4,3,10,21,-54,7,3,217,113
581,32,3,3,8,5,-65,32,2,5,152,145
581,33,4,3,9,4,45,31,7,6,197,176
581,34,5,2,11,2,-44,20,3,6,153,196
581,35,3,3,5,8,32,-65,5,1,185,131
581,36,2,5,2,11,20,56,5,7,205,187
581,37,4,3,9,4,-55,31,0,8,150,218
581,38,3,3,6,7,33,-66,3,2,183,152
581,39,2,5,5,8,23,53,6,5,206,205
581,40,3,4,5,8,32,44,8,9,238,249
581,41,3,4,9,4,-64,40,4,9,174,289
581,42,3,4,5,8,32,-56,6,3,206,233
581,43,5,2,9,4,-46,22,0,5,160,255
581,44,2,4,4,9,22,-55,2,0,182,200
581,45,4,2,7,6,43,24,5,4,225,224
581,46,3,3,5,8,32,35,7,9,257,259
581,47,4,3,9,4,-55,-69,2,0,202,190
581,48,3,3,5,8,32,35,4,5,234,225
581,49,3,4,7,6,34,42,8,7,268,267
581,50,3,4,8,5,-65,41,3,8,203,308
581,51,2,5,2,11,20,-44,3,4,223,264
581,52,4,2,9,4,45,22,8,6,268,286
581,53,4,3,5,8,41,-65,9,1,309,221
581,54,4,3,10,3,-54,30,5,1,255,251
581,55,2,4,3,10,21,46,6,7,276,297
581,56,2,4,3,10,21,-54,7,3,297,243
581,57,2,4,6,7,-76,43,1,6,221,286
581,58,2,4,4,9,22,-55,3,1,243,231
581,59,3,3,5,8,32,35,5,6,275,266
581,60,2,4,5,8,23,-56,8,0,298,210
581,61,3,4,6,7,-67,43,1,3,231,253
581,62,2,5,5,8,23,53,4,6,254,306
581,63,2,4,6,7,24,43,8,9,278,349
581,64,3,3,8,5,-65,-68,3,1,213,281
581,65,4,3,5,8,41,35,4,6,254,316
581,66,5,2,7,6,52,-76,6,0,306,240
581,67,3,3,8,5,-65,32,1,2,241,272
581,68,5,2,8,5,53,23,4,5,294,295
581,69,4,2,10,3,-54,21,0,6,240,316
581,70,3,3,6,7,33,-66,3,0,273,250
581,71,2,4,8,5,26,41,9,1,299,291
581,72,3,3,8,5,-65,32,4,3,234,323
581,73,5,2,10,3,55,21,9,4,289,344
581,74,4,3,8,5,-56,32,3,6,233,376
581,75,2,5,3,10,21,-45,4,1,254,331
581,76,4,3,6,7,42,34,6,5,296,365
581,77,4,2,10,3,-54,21,2,6,242,386
581,78,4,3,7,6,43,33,5,9,285,419
581,79,2,4,3,10,21,-54,6,5,306,365
581,80,4,2,11,2,-53,20,3,5,253,385
581,81,2,4,7,6,25,42,8,7,278,427
581,82,3,4,6,7,-67,-57,1,0,211,370
581,83,3,4,5,8,32,44,3,4,243,414
581,84,5,2,9,4,54,22,7,6,297,436
581,85,3,3,5,8,32,-65,9,1,329,371
581,86,4,3,5,8,-59,35,0,6,270,406
581,87,3,3,6,7,33,-66,3,0,303,340
581,88,3,4,5,8,32,44,5,4,335,384
581,89,4,2,9,4,-55,22,0,6,280,406
581,90,4,3,9,4,45,31,5,7,325,437
581,91,4,3,7,6,43,-67,8,0,368,370
581,92,3,3,6,7,-67,34,1,4,301,404
581,93,4,2,7,6,43,24,4,8,344,428
581,94,3,4,3,10,30,-54,4,4,374,374
581,95,2,5,3,10,21,55,5,9,395,429
581,96,2,4,5,8,23,-56,8,3,418,373
581,97,3,3,5,8,-68,35,0,8,350,408
581,98,4,2,10,3,46,21,6,9,396,429
581,99,3,4,6,7,33,-57,9,2,429,372
581,100,3,4,6,7,-67,43,2,5,362,415
581,101,3,3,6,7,33,34,5,9,395,449
581,102,3,3,8,5,-65,-68,0,1,330,381
581,103,4,2,9,4,45,22,5,3,375,403
581,104,3,3,8,5,-65,32,0,5,310,435
581,105,4,2,10,3,46,21,6,6,356,456
581,106,5,2,8,5,53,23,9,9,409,479
581,107,5,2,8,5,-47,-77,2,2,362,402
581,108,3,3,9,4,36,31,8,3,398,433
581,109,3,4,6,7,-67,43,1,6,331,476
581,110,3,3,7,6,34,33,5,9,365,509
582,1,4,2,9,4,45,22,5,2,45,22
582,2,4,2,7,6,43,24,8,6,88,46
582,3,4,2,6,7,-58,-75,0,1,30,-29
582,4,4,2,8,5,44,23,4,4,74,-6
582,5,3,4,4,9,31,45,5,9,105,39
582,6,3,3,7,6,34,-67,9,2,139,-28
582,7,3,3,6,7,-67,34,2,6,72,6
582,8,4,3,9,4,45,31,7,7,117,37
582,9,2,5,7,6,-75,51,2,8,42,88
582,10,3,5,5,8,32,-47,4,1,74,41
582,11,4,3,5,8,41,35,5,6,115,76
582,12,3,4,4,9,31,-55,6,1,146,21
582,13,4,2,10,3,-54,21,2,2,92,42
582,14,3,5,5,8,32,53,4,5,124,95
582,15,2,5,4,9,22,54,6,9,146,149
582,16,2,5,3,10,21,-45,7,4,167,104
582,17,5,2,8,5,-47,23,0,7,120,127
582,18,3,4,8,5,35,41,5,8,155,168
582,19,3,4,6,7,33,-57,8,1,188,111
582,20,2,4,5,8,-77,44,1,5,111,155
582,21,3,3,6,7,33,34,4,9,144,189
582,22,3,4,4,9,31,-55,5,4,175,134
582,23,3,3,9,4,-64,31,1,5,111,165
582,24,3,3,7,6,34,33,5,8,145,198
582,25,3,4,8,5,-65,41,0,9,80,239
582,26,3,3,8,5,35,-68,5,1,115,171
582,27,3,3,4,9,31,36,6,7,146,207
582,28,3,4,8,5,-65,41,1,8,81,248
582,29,4,2,7,6,43,-76,4,2,124,172
582,30,2,5,7,6,25,51,9,3,149,223
582,31,5,2,7,6,-48,24,1,7,101,247
582,32,3,3,7,6,34,-67,5,0,135,180
582,33,4,2,6,7,42,25,7,5,177,205
582,34,4,3,6,7,42,34,9,9,219,239
582,35,4,2,5,8,-59,-74,0,5,160,165
582,36,4,3,7,6,43,33,3,8,203,198
582,37,3,4,4,9,31,-55,4,3,234,143
582,38,3,3,8,5,35,32,9,5,269,175
582,39,5,2,11,2,-44,20,5,5,225,195
582,40,3,3,8,5,-65,32,0,7,160,227
582,41,4,2,6,7,42,-75,2,2,202,152
582,42,3,4,6,7,33,43,5,5,235,195
582,43,4,2,7,6,43,24,8,9,278,219
582,44,4,2,8,5,-56,-77,2,2,222,142
582,45,5,2,10,3,55,21,7,3,277,163
582,46,3,3,6,7,-67,34,0,7,210,197
582,47,3,3,5,8,32,-65,2,2,242,132
582,48,2,4,7,6,25,42,7,4,267,174
582,49,4,3,7,6,-57,33,0,7,210,207
582,50,3,3,5,8,32,-65,2,2,242,142
582,51,5,2,9,4,54,22,6,4,296,164
582,52,4,3,6,7,42,34,8,8,338,198
582,53,3,4,4,9,31,-55,9,3,369,143
582,54,4,2,9,4,-55,22,4,5,314,165
582,55,2,5,3,10,21,-45,5,0,335,120
582,56,4,2,7,6,43,24,8,4,378,144
582,57,4,4,5,8,41,44,9,8,419,188
582,58,3,4,4,9,-69,-55,0,3,350,133
582,59,3,3,4,9,31,36,1,9,381,169
582,60,3,4,7,6,34,-58,5,1,415,111
582,61,4,3,4,9,40,36,5,7,455,147
582,62,3,3,6,7,33,-66,8,1,488,81
582,63,2,5,3,10,21,55,9,6,509,136
583,1,2,4,7,6,25,42,5,2,25,42
583,2,2,5,3,10,21,55,6,7,46,97
583,3,4,3,7,6,43,-67,9,0,89,30
583,4,5,2,9,4,-46,22,3,2,43,52
583,5,4,3,7,6,43,33,6,5,86,85
583,6,4,3,7,6,43,33,9,8,129,118
583,7,3,3,7,6,-66,-67,3,1,63,51
583,8,3,3,4,9,31,36,4,7,94,87
583,9,2,4,4,9,22,-55,6,2,116,32
583,10,2,4,5,8,23,44,9,6,139,76
583,11,4,2,9,4,-55,22,4,8,84,98
583,12,2,6,3,10,21,-36,5,2,105,62
583,13,3,3,8,5,-65,32,0,4,40,94
583,14,4,2,6,7,42,25,2,9,82,119
583,15,5,2,10,3,55,-79,7,0,137,40
583,16,2,4,3,10,21,46,8,6,158,86
583,17,3,3,5,8,-68,-65,0,1,90,21
583,18,4,3,5,8,41,35,1,6,131,56
583,19,4,3,7,6,43,33,4,9,174,89
583,20,3,4,7,6,34,-58,8,1,208,31
583,21,3,3,9,4,-64,31,4,2,144,62
583,22,5,3,8,5,53,32,7,4,197,94
583,23,4,2,10,3,-54,21,3,5,143,115
583,24,3,4,4,9,31,-55,4,0,174,60
583,25,2,6,3,10,21,64,5,4,195,124
583,26,2,4,3,10,21,-54,6,0,216,70
583,27,2,4,3,10,21,46,7,6,237,116
583,28,3,4,7,6,-66,42,1,8,171,158
583,29,4,3,6,7,42,-66,3,2,213,92
583,30,2,4,4,9,22,45,5,7,235,137
583,31,5,2,7,6,52,-76,7,1,287,61
583,32,2,5,5,8,-77,53,0,4,210,114
583,33,3,3,9,4,36,31,6,5,246,145
583,34,3,3,7,6,-66,33,0,8,180,178
583,35,2,5,3,10,21,-45,1,3,201,133
583,36,3,3,5,8,32,35,3,8,233,168
583,37,3,3,8,5,35,-68,8,0,268,100
583,38,2,4,6,7,-76,43,2,3,192,143
583,39,4,3,8,5,44,32,6,5,236,175
583,40,2,4,5,8,23,44,9,9,259,219
583,41,3,4,6,7,-67,-57,2,2,192,162
583,42,2,6,3,10,21,64,3,6,213,226
583,43,5,2,9,4,54,22,7,8,267,248
583,44,3,4,8,5,-65,41,2,9,202,289
583,45,4,2,9,4,45,-78,7,1,247,211
583,46,4,3,7,6,-57,33,0,4,190,244
583,47,2,4,7,6,25,42,5,6,215,286
583,48,4,2,7,6,43,-76,8,0,258,210
583,49,4,3,9,4,-55,31,3,1,203,241
583,50,2,4,6,7,24,43,7,4,227,284
583,51,3,4,7,6,-66,42,1,6,161,326
583,52,4,3,5,8,41,-65,2,1,202,261
583,53,4,3,7,6,43,33,5,4,245,294
583,54,5,2,11,2,-44,20,1,4,201,314
583,55,3,3,5,8,32,35,3,9,233,349
583,56,6,2,11,2,65,20,8,9,298,369
583,57,2,4,3,10,21,-54,9,5,319,315
583,58,3,4,6,7,-67,43,2,8,252,358
583,59,3,3,7,6,34,-67,6,1,286,291
583,60,4,3,6,7,42,34,8,5,328,325
583,61,3,3,6,7,-67,34,1,9,261,359
583,62,3,3,7,6,34,-67,5,2,295,292
583,63,5,2,8,5,53,23,8,5,348,315
583,64,2,4,6,7,-76,43,2,8,272,358
583,65,3,3,9,4,36,31,8,9,308,389
583,66,3,5,5,8,-68,-47,0,2,240,342
583,67,2,4,2,11,20,47,0,9,260,389
583,68,2,4,6,7,24,-57,4,2,284,332
583,69,3,3,7,6,34,33,8,5,318,365
583,70,2,4,4,9,-78,-55,0,0,240,310
583,71,2,5,6,7,24,52,4,2,264,362
583,72,5,2,10,3,55,21,9,3,319,383
583,73,2,4,6,7,-76,43,3,6,243,426
583,74,2,4,6,7,24,43,7,9,267,469
583,75,5,2,9,4,-46,-78,1,1,221,391
583,76,4,2,9,4,45,22,6,3,266,413
583,77,4,3,6,7,42,34,8,7,308,447
583,78,2,4,4,9,-78,-55,0,2,230,392
583,79,4,2,11,2,47,20,7,2,277,412
583,80,3,4,6,7,-67,43,0,5,210,455
583,81,3,3,7,6,34,33,4,8,244,488
583,82,2,4,3,10,21,-54,5,4,265,434
583,83,4,2,9,4,-55,22,0,6,210,456
583,84,4,3,7,6,43,33,3,9,253,489
583,85,2,4,3,10,21,-54,4,5,274,435
583,86,2,4,7,6,25,42,9,7,299,477
583,87,3,4,6,7,-67,-57,2,0,232,420
583,88,4,2,8,5,44,23,6,3,276,443
583,89,2,5,3,10,21,55,7,8,297,498
583,90,3,3,5,8,32,-65,9,3,329,433
583,91,4,3,9,4,-55,31,4,4,274,464
583,92,5,2,10,3,55,21,9,5,329,485
583,93,3,3,7,6,-66,33,3,8,263,518
584,1,2,4,7,6,25,42,5,2,25,42
584,2,4,2,6,7,42,25,7,7,67,67
584,3,4,3,5,8,41,-65,8,2,108,2
584,4,3,5,3,10,30,55,8,7,138,57
584,5,4,2,10,3,-54,21,4,8,84,78
584,6,4,3,6,7,42,-66,6,2,126,12
584,7,5,2,9,4,-46,22,0,4,80,34
584,8,4,2,8,5,44,23,4,7,124,57
584,9,3,3,7,6,34,-67,8,0,158,-10
584,10,2,4,5,8,-77,44,1,4,81,34
584,11,4,2,8,5,44,23,5,7,125,57
584,12,2,4,3,10,21,-54,6,3,146,3
584,13,4,2,7,6,43,24,9,7,189,27
584,14,3,3,6,7,-67,-66,2,1,122,-39
584,15,5,2,9,4,54,22,6,3,176,-17
584,16,4,2,10,3,-54,21,2,4,122,4
584,17,4,3,9,4,45,31,7,5,167,35
584,18,6,2,11,2,-35,20,2,5,132,55
584,19,3,3,6,7,33,34,5,9,165,89
584,20,5,2,6,7,51,-75,6,4,216,14
584,21,4,3,5,8,41,35,7,9,257,49
584,22,2,4,3,10,21,-54,8,5,278,-5
584,23,2,5,3,10,21,-45,9,0,299,-50
584,24,5,2,8,5,-47,23,2,3,252,-27
584,25,5,2,11,2,56,20,8,3,308,-7
584,26,3,3,7,6,-66,33,2,6,242,26
584,27,4,3,6,7,42,-66,4,0,284,-40
584,28,3,3,6,7,33,34,7,4,317,-6
584,29,2,4,5,8,-77,44,0,8,240,38
584,30,2,4,4,9,22,-55,2,3,262,-17
584,31,3,3,5,8,32,35,4,8,294,18
584,32,3,3,6,7,33,-66,7,2,327,-48
584,33,2,4,4,9,22,45,9,7,349,-3
584,34,2,5,2,11,20,-44,9,3,369,-47
584,35,4,3,9,4,-55,31,4,4,314,-16
584,36,4,4,6,7,42,43,6,7,356,27
584,37,5,2,9,4,-46,22,0,9,310,49
584,38,2,5,2,11,20,-44,0,5,330,5
584,39,4,3,10,3,46,30,6,5,376,35
584,40,3,5,5,8,32,53,8,8,408,88
584,41,4,3,8,5,-56,-68,2,0,352,20
584,42,4,2,6,7,42,25,4,5,394,45
584,43,3,3,7,6,34,33,8,8,428,78
584,44,2,4,7,6,-75,-58,3,0,353,20
584,45,4,2,10,3,46,21,9,1,399,41
584,46,3,4,4,9,-69,45,0,6,330,86
584,47,4,4,9,4,45,40,5,6,375,126
584,48,5,2,7,6,52,-76,7,0,427,50
584,49,3,3,10,3,-63,30,4,0,364,80
584,50,3,3,5,8,32,35,6,5,396,115
584,51,2,4,7,6,-75,42,1,7,321,157
584,52,3,3,8,5,35,32,6,9,356,189
584,53,4,2,9,4,-55,-78,1,1,301,111
584,54,3,3,5,8,32,35,3,6,333,146
584,55,3,4,8,5,35,41,8,7,368,187
584,56,3,4,6,7,-67,-57,1,0,301,130
584,57,3,4,7,6,34,42,5,2,335,172
584,58,2,4,6,7,24,43,9,5,359,215
584,59,5,2,9,4,-46,22,3,7,313,237
584,60,4,2,8,5,44,-77,7,0,357,160
584,61,2,4,6,7,-76,43,1,3,281,203
584,62,2,4,5,8,23,44,4,7,304,247
584,63,4,4,7,6,43,42,7,9,347,289
584,64,4,2,8,5,-56,-77,1,2,291,212
584,65,5,3,9,4,54,31,5,3,345,243
584,66,3,4,8,5,-65,41,0,4,280,284
584,67,4,2,8,5,44,23,4,7,324,307
584,68,3,3,7,6,34,-67,8,0,358,240
584,69,4,3,5,8,41,35,9,5,399,275
584,70,3,3,8,5,-65,32,4,7,334,307
584,71,5,2,9,4,54,22,8,9,388,329
584,72,2,5,4,9,-78,-46,0,3,310,283
584,73,4,2,8,5,44,23,4,6,354,306
584,74,4,3,9,4,45,31,9,7,399,337
584,75,5,3,9,4,-46,31,3,8,353,368
584,76,3,3,5,8,32,-65,5,3,385,303
584,77,4,3,9,4,-55,31,0,4,330,334
584,78,4,2,8,5,44,23,4,7,374,357
584,79,4,3,8,5,44,32,8,9,418,389
584,80,2,4,4,9,-78,-55,0,4,340,334
584,81,3,3,9,4,36,31,6,5,376,365
584,82,4,2,9,4,-55,22,1,7,321,387
584,83,3,4,7,6,34,42,5,9,355,429
584,84,3,4,4,9,31,-55,6,4,386,374
584,85,2,4,5,8,23,44,9,8,409,418
584,86,4,2,9,4,-55,-78,4,0,354,340
584,87,2,5,5,8,23,53,7,3,377,393
584,88,3,4,4,9,31,45,8,8,408,438
584,89,2,4,4,9,-78,-55,0,3,330,383
584,90,4,3,10,3,46,30,6,3,376,413
584,91,4,2,9,4,-55,22,1,5,321,435
584,92,2,5,6,7,24,52,5,7,345,487
584,93,2,6,3,10,21,-36,6,1,366,451
584,94,3,3,7,6,-66,33,0,4,300,484
584,95,3,4,7,6,34,42,4,6,334,526
585,1,5,2,8,5,53,23,3,3,53,23
585,2,3,3,7,6,34,33,7,6,87,56
585,3,2,5,4,9,22,-46,9,0,109,10
585,4,3,3,7,6,-66,33,3,3,43,43
585,5,4,2,10,3,46,21,9,4,89,64
585,6,4,2,6,7,-58,25,1,9,31,89
585,7,2,6,2,11,20,-35,1,4,51,54
585,8,3,4,3,10,30,-54,1,0,81,0
585,9,4,2,8,5,44,23,5,3,125,23
585,10,3,3,9,4,-64,31,1,4,61,54
585,11,3,3,7,6,34,33,5,7,95,87
585,12,3,3,6,7,33,-66,8,1,128,21
585,13,2,4,6,7,-76,43,2,4,52,64
585,14,4,3,6,7,42,34,4,8,94,98
585,15,3,3,3,10,30,-63,4,5,124,35
585,16,4,2,9,4,45,22,9,7,169,57
585,17,3,3,4,9,-69,-64,0,3,100,-7
585,18,2,4,3,10,21,46,1,9,121,39
585,19,3,4,7,6,34,-58,5,1,155,-19
585,20,4,3,7,6,43,33,8,4,198,14
585,21,2,6,3,10,21,64,9,8,219,78
585,22,5,2,8,5,-47,-77,2,1,172,1
585,23,5,2,8,5,53,23,5,4,225,24
585,24,4,3,6,7,42,34,7,8,267,58
585,25,4,3,7,6,-57,-67,0,1,210,-9
585,26,2,4,3,10,21,46,1,7,231,37
585,27,3,3,9,4,36,31,7,8,267,68
585,28,3,3,6,7,-67,-66,0,2,200,2
585,29,2,4,4,9,22,45,2,7,222,47
585,30,5,2,10,3,55,21,7,8,277,68
585,31,2,4,8,5,-74,41,3,9,203,109
585,32,2,4,5,8,23,-56,6,3,226,53
585,33,3,3,5,8,32,35,8,8,258,88
585,34,3,4,6,7,-67,-57,1,1,191,31
585,35,5,2,11,2,56,20,7,1,247,51
585,36,3,4,7,6,-66,42,1,3,181,93
585,37,3,3,9,4,36,31,7,4,217,124
585,38,5,2,8,5,-47,23,0,7,170,147
585,39,4,4,6,7,42,-57,2,0,212,90
585,40,5,3,6,7,51,34,3,4,263,124
585,41,3,3,5,8,32,35,5,9,295,159
585,42,3,4,7,6,34,-58,9,1,329,101
585,43,3,4,7,6,-66,42,3,3,263,143
585,44,3,4,4,9,31,45,4,8,294,188
585,45,2,4,5,8,23,-56,7,2,317,132
585,46,3,4,4,9,31,45,8,7,348,177
585,47,2,5,3,10,21,-45,9,2,369,132
585,48,2,6,2,11,20,65,9,7,389,197
585,49,3,4,8,5,-65,41,4,8,324,238
585,50,3,3,6,7,33,-66,7,2,357,172
585,51,3,4,5,8,32,44,9,6,389,216
585,52,4,3,7,6,-57,33,2,9,332,249
585,53,3,3,7,6,34,-67,6,2,366,182
585,54,3,4,6,7,33,43,9,5,399,225
585,55,5,3,6,7,-49,34,0,9,350,259
585,56,3,3,5,8,32,-65,2,4,382,194
585,57,2,4,6,7,24,43,6,7,406,237
585,58,5,2,9,4,-46,22,0,9,360,259
585,59,5,2,9,4,54,-78,4,1,414,181
585,60,4,3,9,4,45,31,9,2,459,212
585,61,3,3,7,6,-66,33,3,5,393,245
585,62,3,4,6,7,33,43,6,8,426,288
585,63,3,4,4,9,31,-55,7,3,457,233
585,64,3,4,5,8,32,44,9,7,489,277
585,65,3,4,9,4,-64,40,5,7,425,317
585,66,2,4,7,6,-75,42,0,9,350,359
585,67,2,5,4,9,22,-46,2,3,372,313
585,68,4,3,9,4,45,31,7,4,417,344
585,69,5,2,9,4,-46,22,1,6,371,366
585,70,2,5,2,11,20,-44,1,2,391,322
585,71,5,2,8,5,53,23,4,5,444,345
585,72,3,3,6,7,33,34,7,9,477,379
585,73,2,5,5,8,-77,-47,0,2,400,332
585,74,4,2,7,6,43,24,3,6,443,356
585,75,2,4,4,9,22,-55,5,1,465,301
585,76,4,3,8,5,44,32,9,3,509,333
586,1,3,3,6,7,33,34,3,4,33,34
586,2,3,3,9,4,36,31,9,5,69,65
586,3,2,5,3,10,-79,-45,0,0,-10,20
586,4,4,3,7,6,43,33,3,3,33,53
586,5,5,2,9,4,54,22,7,5,87,75
586,6,5,2,7,6,52,24,9,9,139,99
586,7,3,3,8,5,-65,-68,4,1,74,31
586,8,2,5,5,8,23,53,7,4,97,84
586,9,5,2,10,3,-45,21,2,5,52,105
586,10,3,3,7,6,34,33,6,8,86,138
586,11,2,5,4,9,22,-46,8,2,108,92
586,12,4,3,7,6,-57,33,1,5,51,125
586,13,4,2,8,5,44,23,5,8,95,148
586,14,3,3,6,7,33,-66,8,2,128,82
586,15,3,3,3,10,30,37,8,9,158,119
586,16,3,3,7,6,-66,-67,2,2,92,52
586,17,3,4,6,7,33,43,5,5,125,95
586,18,3,3,8,5,-65,32,0,7,60,127
586,19,4,2,7,6,43,-76,3,1,103,51
586,20,3,3,9,4,36,31,9,2,139,82
586,21,5,2,7,6,-48,24,1,6,91,106
586,22,3,3,7,6,34,33,5,9,125,139
586,23,3,4,6,7,33,-57,8,2,158,82
586,24,5,2,9,4,-46,22,2,4,112,104
586,25,2,4,5,8,23,44,5,8,135,148
586,26,4,2,9,4,-55,-78,0,0,80,70
586,27,4,2,10,3,46,21,6,1,126,91
586,28,5,2,10,3,-45,21,1,2,81,112
586,29,4,3,7,6,43,33,4,5,124,145
586,30,3,3,6,7,33,34,7,9,157,179
586,31,5,3,8,5,-47,-68,0,1,110,111
586,32,3,3,6,7,33,34,3,5,143,145
586,33,4,3,10,3,46,30,9,5,189,175
586,34,3,4,7,6,-66,42,3,7,123,217
586,35,4,3,5,8,41,-65,4,2,164,152
586,36,2,5,4,9,22,54,6,6,186,206
586,37,4,2,6,7,42,-75,8,1,228,131
586,38,4,2,8,5,-56,23,2,4,172,154
586,39,3,3,5,8,32,35,4,9,204,189
586,40,4,2,11,2,-53,20,1,9,151,209
586,41,2,4,8,5,26,-59,7,0,177,150
586,42,3,4,6,7,-67,43,0,3,110,193
586,43,3,5,6,7,33,52,3,5,143,245
586,44,4,2,6,7,42,-75,5,0,185,170
586,45,3,5,6,7,33,52,8,2,218,222
586,46,3,3,8,5,-65,32,3,4,153,254
586,47,2,4,5,8,23,44,6,8,176,298
586,48,3,3,7,6,-66,-67,0,1,110,231
586,49,4,3,8,5,44,32,4,3,154,263
586,50,4,2,8,5,44,23,8,6,198,286
586,51,4,3,6,7,-58,-66,0,0,140,220
586,52,3,4,7,6,34,42,4,2,174,262
586,53,4,2,7,6,43,24,7,6,217,286
586,54,4,2,7,6,-57,-76,0,0,160,210
586,55,2,5,6,7,24,52,4,2,184,262
586,56,3,3,8,5,35,32,9,4,219,294
586,57,4,3,5,8,-59,35,0,9,160,329
586,58,4,3,5,8,41,-65,1,4,201,264
586,59,5,2,8,5,53,23,4,7,254,287
586,60,5,2,10,3,55,21,9,8,309,308
586,61,4,3,10,3,-54,30,5,8,255,338
586,62,4,3,6,7,42,-66,7,2,297,272
586,63,5,2,8,5,-47,23,0,5,250,295
586,64,4,3,7,6,43,33,3,8,293,328
586,65,2,5,5,8,23,-47,6,1,316,281
586,66,4,2,6,7,42,25,8,6,358,306
586,67,2,4,4,9,-78,-55,0,1,280,251
586,68,2,5,3,10,21,55,1,6,301,306
586,69,4,2,8,5,44,23,5,9,345,329
586,70,4,2,11,2,-53,20,2,9,292,349
586,71,2,4,4,9,22,-55,4,4,314,294
586,72,2,5,4,9,22,54,6,8,336,348
586,73,3,5,5,8,32,-47,8,1,368,301
586,74,3,3,5,8,-68,35,0,6,300,336
586,75,2,5,2,11,20,-44,0,2,320,292
586,76,3,4,7,6,34,42,4,4,354,334
586,77,2,5,3,10,21,55,5,9,375,389
586,78,3,4,7,6,34,-58,9,1,409,331
586,79,5,2,9,4,-46,22,3,3,363,353
586,80,5,2,7,6,52,24,5,7,415,377
586,81,5,2,9,4,54,22,9,9,469,399
586,82,3,3,7,6,-66,-67,3,2,403,332
586,83,2,5,3,10,21,55,4,7,424,387
586,84,2,4,6,7,24,-57,8,0,448,330
586,85,5,2,10,3,-45,21,3,1,403,351
586,86,3,3,6,7,33,34,6,5,436,385
586,87,4,3,8,5,-56,32,0,7,380,417
586,88,4,2,7,6,43,-76,3,1,423,341
586,89,3,3,9,4,36,31,9,2,459,372
586,90,5,2,9,4,-46,22,3,4,413,394
586,91,4,3,8,5,44,32,7,6,457,426
586,92,3,4,3,10,30,-54,7,2,487,372
586,93,4,3,7,6,-57,33,0,5,430,405
586,94,4,2,9,4,45,22,5,7,475,427
586,95,4,2,7,6,43,-76,8,1,518,351
587,1,3,4,8,5,35,41,5,1,35,41
587,2,3,3,10,3,-63,30,2,1,-28,71
587,3,2,5,3,10,21,55,3,6,-7,126
587,4,4,2,10,3,46,21,9,7,39,147
587,5,4,2,7,6,-57,-76,2,1,-18,71
587,6,3,3,7,6,34,33,6,4,16,104
587,7,3,3,7,6,-66,33,0,7,-50,137
587,8,2,4,8,5,26,41,6,8,-24,178
587,9,4,3,7,6,43,-67,9,1,19,111
587,10,4,3,8,5,-56,32,3,3,-37,143
587,11,4,2,10,3,46,21,9,4,9,164
587,12,4,3,8,5,-56,32,3,6,-47,196
587,13,3,4,4,9,31,-55,4,1,-16,141
587,14,5,2,10,3,55,21,9,2,39,162
587,15,4,3,7,6,-57,33,2,5,-18,195
587,16,3,3,8,5,35,32,7,7,17,227
587,17,2,4,6,7,-76,-57,1,0,-59,170
587,18,4,3,10,3,46,30,7,0,-13,200
587,19,4,2,8,5,-56,23,1,3,-69,223
587,20,2,5,5,8,23,53,4,6,-46,276
587,21,3,3,8,5,35,32,9,8,-11,308
587,22,2,5,4,9,-78,-46,1,2,-89,262
587,23,2,5,3,10,21,55,2,7,-68,317
587,24,3,3,7,6,34,-67,6,0,-34,250
587,25,3,3,4,9,31,36,7,6,-3,286
587,26,4,2,9,4,-55,22,2,8,-58,308
587,27,3,4,5,8,32,-56,4,2,-26,252
587,28,5,2,9,4,54,22,8,4,28,274
587,29,2,5,7,6,-75,51,3,5,-47,325
587,30,3,3,6,7,33,34,6,9,-14,359
587,31,2,6,3,10,21,-36,7,3,7,323
587,32,3,3,7,6,-66,33,1,6,-59,356
587,33,4,2,10,3,46,21,7,7,-13,377
587,34,2,5,4,9,22,-46,9,1,9,331
587,35,3,4,4,9,-69,45,0,6,-60,376
587,36,5,2,10,3,55,21,5,7,-5,397
587,37,5,2,10,3,-45,21,0,8,-50,418
587,38,3,3,5,8,32,-65,2,3,-18,353
587,39,5,2,7,6,52,24,4,7,34,377
587,40,4,3,8,5,44,32,8,9,78,409
587,41,3,3,6,7,-67,-66,1,3,11,343
587,42,2,4,4,9,22,45,3,8,33,388
587,43,3,4,5,8,32,-56,5,2,65,332
587,44,2,6,3,10,21,64,6,6,86,396
587,45,3,4,7,6,-66,42,0,8,20,438
587,46,5,2,10,3,55,21,5,9,75,459
587,47,3,5,6,7,33,-48,8,1,108,411
587,48,2,5,2,11,20,56,8,7,128,467
587,49,3,4,6,7,-67,-57,1,0,61,410
587,50,3,3,10,3,37,30,8,0,98,440
587,51,5,2,11,2,-44,20,4,0,54,460
587,52,3,3,5,8,32,35,6,5,86,495
587,53,3,4,6,7,33,43,9,8,119,538
588,1,2,5,6,7,24,52,4,2,24,52
588,2,4,2,9,4,45,22,9,4,69,74
588,3,3,4,5,8,-68,44,1,8,1,118
588,4,3,3,8,5,35,-68,6,0,36,50
588,5,4,2,7,6,43,24,9,4,79,74
588,6,5,2,9,4,-46,22,3,6,33,96
588,7,4,3,8,5,44,32,7,8,77,128
588,8,4,2,7,6,-57,-76,0,2,20,52
588,9,4,3,7,6,43,33,3,5,63,85
588,10,3,3,9,4,36,31,9,6,99,116
588,11,5,2,9,4,-46,22,3,8,53,138
588,12,2,5,3,10,21,-45,4,3,74,93
588,13,4,3,6,7,42,34,6,7,116,127
588,14,3,3,8,5,-65,32,1,9,51,159
588,15,3,3,7,6,34,-67,5,2,85,92
588,16,4,2,8,5,44,23,9,5,129,115
588,17,4,2,6,7,-58,-75,1,0,71,40
588,18,4,4,6,7,42,43,3,3,113,83
588,19,4,3,7,6,43,33,6,6,156,116
588,20,4,3,9,4,-55,31,1,7,101,147
588,21,3,4,7,6,34,42,5,9,135,189
588,22,3,4,4,9,31,-55,6,4,166,134
588,23,4,3,5,8,41,35,7,9,207,169
588,24,3,3,5,8,32,-65,9,4,239,104
588,25,4,3,7,6,-57,33,2,7,182,137
588,26,4,2,7,6,43,-76,5,1,225,61
588,27,3,4,6,7,33,43,8,4,258,104
588,28,3,3,5,8,-68,35,0,9,190,139
588,29,5,2,11,2,56,20,6,9,246,159
588,30,2,5,2,11,20,-44,6,5,266,115
588,31,2,5,4,9,22,54,8,9,288,169
588,32,3,3,5,8,-68,-65,0,4,220,104
588,33,5,3,8,5,53,32,3,6,273,136
588,34,3,5,6,7,33,52,6,8,306,188
588,35,2,5,4,9,22,-46,8,2,328,142
588,36,4,3,8,5,-56,32,2,4,272,174
588,37,2,5,5,8,23,53,5,7,295,227
588,38,3,4,5,8,32,-56,7,1,327,171
588,39,3,3,5,8,32,35,9,6,359,206
588,40,4,3,7,6,-57,33,2,9,302,239
588,41,3,3,8,5,35,-68,7,1,337,171
588,42,2,4,7,6,-75,42,2,3,262,213
588,43,3,3,8,5,35,32,7,5,297,245
588,44,5,2,9,4,-46,22,1,7,251,267
588,45,3,4,5,8,32,-56,3,1,283,211
588,46,6,2,10,3,64,21,7,2,347,232
588,47,5,2,10,3,-45,21,2,3,302,253
588,48,3,3,8,5,35,32,7,5,337,285
588,49,3,4,5,8,32,44,9,9,369,329
588,50,2,5,4,9,-78,-46,1,3,291,283
588,51,3,4,6,7,33,43,4,6,324,326
588,52,4,3,6,7,42,-66,6,0,366,260
588,53,2,5,4,9,22,54,8,4,388,314
588,54,5,2,10,3,-45,21,3,5,343,335
588,55,5,2,10,3,55,21,8,6,398,356
588,56,2,4,6,7,-76,43,2,9,322,399
588,57,3,4,4,9,31,-55,3,4,353,344
588,58,4,3,9,4,45,31,8,5,398,375
588,59,2,4,6,7,-76,43,2,8,322,418
588,60,4,3,9,4,45,31,7,9,367,449
588,61,3,3,6,7,-67,-66,0,3,300,383
588,62,3,3,7,6,34,33,4,6,334,416
588,63,3,4,4,9,31,-55,5,1,365,361
588,64,2,5,3,10,21,55,6,6,386,416
588,65,3,3,7,6,-66,33,0,9,320,449
588,66,3,4,4,9,31,-55,1,4,351,394
588,67,3,4,4,9,31,45,2,9,382,439
588,68,2,4,3,10,21,-54,3,5,403,385
588,69,4,2,8,5,44,23,7,8,447,408
588,70,5,2,10,3,-45,21,2,9,402,429
588,71,3,4,5,8,32,-56,4,3,434,373
588,72,4,3,6,7,42,34,6,7,476,407
588,73,4,2,9,4,-55,22,1,9,421,429
588,74,2,4,7,6,25,-58,6,1,446,371
588,75,4,2,10,3,-54,21,2,2,392,392
588,76,3,4,6,7,33,43,5,5,425,435
588,77,2,4,4,9,22,-55,7,0,447,380
588,78,4,3,9,4,-55,31,2,1,392,411
588,79,3,3,5,8,32,35,4,6,424,446
588,80,4,4,7,6,43,42,7,8,467,488
588,81,4,2,8,5,-56,-77,1,1,411,411
588,82,4,3,8,5,44,32,5,3,455,443
588,83,4,2,8,5,44,23,9,6,499,466
588,84,3,3,7,6,-66,33,3,9,433,499
588,85,4,2,9,4,45,-78,8,1,478,421
588,86,5,2,9,4,-46,22,2,3,432,443
588,87,3,4,5,8,32,44,4,7,464,487
588,88,3,4,7,6,34,42,8,9,498,529
589,1,4,3,6,7,42,34,2,4,42,34
589,2,5,2,10,3,55,21,7,5,97,55
589,3,2,4,5,8,-77,44,0,9,20,99
589,4,3,4,7,6,34,-58,4,1,54,41
589,5,3,4,5,8,32,44,6,5,86,85
589,6,2,4,2,11,20,-53,6,2,106,32
589,7,2,4,3,10,21,46,7,8,127,78
589,8,2,5,4,9,22,-46,9,2,149,32
589,9,6,2,10,3,-36,21,3,3,113,53
589,10,2,4,3,10,21,46,4,9,134,99
589,11,2,5,4,9,22,-46,6,3,156,53
589,12,2,4,4,9,22,45,8,8,178,98
589,13,5,2,9,4,-46,-78,2,0,132,20
589,14,4,3,7,6,43,33,5,3,175,53
589,15,2,5,5,8,23,53,8,6,198,106
589,16,4,3,6,7,-58,-66,0,0,140,40
589,17,4,2,8,5,44,23,4,3,184,63
589,18,5,2,8,5,53,23,7,6,237,86
589,19,3,4,6,7,-67,43,0,9,170,129
589,20,3,3,6,7,33,-66,3,3,203,63
589,21,4,3,10,3,46,30,9,3,249,93
589,22,2,5,3,10,-79,55,0,8,170,148
589,23,2,5,4,9,22,-46,2,2,192,102
589,24,4,3,8,5,44,32,6,4,236,134
589,25,3,4,7,6,-66,42,0,6,170,176
589,26,3,4,6,7,33,43,3,9,203,219
589,27,4,3,8,5,44,-68,7,1,247,151
589,28,3,4,7,6,-66,42,1,3,181,193
589,29,4,3,7,6,43,33,4,6,224,226
589,30,4,3,7,6,43,33,7,9,267,259
589,31,2,5,3,10,21,-45,8,4,288,214
589,32,4,2,9,4,-55,22,3,6,233,236
589,33,3,4,7,6,34,42,7,8,267,278
589,34,2,4,6,7,-76,-57,1,1,191,221
589,35,3,3,4,9,31,36,2,7,222,257
589,36,2,4,6,7,24,-57,6,0,246,200
589,37,2,5,4,9,22,54,8,4,268,254
589,38,4,2,5,8,41,-74,9,0,309,180
589,39,3,3,6,7,-67,34,2,4,242,214
589,40,4,3,6,7,42,34,4,8,284,248
589,41,2,4,6,7,24,-57,8,1,308,191
589,42,4,4,7,6,-57,42,1,3,251,233
589,43,2,5,4,9,22,54,3,7,273,287
589,44,2,4,2,11,20,-53,3,4,293,234
589,45,3,3,7,6,34,33,7,7,327,267
589,46,3,3,8,5,-65,32,2,9,262,299
589,47,4,3,6,7,42,-66,4,3,304,233
589,48,4,2,7,6,43,24,7,7,347,257
589,49,2,5,2,11,20,-44,7,3,367,213
589,50,4,2,9,4,-55,22,2,5,312,235
589,51,3,4,8,5,35,41,7,6,347,276
589,52,3,4,4,9,31,-55,8,1,378,221
589,53,4,3,9,4,-55,31,3,2,323,252
589,54,6,2,11,2,65,20,8,2,388,272
589,55,6,2,9,4,-37,22,1,4,351,294
589,56,4,2,9,4,45,22,6,6,396,316
589,57,4,3,8,5,-56,32,0,8,340,348
589,58,4,2,6,7,42,-75,2,3,382,273
589,59,3,4,5,8,32,44,4,7,414,317
589,60,2,5,3,10,21,-45,5,2,435,272
589,61,6,2,8,5,62,23,7,5,497,295
589,62,6,2,9,4,-37,22,0,7,460,317
589,63,3,4,6,7,33,-57,3,0,493,260
589,64,4,2,9,4,45,22,8,2,538,282
590,1,3,4,7,6,34,42,4,2,34,42
590,2,3,3,5,8,32,35,6,7,66,77
590,3,4,3,7,6,43,-67,9,0,109,10
590,4,4,3,8,5,-56,32,3,2,53,42
590,5,2,4,4,9,22,45,5,7,75,87
590,6,4,3,7,6,43,-67,8,0,118,20
590,7,3,3,8,5,-65,32,3,2,53,52
590,8,2,4,6,7,24,43,7,5,77,95
590,9,3,4,4,9,31,-55,8,0,108,40
590,10,4,2,7,6,-57,24,1,4,51,64
590,11,2,5,5,8,23,53,4,7,74,117
590,12,3,3,7,6,34,-67,8,0,108,50
590,13,2,4,7,6,-75,42,3,2,33,92
590,14,3,3,6,7,33,34,6,6,66,126
590,15,3,3,7,6,-66,33,0,9,0,159
590,16,3,4,7,6,34,-58,4,1,34,101
590,17,3,3,7,6,34,33,8,4,68,134
590,18,5,2,9,4,-46,22,2,6,22,156
590,19,4,3,6,7,42,-66,4,0,64,90
590,20,2,4,4,9,22,45,6,5,86,135
590,21,2,5,3,10,21,-45,7,0,107,90
590,22,3,3,4,9,31,36,8,6,138,126
590,23,3,3,3,10,30,-63,8,3,168,63
590,24,3,3,6,7,-67,34,1,7,101,97
590,25,3,4,7,6,34,42,5,9,135,139
590,26,4,3,7,6,43,-67,8,2,178,72
590,27,4,2,6,7,-58,25,0,7,120,97
590,28,3,3,3,10,30,-63,0,4,150,34
590,29,4,3,8,5,44,32,4,6,194,66
590,30,2,4,5,8,23,-56,7,0,217,10
590,31,4,2,7,6,-57,24,0,4,160,34
590,32,4,2,8,5,44,23,4,7,204,57
590,33,5,2,9,4,54,22,8,9,258,79
590,34,3,3,6,7,-67,-66,1,3,191,13
590,35,4,3,8,5,44,32,5,5,235,45
590,36,3,5,6,7,33,52,8,7,268,97
590,37,3,3,7,6,-66,-67,2,0,202,30
590,38,5,2,9,4,54,22,6,2,256,52
590,39,2,5,5,8,23,53,9,5,279,105
590,40,4,3,9,4,-55,31,4,6,224,136
590,41,4,2,7,6,43,-76,7,0,267,60
590,42,4,2,10,3,-54,21,3,1,213,81
590,43,3,3,8,5,35,32,8,3,248,113
590,44,4,3,8,5,-56,32,2,5,192,145
590,45,3,4,6,7,33,43,5,8,225,188
590,46,4,3,9,4,-55,31,0,9,170,219
590,47,3,4,6,7,33,-57,3,2,203,162
590,48,4,4,5,8,41,44,4,6,244,206
590,49,5,3,9,4,54,31,8,7,298,237
590,50,2,4,4,9,-78,-55,0,2,220,182
590,51,3,4,5,8,32,44,2,6,252,226
590,52,2,4,6,7,24,43,6,9,276,269
590,53,3,5,6,7,33,-48,9,1,309,221
590,54,4,2,10,3,-54,21,5,2,255,242
590,55,2,4,4,9,22,45,7,7,277,287
590,56,4,2,11,2,-53,20,4,7,224,307
590,57,3,4,7,6,34,42,8,9,258,349
590,58,3,3,4,9,31,-64,9,5,289,285
590,59,5,2,9,4,-46,22,3,7,243,307
590,60,3,3,6,7,33,-66,6,1,276,241
590,61,2,5,4,9,22,54,8,5,298,295
590,62,2,4,7,6,-75,42,3,7,223,337
590,63,4,2,7,6,43,-76,6,1,266,261
590,64,3,4,6,7,33,43,9,4,299,304
590,65,3,5,5,8,-68,53,1,7,231,357
590,66,3,3,7,6,34,-67,5,0,265,290
590,67,2,4,8,5,-74,41,1,1,191,331
590,68,4,3,10,3,46,30,7,1,237,361
590,69,2,6,2,11,20,65,7,6,257,426
590,70,5,2,11,2,-44,20,3,6,213,446
590,71,5,2,9,4,54,22,7,8,267,468
590,72,3,5,4,9,31,-46,8,2,298,422
590,73,3,3,7,6,-66,33,2,5,232,455
590,74,4,2,5,8,41,-74,3,1,273,381
590,75,4,3,8,5,44,32,7,3,317,413
590,76,5,2,10,3,-45,21,2,4,272,434
590,77,3,4,4,9,31,45,3,9,303,479
590,78,5,2,9,4,54,-78,7,1,357,401
590,79,2,4,6,7,-76,43,1,4,281,444
590,80,5,2,8,5,53,23,4,7,334,467
590,81,3,4,6,7,33,-57,7,0,367,410
590,82,2,4,4,9,22,45,9,5,389,455
590,83,4,2,8,5,-56,23,3,8,333,478
590,84,4,3,9,4,45,31,8,9,378,509
591,1,2,4,5,8,23,44,3,4,23,44
591,2,3,4,7,6,34,42,7,6,57,86
591,3,2,5,6,7,-76,52,1,8,-19,138
591,4,2,4,8,5,26,41,7,9,7,179
591,5,3,4,7,6,-66,-58,1,1,-59,121
591,6,3,4,7,6,34,42,5,3,-25,163
591,7,4,3,7,6,43,33,8,6,18,196
591,8,3,4,4,9,31,-55,9,1,49,141
591,9,3,3,7,6,-66,33,3,4,-17,174
591,10,3,3,7,6,34,33,7,7,17,207
591,11,2,4,5,8,-77,-56,0,1,-60,151
591,12,4,2,7,6,43,24,3,5,-17,175
591,13,2,4,5,8,23,44,6,9,6,219
591,14,3,4,3,10,30,-54,6,5,36,165
591,15,4,4,5,8,41,44,7,9,77,209
591,16,3,3,7,6,-66,-67,1,2,11,142
591,17,6,2,11,2,65,20,6,2,76,162
591,18,3,3,6,7,33,34,9,6,109,196
591,19,4,2,9,4,-55,22,4,8,54,218
591,20,6,2,10,3,64,21,8,9,118,239
591,21,2,4,7,6,-75,-58,3,1,43,181
591,22,5,2,8,5,53,23,6,4,96,204
591,23,3,4,5,8,32,44,8,8,128,248
591,24,2,4,5,8,-77,-56,1,2,51,192
591,25,3,3,7,6,34,33,5,5,85,225
591,26,5,2,8,5,53,23,8,8,138,248
591,27,4,3,8,5,-56,-68,2,0,82,180
591,28,3,3,6,7,33,34,5,4,115,214
591,29,4,3,10,3,-54,30,1,4,61,244
591,30,4,2,8,5,44,23,5,7,105,267
591,31,2,6,3,10,21,-36,6,1,126,231
591,32,3,3,8,5,-65,32,1,3,61,263
591,33,5,2,10,3,55,21,6,4,116,284
591,34,2,5,6,7,-76,52,0,6,40,336
591,35,6,2,9,4,63,22,3,8,103,358
591,36,3,3,5,8,32,-65,5,3,135,293
591,37,3,3,8,5,-65,32,0,5,70,325
591,38,3,3,7,6,34,33,4,8,104,358
591,39,2,5,5,8,23,-47,7,1,127,311
591,40,4,3,8,5,-56,32,1,3,71,343
591,41,3,4,7,6,34,42,5,5,105,385
591,42,4,3,6,7,42,34,7,9,147,419
591,43,3,3,4,9,31,-64,8,5,178,355
591,44,2,4,5,8,-77,44,1,9,101,399
591,45,3,3,6,7,33,-66,4,3,134,333
591,46,2,5,3,10,21,55,5,8,155,388
591,47,4,3,8,5,44,-68,9,0,199,320
591,48,2,5,5,8,-77,53,2,3,122,373
591,49,6,2,10,3,64,21,6,4,186,394
591,50,3,4,4,9,31,45,7,9,217,439
591,51,2,4,3,10,21,-54,8,5,238,385
591,52,4,2,7,6,-57,24,1,9,181,409
591,53,5,2,9,4,54,-78,5,1,235,331
591,54,4,3,6,7,42,34,7,5,277,365
591,55,4,3,7,6,-57,33,0,8,220,398
591,56,3,3,4,9,31,-64,1,4,251,334
591,57,4,3,5,8,41,35,2,9,292,369
591,58,2,5,3,10,21,-45,3,4,313,324
591,59,3,4,6,7,33,43,6,7,346,367
591,60,2,5,4,9,22,-46,8,1,368,321
591,61,4,3,7,6,-57,33,1,4,311,354
591,62,4,3,6,7,42,34,3,8,353,388
591,63,2,5,7,6,25,51,8,9,378,439
591,64,2,5,4,9,-78,-46,0,3,300,393
591,65,5,2,10,3,55,21,5,4,355,414
591,66,2,4,6,7,24,43,9,7,379,457
591,67,4,2,6,7,-58,-75,1,2,321,382
591,68,5,2,9,4,54,22,5,4,375,404
591,69,5,2,9,4,54,22,9,6,429,426
591,70,2,6,5,8,-77,62,2,8,352,488
591,71,3,4,5,8,32,-56,4,2,384,432
591,72,2,5,6,7,24,52,8,4,408,484
591,73,3,3,9,4,-64,31,4,5,344,515
592,1,4,2,8,5,44,23,4,3,44,23
592,2,4,3,6,7,42,34,6,7,86,57
592,3,4,3,7,6,43,-67,9,0,129,-10
592,4,4,3,7,6,-57,33,2,3,72,23
592,5,3,4,5,8,32,44,4,7,104,67
592,6,3,3,8,5,35,32,9,9,139,99
592,7,2,5,4,9,-78,-46,1,3,61,53
592,8,4,3,9,4,45,31,6,4,106,84
592,9,4,2,8,5,-56,23,0,7,50,107
592,10,3,3,8,5,35,32,5,9,85,139
592,11,5,2,8,5,53,-77,8,2,138,62
592,12,2,4,4,9,-78,45,0,7,60,107
592,13,3,3,7,6,34,-67,4,0,94,40
592,14,2,5,6,7,24,52,8,2,118,92
592,15,2,5,7,6,-75,51,3,3,43,143
592,16,4,3,10,3,46,30,9,3,89,173
592,17,4,3,10,3,-54,30,5,3,35,203
592,18,4,2,10,3,-54,21,1,4,-19,224
592,19,4,2,5,8,41,-74,2,0,22,150
592,20,4,3,7,6,43,33,5,3,65,183
592,21,3,3,6,7,33,34,8,7,98,217
592,22,5,2,10,3,-45,21,3,8,53,238
592,23,2,6,4,9,22,-37,5,1,75,201
592,24,4,2,8,5,44,23,9,4,119,224
592,25,3,4,6,7,-67,43,2,7,52,267
592,26,4,2,9,4,45,22,7,9,97,289
592,27,3,4,4,9,31,-55,8,4,128,234
592,28,3,3,9,4,-64,31,4,5,64,265
592,29,5,2,7,6,52,24,6,9,116,289
592,30,4,3,8,5,-56,-68,0,1,60,221
592,31,3,4,5,8,32,44,2,5,92,265
592,32,5,3,5,8,50,-65,2,0,142,200
592,33,4,4,5,8,41,44,3,4,183,244
592,34,3,3,9,4,36,31,9,5,219,275
592,35,2,4,7,6,-75,42,4,7,144,317
592,36,3,3,6,7,33,-66,7,1,177,251
592,37,4,2,5,8,41,26,8,7,218,277
592,38,2,5,2,11,20,-44,8,3,238,233
592,39,2,5,4,9,-78,54,0,7,160,287
592,40,3,4,4,9,31,-55,1,2,191,232
592,41,3,4,5,8,32,44,3,6,223,276
592,42,3,3,7,6,34,33,7,9,257,309
592,43,3,3,7,6,-66,-67,1,2,191,242
592,44,3,3,7,6,34,33,5,5,225,275
592,45,3,4,6,7,33,43,8,8,258,318
592,46,2,4,5,8,-77,-56,1,2,181,262
592,47,5,2,9,4,54,22,5,4,235,284
592,48,3,4,7,6,34,42,9,6,269,326
592,49,3,4,4,9,-69,-55,0,1,200,271
592,50,5,2,8,5,53,23,3,4,253,294
592,51,2,4,7,6,25,42,8,6,278,336
592,52,2,4,5,8,-77,-56,1,0,201,280
592,53,3,4,4,9,31,45,2,5,232,325
592,54,2,4,2,11,20,-53,2,2,252,272
592,55,2,4,7,6,25,42,7,4,277,314
592,56,3,3,5,8,32,35,9,9,309,349
592,57,5,3,8,5,-47,-68,2,1,262,281
592,58,2,5,5,8,23,53,5,4,285,334
592,59,4,2,9,4,-55,22,0,6,230,356
592,60,4,3,5,8,41,-65,1,1,271,291
592,61,2,4,5,8,23,44,4,5,294,335
592,62,4,2,6,7,42,-75,6,0,336,260
592,63,3,3,6,7,33,34,9,4,369,294
592,64,3,4,6,7,-67,43,2,7,302,337
592,65,3,3,8,5,35,32,7,9,337,369
592,66,3,4,5,8,32,-56,9,3,369,313
592,67,3,4,6,7,-67,43,2,6,302,356
592,68,2,4,4,9,22,-55,4,1,324,301
592,69,3,4,6,7,33,43,7,4,357,344
592,70,4,2,9,4,-55,22,2,6,302,366
592,71,2,5,3,10,21,-45,3,1,323,321
592,72,5,2,7,6,52,24,5,5,375,345
592,73,4,3,7,6,43,33,8,8,418,378
592,74,2,4,4,9,-78,-55,0,3,340,323
592,75,5,2,9,4,54,22,4,5,394,345
592,76,4,3,7,6,43,33,7,8,437,378
592,77,3,4,5,8,32,-56,9,2,469,322
592,78,3,4,6,7,-67,43,2,5,402,365
592,79,3,3,7,6,34,33,6,8,436,398
592,80,5,2,9,4,-46,-78,0,0,390,320
592,81,3,3,6,7,33,34,3,4,423,354
592,82,4,2,10,3,46,21,9,5,469,375
592,83,3,3,6,7,-67,34,2,9,402,409
592,84,4,3,7,6,43,-67,5,2,445,342
592,85,3,3,6,7,33,34,8,6,478,376
592,86,2,5,2,11,20,-44,8,2,498,332
592,87,3,3,4,9,31,36,9,8,529,368
593,1,5,3,8,5,53,32,3,2,53,32
593,2,3,3,6,7,33,34,6,6,86,66
593,3,3,3,9,4,-64,31,2,7,22,97
593,4,5,2,9,4,54,22,6,9,76,119
593,5,4,2,8,5,-56,-77,0,2,20,42
593,6,3,4,3,10,30,46,0,8,50,88
593,7,3,3,9,4,36,31,6,9,86,119
593,8,3,3,7,6,-66,-67,0,2,20,52
593,9,5,3,8,5,53,32,3,4,73,84
593,10,3,4,8,5,35,41,8,5,108,125
593,11,4,2,9,4,-55,22,3,7,53,147
593,12,2,5,5,8,23,-47,6,0,76,100
593,13,3,3,9,4,-64,31,2,1,12,131
593,14,4,2,6,7,42,25,4,6,54,156
593,15,2,5,4,9,22,-46,6,0,76,110
593,16,4,3,9,4,-55,31,1,1,21,141
593,17,4,2,6,7,42,25,3,6,63,166
593,18,4,3,7,6,43,33,6,9,106,199
593,19,3,3,3,10,30,-63,6,6,136,136
593,20,3,3,5,8,32,-65,8,1,168,71
593,21,2,6,3,10,21,64,9,5,189,135
593,22,6,2,10,3,-36,21,3,6,153,156
593,23,2,6,3,10,21,-36,4,0,174,120
593,24,5,2,9,4,54,22,8,2,228,142
593,25,4,3,7,6,-57,33,1,5,171,175
593,26,4,3,7,6,43,33,4,8,214,208
593,27,3,4,8,5,35,41,9,9,249,249
593,28,2,4,6,7,-76,-57,3,2,173,192
593,29,4,2,10,3,46,21,9,3,219,213
593,30,3,3,6,7,-67,34,2,7,152,247
593,31,4,2,8,5,44,-77,6,0,196,170
593,32,4,2,7,6,43,24,9,4,239,194
593,33,3,3,9,4,-64,31,5,5,175,225
593,34,5,2,8,5,53,23,8,8,228,248
593,35,2,4,6,7,-76,-57,2,1,152,191
593,36,2,4,4,9,22,45,4,6,174,236
593,37,4,3,8,5,44,32,8,8,218,268
593,38,2,4,4,9,-78,-55,0,3,140,213
593,39,5,2,8,5,53,23,3,6,193,236
593,40,3,3,7,6,34,33,7,9,227,269
593,41,3,3,7,6,-66,-67,1,2,161,202
593,42,2,5,5,8,23,53,4,5,184,255
593,43,3,3,7,6,34,33,8,8,218,288
593,44,3,3,6,7,-67,-66,1,2,151,222
593,45,3,3,5,8,32,35,3,7,183,257
593,46,4,2,8,5,44,-77,7,0,227,180
593,47,4,2,8,5,-56,23,1,3,171,203
593,48,3,3,8,5,35,32,6,5,206,235
593,49,2,5,2,11,20,-44,6,1,226,191
593,50,3,3,5,8,32,35,8,6,258,226
593,51,3,3,4,9,31,-64,9,2,289,162
593,52,2,4,9,4,-73,40,6,2,216,202
593,53,4,2,10,3,-54,21,2,3,162,223
593,54,3,3,5,8,32,35,4,8,194,258
593,55,5,2,10,3,55,21,9,9,249,279
593,56,3,3,7,6,-66,-67,3,2,183,212
593,57,3,3,5,8,32,35,5,7,215,247
593,58,3,5,6,7,33,52,8,9,248,299
593,59,3,3,9,4,-64,-69,4,0,184,230
593,60,4,2,8,5,44,23,8,3,228,253
593,61,3,4,8,5,-65,41,3,4,163,294
593,62,4,4,7,6,43,42,6,6,206,336
593,63,3,3,4,9,31,-64,7,2,237,272
593,64,3,4,6,7,-67,43,0,5,170,315
593,65,5,2,10,3,55,21,5,6,225,336
593,66,3,5,6,7,33,52,8,8,258,388
593,67,2,5,5,8,-77,-47,1,1,181,341
593,68,3,4,5,8,32,44,3,5,213,385
593,69,3,3,5,8,32,-65,5,0,245,320
593,70,3,4,5,8,32,44,7,4,277,364
593,71,3,3,6,7,-67,34,0,8,210,398
593,72,4,3,9,4,45,31,5,9,255,429
593,73,4,3,8,5,44,-68,9,1,299,361
593,74,2,5,3,10,-79,55,0,6,220,416
593,75,4,2,7,6,43,-76,3,0,263,340
593,76,4,3,7,6,43,33,6,3,306,373
593,77,4,3,8,5,-56,32,0,5,250,405
593,78,3,3,7,6,34,33,4,8,284,438
593,79,3,4,8,5,35,41,9,9,319,479
593,80,5,2,10,3,-45,-79,4,0,274,400
593,81,3,4,5,8,32,44,6,4,306,444
593,82,3,4,6,7,33,43,9,7,339,487
593,83,4,2,7,6,-57,-76,2,1,282,411
593,84,2,5,2,11,20,56,2,7,302,467
593,85,3,3,5,8,32,-65,4,2,334,402
593,86,3,5,4,9,31,54,5,6,365,456
593,87,5,2,9,4,54,22,9,8,419,478
593,88,2,4,3,10,-79,-54,0,4,340,424
593,89,4,2,11,2,47,20,7,4,387,444
593,90,3,4,3,10,30,-54,7,0,417,390
593,91,2,5,4,9,22,54,9,4,439,444
593,92,3,4,4,9,-69,45,0,9,370,489
593,93,4,2,9,4,45,-78,5,1,415,411
593,94,5,2,10,3,-45,21,0,2,370,432
593,95,3,3,8,5,35,32,5,4,405,464
593,96,4,2,5,8,41,-74,6,0,446,390
593,97,4,2,7,6,43,24,9,4,489,414
593,98,4,2,9,4,-55,22,4,6,434,436
593,99,2,5,4,9,22,-46,6,0,456,390
593,100,4,3,5,8,41,35,7,5,497,425
593,101,2,5,4,9,22,54,9,9,519,479
594,1,2,5,6,7,24,52,4,2,24,52
594,2,2,4,4,9,22,45,6,7,46,97
594,3,3,4,7,6,-66,42,0,9,-20,139
594,4,5,2,9,4,54,-78,4,1,34,61
594,5,2,4,6,7,24,43,8,4,58,104
594,6,6,2,10,3,-36,21,2,5,22,125
594,7,4,2,8,5,44,23,6,8,66,148
594,8,4,2,6,7,42,-75,8,3,108,73
594,9,3,4,7,6,-66,42,2,5,42,115
594,10,2,4,7,6,25,42,7,7,67,157
594,11,3,3,5,8,32,-65,9,2,99,92
594,12,5,2,11,2,-44,20,5,2,55,112
594,13,4,2,7,6,43,24,8,6,98,136
594,14,2,4,7,6,-75,42,3,8,23,178
594,15,3,3,6,7,33,-66,6,2,56,112
594,16,4,3,4,9,40,36,6,8,96,148
594,17,4,2,7,6,43,-76,9,2,139,72
594,18,2,5,4,9,-78,54,1,6,61,126
594,19,2,5,2,11,20,-44,1,2,81,82
594,20,3,3,5,8,32,35,3,7,113,117
594,21,5,2,10,3,55,21,8,8,168,138
594,22,3,4,7,6,-66,-58,2,0,102,80
594,23,2,4,6,7,24,43,6,3,126,123
594,24,4,2,7,6,43,24,9,7,169,147
594,25,5,2,11,2,-44,20,5,7,125,167
594,26,3,4,5,8,32,-56,7,1,157,111
594,27,4,3,6,7,42,34,9,5,199,145
594,28,4,3,9,4,-55,31,4,6,144,176
594,29,3,4,6,7,33,43,7,9,177,219
594,30,3,4,5,8,32,-56,9,3,209,163
594,31,3,4,8,5,-65,41,4,4,144,204
594,32,2,5,4,9,22,54,6,8,166,258
594,33,4,3,6,7,42,-66,8,2,208,192
594,34,5,2,11,2,-44,20,4,2,164,212
594,35,4,2,7,6,43,24,7,6,207,236
594,36,2,4,7,6,-75,42,2,8,132,278
594,37,2,5,4,9,22,-46,4,2,154,232
594,38,4,3,8,5,44,32,8,4,198,264
594,39,4,3,8,5,-56,32,2,6,142,296
594,40,3,3,6,7,33,-66,5,0,175,230
594,41,3,3,4,9,31,36,6,6,206,266
594,42,2,4,6,7,-76,43,0,9,130,309
594,43,4,3,5,8,41,-65,1,4,171,244
594,44,3,3,7,6,34,33,5,7,205,277
594,45,4,2,7,6,43,-76,8,1,248,201
594,46,4,3,7,6,-57,33,1,4,191,234
594,47,4,2,8,5,44,23,5,7,235,257
594,48,4,3,6,7,42,-66,7,1,277,191
594,49,2,4,2,11,20,47,7,8,297,238
594,50,2,4,4,9,22,-55,9,3,319,183
594,51,4,2,9,4,-55,22,4,5,264,205
594,52,4,3,7,6,43,33,7,8,307,238
594,53,5,2,10,3,-45,21,2,9,262,259
594,54,4,2,7,6,43,-76,5,3,305,183
594,55,4,3,6,7,42,34,7,7,347,217
594,56,4,3,9,4,-55,31,2,8,292,248
594,57,2,4,6,7,24,-57,6,1,316,191
594,58,2,5,7,6,-75,51,1,2,241,242
594,59,3,3,7,6,34,33,5,5,275,275
594,60,3,4,5,8,32,44,7,9,307,319
594,61,3,3,9,4,-64,-69,3,0,243,250
594,62,2,4,5,8,23,44,6,4,266,294
594,63,2,4,4,9,22,45,8,9,288,339
594,64,5,2,7,6,-48,-76,0,3,240,263
594,65,3,4,6,7,33,43,3,6,273,306
594,66,4,3,7,6,43,33,6,9,316,339
594,67,4,3,7,6,43,-67,9,2,359,272
594,68,3,3,8,5,-65,32,4,4,294,304
594,69,2,5,6,7,24,52,8,6,318,356
594,70,4,2,8,5,-56,23,2,9,262,379
594,71,2,4,7,6,25,-58,7,1,287,321
594,72,3,3,7,6,-66,33,1,4,221,354
594,73,5,3,7,6,52,33,3,7,273,387
594,74,5,2,12,1,-43,-20,0,7,230,367
594,75,4,3,7,6,43,-67,3,0,273,300
594,76,4,3,7,6,43,33,6,3,316,333
594,77,2,4,5,8,23,44,9,7,339,377
594,78,2,4,5,8,-77,-56,2,1,262,321
594,79,4,2,8,5,44,23,6,4,306,344
594,80,5,2,10,3,-45,21,1,5,261,365
594,81,3,3,6,7,33,34,4,9,294,399
594,82,3,4,7,6,34,-58,8,1,328,341
594,83,5,2,7,6,-48,24,0,5,280,365
594,84,4,3,6,7,42,34,2,9,322,399
594,85,4,2,8,5,44,-77,6,2,366,322
594,86,4,3,5,8,41,35,7,7,407,357
594,87,4,3,8,5,-56,32,1,9,351,389
594,88,4,3,8,5,44,-68,5,1,395,321
594,89,3,4,5,8,32,44,7,5,427,365
594,90,6,2,9,4,-37,22,0,7,390,387
594,91,4,3,9,4,45,31,5,8,435,418
594,92,3,4,6,7,33,-57,8,1,468,361
594,93,5,2,6,7,51,25,9,6,519,386
595,1,2,4,2,11,20,47,0,7,20,47
595,2,4,3,7,6,43,-67,3,0,63,-20
595,3,2,4,3,10,21,46,4,6,84,26
595,4,4,2,8,5,44,23,8,9,128,49
595,5,2,4,3,10,21,-54,9,5,149,-5
595,6,3,5,6,7,-67,52,2,7,82,47
595,7,3,3,8,5,35,32,7,9,117,79
595,8,6,2,8,5,62,-77,9,2,179,2
595,9,3,3,5,8,-68,35,1,7,111,37
595,10,5,2,10,3,55,21,6,8,166,58
595,11,5,2,9,4,-46,-78,0,0,120,-20
595,12,2,5,5,8,23,53,3,3,143,33
595,13,3,3,5,8,32,35,5,8,175,68
595,14,4,2,5,8,41,-74,6,4,216,-6
595,15,2,4,3,10,21,-54,7,0,237,-60
595,16,4,2,9,4,-55,22,2,2,182,-38
595,17,3,4,8,5,35,41,7,3,217,3
595,18,3,4,6,7,-67,43,0,6,150,46
595,19,4,3,7,6,43,33,3,9,193,79
595,20,5,2,9,4,54,-78,7,1,247,1
595,21,3,3,4,9,31,36,8,7,278,37
595,22,2,4,6,7,-76,-57,2,0,202,-20
595,23,4,3,6,7,42,34,4,4,244,14
595,24,4,3,8,5,44,32,8,6,288,46
595,25,4,2,8,5,-56,23,2,9,232,69
595,26,3,3,4,9,31,-64,3,5,263,5
595,27,3,3,5,8,32,-65,5,0,295,-60
595,28,2,4,3,10,21,46,6,6,316,-14
595,29,4,3,4,9,40,-64,6,2,356,-78
595,30,3,3,7,6,-66,33,0,5,290,-45
595,31,4,2,7,6,43,24,3,9,333,-21
595,32,3,4,5,8,32,-56,5,3,365,-77
595,33,3,3,6,7,33,34,8,7,398,-43
595,34,5,2,11,2,-44,20,4,7,354,-23
595,35,2,4,9,4,-73,40,1,7,281,17
595,36,3,4,5,8,32,-56,3,1,313,-39
595,37,3,5,5,8,32,53,5,4,345,14
595,38,2,5,4,9,22,54,7,8,367,68
595,39,4,3,8,5,-56,-68,1,0,311,0
595,40,4,3,6,7,42,34,3,4,353,34
595,41,5,2,11,2,56,20,9,4,409,54
595,42,3,3,7,6,-66,33,3,7,343,87
595,43,2,5,6,7,24,52,7,9,367,139
595,44,2,5,2,11,20,-44,7,5,387,95
595,45,3,4,4,9,31,-55,8,0,418,40
595,46,5,2,9,4,-46,22,2,2,372,62
595,47,4,2,9,4,45,22,7,4,417,84
595,48,4,2,8,5,-56,23,1,7,361,107
595,49,2,4,8,5,26,41,7,8,387,148
595,50,4,3,7,6,-57,-67,0,1,330,81
595,51,4,2,10,3,46,21,6,2,376,102
595,52,3,3,5,8,32,35,8,7,408,137
595,53,5,2,6,7,51,-75,9,2,459,62
595,54,3,3,7,6,-66,33,3,5,393,95
595,55,5,2,8,5,53,23,6,8,446,118
595,56,3,3,7,6,-66,-67,0,1,380,51
595,57,3,3,6,7,33,34,3,5,413,85
595,58,2,5,3,10,21,-45,4,0,434,40
595,59,2,5,5,8,23,53,7,3,457,93
595,60,2,4,6,7,-76,43,1,6,381,136
595,61,2,4,4,9,22,-55,3,1,403,81
595,62,6,2,10,3,64,21,7,2,467,102
595,63,4,3,9,4,-55,31,2,3,412,133
595,64,3,3,7,6,34,33,6,6,446,166
595,65,5,2,10,3,-45,21,1,7,401,187
595,66,3,4,5,8,32,-56,3,1,433,131
595,67,5,2,9,4,54,22,7,3,487,153
595,68,3,3,5,8,32,35,9,8,519,188
596,1,4,3,9,4,45,31,5,1,45,31
596,2,2,5,4,9,22,54,7,5,67,85
596,3,2,4,8,5,-74,41,3,6,-7,126
596,4,3,3,7,6,34,33,7,9,27,159
596,5,4,2,8,5,-56,-77,1,2,-29,82
596,6,6,2,10,3,64,21,5,3,35,103
596,7,5,3,8,5,53,32,8,5,88,135
596,8,2,4,6,7,-76,43,2,8,12,178
596,9,2,5,5,8,23,-47,5,1,35,131
596,10,4,2,8,5,44,23,9,4,79,154
596,11,2,5,5,8,-77,53,2,7,2,207
596,12,2,4,6,7,24,-57,6,0,26,150
596,13,4,3,7,6,43,33,9,3,69,183
596,14,4,2,6,7,-58,25,1,8,11,208
596,15,3,3,6,7,33,-66,4,2,44,142
596,16,2,4,5,8,23,44,7,6,67,186
596,17,4,2,6,7,42,-75,9,1,109,111
596,18,5,2,7,6,-48,24,1,5,61,135
596,19,5,2,8,5,53,23,4,8,114,158
596,20,4,3,8,5,44,-68,8,0,158,90
596,21,4,3,6,7,-58,34,0,4,100,124
596,22,4,2,8,5,44,23,4,7,144,147
596,23,3,4,4,9,31,-55,5,2,175,92
596,24,4,4,7,6,43,42,8,4,218,134
596,25,6,2,11,2,-35,20,3,4,183,154
596,26,3,3,4,9,31,-64,4,0,214,90
596,27,3,4,3,10,30,46,4,6,244,136
596,28,2,6,4,9,22,63,6,9,266,199
596,29,2,5,5,8,23,-47,9,2,289,152
596,30,2,5,3,10,-79,55,0,7,210,207
596,31,4,2,9,4,45,22,5,9,255,229
596,32,5,2,9,4,54,-78,9,1,309,151
596,33,5,2,9,4,-46,22,3,3,263,173
596,34,2,5,3,10,21,55,4,8,284,228
596,35,3,3,7,6,34,-67,8,1,318,161
596,36,3,4,4,9,31,45,9,6,349,206
596,37,2,5,3,10,-79,-45,0,1,270,161
596,38,3,4,5,8,32,44,2,5,302,205
596,39,2,5,4,9,22,54,4,9,324,259
596,40,4,3,6,7,42,-66,6,3,366,193
596,41,4,3,7,6,43,33,9,6,409,226
596,42,3,3,7,6,-66,33,3,9,343,259
596,43,4,3,6,7,42,-66,5,3,385,193
596,44,5,2,5,8,50,26,5,9,435,219
596,45,2,4,3,10,21,-54,6,5,456,165
596,46,3,3,6,7,33,34,9,9,489,199
596,47,3,4,5,8,-68,-56,1,3,421,143
596,48,2,5,4,9,22,54,3,7,443,197
596,49,4,2,9,4,45,22,8,9,488,219
596,50,3,4,5,8,-68,-56,0,3,420,163
596,51,3,3,6,7,33,34,3,7,453,197
596,52,3,4,6,7,33,-57,6,0,486,140
596,53,4,3,9,4,-55,31,1,1,431,171
596,54,4,3,8,5,44,32,5,3,475,203
596,55,4,3,7,6,43,33,8,6,518,236
597,1,5,2,9,4,54,22,4,2,54,22
597,2,4,4,6,7,42,43,6,5,96,65
597,3,4,3,7,6,43,33,9,8,139,98
597,4,4,2,6,7,-58,-75,1,3,81,23
597,5,2,5,4,9,22,54,3,7,103,77
597,6,3,3,7,6,34,-67,7,0,137,10
597,7,3,3,6,7,-67,34,0,4,70,44
597,8,3,3,5,8,32,35,2,9,102,79
597,9,3,4,7,6,34,-58,6,1,136,21
597,10,6,2,10,3,-36,21,0,2,100,42
597,11,5,2,11,2,56,20,6,2,156,62
597,12,3,3,7,6,-66,33,0,5,90,95
597,13,3,3,8,5,35,32,5,7,125,127
597,14,5,2,7,6,52,-76,7,1,177,51
597,15,4,3,8,5,-56,32,1,3,121,83
597,16,4,3,6,7,42,34,3,7,163,117
597,17,2,5,5,8,23,-47,6,0,186,70
597,18,3,4,6,7,33,43,9,3,219,113
597,19,3,5,3,10,30,55,9,8,249,168
597,20,2,4,6,7,-76,-57,3,1,173,111
597,21,4,2,8,5,44,23,7,4,217,134
597,22,5,2,8,5,-47,23,0,7,170,157
597,23,3,3,7,6,34,-67,4,0,204,90
597,24,3,3,10,3,-63,30,1,0,141,120
597,25,3,4,7,6,34,42,5,2,175,162
597,26,3,3,6,7,33,34,8,6,208,196
597,27,3,3,7,6,-66,33,2,9,142,229
597,28,4,4,6,7,42,-57,4,2,184,172
597,29,2,5,4,9,22,54,6,6,206,226
597,30,4,2,7,6,43,-76,9,0,249,150
597,31,4,2,9,4,-55,22,4,2,194,172
597,32,4,2,10,3,-54,21,0,3,140,193
597,33,3,4,3,10,30,46,0,9,170,239
597,34,3,4,8,5,35,-59,5,0,205,180
597,35,2,5,3,10,21,55,6,5,226,235
597,36,4,3,6,7,42,34,8,9,268,269
597,37,3,4,5,8,-68,-56,0,3,200,213
597,38,3,3,5,8,32,35,2,8,232,248
597,39,2,5,4,9,22,-46,4,2,254,202
597,40,4,3,6,7,42,34,6,6,296,236
597,41,3,3,6,7,33,-66,9,0,329,170
597,42,2,5,6,7,-76,52,3,2,253,222
597,43,3,3,7,6,34,33,7,5,287,255
597,44,3,4,8,5,-65,41,2,6,222,296
597,45,3,4,4,9,31,-55,3,1,253,241
597,46,4,3,8,5,44,32,7,3,297,273
597,47,3,4,5,8,32,44,9,7,329,317
597,48,2,5,4,9,-78,-46,1,1,251,271
597,49,2,5,3,10,21,55,2,6,272,326
597,50,5,2,10,3,55,21,7,7,327,347
597,51,3,4,7,6,-66,42,1,9,261,389
597,52,3,3,6,7,33,-66,4,3,294,323
597,53,2,4,4,9,22,45,6,8,316,368
597,54,3,3,9,4,-64,31,2,9,252,399
597,55,3,3,7,6,34,-67,6,2,286,332
597,56,2,4,3,10,21,46,7,8,307,378
597,57,4,3,8,5,-56,-68,1,0,251,310
597,58,4,3,5,8,41,35,2,5,292,345
597,59,2,4,5,8,23,44,5,9,315,389
597,60,3,4,5,8,32,-56,7,3,347,333
597,61,3,4,7,6,-66,42,1,5,281,375
597,62,3,3,4,9,31,-64,2,1,312,311
597,63,4,3,9,4,45,31,7,2,357,342
597,64,3,4,7,6,-66,42,1,4,291,384
597,65,4,3,8,5,44,32,5,6,335,416
597,66,2,5,3,10,21,-45,6,1,356,371
597,67,2,4,8,5,-74,41,2,2,282,412
597,68,4,3,9,4,45,31,7,3,327,443
597,69,2,6,4,9,22,63,9,6,349,506
598,1,4,3,8,5,44,32,4,2,44,32
598,2,4,3,10,3,-54,30,0,2,-10,62
598,3,2,4,4,9,22,45,2,7,12,107
598,4,4,2,6,7,42,-75,4,2,54,32
598,5,4,4,8,5,44,41,8,3,98,73
598,6,4,3,9,4,-55,31,3,4,43,104
598,7,3,4,6,7,33,43,6,7,76,147
598,8,2,4,5,8,23,-56,9,1,99,91
598,9,5,2,8,5,-47,23,2,4,52,114
598,10,4,3,8,5,44,32,6,6,96,146
598,11,3,4,7,6,-66,42,0,8,30,188
598,12,2,4,4,9,22,-55,2,3,52,133
598,13,4,2,10,3,46,21,8,4,98,154
598,14,4,2,6,7,-58,25,0,9,40,179
598,15,3,4,4,9,31,-55,1,4,71,124
598,16,5,2,8,5,53,23,4,7,124,147
598,17,5,2,10,3,55,21,9,8,179,168
598,18,2,5,6,7,-76,-48,3,0,103,120
598,19,4,2,9,4,45,22,8,2,148,142
598,20,3,5,4,9,31,54,9,6,179,196
598,21,2,5,4,9,-78,-46,1,0,101,150
598,22,3,3,9,4,36,31,7,1,137,181
598,23,2,4,6,7,-76,43,1,4,61,224
598,24,3,3,7,6,34,33,5,7,95,257
598,25,3,4,5,8,32,-56,7,1,127,201
598,26,3,4,8,5,-65,41,2,2,62,242
598,27,4,3,6,7,42,34,4,6,104,276
598,28,4,2,7,6,43,-76,7,0,147,200
598,29,3,3,7,6,-66,33,1,3,81,233
598,30,2,4,4,9,22,45,3,8,103,278
598,31,3,4,7,6,34,-58,7,0,137,220
598,32,3,4,4,9,31,45,8,5,168,265
598,33,3,3,6,7,-67,34,1,9,101,299
598,34,3,3,8,5,35,-68,6,1,136,231
598,35,3,4,7,6,-66,42,0,3,70,273
598,36,4,3,8,5,44,32,4,5,114,305
598,37,3,3,4,9,31,-64,5,1,145,241
598,38,4,4,7,6,43,42,8,3,188,283
598,39,5,2,9,4,-46,22,2,5,142,305
598,40,5,2,7,6,52,24,4,9,194,329
598,41,5,2,9,4,54,-78,8,1,248,251
598,42,2,6,4,9,-78,63,0,4,170,314
598,43,2,5,3,10,21,55,1,9,191,369
598,44,3,3,8,5,35,-68,6,1,226,301
598,45,4,3,9,4,-55,31,1,2,171,332
598,46,2,6,5,8,23,62,4,4,194,394
598,47,3,4,4,9,31,45,5,9,225,439
598,48,2,4,6,7,24,-57,9,2,249,382
598,49,5,2,7,6,-48,24,1,6,201,406
598,50,3,3,8,5,35,32,6,8,236,438
598,51,3,3,4,9,31,-64,7,4,267,374
598,52,3,4,7,6,-66,42,1,6,201,416
598,53,4,3,6,7,42,-66,3,0,243,350
598,54,2,5,2,11,20,56,3,6,263,406
598,55,3,3,5,8,32,-65,5,1,295,341
598,56,4,2,9,4,-55,22,0,3,240,363
598,57,2,4,6,7,24,43,4,6,264,406
598,58,3,4,6,7,33,43,7,9,297,449
598,59,4,2,6,7,42,-75,9,4,339,374
598,60,2,4,5,8,-77,44,2,8,262,418
598,61,2,4,6,7,24,-57,6,1,286,361
598,62,3,3,7,6,-66,33,0,4,220,394
598,63,3,3,6,7,33,34,3,8,253,428
598,64,3,3,6,7,33,-66,6,2,286,362
598,65,3,4,8,5,-65,41,1,3,221,403
598,66,5,2,8,5,53,23,4,6,274,426
598,67,3,4,5,8,32,-56,6,0,306,370
598,68,2,5,3,10,21,55,7,5,327,425
598,69,2,4,7,6,-75,42,2,7,252,467
598,70,4,3,7,6,43,-67,5,0,295,400
598,71,5,2,9,4,54,22,9,2,349,422
598,72,3,3,8,5,-65,32,4,4,284,454
598,73,3,3,10,3,-63,30,1,4,221,484
598,74,4,2,11,2,47,20,8,4,268,504
599,1,4,2,5,8,41,26,1,6,41,26
599,2,6,2,8,5,62,23,3,9,103,49
599,3,3,4,5,8,32,-56,5,3,135,-7
599,4,4,3,6,7,42,34,7,7,177,27
599,5,2,4,3,10,21,-54,8,3,198,-27
599,6,4,4,7,6,-57,42,1,5,141,15
599,7,2,4,4,9,22,-55,3,0,163,-40
599,8,2,5,4,9,22,54,5,4,185,14
599,9,2,4,9,4,-73,40,2,4,112,54
599,10,5,2,7,6,52,24,4,8,164,78
599,11,2,5,3,10,21,-45,5,3,185,33
599,12,3,3,8,5,-65,32,0,5,120,65
599,13,3,3,5,8,32,-65,2,0,152,0
599,14,3,3,6,7,33,34,5,4,185,34
599,15,4,2,6,7,42,25,7,9,227,59
599,16,4,3,5,8,41,-65,8,4,268,-6
599,17,2,5,7,6,-75,51,3,5,193,45
599,18,5,2,6,7,51,-75,4,0,244,-30
599,19,3,4,6,7,33,43,7,3,277,13
599,20,5,2,7,6,52,24,9,7,329,37
599,21,5,2,10,3,-45,21,4,8,284,58
599,22,5,2,7,6,52,-76,6,2,336,-18
599,23,3,3,7,6,-66,33,0,5,270,15
599,24,3,3,8,5,35,32,5,7,305,47
599,25,3,4,5,8,32,-56,7,1,337,-9
599,26,3,4,3,10,30,46,7,7,367,37
599,27,2,5,6,7,-76,52,1,9,291,89
599,28,5,2,8,5,53,-77,4,2,344,12
599,29,3,3,6,7,33,34,7,6,377,46
599,30,3,4,6,7,-67,43,0,9,310,89
599,31,4,3,9,4,45,-69,5,0,355,20
599,32,3,3,6,7,33,34,8,4,388,54
599,33,3,4,6,7,-67,43,1,7,321,97
599,34,3,3,5,8,32,-65,3,2,353,32
599,35,4,3,7,6,43,33,6,5,396,65
599,36,5,2,8,5,53,23,9,8,449,88
599,37,4,3,9,4,-55,31,4,9,394,119
599,38,6,2,9,4,63,-78,7,1,457,41
599,39,2,4,5,8,-77,44,0,5,380,85
599,40,2,4,6,7,24,43,4,8,404,128
599,41,3,4,6,7,33,-57,7,1,437,71
599,42,3,4,6,7,-67,43,0,4,370,114
599,43,3,4,9,4,36,40,6,4,406,154
599,44,4,3,7,6,43,33,9,7,449,187
599,45,3,3,9,4,-64,31,5,8,385,218
599,46,2,5,6,7,24,-48,9,0,409,170
599,47,2,5,5,8,-77,53,2,3,332,223
599,48,5,2,8,5,53,23,5,6,385,246
599,49,3,3,9,4,-64,31,1,7,321,277
599,50,3,4,5,8,32,-56,3,1,353,221
599,51,3,3,7,6,34,33,7,4,387,254
599,52,3,4,8,5,-65,41,2,5,322,295
599,53,3,3,10,3,37,30,9,5,359,325
599,54,3,4,8,5,-65,41,4,6,294,366
599,55,4,2,6,7,42,-75,6,1,336,291
599,56,4,3,7,6,43,33,9,4,379,324
599,57,3,3,8,5,-65,32,4,6,314,356
599,58,4,2,10,3,-54,21,0,7,260,377
599,59,4,2,6,7,42,-75,2,2,302,302
599,60,3,4,7,6,34,42,6,4,336,344
599,61,4,2,8,5,-56,23,0,7,280,367
599,62,4,3,9,4,45,31,5,8,325,398
599,63,2,4,6,7,24,-57,9,1,349,341
599,64,6,2,9,4,-37,22,2,3,312,363
599,65,2,4,4,9,22,45,4,8,334,408
599,66,2,5,3,10,21,-45,5,3,355,363
599,67,2,5,4,9,22,54,7,7,377,417
599,68,3,4,4,9,31,-55,8,2,408,362
599,69,4,3,7,6,-57,33,1,5,351,395
599,70,5,2,6,7,51,-75,2,0,402,320
599,71,4,4,5,8,41,44,3,4,443,364
599,72,3,4,5,8,32,44,5,8,475,408
599,73,3,4,6,7,33,-57,8,1,508,351
600,1,4,2,10,3,46,21,6,1,46,21
600,2,5,3,9,4,-46,31,0,2,0,52
600,3,2,5,5,8,23,53,3,5,23,105
600,4,2,4,7,6,25,42,8,7,48,147
600,5,3,4,6,7,-67,-57,1,0,-19,90
600,6,3,3,8,5,35,32,6,2,16,122
600,7,2,5,4,9,22,54,8,6,38,176
600,8,3,4,9,4,-64,40,4,6,-26,216
600,9,3,4,5,8,32,-56,6,0,6,160
600,10,4,3,8,5,-56,32,0,2,-50,192
600,11,4,4,4,9,40,45,0,7,-10,237
600,12,4,3,10,3,46,30,6,7,36,267
600,13,3,4,4,9,31,-55,7,2,67,212
600,14,2,5,3,10,21,55,8,7,88,267
600,15,3,4,5,8,-68,-56,0,1,20,211
600,16,2,4,3,10,21,46,1,7,41,257
600,17,3,3,6,7,33,-66,4,1,74,191
600,18,3,3,6,7,33,34,7,5,107,225
600,19,3,4,6,7,-67,43,0,8,40,268
600,20,2,5,4,9,22,-46,2,2,62,222
600,21,2,6,2,11,20,65,2,7,82,287
600,22,5,2,8,5,53,-77,5,0,135,210
600,23,3,4,6,7,33,43,8,3,168,253
600,24,2,4,4,9,-78,45,0,8,90,298
600,25,5,2,8,5,53,-77,3,1,143,221
600,26,4,2,8,5,44,23,7,4,187,244
600,27,6,2,8,5,62,23,9,7,249,267
600,28,2,4,4,9,-78,-55,1,2,171,212
600,29,3,4,8,5,35,41,6,3,206,253
600,30,6,2,10,3,-36,21,0,4,170,274
600,31,5,2,6,7,51,25,1,9,221,299
600,32,3,4,6,7,33,-57,4,2,254,242
600,33,3,3,5,8,32,35,6,7,286,277
600,34,3,4,8,5,-65,41,1,8,221,318
600,35,3,4,4,9,31,-55,2,3,252,263
600,36,4,3,8,5,44,32,6,5,296,295
600,37,6,2,10,3,-36,21,0,6,260,316
600,38,5,2,8,5,53,23,3,9,313,339
600,39,2,4,6,7,24,-57,7,2,337,282
600,40,2,4,6,7,-76,43,1,5,261,325
600,41,5,2,8,5,53,23,4,8,314,348
600,42,4,3,8,5,44,-68,8,0,358,280
600,43,3,3,7,6,-66,33,2,3,292,313
600,44,2,6,5,8,23,62,5,5,315,375
600,45,3,3,5,8,32,-65,7,0,347,310
600,46,4,2,10,3,-54,21,3,1,293,331
600,47,5,2,6,7,51,25,4,6,344,356
600,48,6,2,10,3,64,21,8,7,408,377
600,49,3,3,6,7,-67,-66,1,1,341,311
600,50,4,3,6,7,42,34,3,5,383,345
600,51,3,3,5,8,32,-65,5,0,415,280
600,52,3,3,7,6,34,33,9,3,449,313
600,53,4,2,7,6,-57,24,2,7,392,337
600,54,2,4,5,8,23,-56,5,1,415,281
600,55,5,3,7,6,52,33,7,4,467,314
600,56,4,2,8,5,-56,23,1,7,411,337
600,57,3,3,7,6,34,-67,5,0,445,270
600,58,4,2,9,4,-55,22,0,2,390,292
600,59,3,3,6,7,33,34,3,6,423,326
600,60,3,3,7,6,34,33,7,9,457,359
600,61,6,2,10,3,-36,-79,1,0,421,280
600,62,3,4,4,9,31,45,2,5,452,325
600,63,5,2,9,4,54,22,6,7,506,347
601,1,5,2,8,5,53,23,3,3,53,23
601,2,2,4,4,9,22,45,5,8,75,68
601,3,3,5,6,7,33,-48,8,0,108,20
601,4,2,5,5,8,-77,53,1,3,31,73
601,5,4,4,9,4,45,40,6,3,76,113
601,6,2,4,6,7,-76,43,0,6,0,156
601,7,2,4,4,9,22,-55,2,1,22,101
601,8,2,4,3,10,21,46,3,7,43,147
601,9,3,3,7,6,34,-67,7,0,77,80
601,10,3,3,5,8,32,35,9,5,109,115
601,11,2,5,3,10,-79,-45,0,0,30,70
601,12,2,4,6,7,24,43,4,3,54,113
601,13,5,2,9,4,54,22,8,5,108,135
601,14,2,4,6,7,-76,43,2,8,32,178
601,15,5,3,6,7,51,-66,3,2,83,112
601,16,2,4,4,9,22,45,5,7,105,157
601,17,4,3,4,9,40,-64,5,3,145,93
601,18,2,4,7,6,-75,42,0,5,70,135
601,19,2,4,7,6,25,42,5,7,95,177
601,20,4,3,6,7,42,-66,7,1,137,111
601,21,5,2,10,3,-45,21,2,2,92,132
601,22,4,3,9,4,45,31,7,3,137,163
601,23,3,3,9,4,-64,31,3,4,73,194
601,24,4,2,9,4,45,22,8,6,118,216
601,25,3,5,7,6,-66,51,2,7,52,267
601,26,4,3,6,7,42,-66,4,1,94,201
601,27,3,3,6,7,33,34,7,5,127,235
601,28,5,2,9,4,-46,22,1,7,81,257
601,29,3,3,9,4,36,31,7,8,117,288
601,30,3,4,4,9,31,-55,8,3,148,233
601,31,3,3,7,6,-66,33,2,6,82,266
601,32,3,4,5,8,32,-56,4,0,114,210
601,33,2,4,5,8,23,44,7,4,137,254
601,34,4,3,6,7,42,34,9,8,179,288
601,35,3,3,9,4,-64,31,5,9,115,319
601,36,4,2,8,5,44,-77,9,2,159,242
601,37,2,4,6,7,-76,43,3,5,83,285
601,38,2,4,5,8,23,44,6,9,106,329
601,39,3,4,5,8,32,-56,8,3,138,273
601,40,3,4,5,8,-68,44,0,7,70,317
601,41,2,4,5,8,23,-56,3,1,93,261
601,42,3,4,7,6,34,42,7,3,127,303
601,43,3,4,7,6,-66,42,1,5,61,345
601,44,3,3,5,8,32,-65,3,0,93,280
601,45,3,3,7,6,34,33,7,3,127,313
601,46,2,6,4,9,22,63,9,6,149,376
601,47,2,4,6,7,-76,43,3,9,73,419
601,48,4,2,5,8,41,-74,4,5,114,345
601,49,4,2,7,6,43,24,7,9,157,369
601,50,3,4,8,5,-65,-59,2,0,92,310
601,51,3,4,7,6,34,42,6,2,126,352
601,52,4,3,7,6,43,33,9,5,169,385
601,53,2,4,4,9,-78,-55,1,0,91,330
601,54,4,3,9,4,45,31,6,1,136,361
601,55,3,4,6,7,33,43,9,4,169,404
601,56,5,2,10,3,-45,21,4,5,124,425
601,57,5,2,9,4,54,22,8,7,178,447
601,58,2,5,3,10,21,-45,9,2,199,402
601,59,3,4,8,5,-65,41,4,3,134,443
601,60,4,3,7,6,43,33,7,6,177,476
601,61,3,3,8,5,-65,32,2,8,112,508
602,1,2,6,3,10,21,64,1,4,21,64
602,2,4,3,9,4,45,31,6,5,66,95
602,3,3,3,6,7,33,34,9,9,99,129
602,4,4,3,6,7,-58,-66,1,3,41,63
602,5,3,3,6,7,33,34,4,7,74,97
602,6,2,4,2,11,20,-53,4,4,94,44
602,7,3,4,9,4,-64,40,0,4,30,84
602,8,2,4,6,7,24,43,4,7,54,127
602,9,2,4,6,7,24,-57,8,0,78,70
602,10,3,4,5,8,-68,44,0,4,10,114
602,11,2,4,5,8,23,44,3,8,33,158
602,12,2,6,4,9,22,-37,5,1,55,121
602,13,3,3,5,8,32,35,7,6,87,156
602,14,3,3,8,5,-65,32,2,8,22,188
602,15,4,3,9,4,45,31,7,9,67,219
602,16,4,3,9,4,-55,-69,2,0,12,150
602,17,3,4,6,7,33,43,5,3,45,193
602,18,5,2,9,4,54,22,9,5,99,215
602,19,3,4,6,7,-67,43,2,8,32,258
602,20,4,2,8,5,44,-77,6,1,76,181
602,21,3,4,6,7,33,43,9,4,109,224
602,22,3,4,4,9,-69,45,0,9,40,269
602,23,3,4,6,7,33,-57,3,2,73,212
602,24,2,5,3,10,21,55,4,7,94,267
602,25,2,5,2,11,20,-44,4,3,114,223
602,26,4,3,9,4,45,31,9,4,159,254
602,27,3,3,10,3,-63,30,6,4,96,284
602,28,5,2,9,4,-46,22,0,6,50,306
602,29,2,4,5,8,23,-56,3,0,73,250
602,30,2,4,7,6,25,42,8,2,98,292
602,31,4,2,6,7,-58,25,0,7,40,317
602,32,3,4,7,6,34,42,4,9,74,359
602,33,4,2,7,6,43,-76,7,3,117,283
602,34,3,4,7,6,-66,42,1,5,51,325
602,35,4,4,6,7,42,43,3,8,93,368
602,36,5,2,9,4,54,-78,7,0,147,290
602,37,2,5,4,9,22,54,9,4,169,344
602,38,4,4,6,7,-58,43,1,7,111,387
602,39,2,4,4,9,22,-55,3,2,133,332
602,40,3,3,7,6,34,33,7,5,167,365
602,41,4,2,7,6,-57,24,0,9,110,389
602,42,2,5,3,10,21,-45,1,4,131,344
602,43,5,2,10,3,55,21,6,5,186,365
602,44,4,3,9,4,-55,31,1,6,131,396
602,45,3,4,3,10,30,-54,1,2,161,342
602,46,3,4,7,6,34,42,5,4,195,384
602,47,4,2,5,8,41,-74,6,0,236,310
602,48,3,3,8,5,-65,32,1,2,171,342
602,49,2,4,3,10,21,46,2,8,192,388
602,50,2,5,7,6,25,51,7,9,217,439
602,51,3,4,4,9,31,-55,8,4,248,384
602,52,2,4,7,6,-75,42,3,6,173,426
602,53,3,3,4,9,31,-64,4,2,204,362
602,54,3,3,6,7,33,34,7,6,237,396
602,55,5,3,7,6,52,33,9,9,289,429
602,56,3,3,8,5,-65,-68,4,1,224,361
602,57,4,3,7,6,43,33,7,4,267,394
602,58,2,4,6,7,-76,43,1,7,191,437
602,59,2,5,3,10,21,-45,2,2,212,392
602,60,3,3,7,6,34,33,6,5,246,425
602,61,5,2,9,4,-46,22,0,7,200,447
602,62,3,4,9,4,36,40,6,7,236,487
602,63,2,4,5,8,23,-56,9,1,259,431
602,64,4,3,7,6,-57,33,2,4,202,464
602,65,4,3,9,4,45,31,7,5,247,495
602,66,4,3,7,6,-57,33,0,8,190,528
603,1,2,5,6,7,24,52,4,2,24,52
603,2,4,3,7,6,43,33,7,5,67,85
603,3,4,3,7,6,-57,33,0,8,10,118
603,4,3,3,7,6,34,-67,4,1,44,51
603,5,2,4,5,8,23,44,7,5,67,95
603,6,4,3,8,5,-56,32,1,7,11,127
603,7,2,5,7,6,25,51,6,8,36,178
603,8,5,2,10,3,-45,21,1,9,-9,199
603,9,5,2,8,5,53,-77,4,2,44,122
603,10,4,3,7,6,43,33,7,5,87,155
603,11,2,4,9,4,-73,40,4,5,14,195
603,12,4,3,6,7,42,34,6,9,56,229
603,13,3,4,3,10,30,-54,6,5,86,175
603,14,3,3,7,6,-66,33,0,8,20,208
603,15,3,3,5,8,32,-65,2,3,52,143
603,16,4,2,9,4,45,22,7,5,97,165
603,17,2,4,7,6,-75,42,2,7,22,207
603,18,4,3,6,7,42,-66,4,1,64,141
603,19,2,4,4,9,22,45,6,6,86,186
603,20,3,4,5,8,32,-56,8,0,118,130
603,21,4,3,10,3,-54,30,4,0,64,160
603,22,3,4,4,9,31,45,5,5,95,205
603,23,2,4,4,9,22,-55,7,0,117,150
603,24,3,4,6,7,-67,43,0,3,50,193
603,25,5,2,8,5,53,23,3,6,103,216
603,26,3,3,6,7,33,-66,6,0,136,150
603,27,4,3,8,5,-56,32,0,2,80,182
603,28,2,4,4,9,22,45,2,7,102,227
603,29,3,4,4,9,31,-55,3,2,133,172
603,30,5,2,10,3,55,21,8,3,188,193
603,31,3,4,6,7,-67,43,1,6,121,236
603,32,4,3,6,7,42,-66,3,0,163,170
603,33,5,2,9,4,54,22,7,2,217,192
603,34,4,3,9,4,-55,31,2,3,162,223
603,35,3,4,6,7,33,43,5,6,195,266
603,36,4,3,5,8,41,-65,6,1,236,201
603,37,3,3,5,8,32,35,8,6,268,236
603,38,5,2,9,4,-46,22,2,8,222,258
603,39,3,3,8,5,35,-68,7,0,257,190
603,40,5,3,8,5,-47,32,0,2,210,222
603,41,3,4,5,8,32,44,2,6,242,266
603,42,4,2,10,3,46,21,8,7,288,287
603,43,5,2,7,6,-48,-76,0,1,240,211
603,44,2,5,5,8,23,53,3,4,263,264
603,45,4,3,7,6,43,33,6,7,306,297
603,46,5,2,9,4,-46,22,0,9,260,319
603,47,3,4,7,6,34,-58,4,1,294,261
603,48,3,3,6,7,33,34,7,5,327,295
603,49,4,4,6,7,42,43,9,8,369,338
603,50,2,6,4,9,-78,-37,1,1,291,301
603,51,4,3,6,7,42,34,3,5,333,335
603,52,4,3,9,4,45,31,8,6,378,366
603,53,4,2,6,7,-58,-75,0,1,320,291
603,54,4,2,7,6,43,24,3,5,363,315
603,55,3,4,5,8,32,44,5,9,395,359
603,56,4,2,6,7,42,-75,7,4,437,284
603,57,2,4,3,10,21,-54,8,0,458,230
603,58,5,3,6,7,51,34,9,4,509,264
604,1,3,3,5,8,32,35,2,5,32,35
604,2,3,3,5,8,32,-65,4,0,64,-30
604,3,2,4,5,8,23,44,7,4,87,14
604,4,2,5,2,11,20,-44,7,0,107,-30
604,5,5,2,10,3,-45,21,2,1,62,-9
604,6,3,3,5,8,32,35,4,6,94,26
604,7,3,4,5,8,32,-56,6,0,126,-30
604,8,5,3,8,5,53,32,9,2,179,2
604,9,4,2,8,5,-56,23,3,5,123,25
604,10,4,3,6,7,42,34,5,9,165,59
604,11,3,4,5,8,32,-56,7,3,197,3
604,12,5,2,9,4,-46,22,1,5,151,25
604,13,2,4,6,7,24,43,5,8,175,68
604,14,3,4,5,8,32,-56,7,2,207,12
604,15,3,3,5,8,32,35,9,7,239,47
604,16,3,4,7,6,-66,42,3,9,173,89
604,17,2,5,3,10,21,-45,4,4,194,44
604,18,3,3,9,4,-64,31,0,5,130,75
604,19,5,3,7,6,52,33,2,8,182,108
604,20,5,2,8,5,53,-77,5,1,235,31
604,21,3,3,7,6,34,33,9,4,269,64
604,22,3,3,5,8,-68,35,1,9,201,99
604,23,6,2,11,2,65,20,6,9,266,119
604,24,2,4,8,5,-74,-59,2,0,192,60
604,25,2,4,4,9,22,45,4,5,214,105
604,26,4,3,10,3,-54,30,0,5,160,135
604,27,2,4,5,8,23,44,3,9,183,179
604,28,4,3,5,8,41,-65,4,4,224,114
604,29,2,5,3,10,21,55,5,9,245,169
604,30,5,2,8,5,53,-77,8,2,298,92
604,31,3,4,7,6,-66,42,2,4,232,134
604,32,3,4,8,5,35,41,7,5,267,175
604,33,2,4,5,8,-77,44,0,9,190,219
604,34,4,2,10,3,46,-79,6,0,236,140
604,35,2,5,5,8,23,53,9,3,259,193
604,36,5,2,10,3,-45,21,4,4,214,214
604,37,2,4,5,8,23,44,7,8,237,258
604,38,2,5,4,9,22,-46,9,2,259,212
604,39,5,2,7,6,-48,24,1,6,211,236
604,40,4,3,6,7,42,-66,3,0,253,170
604,41,2,4,4,9,22,45,5,5,275,215
604,42,3,3,4,9,31,-64,6,1,306,151
604,43,4,2,9,4,-55,22,1,3,251,173
604,44,4,2,8,5,44,23,5,6,295,196
604,45,2,5,2,11,20,-44,5,2,315,152
604,46,3,3,7,6,34,33,9,5,349,185
604,47,2,4,7,6,-75,42,4,7,274,227
604,48,6,2,9,4,63,22,7,9,337,249
604,49,2,4,3,10,21,-54,8,5,358,195
604,50,4,3,7,6,-57,33,1,8,301,228
604,51,4,3,7,6,43,-67,4,1,344,161
604,52,5,2,9,4,54,22,8,3,398,183
604,53,5,3,6,7,51,34,9,7,449,217
604,54,4,2,10,3,-54,21,5,8,395,238
604,55,3,3,7,6,34,-67,9,1,429,171
604,56,4,3,8,5,-56,32,3,3,373,203
604,57,3,4,6,7,33,43,6,6,406,246
604,58,3,4,5,8,32,-56,8,0,438,190
604,59,3,4,6,7,-67,43,1,3,371,233
604,60,3,3,5,8,32,35,3,8,403,268
604,61,3,3,8,5,35,-68,8,0,438,200
604,62,2,5,5,8,-77,53,1,3,361,253
604,63,4,3,7,6,43,33,4,6,404,286
604,64,4,2,9,4,45,22,9,8,449,308
604,65,2,4,5,8,-77,-56,2,2,372,252
604,66,4,2,9,4,45,22,7,4,417,274
604,67,3,4,5,8,32,44,9,8,449,318
604,68,5,3,8,5,-47,-68,2,0,402,250
604,69,3,3,6,7,33,34,5,4,435,284
604,70,3,4,5,8,32,44,7,8,467,328
604,71,2,4,5,8,-77,-56,0,2,390,272
604,72,4,3,7,6,43,33,3,5,433,305
604,73,2,4,3,10,21,-54,4,1,454,251
604,74,3,3,6,7,33,34,7,5,487,285
604,75,4,2,7,6,-57,24,0,9,430,309
604,76,5,2,10,3,55,-79,5,0,485,230
604,77,3,3,5,8,32,35,7,5,517,265
605,1,2,4,5,8,23,44,3,4,23,44
605,2,2,4,4,9,22,45,5,9,45,89
605,3,3,5,5,8,32,-47,7,2,77,42
605,4,4,3,8,5,-56,32,1,4,21,74
605,5,3,4,8,5,35,41,6,5,56,115
605,6,3,4,6,7,33,43,9,8,89,158
605,7,2,5,4,9,-78,-46,1,2,11,112
605,8,4,3,9,4,45,31,6,3,56,143
605,9,4,2,6,7,42,25,8,8,98,168
605,10,4,3,5,8,41,-65,9,3,139,103
605,11,2,6,4,9,-78,63,1,6,61,166
605,12,4,4,6,7,42,43,3,9,103,209
605,13,4,3,7,6,43,-67,6,2,146,142
605,14,3,4,4,9,31,45,7,7,177,187
605,15,3,3,7,6,-66,-67,1,0,111,120
605,16,3,3,7,6,34,33,5,3,145,153
605,17,3,4,3,10,30,46,5,9,175,199
605,18,2,5,6,7,24,-48,9,1,199,151
605,19,3,3,8,5,-65,32,4,3,134,183
605,20,2,4,3,10,21,46,5,9,155,229
605,21,4,2,7,6,43,-76,8,3,198,153
605,22,3,4,7,6,-66,42,2,5,132,195
605,23,3,4,5,8,32,44,4,9,164,239
605,24,3,4,4,9,31,-55,5,4,195,184
605,25,4,2,7,6,43,24,8,8,238,208
605,26,4,2,9,4,-55,-78,3,0,183,130
605,27,3,4,5,8,32,44,5,4,215,174
605,28,3,4,4,9,31,45,6,9,246,219
605,29,3,4,7,6,-66,-58,0,1,180,161
605,30,3,4,5,8,32,44,2,5,212,205
605,31,2,4,5,8,23,44,5,9,235,249
605,32,3,3,7,6,34,-67,9,2,269,182
605,33,2,5,4,9,-78,54,1,6,191,236
605,34,3,4,7,6,34,42,5,8,225,278
605,35,3,3,9,4,-64,31,1,9,161,309
605,36,3,3,7,6,34,-67,5,2,195,242
605,37,3,3,9,4,-64,31,1,3,131,273
605,38,3,3,5,8,32,35,3,8,163,308
605,39,5,2,11,2,56,20,9,8,219,328
605,40,3,3,6,7,-67,-66,2,2,152,262
605,41,2,5,4,9,22,54,4,6,174,316
605,42,3,3,7,6,34,33,8,9,208,349
605,43,5,2,11,2,-44,20,4,9,164,369
605,44,5,2,9,4,54,-78,8,1,218,291
605,45,2,5,4,9,-78,54,0,5,140,345
605,46,2,6,5,8,23,62,3,7,163,407
605,47,4,2,5,8,41,-74,4,3,204,333
605,48,5,2,7,6,52,24,6,7,256,357
605,49,5,2,11,2,-44,20,2,7,212,377
605,50,3,4,7,6,34,42,6,9,246,419
605,51,6,2,9,4,63,-78,9,1,309,341
605,52,3,4,3,10,30,46,9,7,339,387
605,53,5,2,10,3,-45,21,4,8,294,408
605,54,5,2,11,2,-44,20,0,8,250,428
605,55,3,4,6,7,33,-57,3,1,283,371
605,56,3,4,5,8,32,44,5,5,315,415
605,57,2,5,5,8,23,53,8,8,338,468
605,58,3,3,10,3,-63,30,5,8,275,498
605,59,2,5,4,9,22,-46,7,2,297,452
605,60,4,2,7,6,-57,24,0,6,240,476
605,61,3,4,6,7,33,43,3,9,273,519
606,1,2,5,7,6,25,51,5,1,25,51
606,2,4,3,7,6,43,33,8,4,68,84
606,3,4,3,8,5,-56,32,2,6,12,116
606,4,3,3,4,9,31,-64,3,2,43,52
606,5,4,2,9,4,45,22,8,4,88,74
606,6,4,2,5,8,41,-74,9,0,129,0
606,7,3,3,9,4,-64,31,5,1,65,31
606,8,4,3,6,7,42,34,7,5,107,65
606,9,3,3,6,7,-67,34,0,9,40,99
606,10,3,3,8,5,35,-68,5,1,75,31
606,11,4,2,9,4,-55,22,0,3,20,53
606,12,2,4,7,6,25,42,5,5,45,95
606,13,3,4,6,7,33,43,8,8,78,138
606,14,2,4,5,8,-77,-56,1,2,1,82
606,15,2,5,4,9,22,54,3,6,23,136
606,16,5,2,8,5,53,23,6,9,76,159
606,17,3,4,7,6,-66,-58,0,1,10,101
606,18,2,5,5,8,23,53,3,4,33,154
606,19,3,3,5,8,32,35,5,9,65,189
606,20,2,4,9,4,-73,40,2,9,-8,229
606,21,3,3,6,7,33,-66,5,3,25,163
606,22,6,2,11,2,-35,20,0,3,-10,183
606,23,5,2,7,6,52,24,2,7,42,207
606,24,3,3,7,6,34,-67,6,0,76,140
606,25,4,3,7,6,43,33,9,3,119,173
606,26,5,2,9,4,-46,22,3,5,73,195
606,27,2,4,4,9,22,-55,5,0,95,140
606,28,2,5,2,11,20,56,5,6,115,196
606,29,4,3,8,5,44,32,9,8,159,228
606,30,3,5,4,9,-69,-46,0,2,90,182
606,31,2,5,3,10,21,55,1,7,111,237
606,32,5,3,10,3,55,30,6,7,166,267
606,33,3,3,7,6,-66,-67,0,0,100,200
606,34,4,2,9,4,45,22,5,2,145,222
606,35,2,4,5,8,23,44,8,6,168,266
606,36,2,6,3,10,21,-36,9,0,189,230
606,37,6,2,10,3,-36,21,3,1,153,251
606,38,3,5,5,8,32,53,5,4,185,304
606,39,3,3,5,8,32,35,7,9,217,339
606,40,2,4,6,7,-76,-57,1,2,141,282
606,41,2,4,6,7,24,43,5,5,165,325
606,42,3,3,5,8,32,-65,7,0,197,260
606,43,4,4,8,5,-56,41,1,1,141,301
606,44,5,2,11,2,56,20,7,1,197,321
606,45,4,3,8,5,-56,32,1,3,141,353
606,46,3,4,4,9,31,45,2,8,172,398
606,47,4,3,7,6,43,-67,5,1,215,331
606,48,3,3,4,9,31,36,6,7,246,367
606,49,3,3,7,6,-66,-67,0,0,180,300
606,50,3,3,4,9,31,36,1,6,211,336
606,51,2,5,7,6,25,51,6,7,236,387
606,52,3,3,6,7,33,-66,9,1,269,321
606,53,3,4,8,5,-65,41,4,2,204,362
606,54,3,4,6,7,33,43,7,5,237,405
606,55,3,4,6,7,-67,43,0,8,170,448
606,56,5,2,9,4,54,-78,4,0,224,370
606,57,2,5,3,10,21,55,5,5,245,425
606,58,3,4,6,7,33,43,8,8,278,468
606,59,3,4,5,8,-68,-56,0,2,210,412
606,60,5,2,7,6,52,24,2,6,262,436
606,61,2,5,2,11,20,-44,2,2,282,392
606,62,2,6,3,10,21,64,3,6,303,456
606,63,4,4,8,5,44,41,7,7,347,497
606,64,2,5,5,8,-77,-47,0,0,270,450
606,65,4,3,7,6,43,33,3,3,313,483
606,66,3,3,7,6,34,33,7,6,347,516
607,1,4,3,8,5,44,32,4,2,44,32
607,2,3,4,4,9,31,45,5,7,75,77
607,3,4,3,8,5,44,32,9,9,119,109
607,4,4,2,5,8,-59,-74,0,5,60,35
607,5,3,3,8,5,35,32,5,7,95,67
607,6,4,2,8,5,44,-77,9,0,139,-10
607,7,3,4,6,7,-67,43,2,3,72,33
607,8,4,3,8,5,44,32,6,5,116,65
607,9,3,3,8,5,-65,32,1,7,51,97
607,10,3,4,6,7,33,-57,4,0,84,40
607,11,2,4,5,8,23,44,7,4,107,84
607,12,4,3,5,8,41,35,8,9,148,119
607,13,2,4,3,10,21,-54,9,5,169,65
607,14,6,2,9,4,-37,22,2,7,132,87
607,15,5,2,7,6,52,-76,4,1,184,11
607,16,3,3,9,4,-64,31,0,2,120,42
607,17,2,6,4,9,22,63,2,5,142,105
607,18,2,4,8,5,26,41,8,6,168,146
607,19,4,3,9,4,-55,31,3,7,113,177
607,20,3,4,7,6,34,42,7,9,147,219
607,21,3,3,7,6,-66,-67,1,2,81,152
607,22,3,4,7,6,34,42,5,4,115,194
607,23,3,3,7,6,34,33,9,7,149,227
607,24,3,3,8,5,-65,32,4,9,84,259
607,25,2,5,6,7,24,-48,8,1,108,211
607,26,5,2,8,5,-47,23,1,4,61,234
607,27,4,3,9,4,45,31,6,5,106,265
607,28,4,3,7,6,43,33,9,8,149,298
607,29,3,3,7,6,-66,-67,3,1,83,231
607,30,3,4,6,7,33,43,6,4,116,274
607,31,2,4,6,7,-76,43,0,7,40,317
607,32,5,2,8,5,53,-77,3,0,93,240
607,33,5,2,9,4,54,22,7,2,147,262
607,34,3,4,5,8,32,44,9,6,179,306
607,35,5,2,10,3,-45,21,4,7,134,327
607,36,4,3,9,4,45,31,9,8,179,358
607,37,2,5,2,11,20,-44,9,4,199,314
607,38,2,5,5,8,-77,53,2,7,122,367
607,39,3,3,6,7,33,-66,5,1,155,301
607,40,2,5,5,8,23,53,8,4,178,354
607,41,2,5,5,8,-77,53,1,7,101,407
607,42,4,3,8,5,44,32,5,9,145,439
607,43,4,3,9,4,-55,-69,0,0,90,370
607,44,2,4,3,10,21,46,1,6,111,416
607,45,3,3,8,5,35,32,6,8,146,448
607,46,6,2,7,6,61,-76,7,2,207,372
607,47,4,3,8,5,-56,32,1,4,151,404
607,48,4,2,9,4,45,22,6,6,196,426
607,49,2,5,6,7,-76,52,0,8,120,478
607,50,4,2,7,6,43,-76,3,2,163,402
607,51,2,4,2,11,20,47,3,9,183,449
607,52,4,3,6,7,42,-66,5,3,225,383
607,53,5,2,10,3,-45,21,0,4,180,404
607,54,2,5,3,10,21,55,1,9,201,459
607,55,4,2,10,3,46,-79,7,0,247,380
607,56,5,2,7,6,52,24,9,4,299,404
607,57,4,2,8,5,-56,23,3,7,243,427
607,58,2,5,3,10,21,-45,4,2,264,382
607,59,4,2,8,5,44,23,8,5,308,405
607,60,3,3,7,6,-66,33,2,8,242,438
607,61,6,2,8,5,62,-77,4,1,304,361
607,62,3,4,8,5,35,41,9,2,339,402
607,63,3,3,7,6,-66,33,3,5,273,435
607,64,2,5,6,7,24,52,7,7,297,487
607,65,3,3,7,6,-66,-67,1,0,231,420
607,66,6,2,9,4,63,22,4,2,294,442
607,67,3,3,6,7,33,34,7,6,327,476
607,68,3,3,7,6,-66,33,1,9,261,509
608,1,3,3,7,6,34,33,4,3,34,33
608,2,4,3,6,7,42,34,6,7,76,67
608,3,3,4,7,6,-66,42,0,9,10,109
608,4,3,3,9,4,36,-69,6,0,46,40
608,5,3,3,5,8,32,35,8,5,78,75
608,6,3,4,7,6,-66,42,2,7,12,117
608,7,4,3,7,6,43,-67,5,0,55,50
608,8,3,3,9,4,-64,31,1,1,-9,81
608,9,4,2,10,3,46,21,7,2,37,102
608,10,5,2,9,4,-46,22,1,4,-9,124
608,11,3,3,6,7,33,34,4,8,24,158
608,12,3,4,5,8,32,-56,6,2,56,102
608,13,4,2,8,5,-56,23,0,5,0,125
608,14,2,5,4,9,22,54,2,9,22,179
608,15,5,2,8,5,53,-77,5,2,75,102
608,16,3,3,10,3,-63,30,2,2,12,132
608,17,2,4,5,8,23,44,5,6,35,176
608,18,2,5,3,10,21,-45,6,1,56,131
608,19,2,4,7,6,-75,42,1,3,-19,173
608,20,4,2,8,5,44,23,5,6,25,196
608,21,4,2,5,8,41,-74,6,2,66,122
608,22,2,4,9,4,-73,40,3,2,-7,162
608,23,4,2,5,8,41,26,4,8,34,188
608,24,3,4,5,8,32,-56,6,2,66,132
608,25,2,5,3,10,21,55,7,7,87,187
608,26,2,5,3,10,21,-45,8,2,108,142
608,27,4,2,10,3,-54,21,4,3,54,163
608,28,2,5,3,10,21,55,5,8,75,218
608,29,2,5,4,9,22,-46,7,2,97,172
608,30,3,3,8,5,-65,32,2,4,32,204
608,31,3,3,6,7,33,34,5,8,65,238
608,32,3,3,5,8,32,-65,7,3,97,173
608,33,4,2,6,7,42,25,9,8,139,198
608,34,4,3,9,4,-55,31,4,9,84,229
608,35,3,4,6,7,33,-57,7,2,117,172
608,36,4,2,7,6,-57,24,0,6,60,196
608,37,4,2,5,8,41,-74,1,2,101,122
608,38,2,5,4,9,22,54,3,6,123,176
608,39,2,5,5,8,23,53,6,9,146,229
608,40,4,2,8,5,-56,-77,0,2,90,152
608,41,2,5,4,9,22,54,2,6,112,206
608,42,3,3,6,7,33,-66,5,0,145,140
608,43,4,2,8,5,44,23,9,3,189,163
608,44,4,2,8,5,-56,23,3,6,133,186
608,45,2,5,4,9,22,-46,5,0,155,140
608,46,3,3,8,5,-65,32,0,2,90,172
608,47,3,3,7,6,34,33,4,5,124,205
608,48,2,5,3,10,21,-45,5,0,145,160
608,49,4,2,7,6,43,24,8,4,188,184
608,50,4,3,8,5,-56,32,2,6,132,216
608,51,3,3,7,6,34,33,6,9,166,249
608,52,5,2,10,3,-45,-79,1,0,121,170
608,53,2,5,5,8,23,53,4,3,144,223
608,54,3,3,9,4,-64,31,0,4,80,254
608,55,3,3,9,4,36,31,6,5,116,285
608,56,5,2,8,5,53,23,9,8,169,308
608,57,3,3,8,5,-65,-68,4,0,104,240
608,58,3,4,4,9,31,45,5,5,135,285
608,59,3,3,3,10,30,-63,5,2,165,222
608,60,3,4,5,8,32,44,7,6,197,266
608,61,4,2,9,4,-55,22,2,8,142,288
608,62,3,3,8,5,35,-68,7,0,177,220
608,63,3,4,3,10,30,46,7,6,207,266
608,64,3,3,9,4,-64,31,3,7,143,297
608,65,4,3,6,7,42,-66,5,1,185,231
608,66,5,2,8,5,53,23,8,4,238,254
608,67,2,6,2,11,20,65,8,9,258,319
608,68,3,4,8,5,-65,-59,3,0,193,260
608,69,3,4,7,6,34,42,7,2,227,302
608,70,4,2,8,5,-56,23,1,5,171,325
608,71,4,2,5,8,41,-74,2,1,212,251
608,72,4,3,7,6,43,33,5,4,255,284
608,73,3,4,7,6,34,42,9,6,289,326
608,74,3,4,4,9,-69,-55,0,1,220,271
608,75,4,2,8,5,44,23,4,4,264,294
608,76,3,4,4,9,31,45,5,9,295,339
608,77,3,3,7,6,34,-67,9,2,329,272
608,78,3,4,5,8,-68,44,1,6,261,316
608,79,2,4,5,8,23,-56,4,0,284,260
608,80,3,4,3,10,30,46,4,6,314,306
608,81,4,3,8,5,44,32,8,8,358,338
608,82,5,2,8,5,-47,-77,1,1,311,261
608,83,3,4,4,9,31,45,2,6,342,306
608,84,4,3,10,3,46,30,8,6,388,336
608,85,3,4,6,7,-67,43,1,9,321,379
608,86,4,3,9,4,45,-69,6,0,366,310
608,87,2,5,3,10,21,55,7,5,387,365
608,88,4,2,8,5,-56,23,1,8,331,388
608,89,3,3,6,7,33,-66,4,2,364,322
608,90,3,4,4,9,31,45,5,7,395,367
608,91,4,2,8,5,44,-77,9,0,439,290
608,92,2,5,4,9,-78,54,1,4,361,344
608,93,4,3,10,3,46,30,7,4,407,374
608,94,3,4,7,6,-66,42,1,6,341,416
608,95,5,2,7,6,52,-76,3,0,393,340
608,96,2,5,7,6,25,51,8,1,418,391
608,97,3,3,8,5,-65,32,3,3,353,423
608,98,2,5,5,8,23,53,6,6,376,476
608,99,3,4,6,7,33,43,9,9,409,519
609,1,2,5,6,7,24,52,4,2,24,52
609,2,3,3,9,4,-64,31,0,3,-40,83
609,3,2,4,8,5,26,41,6,4,-14,124
609,4,3,3,8,5,-65,32,1,6,-79,156
609,5,3,3,5,8,32,-65,3,1,-47,91
609,6,4,3,8,5,44,32,7,3,-3,123
609,7,5,2,7,6,52,24,9,7,49,147
609,8,4,3,8,5,-56,32,3,9,-7,179
609,9,4,2,6,7,42,-75,5,4,35,104
609,10,3,3,7,6,34,33,9,7,69,137
609,11,2,5,5,8,-77,-47,2,0,-8,90
609,12,2,5,2,11,20,56,2,6,12,146
609,13,2,5,6,7,24,52,6,8,36,198
609,14,3,3,5,8,32,-65,8,3,68,133
609,15,5,2,10,3,-45,21,3,4,23,154
609,16,3,3,7,6,34,33,7,7,57,187
609,17,3,3,5,8,32,-65,9,2,89,122
609,18,4,3,7,6,-57,33,2,5,32,155
609,19,5,2,10,3,55,21,7,6,87,176
609,20,3,3,6,7,-67,-66,0,0,20,110
609,21,3,3,6,7,33,34,3,4,53,144
609,22,3,4,6,7,33,43,6,7,86,187
609,23,4,2,7,6,43,-76,9,1,129,111
609,24,4,2,8,5,-56,23,3,4,73,134
609,25,4,3,8,5,44,32,7,6,117,166
609,26,3,3,7,6,-66,33,1,9,51,199
609,27,5,2,8,5,53,-77,4,2,104,122
609,28,4,2,7,6,43,24,7,6,147,146
609,29,4,3,6,7,42,-66,9,0,189,80
609,30,4,3,7,6,-57,33,2,3,132,113
609,31,4,3,7,6,43,33,5,6,175,146
609,32,3,4,3,10,30,-54,5,2,205,92
609,33,4,2,6,7,42,25,7,7,247,117
609,34,3,4,4,9,31,-55,8,2,278,62
609,35,5,2,9,4,-46,22,2,4,232,84
609,36,3,3,7,6,34,33,6,7,266,117
609,37,3,3,6,7,33,-66,9,1,299,51
609,38,4,3,5,8,-59,35,0,6,240,86
609,39,2,6,4,9,22,63,2,9,262,149
609,40,2,4,5,8,23,-56,5,3,285,93
609,41,4,2,9,4,-55,22,0,5,230,115
609,42,3,4,5,8,32,44,2,9,262,159
609,43,2,4,6,7,24,-57,6,2,286,102
609,44,2,4,6,7,-76,43,0,5,210,145
609,45,3,5,5,8,32,53,2,8,242,198
609,46,3,3,4,9,31,-64,3,4,273,134
609,47,3,4,5,8,32,44,5,8,305,178
609,48,3,5,6,7,33,-48,8,0,338,130
609,49,2,4,7,6,-75,42,3,2,263,172
609,50,2,4,3,10,21,46,4,8,284,218
609,51,5,2,9,4,54,-78,8,0,338,140
609,52,3,3,7,6,-66,33,2,3,272,173
609,53,2,5,5,8,23,53,5,6,295,226
609,54,4,3,8,5,44,32,9,8,339,258
609,55,4,3,6,7,-58,-66,1,2,281,192
609,56,3,3,5,8,32,35,3,7,313,227
609,57,4,3,6,7,42,-66,5,1,355,161
609,58,5,2,10,3,-45,21,0,2,310,182
609,59,4,2,7,6,43,24,3,6,353,206
609,60,2,5,6,7,24,52,7,8,377,258
609,61,2,5,6,7,-76,-48,1,0,301,210
609,62,4,3,10,3,46,30,7,0,347,240
609,63,2,4,8,5,-74,41,3,1,273,281
609,64,3,3,8,5,35,32,8,3,308,313
609,65,2,4,8,5,-74,41,4,4,234,354
609,66,2,5,4,9,22,54,6,8,256,408
609,67,2,4,4,9,22,-55,8,3,278,353
609,68,3,3,7,6,-66,33,2,6,212,386
609,69,3,3,9,4,36,31,8,7,248,417
609,70,4,2,8,5,-56,-77,2,0,192,340
609,71,4,3,5,8,41,35,3,5,233,375
609,72,2,5,4,9,22,54,5,9,255,429
609,73,2,4,7,6,-75,-58,0,1,180,371
609,74,4,3,5,8,41,35,1,6,221,406
609,75,4,4,7,6,43,42,4,8,264,448
609,76,3,4,5,8,32,-56,6,2,296,392
609,77,4,2,6,7,42,25,8,7,338,417
609,78,3,3,5,8,-68,-65,0,2,270,352
609,79,2,5,4,9,22,54,2,6,292,406
609,80,3,4,8,5,35,41,7,7,327,447
609,81,3,3,8,5,-65,32,2,9,262,479
609,82,3,3,6,7,33,-66,5,3,295,413
609,83,4,3,7,6,43,33,8,6,338,446
609,84,2,5,3,10,21,-45,9,1,359,401
609,85,3,4,8,5,-65,41,4,2,294,442
609,86,5,2,9,4,54,22,8,4,348,464
609,87,3,3,7,6,-66,33,2,7,282,497
609,88,3,3,8,5,35,32,7,9,317,529
610,1,3,3,9,4,36,31,6,1,36,31
610,2,3,4,6,7,33,43,9,4,69,74
610,3,4,2,8,5,-56,23,3,7,13,97
610,4,3,3,7,6,34,-67,7,0,47,30
610,5,4,3,6,7,42,34,9,4,89,64
610,6,4,3,8,5,-56,32,3,6,33,96
610,7,2,4,5,8,23,-56,6,0,56,40
610,8,2,4,4,9,22,45,8,5,78,85
610,9,5,2,8,5,-47,23,1,8,31,108
610,10,2,5,3,10,21,-45,2,3,52,63
610,11,3,4,5,8,32,44,4,7,84,107
610,12,4,2,10,3,-54,21,0,8,30,128
610,13,3,4,6,7,33,-57,3,1,63,71
610,14,4,3,6,7,42,34,5,5,105,105
610,15,4,2,5,8,41,-74,6,1,146,31
610,16,5,2,8,5,53,23,9,4,199,54
610,17,4,2,8,5,-56,23,3,7,143,77
610,18,4,2,7,6,43,-76,6,1,186,1
610,19,3,3,7,6,-66,33,0,4,120,34
610,20,3,3,8,5,35,32,5,6,155,66
610,21,3,4,7,6,34,42,9,8,189,108
610,22,5,2,7,6,-48,-76,1,2,141,32
610,23,3,4,5,8,32,44,3,6,173,76
610,24,4,3,7,6,43,33,6,9,216,109
610,25,5,2,9,4,-46,-78,0,1,170,31
610,26,3,3,8,5,35,32,5,3,205,63
610,27,4,3,10,3,-54,30,1,3,151,93
610,28,2,4,5,8,23,44,4,7,174,137
610,29,2,4,7,6,25,42,9,9,199,179
610,30,5,2,9,4,-46,-78,3,1,153,101
610,31,4,2,6,7,42,25,5,6,195,126
610,32,3,3,7,6,34,33,9,9,229,159
610,33,2,5,5,8,-77,-47,2,2,152,112
610,34,4,3,8,5,44,32,6,4,196,144
610,35,2,4,6,7,-76,43,0,7,120,187
610,36,3,3,10,3,37,30,7,7,157,217
610,37,4,3,7,6,-57,-67,0,0,100,150
610,38,3,4,7,6,34,42,4,2,134,192
610,39,4,3,9,4,45,31,9,3,179,223
610,40,3,3,8,5,-65,32,4,5,114,255
610,41,3,4,7,6,34,42,8,7,148,297
610,42,4,2,11,2,-53,20,5,7,95,317
610,43,2,4,7,6,-75,42,0,9,20,359
610,44,3,4,8,5,35,-59,5,0,55,300
610,45,3,4,8,5,-65,41,0,1,-10,341
610,46,2,5,4,9,22,54,2,5,12,395
610,47,4,3,9,4,45,31,7,6,57,426
610,48,3,3,9,4,-64,31,3,7,-7,457
610,49,2,4,7,6,25,42,8,9,18,499
610,50,3,3,5,8,-68,-65,0,4,-50,434
610,51,2,4,6,7,24,43,4,7,-26,477
610,52,2,5,4,9,22,-46,6,1,-4,431
610,53,3,3,4,9,31,36,7,7,27,467
610,54,5,3,10,3,-45,30,2,7,-18,497
610,55,5,3,9,4,54,31,6,8,36,528
611,1,3,4,6,7,33,43,3,3,33,43
611,2,3,5,4,9,31,54,4,7,64,97
611,3,2,4,5,8,23,-56,7,1,87,41
611,4,2,5,3,10,21,55,8,6,108,96
611,5,5,2,11,2,-44,20,4,6,64,116
611,6,4,3,7,6,43,33,7,9,107,149
611,7,4,3,4,9,40,-64,7,5,147,85
611,8,3,3,5,8,32,-65,9,0,179,20
611,9,2,5,5,8,-77,53,2,3,102,73
611,10,4,3,8,5,44,32,6,5,146,105
611,11,4,2,8,5,-56,23,0,8,90,128
611,12,2,5,4,9,22,-46,2,2,112,82
611,13,3,3,4,9,31,36,3,8,143,118
611,14,2,5,3,10,21,-45,4,3,164,73
611,15,5,2,8,5,53,23,7,6,217,96
611,16,6,2,10,3,-36,21,1,7,181,117
611,17,3,3,7,6,34,-67,5,0,215,50
611,18,3,3,7,6,34,33,9,3,249,83
611,19,2,4,5,8,-77,44,2,7,172,127
611,20,6,2,9,4,63,22,5,9,235,149
611,21,2,4,5,8,23,-56,8,3,258,93
611,22,3,3,5,8,-68,35,0,8,190,128
611,23,2,4,3,10,21,-54,1,4,211,74
611,24,4,2,10,3,46,21,7,5,257,95
611,25,4,3,10,3,-54,30,3,5,203,125
611,26,4,2,7,6,43,24,6,9,246,149
611,27,2,5,5,8,23,-47,9,2,269,102
611,28,2,5,3,10,-79,55,0,7,190,157
611,29,2,4,4,9,22,-55,2,2,212,102
611,30,3,3,5,8,32,35,4,7,244,137
611,31,3,3,8,5,35,32,9,9,279,169
611,32,2,4,2,11,20,-53,9,6,299,116
611,33,2,4,6,7,-76,43,3,9,223,159
611,34,4,3,7,6,43,-67,6,2,266,92
611,35,3,4,5,8,32,44,8,6,298,136
611,36,3,3,9,4,-64,31,4,7,234,167
611,37,5,2,8,5,53,-77,7,0,287,90
611,38,2,5,7,6,-75,51,2,1,212,141
611,39,4,3,6,7,42,34,4,5,254,175
611,40,5,2,11,2,-44,20,0,5,210,195
611,41,3,3,5,8,32,-65,2,0,242,130
611,42,2,5,3,10,21,55,3,5,263,185
611,43,2,4,5,8,23,44,6,9,286,229
611,44,2,5,3,10,21,-45,7,4,307,184
611,45,5,2,8,5,-47,23,0,7,260,207
611,46,2,4,6,7,24,-57,4,0,284,150
611,47,3,4,5,8,32,44,6,4,316,194
611,48,4,3,8,5,-56,32,0,6,260,226
611,49,2,5,5,8,23,53,3,9,283,279
611,50,3,4,6,7,33,-57,6,2,316,222
611,51,4,3,10,3,-54,30,2,2,262,252
611,52,3,3,7,6,34,33,6,5,296,285
611,53,3,4,5,8,32,44,8,9,328,329
611,54,2,4,5,8,-77,-56,1,3,251,273
611,55,3,4,3,10,30,46,1,9,281,319
611,56,4,2,7,6,43,-76,4,3,324,243
611,57,3,3,6,7,33,34,7,7,357,277
611,58,5,2,9,4,-46,22,1,9,311,299
611,59,3,4,6,7,33,-57,4,2,344,242
611,60,2,4,7,6,25,42,9,4,369,284
611,61,4,3,4,9,40,-64,9,0,409,220
611,62,3,4,7,6,-66,42,3,2,343,262
611,63,6,2,10,3,64,21,7,3,407,283
611,64,4,3,8,5,-56,32,1,5,351,315
611,65,3,3,6,7,33,34,4,9,384,349
611,66,4,3,6,7,42,-66,6,3,426,283
611,67,2,5,3,10,21,55,7,8,447,338
611,68,4,3,7,6,-57,-67,0,1,390,271
611,69,4,3,4,9,40,36,0,7,430,307
611,70,4,3,6,7,42,-66,2,1,472,241
611,71,4,2,5,8,41,26,3,7,513,267
612,1,4,3,5,8,41,35,1,5,41,35
612,2,3,4,6,7,33,43,4,8,74,78
612,3,3,3,6,7,33,-66,7,2,107,12
612,4,3,4,5,8,32,44,9,6,139,56
612,5,3,4,6,7,-67,43,2,9,72,99
612,6,2,4,5,8,23,-56,5,3,95,43
612,7,3,3,9,4,-64,31,1,4,31,74
612,8,3,3,6,7,33,34,4,8,64,108
612,9,2,5,7,6,25,51,9,9,89,159
612,10,2,5,3,10,-79,-45,0,4,10,114
612,11,5,2,10,3,55,21,5,5,65,135
612,12,2,4,4,9,22,-55,7,0,87,80
612,13,2,4,5,8,-77,44,0,4,10,124
612,14,4,3,8,5,44,32,4,6,54,156
612,15,2,5,4,9,22,-46,6,0,76,110
612,16,4,3,9,4,-55,31,1,1,21,141
612,17,4,2,6,7,42,25,3,6,63,166
612,18,4,2,9,4,45,22,8,8,108,188
612,19,4,3,7,6,-57,-67,1,1,51,121
612,20,4,3,9,4,45,31,6,2,96,152
612,21,3,4,7,6,-66,42,0,4,30,194
612,22,4,2,7,6,43,24,3,8,73,218
612,23,3,4,7,6,34,-58,7,0,107,160
612,24,4,2,7,6,-57,24,0,4,50,184
612,25,4,3,8,5,44,32,4,6,94,216
612,26,5,2,10,3,55,21,9,7,149,237
612,27,3,4,8,5,-65,41,4,8,84,278
612,28,4,2,10,3,-54,21,0,9,30,299
612,29,2,4,3,10,21,-54,1,5,51,245
612,30,4,3,9,4,45,31,6,6,96,276
612,31,4,3,9,4,-55,31,1,7,41,307
612,32,4,2,5,8,41,-74,2,3,82,233
612,33,3,4,4,9,31,45,3,8,113,278
612,34,3,3,8,5,35,-68,8,0,148,210
612,35,3,3,4,9,31,36,9,6,179,246
612,36,3,4,6,7,-67,43,2,9,112,289
612,37,2,5,4,9,22,-46,4,3,134,243
612,38,2,4,6,7,24,43,8,6,158,286
612,39,4,2,4,9,40,-73,8,3,198,213
612,40,4,3,8,5,-56,32,2,5,142,245
612,41,6,2,8,5,62,23,4,8,204,268
612,42,2,4,3,10,21,-54,5,4,225,214
612,43,5,2,7,6,52,24,7,8,277,238
612,44,3,4,5,8,32,-56,9,2,309,182
612,45,3,3,5,8,-68,35,1,7,241,217
612,46,3,3,8,5,35,32,6,9,276,249
612,47,4,3,6,7,42,-66,8,3,318,183
612,48,4,3,6,7,-58,34,0,7,260,217
612,49,3,4,6,7,33,-57,3,0,293,160
612,50,3,4,6,7,33,43,6,3,326,203
612,51,2,4,4,9,22,45,8,8,348,248
612,52,2,5,6,7,-76,-48,2,0,272,200
612,53,3,4,8,5,35,41,7,1,307,241
612,54,3,3,7,6,-66,33,1,4,241,274
612,55,2,4,4,9,22,45,3,9,263,319
612,56,3,3,9,4,36,-69,9,0,299,250
612,57,4,2,7,6,-57,24,2,4,242,274
612,58,4,3,10,3,46,30,8,4,288,304
612,59,4,2,8,5,-56,23,2,7,232,327
612,60,3,3,8,5,35,32,7,9,267,359
612,61,5,2,8,5,-47,-77,0,2,220,282
612,62,2,5,3,10,21,55,1,7,241,337
612,63,3,3,7,6,34,-67,5,0,275,270
612,64,5,2,9,4,54,22,9,2,329,292
612,65,4,3,7,6,-57,33,2,5,272,325
612,66,5,2,10,3,55,21,7,6,327,346
612,67,2,5,3,10,21,-45,8,1,348,301
612,68,4,3,6,7,-58,34,0,5,290,335
612,69,2,5,4,9,22,54,2,9,312,389
612,70,5,2,7,6,52,-76,4,3,364,313
612,71,4,2,7,6,43,24,7,7,407,337
612,72,3,4,8,5,-65,41,2,8,342,378
612,73,3,4,6,7,33,-57,5,1,375,321
612,74,4,4,8,5,44,41,9,2,419,362
612,75,3,4,7,6,-66,42,3,4,353,404
612,76,3,4,6,7,33,43,6,7,386,447
612,77,5,2,10,3,-45,21,1,8,341,468
612,78,2,4,3,10,21,-54,2,4,362,414
612,79,2,5,2,11,20,-44,2,0,382,370
612,80,3,3,5,8,32,35,4,5,414,405
612,81,4,4,6,7,42,43,6,8,456,448
612,82,4,3,10,3,-54,30,2,8,402,478
612,83,2,5,4,9,22,-46,4,2,424,432
612,84,2,5,4,9,22,54,6,6,446,486
612,85,3,4,4,9,31,-55,7,1,477,431
612,86,4,2,10,3,-54,21,3,2,423,452
612,87,3,4,5,8,32,44,5,6,455,496
612,88,4,2,9,4,-55,22,0,8,400,518
613,1,3,4,4,9,31,45,1,5,31,45
613,2,3,4,6,7,33,43,4,8,64,88
613,3,3,3,9,4,-64,31,0,9,0,119
613,4,3,5,6,7,33,-48,3,1,33,71
613,5,4,2,8,5,44,23,7,4,77,94
613,6,4,2,6,7,42,25,9,9,119,119
613,7,3,3,5,8,-68,-65,1,4,51,54
613,8,5,3,7,6,52,33,3,7,103,87
613,9,2,4,2,11,20,-53,3,4,123,34
613,10,3,3,9,4,36,31,9,5,159,65
613,11,4,3,9,4,-55,31,4,6,104,96
613,12,4,2,7,6,43,-76,7,0,147,20
613,13,4,3,8,5,-56,32,1,2,91,52
613,14,5,2,11,2,56,20,7,2,147,72
613,15,4,4,4,9,40,45,7,7,187,117
613,16,4,2,8,5,-56,-77,1,0,131,40
613,17,2,4,8,5,26,41,7,1,157,81
613,18,4,2,9,4,-55,22,2,3,102,103
613,19,5,2,10,3,55,21,7,4,157,124
613,20,3,3,6,7,-67,34,0,8,90,158
613,21,3,4,4,9,31,-55,1,3,121,103
613,22,3,3,5,8,32,35,3,8,153,138
613,23,3,3,6,7,33,-66,6,2,186,72
613,24,3,3,6,7,33,34,9,6,219,106
613,25,4,2,7,6,-57,-76,2,0,162,30
613,26,4,3,7,6,43,33,5,3,205,63
613,27,3,4,4,9,31,45,6,8,236,108
613,28,5,2,8,5,53,-77,9,1,289,31
613,29,3,3,6,7,-67,34,2,5,222,65
613,30,2,4,3,10,21,-54,3,1,243,11
613,31,3,3,5,8,32,35,5,6,275,46
613,32,5,2,9,4,54,22,9,8,329,68
613,33,3,4,4,9,-69,-55,0,3,260,13
613,34,3,5,6,7,33,52,3,5,293,65
613,35,3,4,5,8,32,44,5,9,325,109
613,36,3,4,7,6,34,-58,9,1,359,51
613,37,3,3,8,5,-65,32,4,3,294,83
613,38,4,2,7,6,43,24,7,7,337,107
613,39,5,2,8,5,-47,-77,0,0,290,30
613,40,2,4,8,5,26,41,6,1,316,71
613,41,4,2,7,6,43,24,9,5,359,95
613,42,2,5,5,8,-77,53,2,8,282,148
613,43,2,4,4,9,22,-55,4,3,304,93
613,44,5,2,9,4,54,22,8,5,358,115
613,45,2,5,4,9,-78,54,0,9,280,169
613,46,5,2,7,6,52,-76,2,3,332,93
613,47,2,5,2,11,20,56,2,9,352,149
613,48,3,4,4,9,31,-55,3,4,383,94
613,49,3,3,9,4,36,31,9,5,419,125
613,50,3,4,8,5,-65,41,4,6,354,166
613,51,4,3,5,8,41,-65,5,1,395,101
613,52,5,2,9,4,54,22,9,3,449,123
613,53,2,4,5,8,-77,44,2,7,372,167
613,54,5,2,11,2,56,20,8,7,428,187
613,55,4,2,6,7,-58,-75,0,2,370,112
613,56,4,3,6,7,42,34,2,6,412,146
613,57,5,2,9,4,54,22,6,8,466,168
613,58,2,4,3,10,21,-54,7,4,487,114
613,59,4,3,10,3,-54,30,3,4,433,144
613,60,4,3,5,8,41,35,4,9,474,179
613,61,3,4,7,6,34,-58,8,1,508,121
614,1,3,3,6,7,33,34,3,4,33,34
614,2,3,4,5,8,32,44,5,8,65,78
614,3,5,2,11,2,-44,20,1,8,21,98
614,4,4,2,9,4,45,-78,6,0,66,20
614,5,3,4,3,10,30,46,6,6,96,66
614,6,2,4,3,10,21,-54,7,2,117,12
614,7,3,3,5,8,32,35,9,7,149,47
614,8,3,3,5,8,-68,-65,1,2,81,-18
614,9,2,5,3,10,21,55,2,7,102,37
614,10,4,2,9,4,45,22,7,9,147,59
614,11,4,2,8,5,-56,-77,1,2,91,-18
614,12,3,4,6,7,33,43,4,5,124,25
614,13,2,4,3,10,21,-54,5,1,145,-29
614,14,4,3,10,3,-54,30,1,1,91,1
614,15,3,4,8,5,35,41,6,2,126,42
614,16,3,3,9,4,-64,31,2,3,62,73
614,17,3,4,6,7,33,43,5,6,95,116
614,18,2,4,2,11,20,-53,5,3,115,63
614,19,3,4,7,6,34,42,9,5,149,105
614,20,2,4,8,5,-74,41,5,6,75,146
614,21,3,4,8,5,-65,41,0,7,10,187
614,22,4,2,8,5,44,-77,4,0,54,110
614,23,2,5,2,11,20,56,4,6,74,166
614,24,3,4,6,7,33,43,7,9,107,209
614,25,2,6,2,11,20,-35,7,4,127,174
614,26,3,3,7,6,-66,33,1,7,61,207
614,27,3,5,6,7,33,52,4,9,94,259
614,28,3,4,5,8,32,-56,6,3,126,203
614,29,4,3,9,4,-55,31,1,4,71,234
614,30,3,4,5,8,32,44,3,8,103,278
614,31,5,2,10,3,55,21,8,9,158,299
614,32,2,5,5,8,-77,-47,1,2,81,252
614,33,5,2,9,4,54,22,5,4,135,274
614,34,5,2,8,5,53,23,8,7,188,297
614,35,4,3,8,5,-56,32,2,9,132,329
614,36,4,3,8,5,44,-68,6,1,176,261
614,37,3,4,8,5,-65,41,1,2,111,302
614,38,2,6,2,11,20,65,1,7,131,367
614,39,3,3,4,9,31,-64,2,3,162,303
614,40,4,2,7,6,43,24,5,7,205,327
614,41,3,3,5,8,32,-65,7,2,237,262
614,42,4,3,6,7,42,34,9,6,279,296
614,43,4,2,10,3,-54,21,5,7,225,317
614,44,3,3,6,7,33,-66,8,1,258,251
614,45,3,3,4,9,31,36,9,7,289,287
614,46,4,3,6,7,-58,-66,1,1,231,221
614,47,3,3,8,5,35,32,6,3,266,253
614,48,4,4,8,5,-56,41,0,4,210,294
614,49,2,5,3,10,21,55,1,9,231,349
614,50,3,3,5,8,32,-65,3,4,263,284
614,51,2,4,5,8,23,44,6,8,286,328
614,52,3,3,3,10,30,-63,6,5,316,265
614,53,4,2,8,5,-56,23,0,8,260,288
614,54,2,5,6,7,24,-48,4,0,284,240
614,55,4,3,9,4,45,31,9,1,329,271
614,56,2,4,6,7,-76,43,3,4,253,314
614,57,2,5,4,9,22,54,5,8,275,368
614,58,3,3,7,6,34,-67,9,1,309,301
614,59,2,4,5,8,-77,44,2,5,232,345
614,60,3,3,5,8,32,-65,4,0,264,280
614,61,3,3,5,8,32,35,6,5,296,315
614,62,4,3,9,4,-55,31,1,6,241,346
614,63,4,3,7,6,43,33,4,9,284,379
614,64,2,4,6,7,24,-57,8,2,308,322
614,65,4,3,7,6,-57,33,1,5,251,355
614,66,3,4,6,7,33,43,4,8,284,398
614,67,2,4,4,9,22,-55,6,3,306,343
614,68,3,4,7,6,-66,42,0,5,240,385
614,69,4,2,8,5,44,23,4,8,284,408
614,70,4,3,7,6,43,-67,7,1,327,341
614,71,4,2,8,5,-56,23,1,4,271,364
614,72,4,2,8,5,44,23,5,7,315,387
614,73,2,5,6,7,24,52,9,9,339,439
614,74,3,3,6,7,-67,-66,2,3,272,373
614,75,3,4,8,5,35,41,7,4,307,414
614,76,2,4,6,7,-76,43,1,7,231,457
614,77,2,5,3,10,21,-45,2,2,252,412
614,78,3,4,6,7,33,43,5,5,285,455
614,79,3,3,8,5,-65,32,0,7,220,487
614,80,4,3,7,6,43,-67,3,0,263,420
614,81,2,4,4,9,22,45,5,5,285,465
614,82,4,3,9,4,-55,31,0,6,230,496
614,83,3,3,6,7,33,-66,3,0,263,430
614,84,3,4,7,6,34,42,7,2,297,472
614,85,4,3,8,5,-56,32,1,4,241,504
615,1,2,5,6,7,24,52,4,2,24,52
615,2,2,5,7,6,25,51,9,3,49,103
615,3,4,2,6,7,-58,25,1,8,-9,128
615,4,5,2,8,5,53,-77,4,1,44,51
615,5,2,5,4,9,22,54,6,5,66,105
615,6,2,5,5,8,23,53,9,8,89,158
615,7,2,5,2,11,20,-44,9,4,109,114
615,8,5,2,6,7,-49,25,0,9,60,139
615,9,3,3,7,6,34,-67,4,2,94,72
615,10,3,4,7,6,34,42,8,4,128,114
615,11,3,5,7,6,-66,51,2,5,62,165
615,12,4,2,5,8,41,-74,3,1,103,91
615,13,3,3,7,6,34,33,7,4,137,124
615,14,3,3,6,7,-67,34,0,8,70,158
615,15,3,3,4,9,31,-64,1,4,101,94
615,16,5,2,8,5,53,23,4,7,154,117
615,17,2,5,3,10,21,-45,5,2,175,72
615,18,5,2,9,4,54,22,9,4,229,94
615,19,6,2,9,4,-37,22,2,6,192,116
615,20,2,5,3,10,21,-45,3,1,213,71
615,21,3,4,9,4,36,40,9,1,249,111
615,22,3,3,5,8,-68,35,1,6,181,146
615,23,2,4,4,9,22,-55,3,1,203,91
615,24,4,2,10,3,46,21,9,2,249,112
615,25,4,2,8,5,-56,23,3,5,193,135
615,26,4,2,10,3,46,21,9,6,239,156
615,27,5,2,10,3,-45,21,4,7,194,177
615,28,3,3,5,8,32,-65,6,2,226,112
615,29,4,2,9,4,-55,22,1,4,171,134
615,30,5,2,9,4,54,22,5,6,225,156
615,31,4,2,7,6,43,-76,8,0,268,80
615,32,3,4,3,10,30,46,8,6,298,126
615,33,3,3,4,9,31,-64,9,2,329,62
615,34,3,3,7,6,-66,33,3,5,263,95
615,35,4,2,8,5,44,23,7,8,307,118
615,36,6,2,8,5,62,-77,9,1,369,41
615,37,4,3,6,7,-58,34,1,5,311,75
615,38,5,3,9,4,54,31,5,6,365,106
615,39,3,3,8,5,-65,32,0,8,300,138
615,40,3,3,7,6,34,-67,4,1,334,71
615,41,4,3,7,6,43,33,7,4,377,104
615,42,2,5,5,8,-77,53,0,7,300,157
615,43,2,6,3,10,21,-36,1,1,321,121
615,44,4,3,7,6,43,33,4,4,364,154
615,45,4,2,6,7,42,25,6,9,406,179
615,46,4,2,9,4,-55,-78,1,1,351,101
615,47,5,2,8,5,53,23,4,4,404,124
615,48,4,2,7,6,43,24,7,8,447,148
615,49,4,2,7,6,-57,-76,0,2,390,72
615,50,3,4,6,7,33,43,3,5,423,115
615,51,2,5,2,11,20,-44,3,1,443,71
615,52,3,4,4,9,31,45,4,6,474,116
615,53,2,4,7,6,25,42,9,8,499,158
615,54,3,3,6,7,-67,-66,2,2,432,92
615,55,2,4,5,8,23,44,5,6,455,136
615,56,4,2,10,3,-54,21,1,7,401,157
615,57,6,2,11,2,65,20,6,7,466,177
615,58,3,3,4,9,31,-64,7,3,497,113
615,59,2,5,4,9,22,54,9,7,519,167
616,1,4,4,7,6,43,42,3,2,43,42
616,2,2,5,4,9,22,54,5,6,65,96
616,3,4,2,9,4,-55,22,0,8,10,118
616,4,3,3,6,7,33,-66,3,2,43,52
616,5,3,3,6,7,33,34,6,6,76,86
616,6,4,2,8,5,-56,23,0,9,20,109
616,7,3,4,5,8,32,-56,2,3,52,53
616,8,4,3,7,6,43,33,5,6,95,86
616,9,4,2,7,6,43,-76,8,0,138,10
616,10,4,3,8,5,-56,32,2,2,82,42
616,11,3,3,8,5,35,32,7,4,117,74
616,12,4,3,10,3,-54,30,3,4,63,104
616,13,3,4,6,7,33,43,6,7,96,147
616,14,3,3,7,6,-66,-67,0,0,30,80
616,15,3,3,5,8,32,35,2,5,62,115
616,16,4,2,8,5,44,23,6,8,106,138
616,17,2,4,4,9,22,-55,8,3,128,83
616,18,4,3,9,4,-55,31,3,4,73,114
616,19,3,3,7,6,34,33,7,7,107,147
616,20,2,5,7,6,-75,51,2,8,32,198
616,21,3,3,5,8,32,-65,4,3,64,133
616,22,2,4,5,8,23,44,7,7,87,177
616,23,4,2,8,5,-56,-77,1,0,31,100
616,24,2,4,6,7,24,43,5,3,55,143
616,25,3,4,6,7,33,43,8,6,88,186
616,26,3,4,6,7,-67,43,1,9,21,229
616,27,3,4,9,4,36,40,7,9,57,269
616,28,2,4,7,6,-75,-58,2,1,-18,211
616,29,2,4,5,8,23,44,5,5,5,255
616,30,2,4,5,8,23,44,8,9,28,299
616,31,2,5,2,11,20,-44,8,5,48,255
616,32,4,3,7,6,-57,33,1,8,-9,288
616,33,4,3,6,7,42,-66,3,2,33,222
616,34,2,4,3,10,21,46,4,8,54,268
616,35,3,3,9,4,-64,31,0,9,-10,299
616,36,6,2,8,5,62,-77,2,2,52,222
616,37,3,5,7,6,34,51,6,3,86,273
616,38,4,3,6,7,42,34,8,7,128,307
616,39,3,4,4,9,31,-55,9,2,159,252
616,40,5,2,10,3,-45,21,4,3,114,273
616,41,3,3,8,5,35,32,9,5,149,305
616,42,3,3,9,4,-64,31,5,6,85,336
616,43,4,3,7,6,43,33,8,9,128,369
616,44,2,4,7,6,-75,-58,3,1,53,311
616,45,4,2,8,5,44,23,7,4,97,334
616,46,3,4,4,9,31,45,8,9,128,379
616,47,3,4,5,8,-68,-56,0,3,60,323
616,48,4,3,9,4,45,31,5,4,105,354
616,49,3,4,5,8,32,44,7,8,137,398
616,50,4,2,8,5,-56,-77,1,1,81,321
616,51,3,4,7,6,34,42,5,3,115,363
616,52,5,2,8,5,53,23,8,6,168,386
616,53,3,4,6,7,-67,43,1,9,101,429
616,54,3,4,5,8,32,-56,3,3,133,373
616,55,5,2,9,4,54,22,7,5,187,395
616,56,4,3,8,5,-56,32,1,7,131,427
616,57,3,3,5,8,32,-65,3,2,163,362
616,58,5,2,10,3,55,21,8,3,218,383
616,59,2,5,4,9,-78,54,0,7,140,437
616,60,3,4,4,9,31,-55,1,2,171,382
616,61,3,3,7,6,34,33,5,5,205,415
616,62,2,5,3,10,21,-45,6,0,226,370
616,63,3,4,3,10,30,46,6,6,256,416
616,64,4,3,5,8,41,-65,7,1,297,351
616,65,3,4,5,8,32,44,9,5,329,395
616,66,4,3,8,5,-56,32,3,7,273,427
616,67,3,3,7,6,34,-67,7,0,307,360
616,68,3,4,7,6,-66,42,1,2,241,402
616,69,4,2,10,3,46,21,7,3,287,423
616,70,2,5,4,9,22,54,9,7,309,477
616,71,5,2,8,5,-47,-77,2,0,262,400
616,72,3,4,8,5,35,41,7,1,297,441
616,73,2,5,4,9,22,54,9,5,319,495
616,74,2,4,6,7,-76,43,3,8,243,538
617,1,4,3,10,3,46,30,6,0,46,30
617,2,3,3,8,5,-65,32,1,2,-19,62
617,3,4,4,6,7,42,43,3,5,23,105
617,4,4,4,5,8,41,44,4,9,64,149
617,5,4,2,8,5,44,-77,8,2,108,72
617,6,4,3,7,6,-57,33,1,5,51,105
617,7,3,3,7,6,34,33,5,8,85,138
617,8,5,3,7,6,52,-67,7,1,137,71
617,9,3,4,5,8,32,44,9,5,169,115
617,10,5,2,9,4,-46,22,3,7,123,137
617,11,2,4,5,8,23,-56,6,1,146,81
617,12,3,3,7,6,-66,33,0,4,80,114
617,13,2,5,5,8,23,53,3,7,103,167
617,14,3,4,5,8,32,-56,5,1,135,111
617,15,3,4,6,7,33,43,8,4,168,154
617,16,3,3,8,5,-65,32,3,6,103,186
617,17,2,6,4,9,22,63,5,9,125,249
617,18,3,4,3,10,30,-54,5,5,155,195
617,19,3,3,6,7,33,34,8,9,188,229
617,20,2,4,4,9,-78,-55,0,4,110,174
617,21,3,4,7,6,34,42,4,6,144,216
617,22,3,3,5,8,32,-65,6,1,176,151
617,23,4,2,9,4,-55,22,1,3,121,173
617,24,5,2,7,6,52,24,3,7,173,197
617,25,5,2,7,6,52,-76,5,1,225,121
617,26,2,4,5,8,23,44,8,5,248,165
617,27,4,2,7,6,-57,24,1,9,191,189
617,28,4,4,7,6,43,-58,4,1,234,131
617,29,3,3,7,6,34,33,8,4,268,164
617,30,4,3,6,7,-58,34,0,8,210,198
617,31,5,2,10,3,55,21,5,9,265,219
617,32,3,3,8,5,-65,-68,0,1,200,151
617,33,4,3,6,7,42,34,2,5,242,185
617,34,3,3,7,6,34,33,6,8,276,218
617,35,4,2,10,3,-54,21,2,9,222,239
617,36,3,3,7,6,34,-67,6,2,256,172
617,37,3,4,5,8,32,44,8,6,288,216
617,38,3,3,5,8,-68,-65,0,1,220,151
617,39,3,3,7,6,34,33,4,4,254,184
617,40,3,4,4,9,31,45,5,9,285,229
617,41,2,4,7,6,-75,-58,0,1,210,171
617,42,3,4,5,8,32,44,2,5,242,215
617,43,3,4,6,7,33,43,5,8,275,258
617,44,4,2,7,6,43,-76,8,2,318,182
617,45,3,3,7,6,-66,33,2,5,252,215
617,46,3,3,9,4,36,31,8,6,288,246
617,47,3,3,8,5,-65,32,3,8,223,278
617,48,3,4,5,8,32,-56,5,2,255,222
617,49,4,4,7,6,43,42,8,4,298,264
617,50,5,2,8,5,-47,23,1,7,251,287
617,51,4,3,9,4,45,31,6,8,296,318
617,52,3,4,8,5,-65,41,1,9,231,359
617,53,2,5,6,7,24,-48,5,1,255,311
617,54,3,3,8,5,-65,32,0,3,190,343
617,55,3,3,8,5,35,32,5,5,225,375
617,56,3,4,3,10,30,-54,5,1,255,321
617,57,2,4,3,10,21,46,6,7,276,367
617,58,3,4,6,7,33,-57,9,0,309,310
617,59,4,2,9,4,-55,22,4,2,254,332
617,60,2,6,4,9,22,63,6,5,276,395
617,61,3,4,7,6,-66,42,0,7,210,437
617,62,2,4,7,6,25,42,5,9,235,479
617,63,2,5,2,11,20,-44,5,5,255,435
617,64,2,5,4,9,22,54,7,9,277,489
617,65,3,3,6,7,-67,-66,0,3,210,423
617,66,2,5,3,10,21,55,1,8,231,478
617,67,3,4,5,8,32,-56,3,2,263,422
617,68,4,2,7,6,43,24,6,6,306,446
617,69,5,2,5,8,50,-74,6,2,356,372
617,70,4,3,9,4,-55,31,1,3,301,403
617,71,3,3,7,6,34,33,5,6,335,436
617,72,3,4,7,6,34,42,9,8,369,478
617,73,3,3,7,6,-66,-67,3,1,303,411
617,74,2,5,7,6,25,51,8,2,328,462
617,75,3,3,4,9,31,36,9,8,359,498
617,76,4,3,9,4,-55,31,4,9,304,529
618,1,3,3,5,8,32,35,2,5,32,35
618,2,2,4,6,7,24,43,6,8,56,78
618,3,3,4,5,8,32,-56,8,2,88,22
618,4,3,3,3,10,30,37,8,9,118,59
618,5,2,5,5,8,-77,-47,1,2,41,12
618,6,4,2,7,6,43,24,4,6,84,36
618,7,2,6,6,7,24,61,8,7,108,97
618,8,3,3,3,10,30,-63,8,4,138,34
618,9,4,3,9,4,-55,31,3,5,83,65
618,10,3,4,7,6,34,42,7,7,117,107
618,11,4,3,9,4,-55,31,2,8,62,138
618,12,3,3,8,5,35,-68,7,0,97,70
618,13,2,4,4,9,22,45,9,5,119,115
618,14,5,2,9,4,-46,22,3,7,73,137
618,15,2,4,2,11,20,-53,3,4,93,84
618,16,2,4,5,8,23,44,6,8,116,128
618,17,4,2,8,5,-56,-77,0,1,60,51
618,18,3,3,9,4,36,31,6,2,96,82
618,19,4,3,7,6,43,33,9,5,139,115
618,20,2,5,3,10,-79,-45,0,0,60,70
618,21,4,3,7,6,43,33,3,3,103,103
618,22,3,3,7,6,34,33,7,6,137,136
618,23,3,3,7,6,-66,33,1,9,71,169
618,24,3,3,6,7,33,-66,4,3,104,103
618,25,4,3,9,4,45,31,9,4,149,134
618,26,3,3,7,6,-66,33,3,7,83,167
618,27,3,4,7,6,34,42,7,9,117,209
618,28,4,2,4,9,40,-73,7,6,157,136
618,29,3,3,9,4,-64,31,3,7,93,167
618,30,2,5,3,10,21,-45,4,2,114,122
618,31,3,3,8,5,35,32,9,4,149,154
618,32,3,4,7,6,-66,42,3,6,83,196
618,33,5,2,8,5,53,23,6,9,136,219
618,34,3,3,5,8,32,-65,8,4,168,154
618,35,3,3,6,7,-67,34,1,8,101,188
618,36,5,2,7,6,52,-76,3,2,153,112
618,37,3,3,8,5,35,32,8,4,188,144
618,38,4,2,10,3,-54,21,4,5,134,165
618,39,2,5,7,6,25,51,9,6,159,216
618,40,4,3,6,7,-58,-66,1,0,101,150
618,41,3,3,6,7,33,34,4,4,134,184
618,42,3,4,3,10,30,-54,4,0,164,130
618,43,3,3,6,7,33,34,7,4,197,164
618,44,2,5,4,9,22,54,9,8,219,218
618,45,3,4,3,10,30,-54,9,4,249,164
618,46,3,4,7,6,-66,42,3,6,183,206
618,47,4,4,7,6,43,42,6,8,226,248
618,48,2,5,5,8,23,-47,9,1,249,201
618,49,3,3,7,6,-66,33,3,4,183,234
618,50,4,3,10,3,46,30,9,4,229,264
618,51,4,3,7,6,-57,33,2,7,172,297
618,52,4,3,9,4,45,31,7,8,217,328
618,53,4,3,5,8,41,-65,8,3,258,263
618,54,5,2,10,3,-45,21,3,4,213,284
618,55,2,4,5,8,23,44,6,8,236,328
618,56,2,4,5,8,23,-56,9,2,259,272
618,57,3,5,4,9,-69,54,0,6,190,326
618,58,3,3,9,4,36,31,6,7,226,357
618,59,5,2,7,6,52,-76,8,1,278,281
618,60,3,4,6,7,-67,43,1,4,211,324
618,61,3,4,4,9,31,45,2,9,242,369
618,62,3,4,5,8,32,-56,4,3,274,313
618,63,2,4,6,7,24,43,8,6,298,356
618,64,4,2,9,4,-55,22,3,8,243,378
618,65,4,2,11,2,-53,20,0,8,190,398
618,66,3,3,5,8,32,-65,2,3,222,333
618,67,4,2,8,5,44,23,6,6,266,356
618,68,2,4,5,8,23,-56,9,0,289,300
618,69,2,4,7,6,-75,42,4,2,214,342
618,70,2,4,5,8,23,44,7,6,237,386
618,71,4,4,6,7,42,43,9,9,279,429
618,72,4,2,7,6,-57,-76,2,3,222,353
618,73,3,4,4,9,31,45,3,8,253,398
618,74,5,2,9,4,54,-78,7,0,307,320
618,75,5,2,8,5,-47,23,0,3,260,343
618,76,2,6,2,11,20,65,0,8,280,408
618,77,4,3,8,5,44,-68,4,0,324,340
618,78,6,2,10,3,64,21,8,1,388,361
618,79,4,3,8,5,-56,32,2,3,332,393
618,80,5,2,10,3,55,21,7,4,387,414
618,81,6,2,10,3,-36,21,1,5,351,435
618,82,2,5,5,8,23,53,4,8,374,488
618,83,3,3,6,7,33,-66,7,2,407,422
618,84,2,4,7,6,-75,42,2,4,332,464
618,85,6,2,8,5,62,23,4,7,394,487
618,86,4,3,6,7,42,-66,6,1,436,421
618,87,5,2,9,4,-46,22,0,3,390,443
618,88,4,2,8,5,44,23,4,6,434,466
618,89,3,3,7,6,34,33,8,9,468,499
618,90,4,4,7,6,-57,-58,1,1,411,441
618,91,2,4,7,6,25,42,6,3,436,483
618,92,4,4,4,9,40,45,6,8,476,528
619,1,3,3,8,5,35,32,5,2,35,32
619,2,3,4,6,7,33,43,8,5,68,75
619,3,3,3,7,6,-66,33,2,8,2,108
619,4,4,3,5,8,41,-65,3,3,43,43
619,5,3,4,5,8,32,44,5,7,75,87
619,6,3,4,7,6,34,42,9,9,109,129
619,7,2,4,6,7,-76,-57,3,2,33,72
619,8,2,6,3,10,21,64,4,6,54,136
619,9,2,5,5,8,23,53,7,9,77,189
619,10,3,4,6,7,-67,-57,0,2,10,132
619,11,3,3,5,8,32,35,2,7,42,167
619,12,4,2,10,3,46,21,8,8,88,188
619,13,3,4,4,9,31,-55,9,3,119,133
619,14,2,4,4,9,-78,45,1,8,41,178
619,15,4,3,8,5,44,-68,5,0,85,110
619,16,4,3,7,6,43,33,8,3,128,143
619,17,4,3,6,7,-58,34,0,7,70,177
619,18,2,5,4,9,22,-46,2,1,92,131
619,19,3,3,6,7,33,34,5,5,125,165
619,20,4,4,6,7,42,43,7,8,167,208
619,21,2,5,4,9,22,-46,9,2,189,162
619,22,5,2,8,5,-47,23,2,5,142,185
619,23,4,3,9,4,45,31,7,6,187,216
619,24,4,3,9,4,-55,31,2,7,132,247
619,25,2,4,6,7,24,-57,6,0,156,190
619,26,5,2,9,4,-46,22,0,2,110,212
619,27,2,4,4,9,22,45,2,7,132,257
619,28,3,3,7,6,34,-67,6,0,166,190
619,29,2,5,4,9,22,54,8,4,188,244
619,30,3,3,7,6,-66,33,2,7,122,277
619,31,4,3,9,4,45,31,7,8,167,308
619,32,3,4,9,4,-64,40,3,8,103,348
619,33,3,3,6,7,33,-66,6,2,136,282
619,34,3,4,5,8,32,44,8,6,168,326
619,35,4,2,7,6,-57,-76,1,0,111,250
619,36,3,4,7,6,34,42,5,2,145,292
619,37,3,3,6,7,33,34,8,6,178,326
619,38,4,2,8,5,-56,23,2,9,122,349
619,39,4,2,9,4,45,-78,7,1,167,271
619,40,5,2,10,3,-45,21,2,2,122,292
619,41,5,2,10,3,55,21,7,3,177,313
619,42,4,3,8,5,-56,32,1,5,121,345
619,43,3,3,8,5,35,32,6,7,156,377
619,44,2,5,5,8,23,-47,9,0,179,330
619,45,2,4,6,7,-76,43,3,3,103,373
619,46,3,4,5,8,32,44,5,7,135,417
619,47,4,3,9,4,-55,31,0,8,80,448
619,48,3,4,7,6,34,-58,4,0,114,390
619,49,5,2,10,3,55,21,9,1,169,411
619,50,3,4,6,7,-67,43,2,4,102,454
619,51,3,3,7,6,34,33,6,7,136,487
619,52,4,3,9,4,-55,31,1,8,81,518
620,1,2,5,4,9,22,54,2,4,22,54
620,2,4,2,6,7,42,25,4,9,64,79
620,3,3,4,9,4,-64,40,0,9,0,119
620,4,5,2,10,3,55,-79,5,0,55,40
620,5,4,2,10,3,-54,21,1,1,1,61
620,6,4,3,8,5,44,32,5,3,45,93
620,7,4,3,5,8,41,35,6,8,86,128
620,8,2,4,5,8,23,-56,9,2,109,72
620,9,2,4,4,9,-78,45,1,7,31,117
620,10,2,6,2,11,20,-35,1,2,51,82
620,11,3,4,8,5,35,41,6,3,86,123
620,12,3,3,8,5,-65,32,1,5,21,155
620,13,5,2,8,5,53,23,4,8,74,178
620,14,3,3,5,8,32,-65,6,3,106,113
620,15,3,3,6,7,33,34,9,7,139,147
620,16,4,3,8,5,-56,32,3,9,83,179
620,17,4,3,8,5,44,-68,7,1,127,111
620,18,3,3,6,7,-67,34,0,5,60,145
620,19,3,3,5,8,32,-65,2,0,92,80
620,20,5,2,10,3,55,21,7,1,147,101
620,21,2,4,5,8,-77,44,0,5,70,145
620,22,2,4,5,8,23,44,3,9,93,189
620,23,4,3,6,7,42,-66,5,3,135,123
620,24,6,2,9,4,63,22,8,5,198,145
620,25,4,3,7,6,-57,33,1,8,141,178
620,26,4,2,9,4,45,-78,6,0,186,100
620,27,2,4,5,8,23,44,9,4,209,144
620,28,5,3,7,6,-48,33,1,7,161,177
620,29,3,3,3,10,30,-63,1,4,191,114
620,30,5,2,8,5,53,23,4,7,244,137
620,31,3,3,7,6,34,-67,8,0,278,70
620,32,5,2,9,4,-46,22,2,2,232,92
620,33,3,3,8,5,35,32,7,4,267,124
620,34,4,2,6,7,42,25,9,9,309,149
620,35,2,6,4,9,-78,-37,1,2,231,112
620,36,3,3,8,5,35,32,6,4,266,144
620,37,4,2,8,5,-56,23,0,7,210,167
620,38,3,3,7,6,34,-67,4,0,244,100
620,39,4,2,9,4,45,22,9,2,289,122
620,40,4,3,6,7,-58,34,1,6,231,156
620,41,2,7,6,7,24,70,5,6,255,226
620,42,3,3,7,6,34,33,9,9,289,259
620,43,5,2,7,6,-48,-76,1,3,241,183
620,44,2,5,5,8,23,53,4,6,264,236
620,45,4,2,9,4,45,22,9,8,309,258
620,46,3,4,6,7,-67,-57,2,1,242,201
620,47,3,3,5,8,32,35,4,6,274,236
620,48,2,4,7,6,25,42,9,8,299,278
620,49,2,5,3,10,-79,-45,0,3,220,233
620,50,3,4,5,8,32,44,2,7,252,277
620,51,3,3,6,7,33,-66,5,1,285,211
620,52,4,2,6,7,42,25,7,6,327,236
620,53,2,4,6,7,-76,43,1,9,251,279
620,54,2,4,7,6,25,-58,6,1,276,221
620,55,2,6,4,9,22,63,8,4,298,284
620,56,4,2,11,2,-53,20,5,4,245,304
620,57,5,3,8,5,53,32,8,6,298,336
620,58,3,3,8,5,-65,32,3,8,233,368
620,59,4,3,6,7,42,-66,5,2,275,302
620,60,4,2,8,5,44,23,9,5,319,325
620,61,3,4,8,5,-65,41,4,6,254,366
620,62,5,2,10,3,55,21,9,7,309,387
620,63,4,2,9,4,-55,22,4,9,254,409
620,64,4,3,9,4,45,-69,9,0,299,340
620,65,2,5,4,9,-78,54,1,4,221,394
620,66,3,3,5,8,32,35,3,9,253,429
620,67,2,5,3,10,21,-45,4,4,274,384
620,68,2,4,6,7,24,43,8,7,298,427
620,69,3,4,5,8,-68,-56,0,1,230,371
620,70,2,4,3,10,21,46,1,7,251,417
620,71,3,3,7,6,34,-67,5,0,285,350
620,72,2,5,5,8,23,53,8,3,308,403
620,73,5,2,9,4,-46,22,2,5,262,425
620,74,4,3,6,7,42,34,4,9,304,459
620,75,3,4,4,9,31,-55,5,4,335,404
620,76,2,4,6,7,24,43,9,7,359,447
620,77,4,3,8,5,-56,32,3,9,303,479
620,78,4,3,7,6,43,-67,6,2,346,412
620,79,4,3,7,6,43,33,9,5,389,445
620,80,3,4,3,10,30,-54,9,1,419,391
620,81,3,3,6,7,-67,34,2,5,352,425
620,82,3,3,6,7,33,34,5,9,385,459
620,83,6,2,11,2,-35,20,0,9,350,479
620,84,3,4,6,7,33,-57,3,2,383,422
620,85,2,5,5,8,23,53,6,5,406,475
620,86,3,5,3,10,30,-45,6,0,436,430
620,87,2,4,6,7,-76,43,0,3,360,473
620,88,3,3,4,9,31,36,1,9,391,509
621,1,3,4,7,6,34,42,4,2,34,42
621,2,5,2,8,5,53,23,7,5,87,65
621,3,3,4,3,10,30,-54,7,1,117,11
621,4,4,2,6,7,42,25,9,6,159,36
621,5,4,3,6,7,-58,-66,1,0,101,-30
621,6,3,3,7,6,34,33,5,3,135,3
621,7,4,2,10,3,-54,21,1,4,81,24
621,8,3,3,3,10,30,-63,1,1,111,-39
621,9,3,3,6,7,33,34,4,5,144,-5
621,10,2,4,8,5,-74,41,0,6,70,36
621,11,4,3,8,5,44,32,4,8,114,68
621,12,4,2,9,4,45,-78,9,0,159,-10
621,13,4,2,10,3,-54,21,5,1,105,11
621,14,2,4,8,5,-74,41,1,2,31,52
621,15,5,3,5,8,50,35,1,7,81,87
621,16,4,3,7,6,43,-67,4,0,124,20
621,17,2,4,7,6,25,42,9,2,149,62
621,18,3,4,5,8,-68,44,1,6,81,106
621,19,2,6,3,10,21,-36,2,0,102,70
621,20,3,4,3,10,30,46,2,6,132,116
621,21,4,2,8,5,44,23,6,9,176,139
621,22,2,4,6,7,-76,-57,0,2,100,82
621,23,4,3,7,6,43,33,3,5,143,115
621,24,2,5,4,9,22,54,5,9,165,169
621,25,4,3,7,6,43,-67,8,2,208,102
621,26,3,4,5,8,-68,44,0,6,140,146
621,27,4,3,9,4,45,31,5,7,185,177
621,28,5,2,10,3,-45,21,0,8,140,198
621,29,3,4,5,8,32,-56,2,2,172,142
621,30,3,3,6,7,33,34,5,6,205,176
621,31,2,4,4,9,22,-55,7,1,227,121
621,32,4,3,8,5,-56,32,1,3,171,153
621,33,3,3,8,5,35,32,6,5,206,185
621,34,4,3,7,6,43,33,9,8,249,218
621,35,4,4,7,6,-57,-58,2,0,192,160
621,36,2,5,3,10,21,55,3,5,213,215
621,37,5,2,7,6,52,24,5,9,265,239
621,38,4,3,10,3,-54,30,1,9,211,269
621,39,2,5,3,10,21,-45,2,4,232,224
621,40,3,3,5,8,32,35,4,9,264,259
621,41,2,4,4,9,22,-55,6,4,286,204
621,42,4,2,7,6,43,24,9,8,329,228
621,43,4,3,8,5,-56,-68,3,0,273,160
621,44,4,2,11,2,-53,20,0,0,220,180
621,45,3,3,4,9,31,36,1,6,251,216
621,46,4,3,8,5,44,32,5,8,295,248
621,47,5,2,11,2,-44,20,1,8,251,268
621,48,2,4,4,9,22,-55,3,3,273,213
621,49,3,3,5,8,32,35,5,8,305,248
621,50,4,3,9,4,-55,31,0,9,250,279
621,51,4,2,9,4,45,-78,5,1,295,201
621,52,4,4,7,6,43,42,8,3,338,243
621,53,3,4,5,8,-68,44,0,7,270,287
621,54,3,3,6,7,33,-66,3,1,303,221
621,55,4,2,8,5,44,23,7,4,347,244
621,56,5,2,9,4,-46,22,1,6,301,266
621,57,4,3,6,7,42,-66,3,0,343,200
621,58,3,3,6,7,33,34,6,4,376,234
621,59,4,3,6,7,42,34,8,8,418,268
621,60,2,4,5,8,-77,-56,1,2,341,212
621,61,3,3,7,6,34,33,5,5,375,245
621,62,4,3,9,4,-55,31,0,6,320,276
621,63,2,5,6,7,24,52,4,8,344,328
621,64,4,2,9,4,45,-78,9,0,389,250
621,65,3,4,6,7,-67,43,2,3,322,293
621,66,3,3,6,7,33,34,5,7,355,327
621,67,4,4,6,7,42,-57,7,0,397,270
621,68,6,2,9,4,-37,22,0,2,360,292
621,69,2,5,5,8,23,53,3,5,383,345
621,70,3,4,7,6,34,42,7,7,417,387
621,71,4,2,7,6,-57,-76,0,1,360,311
621,72,6,2,10,3,64,21,4,2,424,332
621,73,2,6,4,9,22,63,6,5,446,395
621,74,5,2,11,2,-44,20,2,5,402,415
621,75,4,2,7,6,43,24,5,9,445,439
621,76,3,4,5,8,32,-56,7,3,477,383
621,77,4,3,5,8,41,35,8,8,518,418
622,1,4,3,8,5,44,32,4,2,44,32
622,2,4,3,9,4,45,31,9,3,89,63
622,3,2,4,5,8,-77,44,2,7,12,107
622,4,4,3,5,8,41,-65,3,2,53,42
622,5,3,4,5,8,32,44,5,6,85,86
622,6,2,5,4,9,22,-46,7,0,107,40
622,7,3,3,6,7,-67,34,0,4,40,74
622,8,4,2,9,4,45,22,5,6,85,96
622,9,2,4,4,9,22,-55,7,1,107,41
622,10,5,3,8,5,-47,32,0,3,60,73
622,11,2,5,3,10,21,55,1,8,81,128
622,12,4,2,7,6,43,-76,4,2,124,52
622,13,2,4,5,8,23,44,7,6,147,96
622,14,3,4,7,6,-66,42,1,8,81,138
622,15,4,2,5,8,41,-74,2,4,122,64
622,16,2,5,4,9,22,54,4,8,144,118
622,17,5,2,10,3,55,21,9,9,199,139
622,18,3,4,7,6,-66,-58,3,1,133,81
622,19,3,4,6,7,33,43,6,4,166,124
622,20,3,3,8,5,-65,32,1,6,101,156
622,21,3,3,7,6,34,33,5,9,135,189
622,22,3,4,8,5,-65,-59,0,0,70,130
622,23,4,3,7,6,43,33,3,3,113,163
622,24,4,4,6,7,42,43,5,6,155,206
622,25,2,4,4,9,22,-55,7,1,177,151
622,26,3,4,6,7,-67,43,0,4,110,194
622,27,4,2,10,3,46,21,6,5,156,215
622,28,2,5,3,10,21,-45,7,0,177,170
622,29,4,3,7,6,-57,33,0,3,120,203
622,30,3,4,4,9,31,45,1,8,151,248
622,31,3,4,5,8,32,-56,3,2,183,192
622,32,4,3,5,8,41,35,4,7,224,227
622,33,3,3,5,8,32,-65,6,2,256,162
622,34,3,3,6,7,33,34,9,6,289,196
622,35,3,4,5,8,-68,-56,1,0,221,140
622,36,2,4,6,7,24,43,5,3,245,183
622,37,4,2,7,6,43,24,8,7,288,207
622,38,4,2,7,6,-57,-76,1,1,231,131
622,39,2,5,2,11,20,56,1,7,251,187
622,40,5,2,9,4,54,22,5,9,305,209
622,41,2,4,7,6,-75,-58,0,1,230,151
622,42,3,4,8,5,35,41,5,2,265,192
622,43,3,4,4,9,31,45,6,7,296,237
622,44,3,3,6,7,33,-66,9,1,329,171
622,45,2,5,7,6,-75,51,4,2,254,222
622,46,2,6,1,12,-20,66,4,8,234,288
622,47,4,2,8,5,44,-77,8,1,278,211
622,48,2,5,4,9,-78,54,0,5,200,265
622,49,2,4,5,8,23,44,3,9,223,309
622,50,4,3,6,7,42,-66,5,3,265,243
622,51,4,2,9,4,-55,22,0,5,210,265
622,52,4,3,8,5,44,32,4,7,254,297
622,53,4,3,9,4,45,31,9,8,299,328
622,54,5,2,10,3,-45,21,4,9,254,349
622,55,3,3,6,7,33,-66,7,3,287,283
622,56,2,5,4,9,22,54,9,7,309,337
622,57,2,4,5,8,-77,-56,2,1,232,281
622,58,4,3,8,5,44,32,6,3,276,313
622,59,3,3,8,5,-65,32,1,5,211,345
622,60,4,3,8,5,44,32,5,7,255,377
622,61,5,2,8,5,53,-77,8,0,308,300
622,62,5,2,8,5,-47,23,1,3,261,323
622,63,4,2,7,6,43,24,4,7,304,347
622,64,4,3,10,3,-54,30,0,7,250,377
622,65,5,2,8,5,53,-77,3,0,303,300
622,66,4,2,8,5,44,23,7,3,347,323
622,67,3,4,4,9,31,45,8,8,378,368
622,68,4,3,9,4,-55,31,3,9,323,399
622,69,5,2,7,6,52,-76,5,3,375,323
622,70,2,4,6,7,24,43,9,6,399,366
622,71,2,5,3,10,-79,-45,0,1,320,321
622,72,5,2,11,2,56,20,6,1,376,341
622,73,3,3,9,4,-64,31,2,2,312,372
622,74,3,3,5,8,32,35,4,7,344,407
622,75,4,2,10,3,-54,21,0,8,290,428
622,76,2,5,8,5,26,50,6,8,316,478
622,77,5,2,10,3,-45,21,1,9,271,499
622,78,6,2,10,3,64,-79,5,0,335,420
622,79,3,3,9,4,-64,31,1,1,271,451
622,80,3,3,7,6,34,33,5,4,305,484
622,81,4,2,8,5,44,23,9,7,349,507
623,1,3,3,6,7,33,34,3,4,33,34
623,2,2,5,4,9,22,54,5,8,55,88
623,3,2,5,5,8,23,-47,8,1,78,41
623,4,4,2,8,5,-56,23,2,4,22,64
623,5,2,4,6,7,24,43,6,7,46,107
623,6,3,3,8,5,-65,32,1,9,-19,139
623,7,4,3,7,6,43,-67,4,2,24,72
623,8,3,4,7,6,34,42,8,4,58,114
623,9,3,4,7,6,-66,42,2,6,-8,156
623,10,3,4,6,7,33,43,5,9,25,199
623,11,5,3,8,5,53,-68,8,1,78,131
623,12,4,3,8,5,-56,32,2,3,22,163
623,13,3,3,9,4,36,31,8,4,58,194
623,14,2,5,3,10,21,55,9,9,79,249
623,15,5,2,10,3,-45,-79,4,0,34,170
623,16,3,4,3,10,30,46,4,6,64,216
623,17,5,2,11,2,-44,20,0,6,20,236
623,18,4,3,6,7,42,-66,2,0,62,170
623,19,2,5,2,11,20,56,2,6,82,226
623,20,2,4,6,7,24,43,6,9,106,269
623,21,4,3,5,8,41,-65,7,4,147,204
623,22,3,3,9,4,-64,31,3,5,83,235
623,23,4,3,9,4,45,31,8,6,128,266
623,24,5,2,6,7,51,-75,9,1,179,191
623,25,3,3,7,6,-66,33,3,4,113,224
623,26,4,2,10,3,46,21,9,5,159,245
623,27,3,3,6,7,-67,34,2,9,92,279
623,28,3,5,5,8,32,-47,4,2,124,232
623,29,5,2,9,4,54,22,8,4,178,254
623,30,5,2,9,4,-46,22,2,6,132,276
623,31,5,2,7,6,52,-76,4,0,184,200
623,32,3,5,4,9,31,54,5,4,215,254
623,33,2,4,6,7,24,43,9,7,239,297
623,34,4,2,8,5,-56,-77,3,0,183,220
623,35,4,2,10,3,46,21,9,1,229,241
623,36,4,2,9,4,-55,22,4,3,174,263
623,37,4,3,7,6,43,33,7,6,217,296
623,38,4,3,9,4,-55,31,2,7,162,327
623,39,4,3,10,3,46,30,8,7,208,357
623,40,4,3,7,6,-57,-67,1,0,151,290
623,41,3,4,7,6,34,42,5,2,185,332
623,42,4,4,7,6,43,42,8,4,228,374
623,43,3,4,3,10,30,-54,8,0,258,320
623,44,2,5,4,9,-78,54,0,4,180,374
623,45,6,2,10,3,64,21,4,5,244,395
623,46,4,2,7,6,43,24,7,9,287,419
623,47,4,4,6,7,42,-57,9,2,329,362
623,48,6,2,10,3,-36,21,3,3,293,383
623,49,3,4,5,8,32,44,5,7,325,427
623,50,3,3,4,9,31,-64,6,3,356,363
623,51,2,4,5,8,23,44,9,7,379,407
623,52,2,6,2,11,20,-35,9,2,399,372
623,53,4,2,9,4,-55,22,4,4,344,394
623,54,3,4,6,7,33,43,7,7,377,437
623,55,3,4,4,9,31,-55,8,2,408,382
623,56,3,3,6,7,-67,34,1,6,341,416
623,57,3,4,5,8,32,-56,3,0,373,360
623,58,3,4,7,6,34,42,7,2,407,402
623,59,4,2,8,5,-56,23,1,5,351,425
623,60,4,3,7,6,43,33,4,8,394,458
623,61,4,3,6,7,42,-66,6,2,436,392
623,62,2,5,7,6,-75,51,1,3,361,443
623,63,3,4,7,6,34,42,5,5,395,485
623,64,2,4,7,6,-75,42,0,7,320,527
624,1,4,3,7,6,43,33,3,3,43,33
624,2,4,2,6,7,42,25,5,8,85,58
624,3,3,3,4,9,31,-64,6,4,116,-6
624,4,4,2,9,4,-55,22,1,6,61,16
624,5,3,3,7,6,34,33,5,9,95,49
624,6,4,3,6,7,42,-66,7,3,137,-17
624,7,3,3,7,6,-66,33,1,6,71,16
624,8,4,3,9,4,45,31,6,7,116,47
624,9,3,3,10,3,-63,30,3,7,53,77
624,10,3,4,7,6,34,42,7,9,87,119
624,11,3,4,5,8,32,-56,9,3,119,63
624,12,3,3,7,6,-66,33,3,6,53,96
624,13,4,2,8,5,44,23,7,9,97,119
624,14,4,2,6,7,42,-75,9,4,139,44
624,15,3,4,6,7,-67,43,2,7,72,87
624,16,4,2,10,3,46,21,8,8,118,108
624,17,3,4,5,8,-68,-56,0,2,50,52
624,18,3,4,7,6,34,42,4,4,84,94
624,19,3,3,7,6,34,33,8,7,118,127
624,20,3,3,5,8,-68,-65,0,2,50,62
624,21,3,4,5,8,32,44,2,6,82,106
624,22,5,2,10,3,55,21,7,7,137,127
624,23,3,4,7,6,-66,42,1,9,71,169
624,24,3,4,5,8,32,-56,3,3,103,113
624,25,4,2,10,3,46,21,9,4,149,134
624,26,3,4,5,8,-68,44,1,8,81,178
624,27,3,3,7,6,34,-67,5,1,115,111
624,28,4,3,7,6,43,33,8,4,158,144
624,29,2,4,4,9,-78,45,0,9,80,189
624,30,2,5,4,9,22,-46,2,3,102,143
624,31,5,2,10,3,55,21,7,4,157,164
624,32,2,4,7,6,-75,42,2,6,82,206
624,33,4,2,9,4,45,22,7,8,127,228
624,34,4,3,7,6,-57,-67,0,1,70,161
624,35,3,3,6,7,33,34,3,5,103,195
624,36,3,3,5,8,32,-65,5,0,135,130
624,37,2,4,6,7,24,43,9,3,159,173
624,38,4,3,8,5,-56,32,3,5,103,205
624,39,4,2,9,4,45,22,8,7,148,227
624,40,3,3,8,5,-65,32,3,9,83,259
624,41,4,2,7,6,43,-76,6,3,126,183
624,42,2,4,5,8,23,44,9,7,149,227
624,43,3,3,4,9,-69,-64,0,3,80,163
624,44,2,5,4,9,22,54,2,7,102,217
624,45,3,3,6,7,33,-66,5,1,135,151
624,46,2,5,5,8,23,53,8,4,158,204
624,47,4,2,6,7,-58,25,0,9,100,229
624,48,2,4,5,8,23,-56,3,3,123,173
624,49,2,4,5,8,23,44,6,7,146,217
624,50,2,4,2,11,20,-53,6,4,166,164
624,51,5,2,9,4,-46,22,0,6,120,186
624,52,4,2,8,5,44,23,4,9,164,209
624,53,3,3,9,4,-64,-69,0,0,100,140
624,54,3,4,3,10,30,46,0,6,130,186
624,55,3,4,8,5,35,41,5,7,165,227
624,56,2,5,4,9,22,-46,7,1,187,181
624,57,4,2,8,5,-56,23,1,4,131,204
624,58,4,3,8,5,44,32,5,6,175,236
624,59,3,4,7,6,34,42,9,8,209,278
624,60,3,3,8,5,-65,-68,4,0,144,210
624,61,4,3,9,4,45,31,9,1,189,241
624,62,3,4,8,5,-65,41,4,2,124,282
624,63,5,2,9,4,54,22,8,4,178,304
624,64,3,4,7,6,-66,42,2,6,112,346
624,65,4,3,9,4,45,31,7,7,157,377
624,66,4,3,10,3,-54,30,3,7,103,407
624,67,5,2,8,5,53,-77,6,0,156,330
624,68,5,2,9,4,-46,22,0,2,110,352
624,69,3,4,7,6,34,42,4,4,144,394
624,70,3,3,7,6,34,33,8,7,178,427
624,71,4,3,6,7,-58,-66,0,1,120,361
624,72,4,3,10,3,46,30,6,1,166,391
624,73,3,4,8,5,-65,41,1,2,101,432
624,74,4,3,7,6,43,33,4,5,144,465
624,75,2,4,4,9,22,-55,6,0,166,410
624,76,2,6,3,10,21,64,7,4,187,474
624,77,2,5,3,10,21,55,8,9,208,529
625,1,2,6,2,11,20,65,0,5,20,65
625,2,3,4,4,9,31,-55,1,0,51,10
625,3,4,3,5,8,41,35,2,5,92,45
625,4,2,5,4,9,22,54,4,9,114,99
625,5,4,3,7,6,43,-67,7,2,157,32
625,6,3,5,5,8,32,53,9,5,189,85
625,7,5,3,7,6,-48,33,1,8,141,118
625,8,4,3,7,6,43,-67,4,1,184,51
625,9,2,5,3,10,21,55,5,6,205,106
625,10,3,3,8,5,-65,32,0,8,140,138
625,11,3,3,7,6,34,-67,4,1,174,71
625,12,3,3,6,7,33,34,7,5,207,105
625,13,5,2,10,3,-45,21,2,6,162,126
625,14,3,3,6,7,33,-66,5,0,195,60
625,15,3,3,4,9,31,36,6,6,226,96
625,16,2,4,7,6,-75,42,1,8,151,138
625,17,2,5,2,11,20,-44,1,4,171,94
625,18,4,3,7,6,43,33,4,7,214,127
625,19,3,4,7,6,34,42,8,9,248,169
625,20,4,2,9,4,-55,-78,3,1,193,91
625,21,3,5,3,10,30,55,3,6,223,146
625,22,2,4,7,6,25,42,8,8,248,188
625,23,2,5,2,11,20,-44,8,4,268,144
625,24,4,2,9,4,-55,22,3,6,213,166
625,25,2,4,9,4,-73,40,0,6,140,206
625,26,4,3,7,6,43,33,3,9,183,239
625,27,3,4,4,9,31,-55,4,4,214,184
625,28,3,3,6,7,33,34,7,8,247,218
625,29,3,3,8,5,-65,-68,2,0,182,150
625,30,2,6,3,10,21,64,3,4,203,214
625,31,3,3,7,6,34,33,7,7,237,247
625,32,2,5,4,9,22,-46,9,1,259,201
625,33,4,2,9,4,-55,22,4,3,204,223
625,34,4,3,6,7,42,34,6,7,246,257
625,35,3,4,4,9,31,-55,7,2,277,202
625,36,3,3,5,8,32,35,9,7,309,237
625,37,3,4,4,9,-69,-55,0,2,240,182
625,38,4,3,8,5,44,32,4,4,284,214
625,39,5,2,10,3,55,21,9,5,339,235
625,40,4,3,10,3,-54,30,5,5,285,265
625,41,3,4,5,8,32,44,7,9,317,309
625,42,3,3,7,6,-66,-67,1,2,251,242
625,43,2,4,7,6,25,42,6,4,276,284
625,44,5,2,11,2,-44,20,2,4,232,304
625,45,3,3,8,5,35,32,7,6,267,336
625,46,4,3,9,4,-55,31,2,7,212,367
625,47,4,2,7,6,43,-76,5,1,255,291
625,48,2,5,6,7,24,52,9,3,279,343
625,49,5,2,11,2,-44,20,5,3,235,363
625,50,3,4,3,10,30,46,5,9,265,409
625,51,2,4,4,9,22,-55,7,4,287,354
625,52,3,3,5,8,32,35,9,9,319,389
625,53,3,4,6,7,-67,-57,2,2,252,332
625,54,4,2,8,5,44,23,6,5,296,355
625,55,4,2,9,4,-55,22,1,7,241,377
625,56,3,3,7,6,34,-67,5,0,275,310
625,57,3,3,8,5,-65,32,0,2,210,342
625,58,3,4,7,6,34,42,4,4,244,384
625,59,3,5,4,9,31,54,5,8,275,438
625,60,4,3,9,4,-55,31,0,9,220,469
625,61,2,4,5,8,23,-56,3,3,243,413
625,62,4,2,7,6,43,24,6,7,286,437
625,63,3,5,6,7,33,52,9,9,319,489
625,64,2,5,3,10,-79,-45,0,4,240,444
625,65,4,3,6,7,42,34,2,8,282,478
625,66,3,3,6,7,33,-66,5,2,315,412
625,67,4,3,7,6,43,33,8,5,358,445
625,68,3,3,7,6,-66,33,2,8,292,478
625,69,4,2,9,4,45,-78,7,0,337,400
625,70,4,2,7,6,-57,24,0,4,280,424
625,71,2,4,4,9,22,45,2,9,302,469
625,72,2,4,6,7,24,-57,6,2,326,412
625,73,3,4,3,10,30,46,6,8,356,458
625,74,5,2,7,6,52,-76,8,2,408,382
625,75,3,3,6,7,-67,34,1,6,341,416
625,76,3,4,6,7,33,43,4,9,374,459
625,77,4,3,8,5,44,-68,8,1,418,391
625,78,5,2,9,4,-46,22,2,3,372,413
625,79,2,4,7,6,25,42,7,5,397,455
625,80,4,2,8,5,-56,23,1,8,341,478
625,81,5,3,7,6,52,-67,3,1,393,411
625,82,4,2,7,6,43,24,6,5,436,435
625,83,2,5,4,9,22,54,8,9,458,489
625,84,5,2,9,4,-46,-78,2,1,412,411
625,85,4,3,9,4,45,31,7,2,457,442
625,86,2,4,6,7,-76,43,1,5,381,485
625,87,3,3,9,4,36,31,7,6,417,516
626,1,5,2,7,6,52,24,2,4,52,24
626,2,5,2,8,5,53,23,5,7,105,47
626,3,4,3,6,7,42,-66,7,1,147,-19
626,4,2,4,2,11,20,47,7,8,167,28
626,5,4,2,6,7,42,-75,9,3,209,-47
626,6,4,4,8,5,-56,41,3,4,153,-6
626,7,4,3,7,6,43,33,6,7,196,27
626,8,3,3,7,6,-66,-67,0,0,130,-40
626,9,3,4,4,9,31,45,1,5,161,5
626,10,3,3,5,8,32,-65,3,0,193,-60
626,11,4,3,9,4,45,31,8,1,238,-29
626,12,3,3,4,9,31,36,9,7,269,7
626,13,5,2,9,4,-46,22,3,9,223,29
626,14,2,5,2,11,20,-44,3,5,243,-15
626,15,4,2,7,6,43,24,6,9,286,9
626,16,5,2,10,3,-45,-79,1,0,241,-70
626,17,3,4,6,7,33,43,4,3,274,-27
626,18,3,3,6,7,33,34,7,7,307,7
626,19,3,3,8,5,-65,32,2,9,242,39
626,20,2,5,3,10,21,-45,3,4,263,-6
626,21,2,5,4,9,22,54,5,8,285,48
626,22,4,3,6,7,42,-66,7,2,327,-18
626,23,3,4,3,10,30,46,7,8,357,28
626,24,2,4,8,5,-74,41,3,9,283,69
626,25,2,5,5,8,23,-47,6,2,306,22
626,26,4,3,6,7,42,34,8,6,348,56
626,27,3,3,4,9,31,-64,9,2,379,-8
626,28,2,5,4,9,-78,54,1,6,301,46
626,29,4,2,11,2,47,20,8,6,348,66
626,30,2,4,4,9,-78,-55,0,1,270,11
626,31,2,5,4,9,22,54,2,5,292,65
626,32,3,4,6,7,33,43,5,8,325,108
626,33,3,3,6,7,33,-66,8,2,358,42
626,34,3,4,4,9,31,45,9,7,389,87
626,35,2,6,4,9,-78,-37,1,0,311,50
626,36,2,4,7,6,25,42,6,2,336,92
626,37,3,3,6,7,33,34,9,6,369,126
626,38,3,4,6,7,-67,43,2,9,302,169
626,39,4,2,7,6,43,-76,5,3,345,93
626,40,3,4,6,7,33,43,8,6,378,136
626,41,4,3,10,3,-54,30,4,6,324,166
626,42,2,4,7,6,25,42,9,8,349,208
626,43,2,5,4,9,-78,-46,1,2,271,162
626,44,5,2,11,2,56,20,7,2,327,182
626,45,3,4,7,6,-66,42,1,4,261,224
626,46,4,2,6,7,42,25,3,9,303,249
626,47,3,4,7,6,34,-58,7,1,337,191
626,48,2,4,9,4,-73,40,4,1,264,231
626,49,2,4,2,11,20,47,4,8,284,278
626,50,2,4,4,9,22,-55,6,3,306,223
626,51,4,3,9,4,-55,31,1,4,251,254
626,52,3,4,8,5,35,41,6,5,286,295
626,53,3,4,4,9,31,-55,7,0,317,240
626,54,5,2,9,4,-46,22,1,2,271,262
626,55,2,5,4,9,22,54,3,6,293,316
626,56,4,3,6,7,42,-66,5,0,335,250
626,57,3,3,4,9,31,36,6,6,366,286
626,58,2,4,3,10,21,-54,7,2,387,232
626,59,3,4,3,10,30,46,7,8,417,278
626,60,3,3,6,7,-67,-66,0,2,350,212
626,61,2,4,4,9,22,45,2,7,372,257
626,62,5,2,7,6,52,-76,4,1,424,181
626,63,5,2,7,6,52,24,6,5,476,205
626,64,4,2,9,4,-55,22,1,7,421,227
626,65,3,4,5,8,32,-56,3,1,453,171
626,66,4,3,7,6,43,33,6,4,496,204
626,67,3,4,8,5,-65,41,1,5,431,245
626,68,4,2,7,6,43,24,4,9,474,269
626,69,2,5,3,10,21,-45,5,4,495,224
626,70,2,4,5,8,23,44,8,8,518,268
627,1,5,2,11,2,56,20,6,0,56,20
627,2,4,3,6,7,42,34,8,4,98,54
627,3,3,4,6,7,-67,43,1,7,31,97
627,4,2,4,5,8,23,-56,4,1,54,41
627,5,2,5,5,8,23,53,7,4,77,94
627,6,4,3,7,6,-57,33,0,7,20,127
627,7,4,3,8,5,44,32,4,9,64,159
627,8,2,5,3,10,21,-45,5,4,85,114
627,9,3,4,4,9,31,45,6,9,116,159
627,10,4,2,7,6,43,-76,9,3,159,83
627,11,5,2,7,6,-48,24,1,7,111,107
627,12,2,6,4,9,22,-37,3,0,133,70
627,13,4,3,7,6,43,33,6,3,176,103
627,14,2,4,6,7,-76,43,0,6,100,146
627,15,2,5,4,9,22,-46,2,0,122,100
627,16,2,4,5,8,23,44,5,4,145,144
627,17,2,5,3,10,21,55,6,9,166,199
627,18,3,3,10,3,-63,30,3,9,103,229
627,19,5,2,11,2,56,20,9,9,159,249
627,20,4,3,9,4,-55,-69,4,0,104,180
627,21,3,3,4,9,31,36,5,6,135,216
627,22,3,5,5,8,32,53,7,9,167,269
627,23,3,3,7,6,-66,-67,1,2,101,202
627,24,3,4,7,6,34,42,5,4,135,244
627,25,3,3,6,7,33,34,8,8,168,278
627,26,2,4,5,8,-77,-56,1,2,91,222
627,27,4,2,7,6,43,24,4,6,134,246
627,28,4,2,6,7,42,-75,6,1,176,171
627,29,4,4,7,6,43,42,9,3,219,213
627,30,3,3,7,6,-66,33,3,6,153,246
627,31,4,3,6,7,42,-66,5,0,195,180
627,32,3,4,6,7,33,43,8,3,228,223
627,33,3,3,6,7,-67,34,1,7,161,257
627,34,5,2,9,4,54,22,5,9,215,279
627,35,3,5,4,9,31,-46,6,3,246,233
627,36,2,4,2,11,20,-53,6,0,266,180
627,37,3,4,7,6,-66,42,0,2,200,222
627,38,2,4,6,7,24,43,4,5,224,265
627,39,3,4,4,9,31,-55,5,0,255,210
627,40,3,4,6,7,33,43,8,3,288,253
627,41,2,5,3,10,21,55,9,8,309,308
627,42,6,2,10,3,-36,21,3,9,273,329
627,43,4,2,6,7,42,-75,5,4,315,254
627,44,2,6,2,11,20,65,5,9,335,319
627,45,4,2,9,4,-55,-78,0,1,280,241
627,46,3,3,7,6,34,33,4,4,314,274
627,47,4,2,10,3,-54,21,0,5,260,295
627,48,2,6,3,10,21,64,1,9,281,359
627,49,4,3,7,6,43,-67,4,2,324,292
627,50,3,3,7,6,34,33,8,5,358,325
627,51,4,3,10,3,-54,30,4,5,304,355
627,52,4,3,8,5,44,32,8,7,348,387
627,53,4,2,8,5,-56,-77,2,0,292,310
627,54,2,4,3,10,21,46,3,6,313,356
627,55,3,4,4,9,31,-55,4,1,344,301
627,56,3,4,5,8,32,44,6,5,376,345
627,57,5,3,9,4,-46,31,0,6,330,376
627,58,3,4,7,6,34,42,4,8,364,418
627,59,3,4,4,9,31,-55,5,3,395,363
627,60,2,5,4,9,22,54,7,7,417,417
627,61,3,3,7,6,-66,-67,1,0,351,350
627,62,3,3,7,6,34,33,5,3,385,383
627,63,5,2,8,5,53,23,8,6,438,406
627,64,3,4,6,7,-67,43,1,9,371,449
627,65,5,2,7,6,52,-76,3,3,423,373
627,66,4,2,10,3,46,21,9,4,469,394
627,67,4,2,6,7,-58,25,1,9,411,419
627,68,3,4,4,9,31,-55,2,4,442,364
627,69,3,4,7,6,34,42,6,6,476,406
627,70,3,4,5,8,32,-56,8,0,508,350
628,1,3,3,5,8,32,35,2,5,32,35
628,2,3,4,6,7,33,43,5,8,65,78
628,3,5,2,8,5,53,-77,8,1,118,1
628,4,3,3,4,9,31,36,9,7,149,37
628,5,2,5,5,8,-77,-47,2,0,72,-10
628,6,4,3,7,6,43,33,5,3,115,23
628,7,4,3,9,4,-55,31,0,4,60,54
628,8,3,3,6,7,33,34,3,8,93,88
628,9,2,5,4,9,22,-46,5,2,115,42
628,10,2,4,5,8,23,44,8,6,138,86
628,11,6,2,10,3,-36,21,2,7,102,107
628,12,2,5,4,9,22,-46,4,1,124,61
628,13,4,2,11,2,-53,20,1,1,71,81
628,14,5,2,9,4,54,22,5,3,125,103
628,15,3,3,7,6,34,33,9,6,159,136
628,16,5,2,7,6,-48,-76,1,0,111,60
628,17,4,3,7,6,43,33,4,3,154,93
628,18,4,4,6,7,42,43,6,6,196,136
628,19,4,4,6,7,42,43,8,9,238,179
628,20,2,4,6,7,-76,-57,2,2,162,122
628,21,4,4,6,7,42,43,4,5,204,165
628,22,5,3,9,4,54,31,8,6,258,196
628,23,4,2,7,6,-57,-76,1,0,201,120
628,24,4,3,6,7,42,34,3,4,243,154
628,25,2,5,3,10,21,55,4,9,264,209
628,26,2,4,6,7,24,-57,8,2,288,152
628,27,4,3,7,6,-57,33,1,5,231,185
628,28,3,3,4,9,31,-64,2,1,262,121
628,29,3,4,6,7,33,43,5,4,295,164
628,30,4,3,6,7,42,34,7,8,337,198
628,31,3,4,4,9,31,-55,8,3,368,143
628,32,4,3,6,7,-58,34,0,7,310,177
628,33,2,4,5,8,23,-56,3,1,333,121
628,34,2,4,5,8,23,44,6,5,356,165
628,35,2,4,7,6,-75,42,1,7,281,207
628,36,5,2,9,4,54,22,5,9,335,229
628,37,4,3,8,5,44,-68,9,1,379,161
628,38,2,4,4,9,-78,45,1,6,301,206
628,39,2,5,3,10,21,-45,2,1,322,161
628,40,4,3,6,7,42,34,4,5,364,195
628,41,2,4,4,9,22,-55,6,0,386,140
628,42,6,2,10,3,-36,21,0,1,350,161
628,43,3,4,4,9,31,45,1,6,381,206
628,44,3,4,3,10,30,-54,1,2,411,152
628,45,3,3,8,5,35,32,6,4,446,184
628,46,3,4,8,5,-65,41,1,5,381,225
628,47,3,4,8,5,35,41,6,6,416,266
628,48,2,4,5,8,23,-56,9,0,439,210
628,49,4,3,7,6,-57,33,2,3,382,243
628,50,2,4,5,8,23,44,5,7,405,287
628,51,5,3,9,4,54,31,9,8,459,318
628,52,4,3,6,7,-58,-66,1,2,401,252
628,53,3,3,8,5,35,32,6,4,436,284
628,54,2,5,5,8,23,53,9,7,459,337
628,55,3,4,9,4,-64,40,5,7,395,377
628,56,4,3,7,6,43,-67,8,0,438,310
628,57,2,5,5,8,-77,53,1,3,361,363
628,58,3,4,6,7,33,43,4,6,394,406
628,59,2,5,6,7,24,52,8,8,418,458
628,60,3,3,5,8,-68,-65,0,3,350,393
628,61,4,2,9,4,45,22,5,5,395,415
628,62,2,4,4,9,22,-55,7,0,417,360
628,63,4,3,7,6,-57,33,0,3,360,393
628,64,2,4,5,8,23,44,3,7,383,437
628,65,3,4,5,8,32,-56,5,1,415,381
628,66,4,3,6,7,42,34,7,5,457,415
628,67,3,3,5,8,32,-65,9,0,489,350
628,68,2,4,3,10,-79,46,0,6,410,396
628,69,3,4,4,9,31,-55,1,1,441,341
628,70,2,5,5,8,23,53,4,4,464,394
628,71,3,3,9,4,-64,31,0,5,400,425
628,72,3,4,7,6,34,42,4,7,434,467
628,73,5,2,10,3,55,21,9,8,489,488
628,74,3,3,5,8,-68,-65,1,3,421,423
628,75,3,3,8,5,35,32,6,5,456,455
628,76,4,2,6,7,42,-75,8,0,498,380
628,77,3,3,3,10,30,37,8,7,528,417
629,1,2,4,4,9,22,45,2,5,22,45
629,2,3,3,7,6,34,33,6,8,56,78
629,3,3,4,7,6,-66,-58,0,0,-10,20
629,4,4,3,7,6,43,33,3,3,33,53
629,5,5,2,8,5,53,23,6,6,86,76
629,6,3,4,4,9,31,-55,7,1,117,21
629,7,6,2,10,3,-36,21,1,2,81,42
629,8,2,5,4,9,22,54,3,6,103,96
629,9,3,4,4,9,31,-55,4,1,134,41
629,10,3,4,5,8,32,44,6,5,166,85
629,11,2,4,6,7,-76,43,0,8,90,128
629,12,2,5,3,10,21,-45,1,3,111,83
629,13,4,4,8,5,44,41,5,4,155,124
629,14,3,3,6,7,33,34,8,8,188,158
629,15,2,5,2,11,20,-44,8,4,208,114
629,16,2,4,4,9,-78,45,0,9,130,159
629,17,2,4,6,7,24,-57,4,2,154,102
629,18,2,5,4,9,22,54,6,6,176,156
629,19,2,4,7,6,-75,42,1,8,101,198
629,20,2,5,4,9,22,-46,3,2,123,152
629,21,4,2,8,5,44,23,7,5,167,175
629,22,4,3,7,6,-57,33,0,8,110,208
629,23,3,3,6,7,33,-66,3,2,143,142
629,24,2,4,5,8,23,44,6,6,166,186
629,25,3,3,3,10,30,-63,6,3,196,123
629,26,4,3,5,8,41,35,7,8,237,158
629,27,2,4,5,8,-77,-56,0,2,160,102
629,28,3,3,6,7,33,34,3,6,193,136
629,29,2,4,5,8,23,-56,6,0,216,80
629,30,4,3,7,6,43,33,9,3,259,113
629,31,5,2,11,2,-44,20,5,3,215,133
629,32,3,3,7,6,34,33,9,6,249,166
629,33,3,4,5,8,-68,-56,1,0,181,110
629,34,2,4,3,10,21,46,2,6,202,156
629,35,3,3,5,8,32,-65,4,1,234,91
629,36,4,3,8,5,44,32,8,3,278,123
629,37,5,3,8,5,-47,32,1,5,231,155
629,38,3,3,4,9,31,-64,2,1,262,91
629,39,5,2,9,4,54,22,6,3,316,113
629,40,3,5,5,8,32,53,8,6,348,166
629,41,4,3,8,5,-56,32,2,8,292,198
629,42,2,5,4,9,22,-46,4,2,314,152
629,43,6,2,11,2,65,20,9,2,379,172
629,44,4,2,7,6,-57,24,2,6,322,196
629,45,3,3,8,5,35,32,7,8,357,228
629,46,3,4,7,6,-66,-58,1,0,291,170
629,47,2,4,6,7,24,43,5,3,315,213
629,48,2,4,4,9,22,45,7,8,337,258
629,49,3,3,8,5,-65,-68,2,0,272,190
629,50,3,4,5,8,32,44,4,4,304,234
629,51,3,3,10,3,-63,30,1,4,241,264
629,52,4,3,8,5,44,32,5,6,285,296
629,53,4,3,5,8,41,-65,6,1,326,231
629,54,4,4,6,7,42,43,8,4,368,274
629,55,4,2,6,7,-58,25,0,9,310,299
629,56,4,3,7,6,43,-67,3,2,353,232
629,57,4,3,6,7,42,34,5,6,395,266
629,58,4,3,10,3,-54,30,1,6,341,296
629,59,4,3,10,3,46,30,7,6,387,326
629,60,4,3,9,4,-55,31,2,7,332,357
629,61,2,4,6,7,24,-57,6,0,356,300
629,62,4,3,8,5,-56,32,0,2,300,332
629,63,5,2,9,4,54,22,4,4,354,354
629,64,2,5,3,10,21,55,5,9,375,409
629,65,4,3,8,5,44,-68,9,1,419,341
629,66,2,5,3,10,-79,55,0,6,340,396
629,67,3,4,5,8,32,-56,2,0,372,340
629,68,5,2,9,4,54,22,6,2,426,362
629,69,3,3,6,7,33,34,9,6,459,396
629,70,4,2,9,4,-55,22,4,8,404,418
629,71,5,2,6,7,51,-75,5,3,455,343
629,72,3,3,8,5,-65,32,0,5,390,375
629,73,4,3,5,8,41,-65,1,0,431,310
629,74,2,5,3,10,21,55,2,5,452,365
629,75,3,3,6,7,33,34,5,9,485,399
629,76,4,3,9,4,-55,-69,0,0,430,330
629,77,4,3,9,4,45,31,5,1,475,361
629,78,2,4,7,6,-75,42,0,3,400,403
629,79,3,4,7,6,34,42,4,5,434,445
629,80,2,4,6,7,24,43,8,8,458,488
629,81,2,4,5,8,-77,-56,1,2,381,432
629,82,3,4,7,6,34,42,5,4,415,474
629,83,5,2,9,4,54,22,9,6,469,496
629,84,3,3,7,6,-66,33,3,9,403,529
630,1,2,4,5,8,23,44,3,4,23,44
630,2,2,4,6,7,24,43,7,7,47,87
630,3,3,4,5,8,32,-56,9,1,79,31
630,4,4,3,5,8,-59,35,0,6,20,66
630,5,2,4,5,8,23,-56,3,0,43,10
630,6,3,5,4,9,31,54,4,4,74,64
630,7,3,4,5,8,32,44,6,8,106,108
630,8,3,4,8,5,-65,41,1,9,41,149
630,9,4,4,5,8,41,-56,2,3,82,93
630,10,4,2,7,6,43,24,5,7,125,117
630,11,4,3,6,7,42,-66,7,1,167,51
630,12,3,4,5,8,32,44,9,5,199,95
630,13,5,2,9,4,-46,22,3,7,153,117
630,14,3,4,5,8,32,-56,5,1,185,61
630,15,3,4,6,7,33,43,8,4,218,104
630,16,3,3,8,5,-65,32,3,6,153,136
630,17,2,4,6,7,24,43,7,9,177,179
630,18,4,2,10,3,-54,-79,3,0,123,100
630,19,3,3,7,6,34,33,7,3,157,133
630,20,2,5,6,7,-76,52,1,5,81,185
630,21,3,4,6,7,33,43,4,8,114,228
630,22,3,3,7,6,34,-67,8,1,148,161
630,23,3,4,4,9,31,45,9,6,179,206
630,24,3,4,7,6,-66,42,3,8,113,248
630,25,3,3,9,4,36,31,9,9,149,279
630,26,3,3,7,6,-66,-67,3,2,83,212
630,27,3,3,5,8,32,35,5,7,115,247
630,28,4,2,8,5,44,-77,9,0,159,170
630,29,4,3,8,5,-56,32,3,2,103,202
630,30,2,5,5,8,23,53,6,5,126,255
630,31,2,5,5,8,23,53,9,8,149,308
630,32,4,3,4,9,40,-64,9,4,189,244
630,33,4,3,7,6,-57,33,2,7,132,277
630,34,2,4,4,9,22,-55,4,2,154,222
630,35,5,3,6,7,51,34,5,6,205,256
630,36,5,2,9,4,54,22,9,8,259,278
630,37,2,5,4,9,-78,-46,1,2,181,232
630,38,2,5,4,9,22,54,3,6,203,286
630,39,3,4,7,6,34,42,7,8,237,328
630,40,4,4,8,5,-56,41,1,9,181,369
630,41,4,4,7,6,43,-58,4,1,224,311
630,42,5,2,10,3,55,21,9,2,279,332
630,43,3,3,6,7,-67,34,2,6,212,366
630,44,2,5,6,7,24,52,6,8,236,418
630,45,4,2,8,5,-56,-77,0,1,180,341
630,46,3,4,6,7,33,43,3,4,213,384
630,47,3,3,7,6,34,33,7,7,247,417
630,48,4,3,8,5,-56,32,1,9,191,449
630,49,3,3,7,6,34,-67,5,2,225,382
630,50,4,3,8,5,44,32,9,4,269,414
630,51,4,3,6,7,-58,34,1,8,211,448
630,52,3,4,6,7,33,-57,4,1,244,391
630,53,5,2,7,6,52,24,6,5,296,415
630,54,4,3,9,4,-55,31,1,6,241,446
630,55,2,5,3,10,21,-45,2,1,262,401
630,56,3,3,5,8,32,35,4,6,294,436
630,57,3,3,7,6,34,33,8,9,328,469
630,58,2,4,4,9,-78,-55,0,4,250,414
630,59,4,2,6,7,42,25,2,9,292,439
630,60,2,5,5,8,23,-47,5,2,315,392
630,61,4,2,6,7,42,25,7,7,357,417
630,62,3,4,6,7,-67,-57,0,0,290,360
630,63,3,3,7,6,34,33,4,3,324,393
630,64,3,3,6,7,33,34,7,7,357,427
630,65,3,3,6,7,-67,-66,0,1,290,361
630,66,2,4,7,6,25,42,5,3,315,403
630,67,4,3,9,4,-55,31,0,4,260,434
630,68,2,5,4,9,22,54,2,8,282,488
630,69,3,3,4,9,31,-64,3,4,313,424
630,70,4,2,7,6,43,24,6,8,356,448
630,71,4,3,5,8,41,-65,7,3,397,383
630,72,4,3,6,7,42,34,9,7,439,417
630,73,4,3,8,5,-56,32,3,9,383,449
630,74,2,5,6,7,24,-48,7,1,407,401
630,75,3,3,7,6,-66,33,1,4,341,434
630,76,2,4,6,7,24,43,5,7,365,477
630,77,3,3,6,7,33,-66,8,1,398,411
630,78,3,3,7,6,-66,33,2,4,332,444
630,79,4,3,7,6,43,33,5,7,375,477
630,80,3,4,8,5,-65,41,0,8,310,518
631,1,5,2,7,6,52,24,2,4,52,24
631,2,2,4,6,7,24,43,6,7,76,67
631,3,5,2,9,4,-46,22,0,9,30,89
631,4,3,3,8,5,35,-68,5,1,65,21
631,5,2,5,3,10,21,55,6,6,86,76
631,6,3,3,9,4,-64,31,2,7,22,107
631,7,3,3,7,6,34,-67,6,0,56,40
631,8,3,3,8,5,-65,32,1,2,-9,72
631,9,3,4,4,9,31,45,2,7,22,117
631,10,2,4,5,8,23,-56,5,1,45,61
631,11,3,3,9,4,-64,31,1,2,-19,92
631,12,5,2,7,6,52,24,3,6,33,116
631,13,3,3,6,7,33,-66,6,0,66,50
631,14,3,4,5,8,32,44,8,4,98,94
631,15,5,2,10,3,-45,21,3,5,53,115
631,16,5,2,9,4,54,22,7,7,107,137
631,17,4,2,8,5,-56,-77,1,0,51,60
631,18,4,2,8,5,44,23,5,3,95,83
631,19,2,4,8,5,-74,41,1,4,21,124
631,20,3,4,8,5,35,41,6,5,56,165
631,21,2,5,6,7,-76,52,0,7,-20,217
631,22,3,4,4,9,31,-55,1,2,11,162
631,23,4,2,5,8,41,26,2,8,52,188
631,24,4,3,6,7,42,-66,4,2,94,122
631,25,4,2,8,5,44,23,8,5,138,145
631,26,2,5,4,9,-78,54,0,9,60,199
631,27,2,4,4,9,22,-55,2,4,82,144
631,28,4,3,9,4,45,31,7,5,127,175
631,29,5,2,11,2,-44,20,3,5,83,195
631,30,3,4,7,6,34,42,7,7,117,237
631,31,5,2,11,2,-44,20,3,7,73,257
631,32,4,2,7,6,43,-76,6,1,116,181
631,33,5,2,8,5,53,23,9,4,169,204
631,34,2,4,5,8,-77,44,2,8,92,248
631,35,4,3,5,8,41,-65,3,3,133,183
631,36,3,3,5,8,32,35,5,8,165,218
631,37,2,4,7,6,-75,-58,0,0,90,160
631,38,3,3,9,4,36,31,6,1,126,191
631,39,4,2,9,4,-55,22,1,3,71,213
631,40,6,2,9,4,63,22,4,5,134,235
631,41,3,4,5,8,32,44,6,9,166,279
631,42,3,3,7,6,-66,-67,0,2,100,212
631,43,6,2,11,2,65,20,5,2,165,232
631,44,3,3,8,5,-65,32,0,4,100,264
631,45,2,5,6,7,24,52,4,6,124,316
631,46,2,4,6,7,24,43,8,9,148,359
631,47,5,2,8,5,-47,-77,1,2,101,282
631,48,4,3,8,5,44,32,5,4,145,314
631,49,3,3,5,8,32,35,7,9,177,349
631,50,3,4,7,6,-66,-58,1,1,111,291
631,51,5,2,9,4,54,22,5,3,165,313
631,52,5,2,7,6,52,24,7,7,217,337
631,53,4,3,7,6,-57,-67,0,0,160,270
631,54,3,3,7,6,34,33,4,3,194,303
631,55,3,3,5,8,32,35,6,8,226,338
631,56,4,3,5,8,41,-65,7,3,267,273
631,57,4,2,6,7,42,25,9,8,309,298
631,58,3,3,8,5,-65,-68,4,0,244,230
631,59,3,3,9,4,-64,31,0,1,180,261
631,60,3,3,7,6,34,33,4,4,214,294
631,61,5,3,8,5,53,32,7,6,267,326
631,62,3,3,7,6,-66,33,1,9,201,359
631,63,4,3,7,6,43,-67,4,2,244,292
631,64,2,4,5,8,23,44,7,6,267,336
631,65,3,3,7,6,-66,33,1,9,201,369
631,66,4,2,8,5,44,-77,5,2,245,292
631,67,4,3,9,4,-55,31,0,3,190,323
631,68,3,4,7,6,34,42,4,5,224,365
631,69,2,4,4,9,22,-55,6,0,246,310
631,70,2,4,5,8,23,44,9,4,269,354
631,71,4,3,10,3,-54,30,5,4,215,384
631,72,5,2,8,5,53,23,8,7,268,407
631,73,2,4,5,8,-77,-56,1,1,191,351
631,74,3,4,6,7,33,43,4,4,224,394
631,75,4,3,6,7,42,34,6,8,266,428
631,76,2,5,4,9,22,-46,8,2,288,382
631,77,6,2,11,2,-35,20,3,2,253,402
631,78,4,3,6,7,42,34,5,6,295,436
631,79,3,3,6,7,33,-66,8,0,328,370
631,80,5,2,8,5,-47,23,1,3,281,393
631,81,4,2,6,7,42,25,3,8,323,418
631,82,2,5,4,9,22,-46,5,2,345,372
631,83,3,3,4,9,31,36,6,8,376,408
631,84,5,2,9,4,-46,-78,0,0,330,330
631,85,3,3,5,8,32,35,2,5,362,365
631,86,4,2,8,5,44,23,6,8,406,388
631,87,3,3,4,9,31,-64,7,4,437,324
631,88,5,3,7,6,52,33,9,7,489,357
631,89,4,2,9,4,-55,22,4,9,434,379
631,90,5,2,10,3,55,-79,9,0,489,300
631,91,3,5,4,9,-69,54,0,4,420,354
631,92,4,3,6,7,42,34,2,8,462,388
631,93,3,4,6,7,33,-57,5,1,495,331
631,94,2,5,6,7,24,52,9,3,519,383
632,1,3,5,5,8,32,53,2,3,32,53
632,2,4,2,10,3,46,21,8,4,78,74
632,3,6,2,8,5,-38,23,0,7,40,97
632,4,3,3,6,7,33,-66,3,1,73,31
632,5,3,3,5,8,32,35,5,6,105,66
632,6,4,2,9,4,-55,22,0,8,50,88
632,7,3,3,5,8,32,-65,2,3,82,23
632,8,4,3,7,6,43,33,5,6,125,56
632,9,3,4,7,6,34,42,9,8,159,98
632,10,3,4,4,9,-69,-55,0,3,90,43
632,11,4,3,9,4,45,31,5,4,135,74
632,12,3,3,5,8,32,35,7,9,167,109
632,13,5,3,8,5,-47,-68,0,1,120,41
632,14,3,3,8,5,35,32,5,3,155,73
632,15,3,3,7,6,34,33,9,6,189,106
632,16,4,2,7,6,-57,-76,2,0,132,30
632,17,2,4,5,8,23,44,5,4,155,74
632,18,4,2,8,5,44,23,9,7,199,97
632,19,2,6,2,11,20,-35,9,2,219,62
632,20,6,2,10,3,-36,21,3,3,183,83
632,21,3,3,6,7,33,34,6,7,216,117
632,22,3,3,6,7,33,-66,9,1,249,51
632,23,5,2,11,2,-44,20,5,1,205,71
632,24,4,3,10,3,-54,30,1,1,151,101
632,25,3,4,5,8,32,44,3,5,183,145
632,26,3,3,7,6,34,33,7,8,217,178
632,27,6,2,9,4,-37,-78,0,0,180,100
632,28,2,5,6,7,24,52,4,2,204,152
632,29,4,3,7,6,43,33,7,5,247,185
632,30,4,2,9,4,-55,22,2,7,192,207
632,31,3,4,5,8,32,-56,4,1,224,151
632,32,3,4,5,8,32,44,6,5,256,195
632,33,4,2,7,6,43,24,9,9,299,219
632,34,3,4,7,6,-66,-58,3,1,233,161
632,35,2,4,4,9,22,45,5,6,255,206
632,36,3,3,6,7,33,-66,8,0,288,140
632,37,3,5,4,9,31,54,9,4,319,194
632,38,5,2,8,5,-47,23,2,7,272,217
632,39,4,4,5,8,41,-56,3,1,313,161
632,40,3,3,7,6,34,33,7,4,347,194
632,41,3,4,6,7,-67,43,0,7,280,237
632,42,3,3,8,5,35,32,5,9,315,269
632,43,5,2,8,5,53,-77,8,2,368,192
632,44,3,4,7,6,-66,42,2,4,302,234
632,45,3,3,7,6,34,33,6,7,336,267
632,46,3,3,8,5,-65,32,1,9,271,299
632,47,3,4,5,8,32,-56,3,3,303,243
632,48,3,4,3,10,30,46,3,9,333,289
632,49,6,2,6,7,60,-75,3,4,393,214
632,50,4,2,6,7,42,25,5,9,435,239
632,51,2,5,3,10,21,-45,6,4,456,194
632,52,5,2,9,4,-46,22,0,6,410,216
632,53,4,2,6,7,42,-75,2,1,452,141
632,54,4,3,7,6,43,33,5,4,495,174
632,55,4,3,9,4,-55,31,0,5,440,205
632,56,4,3,6,7,42,34,2,9,482,239
632,57,2,5,4,9,22,-46,4,3,504,193
633,1,3,4,7,6,34,42,4,2,34,42
633,2,5,2,7,6,52,24,6,6,86,66
633,3,3,3,7,6,-66,33,0,9,20,99
633,4,3,3,6,7,33,-66,3,3,53,33
633,5,4,3,6,7,42,34,5,7,95,67
633,6,3,3,7,6,34,-67,9,0,129,0
633,7,3,3,4,9,-69,36,0,6,60,36
633,8,3,4,6,7,33,43,3,9,93,79
633,9,4,2,10,3,46,-79,9,0,139,0
633,10,5,2,10,3,-45,21,4,1,94,21
633,11,2,5,5,8,23,53,7,4,117,74
633,12,3,3,8,5,-65,32,2,6,52,106
633,13,5,2,9,4,54,22,6,8,106,128
633,14,4,3,8,5,-56,-68,0,0,50,60
633,15,3,4,7,6,34,42,4,2,84,102
633,16,2,4,6,7,24,43,8,5,108,145
633,17,3,4,9,4,-64,40,4,5,44,185
633,18,3,3,6,7,33,34,7,9,77,219
633,19,3,3,8,5,-65,-68,2,1,12,151
633,20,4,3,6,7,42,34,4,5,54,185
633,21,3,4,4,9,31,-55,5,0,85,130
633,22,3,4,4,9,31,45,6,5,116,175
633,23,2,4,7,6,-75,42,1,7,41,217
633,24,5,2,9,4,54,22,5,9,95,239
633,25,3,3,5,8,32,-65,7,4,127,174
633,26,4,2,9,4,-55,22,2,6,72,196
633,27,4,3,8,5,44,32,6,8,116,228
633,28,2,5,5,8,23,-47,9,1,139,181
633,29,4,3,7,6,-57,33,2,4,82,214
633,30,3,3,8,5,35,32,7,6,117,246
633,31,3,4,7,6,-66,42,1,8,51,288
633,32,3,4,3,10,30,-54,1,4,81,234
633,33,4,3,7,6,43,33,4,7,124,267
633,34,2,5,6,7,24,52,8,9,148,319
633,35,2,4,6,7,-76,-57,2,2,72,262
633,36,4,2,9,4,45,22,7,4,117,284
633,37,4,3,7,6,-57,33,0,7,60,317
633,38,2,5,4,9,22,-46,2,1,82,271
633,39,3,3,4,9,31,36,3,7,113,307
633,40,6,2,8,5,62,-77,5,0,175,230
633,41,5,3,9,4,54,31,9,1,229,261
633,42,2,4,4,9,-78,45,1,6,151,306
633,43,2,6,4,9,22,63,3,9,173,369
633,44,3,3,5,8,32,-65,5,4,205,304
633,45,4,2,7,6,43,24,8,8,248,328
633,46,2,4,5,8,-77,-56,1,2,171,272
633,47,4,3,7,6,43,33,4,5,214,305
633,48,3,4,4,9,31,-55,5,0,245,250
633,49,5,2,11,2,-44,20,1,0,201,270
633,50,5,2,7,6,52,24,3,4,253,294
633,51,5,2,8,5,53,23,6,7,306,317
633,52,4,3,9,4,-55,31,1,8,251,348
633,53,4,3,8,5,44,-68,5,0,295,280
633,54,4,2,9,4,-55,22,0,2,240,302
633,55,4,2,9,4,45,22,5,4,285,324
633,56,3,3,6,7,33,34,8,8,318,358
633,57,2,4,7,6,-75,-58,3,0,243,300
633,58,5,2,10,3,55,21,8,1,298,321
633,59,4,3,7,6,-57,33,1,4,241,354
633,60,4,3,9,4,45,31,6,5,286,385
633,61,4,4,5,8,41,44,7,9,327,429
633,62,5,3,8,5,-47,-68,0,1,280,361
633,63,3,3,6,7,33,34,3,5,313,395
633,64,3,4,5,8,32,44,5,9,345,439
633,65,2,4,3,10,21,-54,6,5,366,385
633,66,5,2,9,4,-46,22,0,7,320,407
633,67,3,3,5,8,32,-65,2,2,352,342
633,68,3,3,7,6,34,33,6,5,386,375
633,69,4,2,9,4,-55,22,1,7,331,397
633,70,2,4,6,7,24,-57,5,0,355,340
633,71,3,4,7,6,34,42,9,2,389,382
633,72,3,4,5,8,-68,44,1,6,321,426
633,73,2,4,5,8,23,-56,4,0,344,370
633,74,2,5,3,10,21,55,5,5,365,425
633,75,5,2,8,5,53,23,8,8,418,448
633,76,3,4,6,7,-67,-57,1,1,351,391
633,77,4,3,7,6,43,33,4,4,394,424
633,78,2,5,8,5,-74,50,0,4,320,474
633,79,5,2,10,3,55,21,5,5,375,495
633,80,4,2,8,5,44,23,9,8,419,518
634,1,4,2,9,4,45,22,5,2,45,22
634,2,3,3,6,7,33,34,8,6,78,56
634,3,3,4,5,8,-68,-56,0,0,10,0
634,4,2,4,3,10,21,46,1,6,31,46
634,5,3,3,8,5,35,32,6,8,66,78
634,6,4,2,7,6,43,-76,9,2,109,2
634,7,3,3,5,8,-68,35,1,7,41,37
634,8,5,2,9,4,54,22,5,9,95,59
634,9,3,3,8,5,-65,-68,0,1,30,-9
634,10,5,2,10,3,55,21,5,2,85,12
634,11,2,4,6,7,24,43,9,5,109,55
634,12,2,5,3,10,-79,-45,0,0,30,10
634,13,3,4,7,6,34,42,4,2,64,52
634,14,4,3,7,6,43,33,7,5,107,85
634,15,2,5,3,10,21,-45,8,0,128,40
634,16,3,4,7,6,-66,42,2,2,62,82
634,17,4,2,6,7,42,25,4,7,104,107
634,18,2,4,7,6,25,42,9,9,129,149
634,19,3,4,4,9,-69,-55,0,4,60,94
634,20,6,2,10,3,64,21,4,5,124,115
634,21,4,2,7,6,43,24,7,9,167,139
634,22,2,4,4,9,22,-55,9,4,189,84
634,23,4,2,8,5,-56,23,3,7,133,107
634,24,3,4,6,7,33,-57,6,0,166,50
634,25,3,4,6,7,33,43,9,3,199,93
634,26,3,4,5,8,-68,44,1,7,131,137
634,27,3,3,4,9,31,-64,2,3,162,73
634,28,4,3,7,6,43,33,5,6,205,106
634,29,2,5,4,9,22,-46,7,0,227,60
634,30,4,3,10,3,-54,30,3,0,173,90
634,31,5,2,9,4,54,22,7,2,227,112
634,32,4,3,6,7,42,34,9,6,269,146
634,33,2,6,3,10,-79,-36,0,0,190,110
634,34,2,5,3,10,21,55,1,5,211,165
634,35,3,3,4,9,31,-64,2,1,242,101
634,36,2,5,6,7,24,52,6,3,266,153
634,37,2,4,4,9,22,45,8,8,288,198
634,38,2,5,5,8,-77,-47,1,1,211,151
634,39,4,3,6,7,42,34,3,5,253,185
634,40,3,3,9,4,36,31,9,6,289,216
634,41,5,2,9,4,-46,22,3,8,243,238
634,42,4,3,9,4,45,31,8,9,288,269
634,43,4,2,7,6,-57,-76,1,3,231,193
634,44,3,4,7,6,34,42,5,5,265,235
634,45,3,4,7,6,34,42,9,7,299,277
634,46,2,4,5,8,-77,-56,2,1,222,221
634,47,3,4,4,9,31,45,3,6,253,266
634,48,4,3,6,7,42,-66,5,0,295,200
634,49,4,3,7,6,43,33,8,3,338,233
634,50,2,4,7,6,-75,42,3,5,263,275
634,51,3,4,5,8,32,44,5,9,295,319
634,52,5,2,5,8,50,-74,5,5,345,245
634,53,5,2,8,5,53,23,8,8,398,268
634,54,3,3,7,6,-66,-67,2,1,332,201
634,55,2,4,7,6,25,42,7,3,357,243
634,56,3,4,4,9,31,45,8,8,388,288
634,57,2,5,2,11,20,-44,8,4,408,244
634,58,3,3,4,9,31,-64,9,0,439,180
634,59,3,4,8,5,-65,41,4,1,374,221
634,60,2,4,6,7,24,43,8,4,398,264
634,61,5,2,10,3,-45,21,3,5,353,285
634,62,4,3,8,5,44,32,7,7,397,317
634,63,4,4,8,5,-56,41,1,8,341,358
634,64,4,2,9,4,45,-78,6,0,386,280
634,65,4,2,10,3,-54,21,2,1,332,301
634,66,3,4,5,8,32,44,4,5,364,345
634,67,4,3,9,4,45,31,9,6,409,376
634,68,3,3,6,7,-67,-66,2,0,342,310
634,69,5,2,6,7,51,25,3,5,393,335
634,70,4,3,8,5,44,32,7,7,437,367
634,71,3,3,6,7,-67,-66,0,1,370,301
634,72,2,5,5,8,23,53,3,4,393,354
634,73,4,3,6,7,42,34,5,8,435,388
634,74,4,3,7,6,43,-67,8,1,478,321
634,75,3,4,4,9,31,45,9,6,509,366
635,1,5,2,10,3,55,21,5,1,55,21
635,2,4,4,5,8,41,44,6,5,96,65
635,3,3,3,8,5,-65,32,1,7,31,97
635,4,2,4,7,6,25,42,6,9,56,139
635,5,4,3,7,6,43,-67,9,2,99,72
635,6,4,3,8,5,-56,32,3,4,43,104
635,7,2,4,5,8,23,44,6,8,66,148
635,8,4,3,7,6,43,-67,9,1,109,81
635,9,5,3,7,6,-48,33,1,4,61,114
635,10,5,2,11,2,56,20,7,4,117,134
635,11,4,3,8,5,-56,32,1,6,61,166
635,12,2,5,4,9,22,-46,3,0,83,120
635,13,4,3,6,7,42,34,5,4,125,154
635,14,3,3,8,5,-65,32,0,6,60,186
635,15,5,2,9,4,54,22,4,8,114,208
635,16,2,5,6,7,24,-48,8,0,138,160
635,17,2,4,5,8,-77,44,1,4,61,204
635,18,4,3,7,6,43,33,4,7,104,237
635,19,3,3,8,5,35,32,9,9,139,269
635,20,2,4,6,7,-76,-57,3,2,63,212
635,21,3,3,8,5,35,32,8,4,98,244
635,22,3,4,7,6,-66,42,2,6,32,286
635,23,5,2,6,7,51,-75,3,1,83,211
635,24,2,5,3,10,21,55,4,6,104,266
635,25,4,2,9,4,45,22,9,8,149,288
635,26,4,2,9,4,-55,-78,4,0,94,210
635,27,6,2,10,3,64,21,8,1,158,231
635,28,4,3,8,5,-56,32,2,3,102,263
635,29,5,2,9,4,54,22,6,5,156,285
635,30,4,2,6,7,42,-75,8,0,198,210
635,31,2,4,6,7,-76,43,2,3,122,253
635,32,3,4,7,6,34,42,6,5,156,295
635,33,3,3,6,7,33,34,9,9,189,329
635,34,4,2,10,3,-54,-79,5,0,135,250
635,35,3,4,3,10,30,46,5,6,165,296
635,36,2,5,4,9,22,-46,7,0,187,250
635,37,3,3,4,9,31,36,8,6,218,286
635,38,3,3,6,7,-67,-66,1,0,151,220
635,39,3,3,6,7,33,34,4,4,184,254
635,40,4,3,10,3,-54,30,0,4,130,284
635,41,3,3,6,7,33,34,3,8,163,318
635,42,4,3,9,4,45,31,8,9,208,349
635,43,3,3,9,4,-64,-69,4,0,144,280
635,44,3,4,3,10,30,46,4,6,174,326
635,45,5,2,10,3,55,21,9,7,229,347
635,46,4,2,8,5,-56,-77,3,0,173,270
635,47,3,4,5,8,32,44,5,4,205,314
635,48,3,3,6,7,33,34,8,8,238,348
635,49,4,3,8,5,-56,-68,2,0,182,280
635,50,3,3,6,7,33,34,5,4,215,314
635,51,4,3,8,5,44,32,9,6,259,346
635,52,3,3,5,8,-68,-65,1,1,191,281
635,53,5,2,8,5,53,23,4,4,244,304
635,54,2,5,3,10,21,55,5,9,265,359
635,55,3,3,5,8,32,-65,7,4,297,294
635,56,3,3,6,7,-67,34,0,8,230,328
635,57,4,4,7,6,43,-58,3,0,273,270
635,58,4,2,10,3,46,21,9,1,319,291
635,59,2,6,6,7,-76,61,3,2,243,352
635,60,3,5,6,7,33,52,6,4,276,404
635,61,3,4,5,8,32,44,8,8,308,448
635,62,3,3,7,6,-66,-67,2,1,242,381
635,63,5,2,10,3,55,21,7,2,297,402
635,64,4,4,8,5,-56,41,1,3,241,443
635,65,4,3,6,7,42,34,3,7,283,477
635,66,3,3,10,3,-63,30,0,7,220,507
636,1,3,4,4,9,31,45,1,5,31,45
636,2,4,3,7,6,43,33,4,8,74,78
636,3,4,2,8,5,44,-77,8,1,118,1
636,4,3,4,6,7,-67,43,1,4,51,44
636,5,3,4,7,6,34,42,5,6,85,86
636,6,3,3,6,7,33,-66,8,0,118,20
636,7,3,4,4,9,31,45,9,5,149,65
636,8,4,3,10,3,-54,30,5,5,95,95
636,9,3,4,4,9,31,-55,6,0,126,40
636,10,2,4,5,8,23,44,9,4,149,84
636,11,3,4,6,7,-67,43,2,7,82,127
636,12,3,3,6,7,33,-66,5,1,115,61
636,13,4,3,7,6,43,33,8,4,158,94
636,14,2,5,5,8,-77,53,1,7,81,147
636,15,3,4,5,8,32,-56,3,1,113,91
636,16,5,2,10,3,55,21,8,2,168,112
636,17,3,4,3,10,30,46,8,8,198,158
636,18,4,3,6,7,-58,-66,0,2,140,92
636,19,3,4,4,9,31,45,1,7,171,137
636,20,3,4,6,7,33,-57,4,0,204,80
636,21,3,3,5,8,32,35,6,5,236,115
636,22,2,4,2,11,20,-53,6,2,256,62
636,23,4,4,7,6,43,42,9,4,299,104
636,24,2,4,6,7,-76,43,3,7,223,147
636,25,3,3,3,10,30,-63,3,4,253,84
636,26,5,2,10,3,55,21,8,5,308,105
636,27,3,3,8,5,-65,32,3,7,243,137
636,28,2,5,5,8,23,-47,6,0,266,90
636,29,5,2,8,5,53,23,9,3,319,113
636,30,4,3,7,6,-57,33,2,6,262,146
636,31,3,4,6,7,33,43,5,9,295,189
636,32,2,4,4,9,22,-55,7,4,317,134
636,33,4,3,7,6,-57,33,0,7,260,167
636,34,2,4,8,5,26,41,6,8,286,208
636,35,3,5,5,8,32,-47,8,1,318,161
636,36,3,3,8,5,-65,32,3,3,253,193
636,37,2,5,3,10,21,55,4,8,274,248
636,38,2,6,1,12,-20,-34,4,4,254,214
636,39,6,2,9,4,63,22,7,6,317,236
636,40,2,4,5,8,-77,-56,0,0,240,180
636,41,5,2,9,4,54,22,4,2,294,202
636,42,3,3,7,6,34,33,8,5,328,235
636,43,5,2,8,5,-47,23,1,8,281,258
636,44,3,3,7,6,34,-67,5,1,315,191
636,45,3,3,9,4,-64,31,1,2,251,222
636,46,4,3,10,3,46,30,7,2,297,252
636,47,4,3,5,8,41,35,8,7,338,287
636,48,4,3,7,6,-57,-67,1,0,281,220
636,49,4,3,6,7,42,34,3,4,323,254
636,50,2,5,3,10,21,55,4,9,344,309
636,51,3,3,8,5,35,-68,9,1,379,241
636,52,3,3,7,6,-66,33,3,4,313,274
636,53,4,2,7,6,43,24,6,8,356,298
636,54,2,5,6,7,-76,-48,0,0,280,250
636,55,3,3,9,4,36,31,6,1,316,281
636,56,3,3,7,6,-66,33,0,4,250,314
636,57,2,5,6,7,24,52,4,6,274,366
636,58,4,2,8,5,44,23,8,9,318,389
636,59,5,2,10,3,-45,-79,3,0,273,310
636,60,3,4,8,5,35,41,8,1,308,351
636,61,3,4,5,8,-68,44,0,5,240,395
636,62,4,3,5,8,41,-65,1,0,281,330
636,63,3,3,9,4,36,31,7,1,317,361
636,64,3,3,5,8,32,35,9,6,349,396
636,65,3,5,5,8,-68,53,1,9,281,449
636,66,5,2,9,4,54,-78,5,1,335,371
636,67,3,3,7,6,34,33,9,4,369,404
636,68,3,3,6,7,-67,34,2,8,302,438
636,69,3,3,6,7,33,-66,5,2,335,372
636,70,3,4,8,5,-65,41,0,3,270,413
636,71,2,4,4,9,22,45,2,8,292,458
636,72,4,2,9,4,45,-78,7,0,337,380
636,73,3,4,6,7,-67,43,0,3,270,423
636,74,2,4,4,9,22,45,2,8,292,468
636,75,2,6,4,9,22,-37,4,1,314,431
636,76,2,5,4,9,22,54,6,5,336,485
636,77,4,3,8,5,-56,32,0,7,280,517
637,1,2,4,5,8,23,44,3,4,23,44
637,2,4,2,7,6,43,24,6,8,66,68
637,3,4,4,8,5,-56,41,0,9,10,109
637,4,4,3,7,6,43,-67,3,2,53,42
637,5,5,2,8,5,53,23,6,5,106,65
637,6,4,2,11,2,-53,20,3,5,53,85
637,7,5,2,8,5,53,23,6,8,106,108
637,8,3,4,5,8,32,-56,8,2,138,52
637,9,2,5,6,7,-76,52,2,4,62,104
637,10,4,4,5,8,41,44,3,8,103,148
637,11,4,4,7,6,43,-58,6,0,146,90
637,12,3,3,7,6,-66,33,0,3,80,123
637,13,4,3,7,6,43,33,3,6,123,156
637,14,4,2,7,6,43,-76,6,0,166,80
637,15,3,3,8,5,-65,32,1,2,101,112
637,16,3,4,8,5,35,41,6,3,136,153
637,17,5,2,11,2,-44,20,2,3,92,173
637,18,3,3,7,6,34,33,6,6,126,206
637,19,4,2,9,4,-55,22,1,8,71,228
637,20,4,3,5,8,41,-65,2,3,112,163
637,21,4,2,9,4,45,22,7,5,157,185
637,22,2,4,6,7,-76,43,1,8,81,228
637,23,3,3,6,7,33,-66,4,2,114,162
637,24,4,3,7,6,43,33,7,5,157,195
637,25,4,3,7,6,-57,33,0,8,100,228
637,26,6,2,10,3,64,21,4,9,164,249
637,27,2,4,4,9,22,-55,6,4,186,194
637,28,4,2,10,3,-54,21,2,5,132,215
637,29,5,2,10,3,55,21,7,6,187,236
637,30,2,4,4,9,22,-55,9,1,209,181
637,31,5,2,10,3,-45,21,4,2,164,202
637,32,3,4,4,9,31,45,5,7,195,247
637,33,3,4,6,7,33,-57,8,0,228,190
637,34,3,4,7,6,-66,42,2,2,162,232
637,35,3,4,4,9,31,45,3,7,193,277
637,36,3,3,4,9,31,-64,4,3,224,213
637,37,4,4,7,6,43,42,7,5,267,255
637,38,3,4,6,7,-67,43,0,8,200,298
637,39,5,2,9,4,54,-78,4,0,254,220
637,40,4,2,8,5,44,23,8,3,298,243
637,41,2,4,3,10,21,46,9,9,319,289
637,42,3,5,7,6,-66,-49,3,0,253,240
637,43,4,2,5,8,41,26,4,6,294,266
637,44,3,3,8,5,35,32,9,8,329,298
637,45,4,3,7,6,-57,-67,2,1,272,231
637,46,4,3,8,5,44,32,6,3,316,263
637,47,4,2,8,5,-56,23,0,6,260,286
637,48,2,4,5,8,23,-56,3,0,283,230
637,49,2,5,2,11,20,56,3,6,303,286
637,50,2,4,7,6,25,42,8,8,328,328
637,51,3,3,6,7,-67,-66,1,2,261,262
637,52,2,4,5,8,23,44,4,6,284,306
637,53,4,2,8,5,44,23,8,9,328,329
637,54,4,2,6,7,-58,-75,0,4,270,254
637,55,3,3,9,4,36,31,6,5,306,285
637,56,2,4,6,7,-76,43,0,8,230,328
637,57,4,3,9,4,45,31,5,9,275,359
637,58,2,6,4,9,22,-37,7,2,297,322
637,59,4,4,8,5,-56,41,1,3,241,363
637,60,3,4,6,7,33,43,4,6,274,406
637,61,3,4,8,5,35,41,9,7,309,447
637,62,4,2,7,6,-57,-76,2,1,252,371
637,63,2,4,4,9,22,45,4,6,274,416
637,64,3,4,4,9,31,-55,5,1,305,361
637,65,2,5,4,9,22,54,7,5,327,415
637,66,2,5,3,10,21,-45,8,0,348,370
637,67,3,4,6,7,-67,43,1,3,281,413
637,68,4,4,8,5,44,41,5,4,325,454
637,69,3,4,4,9,31,45,6,9,356,499
637,70,2,4,8,5,-74,-59,2,0,282,440
637,71,3,3,8,5,35,32,7,2,317,472
637,72,4,2,10,3,-54,21,3,3,263,493
637,73,3,5,5,8,32,53,5,6,295,546
638,1,3,3,8,5,35,32,5,2,35,32
638,2,3,4,6,7,33,43,8,5,68,75
638,3,5,2,8,5,-47,23,1,8,21,98
638,4,3,4,6,7,33,-57,4,1,54,41
638,5,4,3,5,8,41,35,5,6,95,76
638,6,3,3,5,8,32,-65,7,1,127,11
638,7,2,4,4,9,22,45,9,6,149,56
638,8,5,2,6,7,-49,-75,0,1,100,-19
638,9,5,2,10,3,55,21,5,2,155,2
638,10,3,3,5,8,32,35,7,7,187,37
638,11,3,3,7,6,-66,-67,1,0,121,-30
638,12,5,2,10,3,55,21,6,1,176,-9
638,13,4,3,7,6,43,33,9,4,219,24
638,14,5,2,10,3,-45,21,4,5,174,45
638,15,5,2,7,6,52,24,6,9,226,69
638,16,5,2,9,4,-46,-78,0,1,180,-9
638,17,3,3,9,4,36,31,6,2,216,22
638,18,4,3,8,5,-56,32,0,4,160,54
638,19,3,5,4,9,31,54,1,8,191,108
638,20,3,4,7,6,34,-58,5,0,225,50
638,21,4,2,6,7,42,25,7,5,267,75
638,22,2,4,4,9,22,-55,9,0,289,20
638,23,3,5,5,8,-68,53,1,3,221,73
638,24,3,4,7,6,34,42,5,5,255,115
638,25,3,3,7,6,34,33,9,8,289,148
638,26,3,3,7,6,-66,-67,3,1,223,81
638,27,2,4,8,5,26,41,9,2,249,122
638,28,3,3,5,8,-68,35,1,7,181,157
638,29,2,4,4,9,22,-55,3,2,203,102
638,30,2,5,3,10,21,55,4,7,224,157
638,31,4,2,9,4,45,22,9,9,269,179
638,32,2,4,5,8,-77,-56,2,3,192,123
638,33,4,2,7,6,43,24,5,7,235,147
638,34,5,2,6,7,51,-75,6,2,286,72
638,35,5,2,10,3,-45,21,1,3,241,93
638,36,4,3,5,8,41,35,2,8,282,128
638,37,3,3,9,4,36,31,8,9,318,159
638,38,4,3,5,8,41,-65,9,4,359,94
638,39,2,5,5,8,-77,53,2,7,282,147
638,40,2,4,4,9,22,-55,4,2,304,92
638,41,6,2,11,2,65,20,9,2,369,112
638,42,3,3,8,5,-65,32,4,4,304,144
638,43,4,2,11,2,-53,20,1,4,251,164
638,44,4,3,5,8,41,35,2,9,292,199
638,45,4,3,8,5,44,-68,6,1,336,131
638,46,5,2,10,3,-45,21,1,2,291,152
638,47,4,3,6,7,42,34,3,6,333,186
638,48,4,3,9,4,45,31,8,7,378,217
638,49,3,4,6,7,-67,-57,1,0,311,160
638,50,3,4,6,7,33,43,4,3,344,203
638,51,3,3,5,8,32,35,6,8,376,238
638,52,2,6,6,7,-76,61,0,9,300,299
638,53,2,4,5,8,23,-56,3,3,323,243
638,54,4,3,7,6,43,33,6,6,366,276
638,55,2,5,7,6,-75,51,1,7,291,327
638,56,3,4,7,6,34,42,5,9,325,369
638,57,4,3,9,4,-55,-69,0,0,270,300
638,58,2,4,4,9,22,45,2,5,292,345
638,59,2,4,5,8,23,44,5,9,315,389
638,60,3,3,7,6,34,-67,9,2,349,322
638,61,3,3,7,6,-66,33,3,5,283,355
638,62,3,4,6,7,33,43,6,8,316,398
638,63,2,5,8,5,-74,50,2,8,242,448
638,64,4,3,8,5,44,-68,6,0,286,380
638,65,4,2,5,8,41,26,7,6,327,406
638,66,4,3,7,6,-57,33,0,9,270,439
638,67,4,2,7,6,43,-76,3,3,313,363
638,68,4,2,7,6,43,24,6,7,356,387
638,69,2,5,3,10,21,-45,7,2,377,342
638,70,3,3,5,8,32,35,9,7,409,377
638,71,3,3,6,7,-67,-66,2,1,342,311
638,72,3,4,4,9,31,45,3,6,373,356
638,73,4,3,9,4,45,31,8,7,418,387
638,74,3,3,7,6,-66,-67,2,0,352,320
638,75,3,3,10,3,37,30,9,0,389,350
638,76,4,2,11,2,-53,20,6,0,336,370
638,77,2,5,4,9,22,54,8,4,358,424
638,78,2,4,5,8,-77,44,1,8,281,468
638,79,3,4,4,9,31,-55,2,3,312,413
638,80,4,3,6,7,42,34,4,7,354,447
638,81,2,5,2,11,20,-44,4,3,374,403
638,82,5,3,6,7,51,34,5,7,425,437
638,83,3,3,8,5,-65,32,0,9,360,469
638,84,3,3,7,6,34,-67,4,2,394,402
638,85,3,3,5,8,32,35,6,7,426,437
638,86,4,2,11,2,-53,20,3,7,373,457
638,87,4,3,9,4,45,31,8,8,418,488
638,88,5,2,9,4,-46,-78,2,0,372,410
638,89,2,4,5,8,23,44,5,4,395,454
638,90,4,3,8,5,44,32,9,6,439,486
638,91,5,2,9,4,-46,22,3,8,393,508
639,1,2,4,4,9,22,45,2,5,22,45
639,2,4,2,7,6,43,24,5,9,65,69
639,3,6,2,9,4,63,-78,8,1,128,-9
639,4,4,3,8,5,-56,32,2,3,72,23
639,5,4,3,7,6,43,33,5,6,115,56
639,6,2,4,5,8,23,-56,8,0,138,0
639,7,2,5,3,10,21,55,9,5,159,55
639,8,2,4,7,6,-75,42,4,7,84,97
639,9,4,2,7,6,43,-76,7,1,127,21
639,10,2,5,4,9,22,54,9,5,149,75
639,11,5,2,10,3,-45,21,4,6,104,96
639,12,4,2,6,7,42,-75,6,1,146,21
639,13,3,4,7,6,-66,42,0,3,80,63
639,14,4,3,9,4,45,31,5,4,125,94
639,15,4,3,8,5,44,32,9,6,169,126
639,16,3,3,7,6,-66,33,3,9,103,159
639,17,2,5,4,9,22,-46,5,3,125,113
639,18,4,2,6,7,42,25,7,8,167,138
639,19,4,3,9,4,-55,31,2,9,112,169
639,20,3,4,5,8,32,-56,4,3,144,113
639,21,2,4,7,6,25,42,9,5,169,155
639,22,5,2,6,7,-49,-75,0,0,120,80
639,23,2,5,2,11,20,56,0,6,140,136
639,24,3,3,6,7,33,-66,3,0,173,70
639,25,4,2,9,4,45,22,8,2,218,92
639,26,4,3,7,6,-57,33,1,5,161,125
639,27,4,3,7,6,43,33,4,8,204,158
639,28,2,4,7,6,25,-58,9,0,229,100
639,29,5,3,9,4,-46,31,3,1,183,131
639,30,2,4,5,8,23,44,6,5,206,175
639,31,3,4,8,5,-65,41,1,6,141,216
639,32,5,2,8,5,53,23,4,9,194,239
639,33,3,3,4,9,31,-64,5,5,225,175
639,34,2,4,3,10,21,-54,6,1,246,121
639,35,3,3,9,4,-64,31,2,2,182,152
639,36,5,2,9,4,54,22,6,4,236,174
639,37,2,4,5,8,23,44,9,8,259,218
639,38,2,4,3,10,-79,-54,0,4,180,164
639,39,5,2,8,5,53,23,3,7,233,187
639,40,2,4,5,8,23,-56,6,1,256,131
639,41,3,3,8,5,-65,32,1,3,191,163
639,42,4,2,7,6,43,24,4,7,234,187
639,43,3,3,8,5,35,32,9,9,269,219
639,44,5,3,9,4,-46,-69,3,0,223,150
639,45,2,5,4,9,22,54,5,4,245,204
639,46,3,3,6,7,33,34,8,8,278,238
639,47,4,2,7,6,-57,-76,1,2,221,162
639,48,4,3,6,7,42,34,3,6,263,196
639,49,3,4,8,5,35,41,8,7,298,237
639,50,2,4,6,7,-76,-57,2,0,222,180
639,51,5,2,8,5,53,23,5,3,275,203
639,52,3,3,9,4,-64,31,1,4,211,234
639,53,2,4,6,7,24,43,5,7,235,277
639,54,3,4,4,9,31,-55,6,2,266,222
639,55,3,4,8,5,-65,41,1,3,201,263
639,56,3,3,5,8,32,35,3,8,233,298
639,57,2,5,3,10,21,-45,4,3,254,253
639,58,3,3,7,6,34,33,8,6,288,286
639,59,2,4,6,7,-76,43,2,9,212,329
639,60,3,3,8,5,35,-68,7,1,247,261
639,61,2,4,3,10,21,46,8,7,268,307
639,62,4,3,7,6,-57,-67,1,0,211,240
639,63,3,3,8,5,35,32,6,2,246,272
639,64,4,2,8,5,-56,23,0,5,190,295
639,65,2,4,7,6,25,42,5,7,215,337
639,66,2,5,4,9,22,-46,7,1,237,291
639,67,3,3,8,5,-65,32,2,3,172,323
639,68,3,5,4,9,31,54,3,7,203,377
639,69,4,2,7,6,43,-76,6,1,246,301
639,70,4,3,9,4,-55,31,1,2,191,332
639,71,3,3,5,8,32,35,3,7,223,367
639,72,5,2,6,7,51,-75,4,2,274,292
639,73,2,6,6,7,24,61,8,3,298,353
639,74,3,3,10,3,-63,30,5,3,235,383
639,75,3,4,8,5,-65,41,0,4,170,424
639,76,6,2,8,5,62,23,2,7,232,447
639,77,4,4,6,7,42,-57,4,0,274,390
639,78,2,5,4,9,22,54,6,4,296,444
639,79,5,2,9,4,-46,22,0,6,250,466
639,80,4,2,9,4,45,22,5,8,295,488
639,81,2,4,5,8,23,-56,8,2,318,432
639,82,4,2,9,4,-55,22,3,4,263,454
639,83,4,3,9,4,45,31,8,5,308,485
639,84,3,3,8,5,-65,32,3,7,243,517
640,1,4,2,8,5,44,23,4,3,44,23
640,2,4,2,5,8,41,26,5,9,85,49
640,3,3,3,5,8,32,-65,7,4,117,-16
640,4,4,3,8,5,-56,32,1,6,61,16
640,5,5,2,8,5,53,23,4,9,114,39
640,6,3,3,6,7,33,-66,7,3,147,-27
640,7,4,3,5,8,41,35,8,8,188,8
640,8,2,4,4,9,-78,-55,0,3,110,-47
640,9,3,4,6,7,33,43,3,6,143,-4
640,10,2,5,3,10,21,-45,4,1,164,-49
640,11,5,2,8,5,53,23,7,4,217,-26
640,12,5,3,10,3,-45,30,2,4,172,4
640,13,3,4,5,8,32,44,4,8,204,48
640,14,3,3,7,6,34,-67,8,1,238,-19
640,15,2,5,3,10,21,55,9,6,259,36
640,16,4,2,7,6,-57,-76,2,0,202,-40
640,17,2,6,5,8,23,62,5,2,225,22
640,18,4,3,9,4,-55,31,0,3,170,53
640,19,3,3,4,9,31,36,1,9,201,89
640,20,4,3,7,6,43,-67,4,2,244,22
640,21,2,4,4,9,22,45,6,7,266,67
640,22,4,2,8,5,-56,-77,0,0,210,-10
640,23,3,3,6,7,33,34,3,4,243,24
640,24,4,3,8,5,44,32,7,6,287,56
640,25,3,4,6,7,-67,43,0,9,220,99
640,26,3,4,6,7,33,-57,3,2,253,42
640,27,2,4,7,6,25,42,8,4,278,84
640,28,3,3,8,5,-65,32,3,6,213,116
640,29,2,4,7,6,25,42,8,8,238,158
640,30,3,3,7,6,-66,-67,2,1,172,91
640,31,5,2,9,4,54,22,6,3,226,113
640,32,2,6,2,11,20,65,6,8,246,178
640,33,3,3,8,5,-65,-68,1,0,181,110
640,34,3,4,7,6,34,42,5,2,215,152
640,35,2,4,6,7,24,43,9,5,239,195
640,36,4,3,8,5,-56,32,3,7,183,227
640,37,3,4,5,8,32,-56,5,1,215,171
640,38,3,4,7,6,34,42,9,3,249,213
640,39,3,4,5,8,-68,44,1,7,181,257
640,40,4,3,7,6,43,-67,4,0,224,190
640,41,3,4,5,8,32,44,6,4,256,234
640,42,2,4,3,10,21,-54,7,0,277,180
640,43,5,3,7,6,52,33,9,3,329,213
640,44,4,2,5,8,-59,26,0,9,270,239
640,45,5,2,8,5,53,-77,3,2,323,162
640,46,4,2,6,7,42,25,5,7,365,187
640,47,5,2,8,5,53,-77,8,0,418,110
640,48,2,5,5,8,-77,53,1,3,341,163
640,49,3,3,5,8,32,35,3,8,373,198
640,50,2,5,4,9,22,-46,5,2,395,152
640,51,4,3,5,8,41,35,6,7,436,187
640,52,3,3,7,6,-66,-67,0,0,370,120
640,53,2,4,5,8,23,44,3,4,393,164
640,54,3,3,7,6,34,33,7,7,427,197
640,55,2,5,3,10,21,-45,8,2,448,152
640,56,4,2,8,5,-56,23,2,5,392,175
640,57,3,4,7,6,34,42,6,7,426,217
640,58,3,4,8,5,-65,41,1,8,361,258
640,59,6,2,10,3,64,21,5,9,425,279
640,60,4,2,8,5,44,-77,9,2,469,202
640,61,3,3,6,7,-67,34,2,6,402,236
640,62,3,3,4,9,31,-64,3,2,433,172
640,63,3,3,7,6,34,33,7,5,467,205
640,64,4,3,7,6,-57,33,0,8,410,238
640,65,4,3,6,7,42,-66,2,2,452,172
640,66,3,3,6,7,33,34,5,6,485,206
640,67,5,2,9,4,54,22,9,8,539,228
641,1,4,2,6,7,42,25,2,5,42,25
641,2,3,3,6,7,33,34,5,9,75,59
641,3,5,2,6,7,51,-75,6,4,126,-16
641,4,4,3,7,6,43,33,9,7,169,17
641,5,2,5,3,10,-79,-45,0,2,90,-28
641,6,3,3,9,4,36,31,6,3,126,3
641,7,3,3,7,6,-66,33,0,6,60,36
641,8,3,4,5,8,32,-56,2,0,92,-20
641,9,3,4,7,6,34,42,6,2,126,22
641,10,3,3,5,8,32,35,8,7,158,57
641,11,4,3,9,4,-55,31,3,8,103,88
641,12,3,4,8,5,35,41,8,9,138,129
641,13,2,5,4,9,-78,-46,0,3,60,83
641,14,5,2,8,5,53,23,3,6,113,106
641,15,4,2,6,7,42,-75,5,1,155,31
641,16,3,4,5,8,32,44,7,5,187,75
641,17,4,2,7,6,-57,24,0,9,130,99
641,18,3,3,6,7,33,-66,3,3,163,33
641,19,4,3,5,8,41,35,4,8,204,68
641,20,5,2,6,7,51,-75,5,3,255,-7
641,21,3,3,7,6,34,33,9,6,289,26
641,22,3,3,5,8,-68,-65,1,1,221,-39
641,23,4,2,10,3,46,21,7,2,267,-18
641,24,2,4,7,6,-75,42,2,4,192,24
641,25,2,4,6,7,24,43,6,7,216,67
641,26,3,4,5,8,32,-56,8,1,248,11
641,27,2,4,3,10,21,46,9,7,269,57
641,28,4,4,8,5,-56,41,3,8,213,98
641,29,5,3,9,4,54,31,7,9,267,129
641,30,3,3,8,5,-65,-68,2,1,202,61
641,31,5,2,9,4,54,22,6,3,256,83
641,32,3,3,7,6,-66,33,0,6,190,116
641,33,2,5,4,9,22,-46,2,0,212,70
641,34,3,3,7,6,34,33,6,3,246,103
641,35,5,3,9,4,-46,31,0,4,200,134
641,36,3,4,6,7,33,43,3,7,233,177
641,37,5,3,7,6,52,-67,5,0,285,110
641,38,3,5,6,7,33,52,8,2,318,162
641,39,5,2,11,2,-44,20,4,2,274,182
641,40,4,2,8,5,44,23,8,5,318,205
641,41,3,4,7,6,-66,42,2,7,252,247
641,42,2,4,6,7,24,-57,6,0,276,190
641,43,5,2,10,3,-45,21,1,1,231,211
641,44,3,4,4,9,31,45,2,6,262,256
641,45,3,4,6,7,33,43,5,9,295,299
641,46,3,3,7,6,34,-67,9,2,329,232
641,47,2,5,6,7,-76,52,3,4,253,284
641,48,4,4,4,9,40,45,3,9,293,329
641,49,2,4,4,9,22,-55,5,4,315,274
641,50,2,4,6,7,24,43,9,7,339,317
641,51,4,3,7,6,-57,-67,2,0,282,250
641,52,3,3,4,9,31,36,3,6,313,286
641,53,4,2,11,2,-53,20,0,6,260,306
641,54,2,4,7,6,25,42,5,8,285,348
641,55,5,3,7,6,52,-67,7,1,337,281
641,56,3,4,7,6,-66,42,1,3,271,323
641,57,2,6,4,9,22,63,3,6,293,386
641,58,3,3,6,7,33,-66,6,0,326,320
641,59,2,5,5,8,23,53,9,3,349,373
641,60,4,3,8,5,-56,32,3,5,293,405
641,61,3,3,5,8,32,-65,5,0,325,340
641,62,3,4,7,6,34,42,9,2,359,382
641,63,3,3,6,7,-67,34,2,6,292,416
641,64,2,4,7,6,25,42,7,8,317,458
641,65,3,3,6,7,-67,-66,0,2,250,392
641,66,4,2,6,7,42,25,2,7,292,417
641,67,3,3,9,4,36,31,8,8,328,448
641,68,4,3,8,5,-56,-68,2,0,272,380
641,69,3,4,4,9,31,45,3,5,303,425
641,70,2,4,6,7,24,43,7,8,327,468
641,71,2,4,4,9,22,-55,9,3,349,413
641,72,2,6,3,10,-79,64,0,7,270,477
641,73,5,2,8,5,53,-77,3,0,323,400
641,74,3,4,4,9,31,45,4,5,354,445
641,75,4,3,7,6,43,33,7,8,397,478
641,76,4,2,8,5,-56,-77,1,1,341,401
641,77,2,5,2,11,20,56,1,7,361,457
641,78,4,2,8,5,44,-77,5,0,405,380
641,79,3,3,6,7,33,34,8,4,438,414
641,80,4,3,6,7,-58,34,0,8,380,448
641,81,2,5,3,10,21,-45,1,3,401,403
641,82,5,2,10,3,55,21,6,4,456,424
641,83,3,3,7,6,-66,33,0,7,390,457
641,84,3,4,7,6,34,42,4,9,424,499
641,85,2,4,7,6,25,-58,9,1,449,441
641,86,3,4,9,4,-64,40,5,1,385,481
641,87,3,3,8,5,-65,32,0,3,320,513
642,1,4,3,7,6,43,33,3,3,43,33
642,2,2,5,4,9,22,54,5,7,65,87
642,3,4,3,8,5,44,32,9,9,109,119
642,4,2,4,5,8,-77,-56,2,3,32,63
642,5,3,3,5,8,32,35,4,8,64,98
642,6,3,4,5,8,32,-56,6,2,96,42
642,7,5,2,10,3,-45,21,1,3,51,63
642,8,2,5,5,8,23,53,4,6,74,116
642,9,2,4,3,10,21,-54,5,2,95,62
642,10,4,3,8,5,44,32,9,4,139,94
642,11,4,3,8,5,-56,32,3,6,83,126
642,12,3,3,7,6,34,33,7,9,117,159
642,13,5,2,8,5,-47,-77,0,2,70,82
642,14,3,3,6,7,33,34,3,6,103,116
642,15,4,3,6,7,42,-66,5,0,145,50
642,16,3,4,6,7,33,43,8,3,178,93
642,17,4,3,5,8,41,35,9,8,219,128
642,18,4,3,7,6,-57,-67,2,1,162,61
642,19,2,5,4,9,22,54,4,5,184,115
642,20,3,3,6,7,33,34,7,9,217,149
642,21,2,5,7,6,-75,-49,2,0,142,100
642,22,3,3,8,5,35,32,7,2,177,132
642,23,3,3,6,7,-67,34,0,6,110,166
642,24,4,4,8,5,44,41,4,7,154,207
642,25,3,4,5,8,32,-56,6,1,186,151
642,26,3,3,6,7,33,34,9,5,219,185
642,27,5,2,9,4,-46,22,3,7,173,207
642,28,4,3,7,6,43,-67,6,0,216,140
642,29,3,5,5,8,32,53,8,3,248,193
642,30,4,3,7,6,-57,33,1,6,191,226
642,31,3,3,5,8,32,-65,3,1,223,161
642,32,4,3,9,4,45,31,8,2,268,192
642,33,2,4,5,8,-77,44,1,6,191,236
642,34,4,3,6,7,42,-66,3,0,233,170
642,35,2,6,3,10,21,64,4,4,254,234
642,36,5,2,10,3,55,21,9,5,309,255
642,37,3,4,7,6,-66,42,3,7,243,297
642,38,4,3,7,6,43,-67,6,0,286,230
642,39,5,2,8,5,53,23,9,3,339,253
642,40,4,2,7,6,-57,24,2,7,282,277
642,41,2,5,4,9,22,-46,4,1,304,231
642,42,3,3,9,4,-64,31,0,2,240,262
642,43,2,5,3,10,21,55,1,7,261,317
642,44,4,2,7,6,43,-76,4,1,304,241
642,45,3,4,7,6,34,42,8,3,338,283
642,46,3,3,7,6,-66,33,2,6,272,316
642,47,2,6,5,8,23,62,5,8,295,378
642,48,3,3,8,5,-65,-68,0,0,230,310
642,49,5,2,8,5,53,23,3,3,283,333
642,50,3,4,4,9,31,45,4,8,314,378
642,51,4,3,7,6,43,-67,7,1,357,311
642,52,3,3,6,7,-67,34,0,5,290,345
642,53,3,4,6,7,33,43,3,8,323,388
642,54,3,3,8,5,35,-68,8,0,358,320
642,55,2,5,2,11,20,56,8,6,378,376
642,56,3,4,4,9,31,-55,9,1,409,321
642,57,4,3,5,8,-59,35,0,6,350,356
642,58,3,4,5,8,32,-56,2,0,382,300
642,59,3,4,6,7,33,43,5,3,415,343
642,60,4,4,6,7,42,43,7,6,457,386
642,61,5,2,7,6,52,-76,9,0,509,310
643,1,2,4,5,8,23,44,3,4,23,44
643,2,3,3,10,3,-63,30,0,4,-40,74
643,3,3,3,8,5,35,32,5,6,-5,106
643,4,4,3,8,5,44,32,9,8,39,138
643,5,3,3,8,5,-65,-68,4,0,-26,70
643,6,5,2,6,7,51,25,5,5,25,95
643,7,3,3,7,6,34,33,9,8,59,128
643,8,3,3,6,7,-67,-66,2,2,-8,62
643,9,2,5,4,9,22,54,4,6,14,116
643,10,3,3,6,7,33,-66,7,0,47,50
643,11,6,2,11,2,-35,20,2,0,12,70
643,12,3,4,7,6,34,42,6,2,46,112
643,13,4,3,7,6,43,33,9,5,89,145
643,14,3,4,9,4,-64,40,5,5,25,185
643,15,3,4,5,8,32,44,7,9,57,229
643,16,5,2,8,5,-47,-77,0,2,10,152
643,17,3,3,6,7,33,34,3,6,43,186
643,18,4,2,10,3,46,21,9,7,89,207
643,19,2,5,3,10,-79,-45,0,2,10,162
643,20,4,3,10,3,46,30,6,2,56,192
643,21,3,4,4,9,31,45,7,7,87,237
643,22,3,4,4,9,31,-55,8,2,118,182
643,23,2,5,2,11,20,56,8,8,138,238
643,24,5,2,9,4,-46,-78,2,0,92,160
643,25,4,2,10,3,46,21,8,1,138,181
643,26,5,2,9,4,-46,22,2,3,92,203
643,27,2,5,5,8,23,53,5,6,115,256
643,28,3,4,9,4,-64,40,1,6,51,296
643,29,3,3,5,8,32,-65,3,1,83,231
643,30,4,3,10,3,46,30,9,1,129,261
643,31,4,3,8,5,-56,32,3,3,73,293
643,32,5,2,11,2,56,20,9,3,129,313
643,33,2,4,3,10,-79,46,0,9,50,359
643,34,2,5,4,9,22,-46,2,3,72,313
643,35,3,4,5,8,32,44,4,7,104,357
643,36,3,4,8,5,35,41,9,8,139,398
643,37,3,3,4,9,-69,-64,0,4,70,334
643,38,4,2,8,5,44,23,4,7,114,357
643,39,3,3,8,5,35,32,9,9,149,389
643,40,3,3,8,5,-65,-68,4,1,84,321
643,41,3,3,8,5,35,32,9,3,119,353
643,42,5,2,9,4,-46,22,3,5,73,375
643,43,4,2,8,5,44,23,7,8,117,398
643,44,3,4,5,8,32,-56,9,2,149,342
643,45,6,2,10,3,-36,21,3,3,113,363
643,46,3,3,5,8,32,35,5,8,145,398
643,47,4,3,6,7,42,-66,7,2,187,332
643,48,2,5,4,9,22,54,9,6,209,386
643,49,4,3,9,4,-55,31,4,7,154,417
643,50,2,5,3,10,21,-45,5,2,175,372
643,51,3,3,7,6,34,33,9,5,209,405
643,52,4,3,7,6,-57,33,2,8,152,438
643,53,3,4,7,6,34,-58,6,0,186,380
643,54,2,5,3,10,21,55,7,5,207,435
643,55,5,3,6,7,51,34,8,9,258,469
643,56,2,4,7,6,-75,-58,3,1,183,411
643,57,3,4,5,8,32,44,5,5,215,455
643,58,4,3,8,5,44,32,9,7,259,487
643,59,3,3,9,4,-64,31,5,8,195,518
644,1,3,3,3,10,30,37,0,7,30,37
644,2,2,4,8,5,26,41,6,8,56,78
644,3,3,3,7,6,-66,-67,0,1,-10,11
644,4,4,3,8,5,44,32,4,3,34,43
644,5,2,4,4,9,22,45,6,8,56,88
644,6,4,3,9,4,-55,31,1,9,1,119
644,7,4,3,9,4,45,-69,6,0,46,50
644,8,3,4,4,9,31,45,7,5,77,95
644,9,3,5,6,7,-67,52,0,7,10,147
644,10,2,5,4,9,22,-46,2,1,32,101
644,11,5,2,11,2,56,20,8,1,88,121
644,12,2,5,3,10,21,55,9,6,109,176
644,13,3,4,4,9,-69,-55,0,1,40,121
644,14,3,3,6,7,33,34,3,5,73,155
644,15,4,2,10,3,46,21,9,6,119,176
644,16,5,2,11,2,-44,20,5,6,75,196
644,17,4,3,9,4,-55,31,0,7,20,227
644,18,5,3,8,5,53,32,3,9,73,259
644,19,4,4,7,6,43,-58,6,1,116,201
644,20,3,4,4,9,31,45,7,6,147,246
644,21,5,2,8,5,-47,23,0,9,100,269
644,22,4,3,6,7,42,-66,2,3,142,203
644,23,3,3,5,8,32,35,4,8,174,238
644,24,4,2,8,5,44,-77,8,1,218,161
644,25,3,3,5,8,-68,35,0,6,150,196
644,26,2,5,3,10,21,-45,1,1,171,151
644,27,2,4,2,11,20,47,1,8,191,198
644,28,2,5,4,9,22,-46,3,2,213,152
644,29,4,3,4,9,40,36,3,8,253,188
644,30,3,3,5,8,32,-65,5,3,285,123
644,31,2,5,3,10,21,55,6,8,306,178
644,32,2,4,7,6,-75,-58,1,0,231,120
644,33,3,4,3,10,30,46,1,6,261,166
644,34,3,4,5,8,32,-56,3,0,293,110
644,35,5,2,10,3,55,21,8,1,348,131
644,36,2,4,7,6,-75,42,3,3,273,173
644,37,2,4,4,9,22,45,5,8,295,218
644,38,2,5,5,8,23,-47,8,1,318,171
644,39,2,5,6,7,-76,52,2,3,242,223
644,40,4,3,8,5,44,32,6,5,286,255
644,41,4,3,9,4,-55,31,1,6,231,286
644,42,3,4,6,7,33,43,4,9,264,329
644,43,4,2,6,7,42,-75,6,4,306,254
644,44,5,2,9,4,-46,22,0,6,260,276
644,45,2,5,4,9,22,-46,2,0,282,230
644,46,3,3,8,5,35,32,7,2,317,262
644,47,5,2,9,4,-46,22,1,4,271,284
644,48,4,2,8,5,44,23,5,7,315,307
644,49,4,4,8,5,44,41,9,8,359,348
644,50,2,4,4,9,-78,-55,1,3,281,293
644,51,4,2,5,8,41,26,2,9,322,319
644,52,3,3,7,6,34,-67,6,2,356,252
644,53,4,2,9,4,-55,22,1,4,301,274
644,54,3,4,6,7,33,43,4,7,334,317
644,55,3,3,7,6,34,-67,8,0,368,250
644,56,3,4,9,4,-64,40,4,0,304,290
644,57,3,4,4,9,31,45,5,5,335,335
644,58,3,4,6,7,33,43,8,8,368,378
644,59,2,4,4,9,-78,-55,0,3,290,323
644,60,3,3,6,7,33,34,3,7,323,357
644,61,3,3,9,4,36,31,9,8,359,388
644,62,4,2,6,7,-58,-75,1,3,301,313
644,63,4,3,7,6,43,33,4,6,344,346
644,64,4,3,9,4,45,31,9,7,389,377
644,65,3,3,8,5,-65,32,4,9,324,409
644,66,5,2,10,3,55,-79,9,0,379,330
644,67,4,3,8,5,-56,32,3,2,323,362
644,68,5,2,7,6,52,24,5,6,375,386
644,69,3,3,8,5,-65,32,0,8,310,418
644,70,3,3,6,7,33,-66,3,2,343,352
644,71,3,4,4,9,31,45,4,7,374,397
644,72,3,3,6,7,33,-66,7,1,407,331
644,73,4,2,9,4,-55,22,2,3,352,353
644,74,3,3,7,6,34,33,6,6,386,386
644,75,4,2,10,3,-54,21,2,7,332,407
644,76,5,2,9,4,54,22,6,9,386,429
644,77,2,4,5,8,23,-56,9,3,409,373
644,78,2,5,2,11,20,56,9,9,429,429
644,79,4,3,10,3,-54,30,5,9,375,459
644,80,3,3,7,6,34,-67,9,2,409,392
644,81,3,3,6,7,-67,34,2,6,342,426
644,82,3,3,6,7,33,-66,5,0,375,360
644,83,4,4,7,6,43,42,8,2,418,402
644,84,4,2,6,7,-58,25,0,7,360,427
644,85,3,4,5,8,32,-56,2,1,392,371
644,86,2,5,6,7,24,52,6,3,416,423
644,87,3,3,5,8,32,35,8,8,448,458
644,88,4,3,5,8,41,-65,9,3,489,393
644,89,5,2,10,3,-45,21,4,4,444,414
644,90,2,4,3,10,21,-54,5,0,465,360
644,91,5,2,7,6,52,24,7,4,517,384
645,1,4,2,8,5,44,23,4,3,44,23
645,2,3,4,7,6,34,42,8,5,78,65
645,3,5,2,8,5,-47,23,1,8,31,88
645,4,2,4,6,7,24,-57,5,1,55,31
645,5,3,4,5,8,32,44,7,5,87,75
645,6,2,4,4,9,22,-55,9,0,109,20
645,7,2,5,2,11,20,56,9,6,129,76
645,8,2,4,7,6,-75,42,4,8,54,118
645,9,3,4,5,8,32,-56,6,2,86,62
645,10,3,3,8,5,-65,32,1,4,21,94
645,11,2,4,5,8,23,44,4,8,44,138
645,12,3,3,5,8,32,-65,6,3,76,73
645,13,4,2,8,5,-56,23,0,6,20,96
645,14,2,4,6,7,24,43,4,9,44,139
645,15,4,4,6,7,42,-57,6,2,86,82
645,16,4,2,7,6,43,24,9,6,129,106
645,17,2,4,4,9,-78,-55,1,1,51,51
645,18,4,3,10,3,46,30,7,1,97,81
645,19,3,4,7,6,-66,42,1,3,31,123
645,20,2,5,5,8,23,53,4,6,54,176
645,21,2,4,6,7,24,43,8,9,78,219
645,22,4,2,9,4,-55,-78,3,1,23,141
645,23,4,3,10,3,46,30,9,1,69,171
645,24,4,3,8,5,-56,32,3,3,13,203
645,25,2,6,3,10,21,64,4,7,34,267
645,26,4,2,4,9,40,-73,4,4,74,194
645,27,3,4,3,10,30,-54,4,0,104,140
645,28,2,4,6,7,24,43,8,3,128,183
645,29,4,2,8,5,-56,23,2,6,72,206
645,30,2,5,5,8,23,53,5,9,95,259
645,31,3,3,7,6,34,-67,9,2,129,192
645,32,3,3,5,8,-68,35,1,7,61,227
645,33,4,2,6,7,42,-75,3,2,103,152
645,34,2,4,6,7,24,43,7,5,127,195
645,35,2,4,3,10,21,-54,8,1,148,141
645,36,3,3,7,6,-66,33,2,4,82,174
645,37,2,4,6,7,24,43,6,7,106,217
645,38,4,4,8,5,-56,41,0,8,50,258
645,39,3,3,6,7,33,-66,3,2,83,192
645,40,3,4,5,8,32,44,5,6,115,236
645,41,3,3,9,4,-64,31,1,7,51,267
645,42,3,3,6,7,33,-66,4,1,84,201
645,43,5,2,6,7,51,25,5,6,135,226
645,44,3,4,6,7,33,43,8,9,168,269
645,45,3,4,8,5,-65,-59,3,0,103,210
645,46,4,2,7,6,43,24,6,4,146,234
645,47,4,3,8,5,-56,32,0,6,90,266
645,48,2,5,5,8,23,53,3,9,113,319
645,49,3,3,4,9,31,-64,4,5,144,255
645,50,5,2,9,4,54,22,8,7,198,277
645,51,5,2,10,3,-45,21,3,8,153,298
645,52,4,3,7,6,43,-67,6,1,196,231
645,53,4,3,9,4,-55,31,1,2,141,262
645,54,2,5,3,10,21,55,2,7,162,317
645,55,2,5,8,5,26,50,8,7,188,367
645,56,5,2,9,4,-46,22,2,9,142,389
645,57,4,3,8,5,44,-68,6,1,186,321
645,58,4,3,9,4,-55,31,1,2,131,352
645,59,2,5,3,10,21,55,2,7,152,407
645,60,3,4,6,7,33,-57,5,0,185,350
645,61,4,2,7,6,43,24,8,4,228,374
645,62,3,4,7,6,-66,42,2,6,162,416
645,63,2,4,6,7,24,43,6,9,186,459
645,64,4,3,8,5,-56,-68,0,1,130,391
645,65,3,3,6,7,33,34,3,5,163,425
645,66,4,2,7,6,43,24,6,9,206,449
645,67,5,2,9,4,-46,-78,0,1,160,371
645,68,3,4,7,6,34,42,4,3,194,413
645,69,2,4,5,8,23,44,7,7,217,457
645,70,3,4,5,8,32,-56,9,1,249,401
645,71,3,3,4,9,-69,36,0,7,180,437
645,72,2,4,4,9,22,-55,2,2,202,382
645,73,2,4,5,8,23,44,5,6,225,426
645,74,3,4,9,4,-64,40,1,6,161,466
645,75,2,4,4,9,22,-55,3,1,183,411
645,76,3,4,4,9,31,45,4,6,214,456
645,77,3,5,5,8,32,53,6,9,246,509
646,1,2,5,4,9,22,54,2,4,22,54
646,2,2,4,3,10,21,-54,3,0,43,0
646,3,2,5,5,8,23,53,6,3,66,53
646,4,3,3,6,7,33,34,9,7,99,87
646,5,3,3,7,6,-66,-67,3,0,33,20
646,6,2,4,2,11,20,47,3,7,53,67
646,7,2,5,4,9,22,-46,5,1,75,21
646,8,4,3,7,6,43,33,8,4,118,54
646,9,3,3,8,5,-65,32,3,6,53,86
646,10,4,3,7,6,43,33,6,9,96,119
646,11,2,5,3,10,21,-45,7,4,117,74
646,12,4,3,9,4,-55,31,2,5,62,105
646,13,2,5,2,11,20,-44,2,1,82,61
646,14,4,3,6,7,42,34,4,5,124,95
646,15,2,5,6,7,24,52,8,7,148,147
646,16,3,4,8,5,-65,41,3,8,83,188
646,17,3,3,3,10,30,-63,3,5,113,125
646,18,3,4,6,7,33,43,6,8,146,168
646,19,4,2,8,5,-56,-77,0,1,90,91
646,20,2,5,6,7,24,52,4,3,114,143
646,21,3,4,6,7,33,43,7,6,147,186
646,22,3,3,5,8,32,-65,9,1,179,121
646,23,3,4,8,5,-65,41,4,2,114,162
646,24,5,2,9,4,54,22,8,4,168,184
646,25,3,3,5,8,-68,35,0,9,100,219
646,26,3,4,6,7,33,-57,3,2,133,162
646,27,3,3,6,7,33,34,6,6,166,196
646,28,4,2,7,6,43,-76,9,0,209,120
646,29,3,3,7,6,-66,33,3,3,143,153
646,30,2,5,5,8,23,53,6,6,166,206
646,31,3,5,4,9,31,-46,7,0,197,160
646,32,2,4,6,7,-76,43,1,3,121,203
646,33,3,3,8,5,35,32,6,5,156,235
646,34,3,3,6,7,33,34,9,9,189,269
646,35,3,4,4,9,-69,-55,0,4,120,214
646,36,3,5,6,7,33,52,3,6,153,266
646,37,5,2,7,6,52,-76,5,0,205,190
646,38,2,4,3,10,21,46,6,6,226,236
646,39,2,5,6,7,-76,52,0,8,150,288
646,40,4,2,7,6,43,-76,3,2,193,212
646,41,4,3,10,3,46,30,9,2,239,242
646,42,4,3,9,4,-55,31,4,3,184,273
646,43,2,5,4,9,22,54,6,7,206,327
646,44,3,3,8,5,-65,32,1,9,141,359
646,45,2,4,4,9,22,-55,3,4,163,304
646,46,3,4,5,8,32,44,5,8,195,348
646,47,4,2,6,7,42,-75,7,3,237,273
646,48,5,2,8,5,-47,23,0,6,190,296
646,49,5,2,8,5,53,23,3,9,243,319
646,50,4,2,9,4,45,-78,8,1,288,241
646,51,6,2,8,5,-38,23,0,4,250,264
646,52,4,3,8,5,44,32,4,6,294,296
646,53,3,3,4,9,31,-64,5,2,325,232
646,54,4,4,4,9,40,45,5,7,365,277
646,55,2,4,4,9,22,-55,7,2,387,222
646,56,2,4,4,9,22,45,9,7,409,267
646,57,4,2,6,7,-58,-75,1,2,351,192
646,58,4,2,6,7,42,25,3,7,393,217
646,59,4,2,7,6,43,-76,6,1,436,141
646,60,4,2,10,3,-54,21,2,2,382,162
646,61,4,3,7,6,43,33,5,5,425,195
646,62,2,4,5,8,23,44,8,9,448,239
646,63,3,3,7,6,-66,-67,2,2,382,172
646,64,2,4,5,8,23,44,5,6,405,216
646,65,4,4,6,7,42,43,7,9,447,259
646,66,3,3,7,6,-66,-67,1,2,381,192
646,67,4,3,7,6,43,33,4,5,424,225
646,68,5,2,9,4,54,22,8,7,478,247
646,69,3,4,5,8,-68,-56,0,1,410,191
646,70,3,4,8,5,35,41,5,2,445,232
646,71,3,4,4,9,31,45,6,7,476,277
646,72,4,3,6,7,42,-66,8,1,518,211
647,1,6,2,10,3,64,21,4,1,64,21
647,2,4,3,8,5,44,32,8,3,108,53
647,3,3,3,9,4,-64,31,4,4,44,84
647,4,4,3,6,7,42,34,6,8,86,118
647,5,4,3,7,6,43,-67,9,1,129,51
647,6,3,4,7,6,-66,42,3,3,63,93
647,7,5,2,9,4,54,22,7,5,117,115
647,8,3,4,5,8,32,44,9,9,149,159
647,9,3,4,6,7,-67,-57,2,2,82,102
647,10,3,4,6,7,33,43,5,5,115,145
647,11,4,3,8,5,44,32,9,7,159,177
647,12,3,3,7,6,-66,-67,3,0,93,110
647,13,3,4,4,9,31,45,4,5,124,155
647,14,5,3,8,5,53,32,7,7,177,187
647,15,4,3,8,5,-56,32,1,9,121,219
647,16,3,3,8,5,35,-68,6,1,156,151
647,17,3,3,8,5,-65,32,1,3,91,183
647,18,5,2,7,6,52,24,3,7,143,207
647,19,4,4,9,4,45,40,8,7,188,247
647,20,6,2,8,5,-38,-77,0,0,150,170
647,21,3,4,4,9,31,45,1,5,181,215
647,22,5,2,11,2,56,20,7,5,237,235
647,23,6,2,8,5,62,23,9,8,299,258
647,24,2,6,4,9,-78,-37,1,1,221,221
647,25,3,3,7,6,34,33,5,4,255,254
647,26,4,3,9,4,-55,31,0,5,200,285
647,27,5,2,10,3,55,21,5,6,255,306
647,28,4,2,8,5,44,23,9,9,299,329
647,29,5,3,8,5,-47,-68,2,1,252,261
647,30,2,6,2,11,20,65,2,6,272,326
647,31,5,2,8,5,53,23,5,9,325,349
647,32,4,4,4,9,40,-55,5,4,365,294
647,33,5,2,10,3,-45,21,0,5,320,315
647,34,3,3,6,7,33,34,3,9,353,349
647,35,2,4,9,4,-73,40,0,9,280,389
647,36,3,3,9,4,36,-69,6,0,316,320
647,37,3,4,6,7,33,43,9,3,349,363
647,38,3,4,7,6,-66,42,3,5,283,405
647,39,4,3,8,5,44,32,7,7,327,437
647,40,2,4,5,8,-77,-56,0,1,250,381
647,41,3,3,8,5,35,32,5,3,285,413
647,42,3,4,4,9,31,45,6,8,316,458
647,43,5,2,7,6,52,-76,8,2,368,382
647,44,5,2,10,3,-45,21,3,3,323,403
647,45,3,4,6,7,33,43,6,6,356,446
647,46,3,4,8,5,-65,41,1,7,291,487
647,47,2,4,5,8,23,-56,4,1,314,431
647,48,2,4,5,8,23,44,7,5,337,475
647,49,4,3,4,9,40,-64,7,1,377,411
647,50,2,4,5,8,-77,44,0,5,300,455
647,51,3,4,4,9,31,-55,1,0,331,400
647,52,4,3,6,7,42,34,3,4,373,434
647,53,4,2,8,5,44,23,7,7,417,457
647,54,5,2,10,3,-45,21,2,8,372,478
647,55,3,4,5,8,32,-56,4,2,404,422
647,56,3,3,7,6,34,33,8,5,438,455
647,57,2,5,4,9,-78,54,0,9,360,509
648,1,2,5,4,9,22,54,2,4,22,54
648,2,5,2,10,3,55,21,7,5,77,75
648,3,3,4,6,7,-67,43,0,8,10,118
648,4,2,5,4,9,22,-46,2,2,32,72
648,5,2,4,5,8,23,44,5,6,55,116
648,6,2,5,4,9,22,-46,7,0,77,70
648,7,4,3,8,5,-56,32,1,2,21,102
648,8,4,3,8,5,44,32,5,4,65,134
648,9,3,3,5,8,32,35,7,9,97,169
648,10,3,3,4,9,31,-64,8,5,128,105
648,11,4,3,8,5,-56,32,2,7,72,137
648,12,4,2,10,3,46,21,8,8,118,158
648,13,2,4,7,6,-75,-58,3,0,43,100
648,14,3,3,4,9,31,36,4,6,74,136
648,15,3,3,8,5,35,32,9,8,109,168
648,16,4,3,7,6,-57,-67,2,1,52,101
648,17,2,4,4,9,22,45,4,6,74,146
648,18,5,2,9,4,54,22,8,8,128,168
648,19,2,4,7,6,-75,-58,3,0,53,110
648,20,3,3,7,6,34,33,7,3,87,143
648,21,2,4,5,8,-77,44,0,7,10,187
648,22,3,4,6,7,33,-57,3,0,43,130
648,23,2,5,5,8,23,53,6,3,66,183
648,24,2,4,6,7,-76,43,0,6,-10,226
648,25,4,2,7,6,43,-76,3,0,33,150
648,26,4,2,10,3,46,21,9,1,79,171
648,27,3,4,6,7,-67,43,2,4,12,214
648,28,2,4,5,8,23,44,5,8,35,258
648,29,2,4,5,8,23,-56,8,2,58,202
648,30,4,2,8,5,-56,23,2,5,2,225
648,31,3,3,3,10,30,-63,2,2,32,162
648,32,3,3,8,5,35,32,7,4,67,194
648,33,2,4,3,10,21,-54,8,0,88,140
648,34,2,4,5,8,-77,44,1,4,11,184
648,35,3,4,8,5,35,41,6,5,46,225
648,36,4,2,7,6,43,24,9,9,89,249
648,37,3,3,7,6,-66,-67,3,2,23,182
648,38,5,2,9,4,54,22,7,4,77,204
648,39,4,3,8,5,-56,32,1,6,21,236
648,40,3,4,3,10,30,-54,1,2,51,182
648,41,5,2,9,4,54,22,5,4,105,204
648,42,3,3,6,7,33,34,8,8,138,238
648,43,3,4,8,5,-65,41,3,9,73,279
648,44,3,3,8,5,35,-68,8,1,108,211
648,45,4,2,5,8,41,26,9,7,149,237
648,46,3,4,4,9,-69,-55,0,2,80,182
648,47,2,4,7,6,25,42,5,4,105,224
648,48,2,5,4,9,22,54,7,8,127,278
648,49,3,3,6,7,-67,-66,0,2,60,212
648,50,3,3,6,7,33,34,3,6,93,246
648,51,3,3,7,6,34,33,7,9,127,279
648,52,3,4,4,9,31,-55,8,4,158,224
648,53,2,5,6,7,-76,52,2,6,82,276
648,54,5,2,9,4,54,22,6,8,136,298
648,55,3,4,4,9,31,-55,7,3,167,243
648,56,2,4,6,7,-76,43,1,6,91,286
648,57,3,4,4,9,31,-55,2,1,122,231
648,58,4,2,9,4,45,22,7,3,167,253
648,59,4,3,8,5,-56,32,1,5,111,285
648,60,3,4,7,6,34,42,5,7,145,327
648,61,5,2,10,3,-45,21,0,8,100,348
648,62,2,4,4,9,22,-55,2,3,122,293
648,63,4,3,7,6,43,33,5,6,165,326
648,64,3,5,6,7,33,52,8,8,198,378
648,65,3,4,7,6,-66,-58,2,0,132,320
648,66,2,4,4,9,22,45,4,5,154,365
648,67,5,2,9,4,54,22,8,7,208,387
648,68,2,4,5,8,-77,-56,1,1,131,331
648,69,2,5,4,9,22,54,3,5,153,385
648,70,3,3,8,5,35,32,8,7,188,417
648,71,2,4,7,6,-75,42,3,9,113,459
648,72,3,3,5,8,32,-65,5,4,145,394
648,73,3,4,4,9,31,45,6,9,176,439
648,74,3,4,6,7,33,-57,9,2,209,382
648,75,5,2,10,3,-45,21,4,3,164,403
648,76,3,3,6,7,33,34,7,7,197,437
648,77,3,3,9,4,-64,31,3,8,133,468
648,78,5,2,7,6,52,-76,5,2,185,392
648,79,3,4,3,10,30,46,5,8,215,438
648,80,2,4,5,8,23,-56,8,2,238,382
648,81,2,5,4,9,-78,54,0,6,160,436
648,82,3,4,7,6,34,42,4,8,194,478
648,83,3,3,10,3,-63,30,1,8,131,508
649,1,3,4,6,7,33,43,3,3,33,43
649,2,2,4,6,7,24,43,7,6,57,86
649,3,5,2,10,3,-45,21,2,7,12,107
649,4,4,2,9,4,45,22,7,9,57,129
649,5,4,3,9,4,-55,-69,2,0,2,60
649,6,3,3,9,4,36,31,8,1,38,91
649,7,3,3,9,4,-64,31,4,2,-26,122
649,8,4,3,9,4,45,31,9,3,19,153
649,9,3,3,5,8,-68,35,1,8,-49,188
649,10,3,5,4,9,31,-46,2,2,-18,142
649,11,3,4,3,10,30,46,2,8,12,188
649,12,2,5,6,7,24,-48,6,0,36,140
649,13,3,4,5,8,32,44,8,4,68,184
649,14,3,4,9,4,-64,40,4,4,4,224
649,15,4,3,5,8,41,35,5,9,45,259
649,16,3,4,7,6,34,-58,9,1,79,201
649,17,2,4,4,9,-78,45,1,6,1,246
649,18,2,6,2,11,20,-35,1,1,21,211
649,19,2,4,6,7,24,43,5,4,45,254
649,20,2,5,7,6,-75,51,0,5,-30,305
649,21,3,3,7,6,34,33,4,8,4,338
649,22,2,4,4,9,22,-55,6,3,26,283
649,23,3,4,6,7,33,43,9,6,59,326
649,24,4,3,10,3,-54,30,5,6,5,356
649,25,4,3,9,4,-55,31,0,7,-50,387
649,26,4,3,7,6,43,-67,3,0,-7,320
649,27,3,3,6,7,33,34,6,4,26,354
649,28,4,2,10,3,-54,21,2,5,-28,375
649,29,3,3,6,7,33,34,5,9,5,409
649,30,4,3,7,6,43,-67,8,2,48,342
649,31,3,4,5,8,-68,44,0,6,-20,386
649,32,2,4,8,5,26,41,6,7,6,427
649,33,2,5,2,11,20,-44,6,3,26,383
649,34,4,3,6,7,42,34,8,7,68,417
649,35,3,4,7,6,-66,42,2,9,2,459
649,36,4,3,5,8,41,-65,3,4,43,394
649,37,5,2,9,4,54,22,7,6,97,416
649,38,5,2,8,5,-47,23,0,9,50,439
649,39,3,3,6,7,33,-66,3,3,83,373
649,40,3,4,7,6,34,42,7,5,117,415
649,41,4,2,8,5,-56,23,1,8,61,438
649,42,3,4,6,7,33,-57,4,1,94,381
649,43,2,5,6,7,24,52,8,3,118,433
649,44,4,3,6,7,-58,34,0,7,60,467
649,45,4,3,7,6,43,-67,3,0,103,400
649,46,3,3,8,5,35,32,8,2,138,432
649,47,2,4,6,7,-76,43,2,5,62,475
649,48,4,3,8,5,44,32,6,7,106,507
650,1,3,4,5,8,32,44,2,4,32,44
650,2,3,4,6,7,33,43,5,7,65,87
650,3,3,4,6,7,33,-57,8,0,98,30
650,4,4,3,7,6,-57,33,1,3,41,63
650,5,3,3,6,7,33,34,4,7,74,97
650,6,4,2,9,4,45,22,9,9,119,119
650,7,3,3,7,6,-66,-67,3,2,53,52
650,8,2,5,5,8,23,53,6,5,76,105
650,9,3,4,5,8,32,44,8,9,108,149
650,10,3,4,7,6,-66,-58,2,1,42,91
650,11,4,3,4,9,40,36,2,7,82,127
650,12,4,2,7,6,43,-76,5,1,125,51
650,13,5,2,9,4,54,22,9,3,179,73
650,14,4,2,9,4,-55,22,4,5,124,95
650,15,3,3,5,8,32,-65,6,0,156,30
650,16,3,4,4,9,31,45,7,5,187,75
650,17,4,3,9,4,-55,31,2,6,132,106
650,18,2,5,5,8,23,53,5,9,155,159
650,19,3,3,6,7,33,-66,8,3,188,93
650,20,6,2,10,3,-36,21,2,4,152,114
650,21,5,2,10,3,55,21,7,5,207,135
650,22,3,3,7,6,-66,33,1,8,141,168
650,23,4,3,5,8,41,-65,2,3,182,103
650,24,3,3,5,8,32,35,4,8,214,138
650,25,4,3,10,3,-54,30,0,8,160,168
650,26,3,4,4,9,31,-55,1,3,191,113
650,27,3,3,6,7,33,34,4,7,224,147
650,28,3,3,7,6,34,-67,8,0,258,80
650,29,3,3,8,5,-65,32,3,2,193,112
650,30,4,3,8,5,44,32,7,4,237,144
650,31,4,3,8,5,-56,32,1,6,181,176
650,32,3,3,6,7,33,-66,4,0,214,110
650,33,5,2,9,4,54,22,8,2,268,132
650,34,2,5,3,10,21,55,9,7,289,187
650,35,5,2,8,5,-47,-77,2,0,242,110
650,36,3,4,5,8,32,44,4,4,274,154
650,37,4,2,10,3,-54,21,0,5,220,175
650,38,2,5,4,9,22,54,2,9,242,229
650,39,4,3,9,4,45,-69,7,0,287,160
650,40,2,4,5,8,-77,44,0,4,210,204
650,41,2,5,3,10,21,55,1,9,231,259
650,42,3,3,6,7,33,-66,4,3,264,193
650,43,2,5,2,11,20,56,4,9,284,249
650,44,3,3,6,7,33,-66,7,3,317,183
650,45,5,3,9,4,-46,31,1,4,271,214
650,46,5,2,10,3,55,21,6,5,326,235
650,47,2,4,6,7,-76,43,0,8,250,278
650,48,5,2,8,5,53,-77,3,1,303,201
650,49,2,4,4,9,22,45,5,6,325,246
650,50,4,3,6,7,42,-66,7,0,367,180
650,51,2,4,7,6,-75,42,2,2,292,222
650,52,4,3,7,6,43,33,5,5,335,255
650,53,2,4,3,10,21,-54,6,1,356,201
650,54,2,4,5,8,23,44,9,5,379,245
650,55,2,5,3,10,-79,-45,0,0,300,200
650,56,4,3,6,7,42,34,2,4,342,234
650,57,4,3,8,5,44,32,6,6,386,266
650,58,2,5,2,11,20,-44,6,2,406,222
650,59,2,4,5,8,23,44,9,6,429,266
650,60,4,2,7,6,-57,-76,2,0,372,190
650,61,3,3,7,6,34,33,6,3,406,223
650,62,3,3,8,5,-65,32,1,5,341,255
650,63,4,3,6,7,42,34,3,9,383,289
650,64,4,3,6,7,42,-66,5,3,425,223
650,65,4,2,8,5,44,23,9,6,469,246
650,66,3,4,7,6,-66,42,3,8,403,288
650,67,4,2,8,5,44,-77,7,1,447,211
650,68,3,3,7,6,-66,33,1,4,381,244
650,69,3,3,7,6,34,33,5,7,415,277
650,70,3,4,4,9,31,-55,6,2,446,222
650,71,3,4,6,7,33,43,9,5,479,265
650,72,2,4,6,7,-76,43,3,8,403,308
650,73,4,2,9,4,45,-78,8,0,448,230
650,74,3,3,8,5,-65,32,3,2,383,262
650,75,2,4,7,6,25,42,8,4,408,304
650,76,3,3,6,7,-67,34,1,8,341,338
650,77,4,2,8,5,44,-77,5,1,385,261
650,78,4,3,5,8,41,35,6,6,426,296
650,79,3,3,6,7,33,-66,9,0,459,230
650,80,4,3,8,5,-56,32,3,2,403,262
650,81,3,4,7,6,34,42,7,4,437,304
650,82,3,4,5,8,32,44,9,8,469,348
650,83,3,4,6,7,-67,-57,2,1,402,291
650,84,2,5,4,9,22,54,4,5,424,345
650,85,3,4,5,8,32,44,6,9,456,389
650,86,6,2,11,2,-35,20,1,9,421,409
650,87,5,2,7,6,52,-76,3,3,473,333
650,88,4,4,6,7,42,43,5,6,515,376
651,1,2,4,7,6,25,42,5,2,25,42
651,2,2,5,5,8,23,53,8,5,48,95
651,3,2,4,6,7,-76,43,2,8,-28,138
651,4,3,4,6,7,33,-57,5,1,5,81
651,5,3,4,6,7,33,43,8,4,38,124
651,6,3,4,6,7,-67,43,1,7,-29,167
651,7,4,3,7,6,43,-67,4,0,14,100
651,8,4,3,6,7,42,34,6,4,56,134
651,9,3,3,7,6,-66,33,0,7,-10,167
651,10,3,4,6,7,33,-57,3,0,23,110
651,11,4,3,3,10,-40,37,3,7,-17,147
651,12,4,3,5,8,41,-65,4,2,24,82
651,13,3,3,10,3,-63,30,1,2,-39,112
651,14,4,4,7,6,43,42,4,4,4,154
651,15,2,5,4,9,22,54,6,8,26,208
651,16,4,3,7,6,43,-67,9,1,69,141
651,17,2,6,2,11,20,65,9,6,89,206
651,18,2,5,3,10,-79,-45,0,1,10,161
651,19,2,5,4,9,22,54,2,5,32,215
651,20,3,4,6,7,33,43,5,8,65,258
651,21,4,2,9,4,-55,-78,0,0,10,180
651,22,3,3,4,9,31,36,1,6,41,216
651,23,3,3,8,5,35,32,6,8,76,248
651,24,3,3,6,7,33,-66,9,2,109,182
651,25,3,5,4,9,-69,54,0,6,40,236
651,26,4,3,7,6,43,33,3,9,83,269
651,27,4,2,9,4,45,-78,8,1,128,191
651,28,2,5,2,11,20,56,8,7,148,247
651,29,4,4,9,4,-55,40,3,7,93,287
651,30,2,4,6,7,24,-57,7,0,117,230
651,31,3,3,3,10,30,37,7,7,147,267
651,32,2,4,4,9,22,-55,9,2,169,212
651,33,2,5,4,9,-78,54,1,6,91,266
651,34,3,3,4,9,31,-64,2,2,122,202
651,35,2,4,3,10,21,46,3,8,143,248
651,36,3,4,7,6,34,-58,7,0,177,190
651,37,4,3,9,4,-55,31,2,1,122,221
651,38,2,5,4,9,22,54,4,5,144,275
651,39,3,4,3,10,30,-54,4,1,174,221
651,40,3,4,7,6,34,42,8,3,208,263
651,41,4,2,9,4,-55,22,3,5,153,285
651,42,3,3,5,8,32,-65,5,0,185,220
651,43,3,4,5,8,32,44,7,4,217,264
651,44,3,4,4,9,31,45,8,9,248,309
651,45,3,3,6,7,-67,-66,1,3,181,243
651,46,5,2,8,5,53,23,4,6,234,266
651,47,6,2,8,5,62,23,6,9,296,289
651,48,2,4,5,8,23,-56,9,3,319,233
651,49,2,5,4,9,-78,54,1,7,241,287
651,50,4,2,10,3,46,21,7,8,287,308
651,51,3,3,8,5,-65,-68,2,0,222,240
651,52,4,3,8,5,44,32,6,2,266,272
651,53,3,3,5,8,32,35,8,7,298,307
651,54,3,3,8,5,-65,32,3,9,233,339
651,55,3,4,7,6,34,-58,7,1,267,281
651,56,2,4,8,5,-74,41,3,2,193,322
651,57,3,4,6,7,33,43,6,5,226,365
651,58,4,2,10,3,-54,21,2,6,172,386
651,59,4,3,8,5,44,32,6,8,216,418
651,60,2,5,5,8,23,-47,9,1,239,371
651,61,2,4,9,4,-73,40,6,1,166,411
651,62,3,3,8,5,-65,32,1,3,101,443
651,63,2,5,6,7,24,52,5,5,125,495
651,64,3,4,5,8,32,44,7,9,157,539
652,1,4,2,8,5,44,23,4,3,44,23
652,2,2,4,5,8,23,44,7,7,67,67
652,3,5,2,12,1,-43,-20,4,7,24,47
652,4,4,2,7,6,43,-76,7,1,67,-29
652,5,2,4,3,10,21,46,8,7,88,17
652,6,5,2,9,4,-46,22,2,9,42,39
652,7,4,3,8,5,44,-68,6,1,86,-29
652,8,2,4,6,7,-76,43,0,4,10,14
652,9,5,2,8,5,53,23,3,7,63,37
652,10,2,4,6,7,24,-57,7,0,87,-20
652,11,3,4,8,5,-65,41,2,1,22,21
652,12,2,5,3,10,21,55,3,6,43,76
652,13,5,3,8,5,53,32,6,8,96,108
652,14,4,2,8,5,-56,-77,0,1,40,31
652,15,2,4,3,10,21,46,1,7,61,77
652,16,4,3,7,6,43,-67,4,0,104,10
652,17,3,3,9,4,-64,31,0,1,40,41
652,18,5,2,8,5,53,23,3,4,93,64
652,19,6,2,10,3,64,21,7,5,157,85
652,20,4,3,7,6,-57,33,0,8,100,118
652,21,4,3,8,5,44,-68,4,0,144,50
652,22,3,3,6,7,33,34,7,4,177,84
652,23,4,3,8,5,-56,32,1,6,121,116
652,24,3,4,8,5,35,41,6,7,156,157
652,25,3,4,7,6,-66,42,0,9,90,199
652,26,3,4,7,6,34,-58,4,1,124,141
652,27,4,3,7,6,43,33,7,4,167,174
652,28,3,3,9,4,-64,31,3,5,103,205
652,29,4,3,5,8,41,-65,4,0,144,140
652,30,2,4,9,4,-73,40,1,0,71,180
652,31,3,4,7,6,34,42,5,2,105,222
652,32,4,3,6,7,42,34,7,6,147,256
652,33,3,3,6,7,-67,-66,0,0,80,190
652,34,7,2,10,3,73,21,3,1,153,211
652,35,2,5,4,9,22,54,5,5,175,265
652,36,3,4,5,8,32,44,7,9,207,309
652,37,2,4,4,9,22,-55,9,4,229,254
652,38,4,3,7,6,-57,33,2,7,172,287
652,39,3,3,7,6,34,-67,6,0,206,220
652,40,3,4,6,7,33,43,9,3,239,263
652,41,3,5,5,8,-68,53,1,6,171,316
652,42,2,4,6,7,24,43,5,9,195,359
652,43,2,5,4,9,22,-46,7,3,217,313
652,44,3,3,7,6,-66,33,1,6,151,346
652,45,3,4,5,8,32,-56,3,0,183,290
652,46,3,4,6,7,33,43,6,3,216,333
652,47,2,4,4,9,22,45,8,8,238,378
652,48,2,4,3,10,21,-54,9,4,259,324
652,49,5,2,10,3,-45,21,4,5,214,345
652,50,3,3,8,5,35,32,9,7,249,377
652,51,5,2,10,3,-45,21,4,8,204,398
652,52,4,3,9,4,45,31,9,9,249,429
652,53,2,5,3,10,-79,-45,0,4,170,384
652,54,4,2,6,7,42,25,2,9,212,409
652,55,2,5,2,11,20,-44,2,5,232,365
652,56,3,3,5,8,32,-65,4,0,264,300
652,57,4,2,9,4,45,22,9,2,309,322
652,58,5,2,10,3,-45,21,4,3,264,343
652,59,3,3,8,5,35,32,9,5,299,375
652,60,4,3,6,7,-58,34,1,9,241,409
652,61,2,4,4,9,22,-55,3,4,263,354
652,62,3,3,7,6,34,33,7,7,297,387
652,63,4,3,7,6,-57,-67,0,0,240,320
652,64,2,4,6,7,24,43,4,3,264,363
652,65,3,3,7,6,34,33,8,6,298,396
652,66,2,5,3,10,21,-45,9,1,319,351
652,67,5,2,8,5,-47,23,2,4,272,374
652,68,2,5,2,11,20,-44,2,0,292,330
652,69,3,3,4,9,31,36,3,6,323,366
652,70,3,3,7,6,34,33,7,9,357,399
652,71,3,4,7,6,-66,-58,1,1,291,341
652,72,4,3,10,3,46,30,7,1,337,371
652,73,4,2,7,6,-57,24,0,5,280,395
652,74,4,3,7,6,43,33,3,8,323,428
652,75,4,2,8,5,44,-77,7,1,367,351
652,76,3,4,6,7,-67,43,0,4,300,394
652,77,3,4,6,7,33,43,3,7,333,437
652,78,3,4,4,9,31,-55,4,2,364,382
652,79,3,4,7,6,34,42,8,4,398,424
652,80,4,3,6,7,-58,34,0,8,340,458
652,81,4,3,10,3,46,30,6,8,386,488
652,82,4,2,9,4,-55,-78,1,0,331,410
652,83,2,5,4,9,22,54,3,4,353,464
652,84,4,2,9,4,45,22,8,6,398,486
652,85,4,3,6,7,-58,-66,0,0,340,420
652,86,3,4,5,8,32,44,2,4,372,464
652,87,3,3,8,5,35,32,7,6,407,496
652,88,4,3,7,6,-57,33,0,9,350,529
653,1,2,5,3,10,21,55,1,5,21,55
653,2,3,4,4,9,31,-55,2,0,52,0
653,3,4,2,7,6,43,24,5,4,95,24
653,4,4,2,9,4,-55,22,0,6,40,46
653,5,4,3,5,8,41,-65,1,1,81,-19
653,6,2,6,5,8,23,62,4,3,104,43
653,7,3,4,8,5,35,41,9,4,139,84
653,8,3,5,6,7,-67,52,2,6,72,136
653,9,5,2,11,2,56,20,8,6,128,156
653,10,4,3,7,6,-57,33,1,9,71,189
653,11,2,6,4,9,22,-37,3,2,93,152
653,12,3,3,6,7,33,34,6,6,126,186
653,13,4,3,7,6,43,33,9,9,169,219
653,14,3,3,9,4,-64,-69,5,0,105,150
653,15,4,3,10,3,-54,30,1,0,51,180
653,16,3,3,7,6,34,33,5,3,85,213
653,17,3,3,4,9,31,36,6,9,116,249
653,18,3,3,6,7,33,-66,9,3,149,183
653,19,3,4,7,6,-66,42,3,5,83,225
653,20,6,2,11,2,65,20,8,5,148,245
653,21,3,4,5,8,-68,44,0,9,80,289
653,22,5,2,7,6,52,-76,2,3,132,213
653,23,4,2,8,5,44,23,6,6,176,236
653,24,4,3,5,8,41,-65,7,1,217,171
653,25,4,3,6,7,42,34,9,5,259,205
653,26,3,3,5,8,-68,-65,1,0,191,140
653,27,2,4,7,6,25,42,6,2,216,182
653,28,5,2,8,5,53,23,9,5,269,205
653,29,2,4,5,8,-77,44,2,9,192,249
653,30,4,2,11,2,47,20,9,9,239,269
653,31,2,4,6,7,-76,-57,3,2,163,212
653,32,4,3,7,6,43,33,6,5,206,245
653,33,3,4,7,6,-66,42,0,7,140,287
653,34,3,4,5,8,32,-56,2,1,172,231
653,35,2,4,3,10,21,46,3,7,193,277
653,36,4,2,6,7,42,-75,5,2,235,202
653,37,3,3,6,7,33,34,8,6,268,236
653,38,4,2,6,7,-58,-75,0,1,210,161
653,39,3,3,5,8,32,35,2,6,242,196
653,40,3,4,6,7,33,43,5,9,275,239
653,41,3,4,7,6,34,-58,9,1,309,181
653,42,2,5,6,7,-76,52,3,3,233,233
653,43,4,3,5,8,41,35,4,8,274,268
653,44,3,3,5,8,32,-65,6,3,306,203
653,45,4,2,10,3,-54,21,2,4,252,224
653,46,4,2,10,3,46,21,8,5,298,245
653,47,4,2,10,3,-54,21,4,6,244,266
653,48,4,2,8,5,44,23,8,9,288,289
653,49,2,5,5,8,-77,-47,1,2,211,242
653,50,6,2,11,2,65,20,6,2,276,262
653,51,5,2,8,5,53,23,9,5,329,285
653,52,3,4,7,6,-66,42,3,7,263,327
653,53,3,4,4,9,31,-55,4,2,294,272
653,54,2,4,6,7,24,43,8,5,318,315
653,55,2,4,5,8,-77,44,1,9,241,359
653,56,2,5,5,8,23,-47,4,2,264,312
653,57,4,3,6,7,42,34,6,6,306,346
653,58,2,4,4,9,22,-55,8,1,328,291
653,59,3,3,7,6,-66,33,2,4,262,324
653,60,4,3,5,8,41,35,3,9,303,359
653,61,4,2,9,4,45,-78,8,1,348,281
653,62,3,4,4,9,31,45,9,6,379,326
653,63,3,3,5,8,-68,-65,1,1,311,261
653,64,3,3,6,7,33,34,4,5,344,295
653,65,2,4,8,5,-74,41,0,6,270,336
653,66,4,2,6,7,42,-75,2,1,312,261
653,67,3,3,7,6,34,33,6,4,346,294
653,68,5,2,9,4,-46,22,0,6,300,316
653,69,2,5,6,7,24,52,4,8,324,368
653,70,2,5,3,10,21,-45,5,3,345,323
653,71,5,2,9,4,54,22,9,5,399,345
653,72,2,4,4,9,-78,-55,1,0,321,290
653,73,3,3,10,3,37,30,8,0,358,320
653,74,4,3,6,7,-58,34,0,4,300,354
653,75,2,5,5,8,23,53,3,7,323,407
653,76,4,2,8,5,44,-77,7,0,367,330
653,77,4,2,5,8,41,26,8,6,408,356
653,78,4,4,8,5,-56,41,2,7,352,397
653,79,4,3,9,4,45,31,7,8,397,428
653,80,5,2,9,4,-46,-78,1,0,351,350
653,81,3,4,5,8,32,44,3,4,383,394
653,82,3,5,5,8,32,53,5,7,415,447
653,83,3,4,5,8,32,-56,7,1,447,391
653,84,4,2,10,3,-54,21,3,2,393,412
653,85,2,5,3,10,21,55,4,7,414,467
653,86,3,3,7,6,34,-67,8,0,448,400
653,87,4,3,6,7,-58,34,0,4,390,434
653,88,4,4,6,7,42,43,2,7,432,477
653,89,4,3,10,3,46,30,8,7,478,507
654,1,3,3,9,4,36,31,6,1,36,31
654,2,4,3,6,7,42,34,8,5,78,65
654,3,3,4,6,7,-67,43,1,8,11,108
654,4,5,2,11,2,56,20,7,8,67,128
654,5,3,3,6,7,-67,-66,0,2,0,62
654,6,3,3,6,7,33,34,3,6,33,96
654,7,2,4,5,8,23,-56,6,0,56,40
654,8,4,3,5,8,41,35,7,5,97,75
654,9,3,4,5,8,32,44,9,9,129,119
654,10,3,4,6,7,-67,-57,2,2,62,62
654,11,5,2,7,6,52,24,4,6,114,86
654,12,4,3,8,5,44,32,8,8,158,118
654,13,2,5,3,10,21,-45,9,3,179,73
654,14,4,2,6,7,-58,25,1,8,121,98
654,15,3,4,4,9,31,-55,2,3,152,43
654,16,3,3,6,7,33,34,5,7,185,77
654,17,3,4,4,9,31,-55,6,2,216,22
654,18,4,3,8,5,-56,32,0,4,160,54
654,19,5,2,8,5,53,23,3,7,213,77
654,20,4,3,8,5,44,32,7,9,257,109
654,21,3,3,4,9,31,-64,8,5,288,45
654,22,2,5,4,9,-78,54,0,9,210,99
654,23,4,3,6,7,42,-66,2,3,252,33
654,24,2,4,3,10,21,46,3,9,273,79
654,25,2,6,2,11,20,-35,3,4,293,44
654,26,4,3,6,7,42,34,5,8,335,78
654,27,2,4,3,10,21,-54,6,4,356,24
654,28,3,4,7,6,-66,42,0,6,290,66
654,29,4,3,7,6,43,33,3,9,333,99
654,30,5,2,7,6,52,-76,5,3,385,23
654,31,2,5,4,9,22,54,7,7,407,77
654,32,4,2,9,4,-55,22,2,9,352,99
654,33,3,3,6,7,33,-66,5,3,385,33
654,34,5,3,8,5,53,32,8,5,438,65
654,35,4,3,7,6,-57,33,1,8,381,98
654,36,2,4,9,4,27,40,8,8,408,138
654,37,5,2,10,3,-45,21,3,9,363,159
654,38,3,4,3,10,30,-54,3,5,393,105
654,39,4,3,6,7,42,34,5,9,435,139
654,40,3,3,6,7,33,-66,8,3,468,73
654,41,5,2,10,3,-45,21,3,4,423,94
654,42,2,4,3,10,21,-54,4,0,444,40
654,43,4,3,7,6,43,33,7,3,487,73
654,44,5,2,7,6,52,24,9,7,539,97
655,1,2,5,4,9,22,54,2,4,22,54
655,2,3,3,4,9,31,-64,3,0,53,-10
655,3,4,3,8,5,44,32,7,2,97,22
655,4,3,3,8,5,-65,32,2,4,32,54
655,5,4,3,8,5,44,32,6,6,76,86
655,6,3,4,9,4,-64,40,2,6,12,126
655,7,5,2,10,3,55,21,7,7,67,147
655,8,3,3,6,7,-67,-66,0,1,0,81
655,9,5,2,10,3,55,21,5,2,55,102
655,10,3,4,8,5,-65,41,0,3,-10,143
655,11,4,3,9,4,45,31,5,4,35,174
655,12,4,3,10,3,-54,30,1,4,-19,204
655,13,3,4,6,7,33,43,4,7,14,247
655,14,2,5,5,8,23,-47,7,0,37,200
655,15,2,4,6,7,-76,43,1,3,-39,243
655,16,3,3,6,7,33,34,4,7,-6,277
655,17,4,3,6,7,42,-66,6,1,36,211
655,18,3,3,4,9,31,36,7,7,67,247
655,19,3,3,4,9,31,-64,8,3,98,183
655,20,2,5,5,8,-77,53,1,6,21,236
655,21,3,4,5,8,32,-56,3,0,53,180
655,22,4,3,8,5,44,32,7,2,97,212
655,23,4,3,7,6,-57,33,0,5,40,245
655,24,2,5,5,8,23,53,3,8,63,298
655,25,3,3,8,5,35,-68,8,0,98,230
655,26,2,5,5,8,-77,53,1,3,21,283
655,27,3,3,6,7,33,34,4,7,54,317
655,28,2,6,3,10,21,-36,5,1,75,281
655,29,4,4,7,6,43,42,8,3,118,323
655,30,2,5,2,11,20,56,8,9,138,379
655,31,3,4,5,8,-68,-56,0,3,70,323
655,32,2,5,3,10,21,55,1,8,91,378
655,33,2,4,8,5,26,41,7,9,117,419
655,34,5,3,6,7,51,-66,8,3,168,353
655,35,5,2,6,7,51,25,9,8,219,378
655,36,6,2,9,4,-37,-78,2,0,182,300
655,37,3,4,5,8,32,44,4,4,214,344
655,38,4,3,4,9,40,-64,4,0,254,280
655,39,5,2,11,2,-44,20,0,0,210,300
655,40,3,4,5,8,32,44,2,4,242,344
655,41,4,3,7,6,43,33,5,7,285,377
655,42,6,2,10,3,64,21,9,8,349,398
655,43,5,2,9,4,-46,-78,3,0,303,320
655,44,6,2,10,3,64,21,7,1,367,341
655,45,5,3,8,5,-47,32,0,3,320,373
655,46,2,4,4,9,22,45,2,8,342,418
655,47,3,4,7,6,34,-58,6,0,376,360
655,48,4,4,5,8,41,44,7,4,417,404
655,49,4,2,9,4,-55,22,2,6,362,426
655,50,3,4,3,10,30,-54,2,2,392,372
655,51,2,4,4,9,22,45,4,7,414,417
655,52,4,3,8,5,44,32,8,9,458,449
655,53,4,3,6,7,-58,-66,0,3,400,383
655,54,4,3,9,4,45,31,5,4,445,414
655,55,3,4,5,8,32,44,7,8,477,458
655,56,3,4,6,7,-67,-57,0,1,410,401
655,57,2,4,7,6,25,42,5,3,435,443
655,58,6,2,10,3,64,21,9,4,499,464
655,59,3,3,10,3,-63,30,6,4,436,494
655,60,4,3,8,5,-56,32,0,6,380,526
656,1,3,3,5,8,32,35,2,5,32,35
656,2,4,3,9,4,45,31,7,6,77,66
656,3,3,4,6,7,-67,43,0,9,10,109
656,4,5,2,9,4,54,-78,4,1,64,31
656,5,3,3,5,8,32,35,6,6,96,66
656,6,3,3,8,5,-65,32,1,8,31,98
656,7,5,2,11,2,56,20,7,8,87,118
656,8,3,3,7,6,-66,-67,1,1,21,51
656,9,2,4,5,8,23,44,4,5,44,95
656,10,4,2,10,3,-54,21,0,6,-10,116
656,11,3,4,7,6,34,42,4,8,24,158
656,12,3,4,7,6,34,-58,8,0,58,100
656,13,4,3,6,7,-58,34,0,4,0,134
656,14,3,5,4,9,31,54,1,8,31,188
656,15,2,5,4,9,22,-46,3,2,53,142
656,16,4,2,9,4,45,22,8,4,98,164
656,17,3,3,5,8,-68,35,0,9,30,199
656,18,5,2,11,2,56,20,6,9,86,219
656,19,3,3,9,4,-64,-69,2,0,22,150
656,20,3,3,8,5,35,32,7,2,57,182
656,21,3,3,6,7,-67,34,0,6,-10,216
656,22,3,3,8,5,35,32,5,8,25,248
656,23,5,2,6,7,51,-75,6,3,76,173
656,24,2,6,4,9,22,63,8,6,98,236
656,25,3,3,8,5,-65,32,3,8,33,268
656,26,4,3,8,5,44,-68,7,0,77,200
656,27,4,3,9,4,-55,31,2,1,22,231
656,28,4,2,6,7,42,25,4,6,64,256
656,29,5,2,10,3,55,21,9,7,119,277
656,30,3,3,6,7,-67,-66,2,1,52,211
656,31,5,3,8,5,53,32,5,3,105,243
656,32,3,3,5,8,32,35,7,8,137,278
656,33,4,3,9,4,-55,31,2,9,82,309
656,34,5,2,10,3,55,-79,7,0,137,230
656,35,5,2,10,3,-45,21,2,1,92,251
656,36,4,3,10,3,46,30,8,1,138,281
656,37,2,4,4,9,-78,45,0,6,60,326
656,38,2,4,3,10,21,-54,1,2,81,272
656,39,3,3,5,8,32,35,3,7,113,307
656,40,2,5,4,9,22,-46,5,1,135,261
656,41,2,4,4,9,22,45,7,6,157,306
656,42,2,5,7,6,-75,51,2,7,82,357
656,43,4,3,7,6,43,-67,5,0,125,290
656,44,4,4,8,5,44,41,9,1,169,331
656,45,6,2,9,4,-37,22,2,3,132,353
656,46,5,2,9,4,54,22,6,5,186,375
656,47,3,4,6,7,33,43,9,8,219,418
656,48,3,4,7,6,-66,-58,3,0,153,360
656,49,3,4,5,8,32,44,5,4,185,404
656,50,2,4,4,9,22,45,7,9,207,449
656,51,3,3,4,9,31,-64,8,5,238,385
656,52,2,4,5,8,-77,44,1,9,161,429
656,53,4,2,11,2,47,20,8,9,208,449
656,54,3,4,5,8,-68,-56,0,3,140,393
656,55,2,4,8,5,26,41,6,4,166,434
656,56,3,4,7,6,-66,42,0,6,100,476
656,57,3,3,6,7,33,-66,3,0,133,410
656,58,2,4,3,10,21,46,4,6,154,456
656,59,5,2,10,3,55,21,9,7,209,477
656,60,4,3,7,6,-57,-67,2,0,152,410
656,61,5,2,9,4,54,22,6,2,206,432
656,62,6,2,9,4,63,22,9,4,269,454
656,63,4,3,4,9,40,-64,9,0,309,390
656,64,2,5,6,7,-76,52,3,2,233,442
656,65,3,4,8,5,35,41,8,3,268,483
656,66,5,2,8,5,-47,23,1,6,221,506
657,1,3,4,5,8,32,44,2,4,32,44
657,2,3,4,7,6,34,42,6,6,66,86
657,3,3,3,7,6,-66,33,0,9,0,119
657,4,4,3,8,5,44,-68,4,1,44,51
657,5,3,4,7,6,34,42,8,3,78,93
657,6,3,3,8,5,-65,32,3,5,13,125
657,7,2,4,5,8,23,44,6,9,36,169
657,8,3,4,6,7,33,-57,9,2,69,112
657,9,2,5,4,9,-78,54,1,6,-9,166
657,10,3,3,6,7,33,-66,4,0,24,100
657,11,4,3,6,7,42,34,6,4,66,134
657,12,3,3,7,6,-66,33,0,7,0,167
657,13,3,3,8,5,35,32,5,9,35,199
657,14,4,2,9,4,-55,-78,0,1,-20,121
657,15,4,3,10,3,46,30,6,1,26,151
657,16,3,4,6,7,33,43,9,4,59,194
657,17,2,5,4,9,-78,54,1,8,-19,248
657,18,4,3,6,7,42,-66,3,2,23,182
657,19,2,5,4,9,22,54,5,6,45,236
657,20,3,4,6,7,33,43,8,9,78,279
657,21,4,2,7,6,-57,-76,1,3,21,203
657,22,4,2,6,7,42,25,3,8,63,228
657,23,6,2,7,6,61,-76,4,2,124,152
657,24,4,4,5,8,41,44,5,6,165,196
657,25,5,2,10,3,-45,21,0,7,120,217
657,26,4,3,8,5,44,32,4,9,164,249
657,27,4,3,8,5,44,-68,8,1,208,181
657,28,3,3,6,7,-67,34,1,5,141,215
657,29,4,3,8,5,44,32,5,7,185,247
657,30,2,5,4,9,22,-46,7,1,207,201
657,31,4,2,9,4,-55,22,2,3,152,223
657,32,2,4,5,8,23,44,5,7,175,267
657,33,2,4,5,8,23,-56,8,1,198,211
657,34,4,2,10,3,-54,21,4,2,144,232
657,35,2,6,4,9,22,63,6,5,166,295
657,36,2,5,2,11,20,-44,6,1,186,251
657,37,5,3,8,5,53,32,9,3,239,283
657,38,3,4,7,6,-66,42,3,5,173,325
657,39,5,3,6,7,51,34,4,9,224,359
657,40,2,5,4,9,22,-46,6,3,246,313
657,41,3,3,3,10,30,-63,6,0,276,250
657,42,3,4,5,8,32,44,8,4,308,294
657,43,3,3,9,4,-64,31,4,5,244,325
657,44,3,3,7,6,34,33,8,8,278,358
657,45,3,4,6,7,-67,-57,1,1,211,301
657,46,5,2,10,3,55,21,6,2,266,322
657,47,3,3,3,10,30,37,6,9,296,359
657,48,3,4,4,9,31,-55,7,4,327,304
657,49,3,3,8,5,-65,32,2,6,262,336
657,50,4,3,8,5,44,32,6,8,306,368
657,51,3,3,8,5,-65,-68,1,0,241,300
657,52,4,3,5,8,41,35,2,5,282,335
657,53,2,5,3,10,21,-45,3,0,303,290
657,54,2,4,5,8,23,44,6,4,326,334
657,55,2,4,4,9,22,45,8,9,348,379
657,56,2,6,4,9,-78,-37,0,2,270,342
657,57,4,2,10,3,46,21,6,3,316,363
657,58,3,4,5,8,32,44,8,7,348,407
657,59,5,2,9,4,-46,22,2,9,302,429
657,60,2,4,4,9,22,-55,4,4,324,374
657,61,4,2,8,5,44,23,8,7,368,397
657,62,4,4,6,7,-58,-57,0,0,310,340
657,63,3,3,4,9,31,36,1,6,341,376
657,64,3,3,6,7,33,-66,4,0,374,310
657,65,2,4,6,7,24,43,8,3,398,353
657,66,5,2,11,2,-44,20,4,3,354,373
657,67,3,4,5,8,32,44,6,7,386,417
657,68,2,4,7,6,-75,42,1,9,311,459
657,69,2,4,6,7,24,-57,5,2,335,402
657,70,3,4,6,7,33,43,8,5,368,445
657,71,5,2,9,4,-46,22,2,7,322,467
657,72,2,4,6,7,24,-57,6,0,346,410
657,73,3,3,7,6,-66,33,0,3,280,443
657,74,5,3,9,4,54,31,4,4,334,474
657,75,5,2,10,3,55,21,9,5,389,495
657,76,3,4,5,8,-68,44,1,9,321,539
658,1,5,2,7,6,52,24,2,4,52,24
658,2,3,4,7,6,34,42,6,6,86,66
658,3,3,4,4,9,31,-55,7,1,117,11
658,4,2,4,4,9,22,45,9,6,139,56
658,5,3,4,4,9,-69,-55,0,1,70,1
658,6,3,3,8,5,35,32,5,3,105,33
658,7,2,4,5,8,23,44,8,7,128,77
658,8,3,3,8,5,-65,32,3,9,63,109
658,9,4,3,5,8,41,-65,4,4,104,44
658,10,4,2,10,3,-54,21,0,5,50,65
658,11,4,3,7,6,43,33,3,8,93,98
658,12,4,2,8,5,44,-77,7,1,137,21
658,13,2,4,6,7,-76,43,1,4,61,64
658,14,3,3,4,9,31,-64,2,0,92,0
658,15,3,3,7,6,34,33,6,3,126,33
658,16,4,2,8,5,-56,23,0,6,70,56
658,17,3,4,3,10,30,-54,0,2,100,2
658,18,2,4,4,9,22,45,2,7,122,47
658,19,3,3,6,7,33,-66,5,1,155,-19
658,20,2,5,4,9,22,54,7,5,177,35
658,21,2,4,6,7,-76,43,1,8,101,78
658,22,3,4,4,9,31,-55,2,3,132,23
658,23,4,3,10,3,46,30,8,3,178,53
658,24,4,2,9,4,-55,22,3,5,123,75
658,25,2,5,4,9,22,54,5,9,145,129
658,26,3,3,10,3,-63,30,2,9,82,159
658,27,2,4,5,8,23,-56,5,3,105,103
658,28,4,3,7,6,43,33,8,6,148,136
658,29,3,4,6,7,-67,43,1,9,81,179
658,30,3,4,5,8,32,-56,3,3,113,123
658,31,3,3,8,5,35,32,8,5,148,155
658,32,4,2,7,6,-57,24,1,9,91,179
658,33,3,4,8,5,35,-59,6,0,126,120
658,34,3,4,7,6,-66,42,0,2,60,162
658,35,3,3,9,4,36,31,6,3,96,193
658,36,2,4,8,5,-74,41,2,4,22,234
658,37,3,3,5,8,32,35,4,9,54,269
658,38,4,3,7,6,43,-67,7,2,97,202
658,39,2,4,8,5,-74,41,3,3,23,243
658,40,4,3,5,8,41,35,4,8,64,278
658,41,2,4,5,8,23,-56,7,2,87,222
658,42,2,6,6,7,-76,61,1,3,11,283
658,43,2,5,4,9,22,54,3,7,33,337
658,44,4,2,7,6,43,-76,6,1,76,261
658,45,4,3,8,5,-56,32,0,3,20,293
658,46,3,3,7,6,34,33,4,6,54,326
658,47,2,5,2,11,20,-44,4,2,74,282
658,48,3,4,5,8,32,44,6,6,106,326
658,49,3,4,8,5,-65,41,1,7,41,367
658,50,2,5,6,7,24,52,5,9,65,419
658,51,2,5,5,8,23,-47,8,2,88,372
658,52,2,4,2,11,20,47,8,9,108,419
658,53,3,3,9,4,-64,-69,4,0,44,350
658,54,3,4,7,6,34,42,8,2,78,392
658,55,3,3,8,5,-65,32,3,4,13,424
658,56,6,2,11,2,65,20,8,4,78,444
658,57,4,3,4,9,40,-64,8,0,118,380
658,58,3,4,7,6,-66,42,2,2,52,422
658,59,2,4,6,7,24,43,6,5,76,465
658,60,2,6,3,10,21,64,7,9,97,529
659,1,4,3,8,5,44,32,4,2,44,32
659,2,3,3,7,6,34,33,8,5,78,65
659,3,5,2,9,4,-46,22,2,7,32,87
659,4,2,5,3,10,21,-45,3,2,53,42
659,5,6,2,9,4,63,22,6,4,116,64
659,6,3,5,5,8,32,53,8,7,148,117
659,7,4,2,10,3,-54,21,4,8,94,138
659,8,3,4,6,7,33,-57,7,1,127,81
659,9,3,3,10,3,-63,30,4,1,64,111
659,10,2,5,2,11,20,56,4,7,84,167
659,11,5,3,8,5,53,32,7,9,137,199
659,12,3,4,6,7,-67,-57,0,2,70,142
659,13,5,2,9,4,54,22,4,4,124,164
659,14,4,2,9,4,45,22,9,6,169,186
659,15,3,3,9,4,-64,31,5,7,105,217
659,16,3,3,6,7,33,-66,8,1,138,151
659,17,3,4,4,9,31,45,9,6,169,196
659,18,3,3,7,6,-66,33,3,9,103,229
659,19,2,4,6,7,24,-57,7,2,127,172
659,20,4,2,9,4,-55,22,2,4,72,194
659,21,3,4,7,6,34,42,6,6,106,236
659,22,5,2,10,3,-45,21,1,7,61,257
659,23,3,3,6,7,33,-66,4,1,94,191
659,24,2,4,4,9,22,45,6,6,116,236
659,25,4,2,9,4,-55,22,1,8,61,258
659,26,5,2,7,6,52,-76,3,2,113,182
659,27,3,3,7,6,34,33,7,5,147,215
659,28,3,3,4,9,31,-64,8,1,178,151
659,29,2,5,2,11,20,56,8,7,198,207
659,30,3,3,6,7,-67,-66,1,1,131,141
659,31,2,4,6,7,24,43,5,4,155,184
659,32,4,3,8,5,44,32,9,6,199,216
659,33,2,5,4,9,-78,-46,1,0,121,170
659,34,5,2,8,5,53,23,4,3,174,193
659,35,4,2,8,5,44,23,8,6,218,216
659,36,2,4,4,9,-78,-55,0,1,140,161
659,37,3,3,7,6,34,33,4,4,174,194
659,38,5,2,7,6,52,24,6,8,226,218
659,39,3,4,7,6,-66,-58,0,0,160,160
659,40,4,3,8,5,44,32,4,2,204,192
659,41,3,4,7,6,34,42,8,4,238,234
659,42,2,4,6,7,-76,43,2,7,162,277
659,43,3,3,6,7,33,-66,5,1,195,211
659,44,3,4,4,9,31,45,6,6,226,256
659,45,3,4,4,9,31,-55,7,1,257,201
659,46,2,5,4,9,22,54,9,5,279,255
659,47,2,4,4,9,-78,-55,1,0,201,200
659,48,5,2,7,6,52,24,3,4,253,224
659,49,3,4,6,7,33,43,6,7,286,267
659,50,3,3,6,7,33,-66,9,1,319,201
659,51,3,3,8,5,-65,32,4,3,254,233
659,52,2,4,4,9,22,45,6,8,276,278
659,53,3,3,6,7,33,-66,9,2,309,212
659,54,4,3,5,8,-59,35,0,7,250,247
659,55,5,2,10,3,55,21,5,8,305,268
659,56,3,4,3,10,30,-54,5,4,335,214
659,57,2,5,2,11,20,-44,5,0,355,170
659,58,2,4,6,7,24,43,9,3,379,213
659,59,2,4,6,7,-76,43,3,6,303,256
659,60,3,4,5,8,32,-56,5,0,335,200
659,61,3,3,4,9,31,36,6,6,366,236
659,62,4,2,8,5,-56,23,0,9,310,259
659,63,4,3,6,7,42,-66,2,3,352,193
659,64,4,2,7,6,43,24,5,7,395,217
659,65,4,2,7,6,43,-76,8,1,438,141
659,66,2,4,8,5,-74,41,4,2,364,182
659,67,2,5,3,10,21,55,5,7,385,237
659,68,3,3,9,4,-64,31,1,8,321,268
659,69,3,3,6,7,33,-66,4,2,354,202
659,70,3,4,5,8,32,44,6,6,386,246
659,71,2,5,4,9,22,-46,8,0,408,200
659,72,3,4,7,6,-66,42,2,2,342,242
659,73,5,3,6,7,51,34,3,6,393,276
659,74,5,2,9,4,54,22,7,8,447,298
659,75,5,2,10,3,-45,21,2,9,402,319
659,76,2,4,7,6,25,-58,7,1,427,261
659,77,4,3,7,6,-57,33,0,4,370,294
659,78,3,4,6,7,33,43,3,7,403,337
659,79,3,4,4,9,31,-55,4,2,434,282
659,80,4,3,7,6,43,33,7,5,477,315
659,81,4,2,7,6,-57,24,0,9,420,339
659,82,5,2,6,7,51,-75,1,4,471,264
659,83,4,3,6,7,42,34,3,8,513,298
660,1,5,2,9,4,54,22,4,2,54,22
660,2,2,4,7,6,25,42,9,4,79,64
660,3,4,3,6,7,-58,34,1,8,21,98
660,4,3,4,5,8,32,-56,3,2,53,42
660,5,5,2,11,2,56,20,9,2,109,62
660,6,4,3,10,3,-54,30,5,2,55,92
660,7,4,3,7,6,43,33,8,5,98,125
660,8,3,3,7,6,-66,33,2,8,32,158
660,9,3,3,5,8,32,-65,4,3,64,93
660,10,5,2,8,5,53,23,7,6,117,116
660,11,4,3,9,4,-55,31,2,7,62,147
660,12,2,5,6,7,24,52,6,9,86,199
660,13,2,5,3,10,21,-45,7,4,107,154
660,14,2,4,7,6,-75,42,2,6,32,196
660,15,2,5,7,6,25,51,7,7,57,247
660,16,3,4,4,9,31,-55,8,2,88,192
660,17,4,3,8,5,-56,32,2,4,32,224
660,18,3,3,5,8,32,35,4,9,64,259
660,19,5,2,10,3,55,-79,9,0,119,180
660,20,5,2,11,2,-44,20,5,0,75,200
660,21,4,3,7,6,43,33,8,3,118,233
660,22,3,4,6,7,-67,43,1,6,51,276
660,23,2,5,5,8,23,53,4,9,74,329
660,24,3,4,5,8,32,-56,6,3,106,273
660,25,4,3,9,4,-55,31,1,4,51,304
660,26,2,5,5,8,23,53,4,7,74,357
660,27,4,3,7,6,43,-67,7,0,117,290
660,28,2,5,3,10,21,55,8,5,138,345
660,29,4,2,7,6,-57,24,1,9,81,369
660,30,3,3,7,6,34,-67,5,2,115,302
660,31,4,3,9,4,-55,31,0,3,60,333
660,32,5,2,10,3,55,21,5,4,115,354
660,33,3,3,9,4,-64,31,1,5,51,385
660,34,3,3,5,8,32,-65,3,0,83,320
660,35,2,4,6,7,24,43,7,3,107,363
660,36,4,3,7,6,-57,33,0,6,50,396
660,37,3,4,5,8,32,-56,2,0,82,340
660,38,2,5,3,10,21,55,3,5,103,395
660,39,5,2,11,2,56,20,9,5,159,415
660,40,4,3,9,4,-55,31,4,6,104,446
660,41,3,4,4,9,31,-55,5,1,135,391
660,42,4,3,7,6,43,33,8,4,178,424
660,43,4,3,7,6,-57,33,1,7,121,457
660,44,4,2,8,5,44,-77,5,0,165,380
660,45,3,4,3,10,30,46,5,6,195,426
660,46,2,5,6,7,24,52,9,8,219,478
660,47,2,4,5,8,-77,-56,2,2,142,422
660,48,3,4,6,7,33,43,5,5,175,465
660,49,4,2,8,5,44,23,9,8,219,488
660,50,2,4,5,8,-77,-56,2,2,142,432
660,51,2,5,3,10,21,55,3,7,163,487
660,52,3,3,7,6,34,-67,7,0,197,420
660,53,2,5,2,11,20,56,7,6,217,476
660,54,3,3,6,7,-67,-66,0,0,150,410
660,55,3,3,5,8,32,35,2,5,182,445
660,56,5,2,9,4,54,22,6,7,236,467
660,57,3,3,5,8,32,-65,8,2,268,402
660,58,3,3,8,5,-65,32,3,4,203,434
660,59,3,4,5,8,32,44,5,8,235,478
660,60,4,2,6,7,42,-75,7,3,277,403
660,61,3,5,3,10,30,55,7,8,307,458
660,62,3,3,5,8,32,-65,9,3,339,393
660,63,4,2,5,8,-59,26,0,9,280,419
660,64,2,5,2,11,20,-44,0,5,300,375
660,65,5,2,8,5,53,23,3,8,353,398
660,66,3,4,4,9,31,-55,4,3,384,343
660,67,5,2,7,6,52,24,6,7,436,367
660,68,4,3,6,7,42,-66,8,1,478,301
660,69,3,3,7,6,-66,33,2,4,412,334
660,70,6,2,12,1,66,-20,8,4,478,314
660,71,4,3,6,7,-58,34,0,8,420,348
660,72,3,3,6,7,33,-66,3,2,453,282
660,73,2,4,3,10,21,46,4,8,474,328
660,74,3,3,5,8,32,-65,6,3,506,263
661,1,2,5,5,8,23,53,3,3,23,53
661,2,5,2,7,6,52,24,5,7,75,77
661,3,3,3,6,7,33,-66,8,1,108,11
661,4,4,2,6,7,-58,25,0,6,50,36
661,5,3,3,8,5,35,32,5,8,85,68
661,6,5,2,9,4,54,-78,9,0,139,-10
661,7,4,3,6,7,-58,34,1,4,81,24
661,8,4,4,7,6,43,42,4,6,124,66
661,9,4,3,5,8,41,-65,5,1,165,1
661,10,2,4,6,7,24,43,9,4,189,44
661,11,5,2,7,6,-48,24,1,8,141,68
661,12,3,4,5,8,32,-56,3,2,173,12
661,13,2,5,6,7,24,52,7,4,197,64
661,14,4,3,8,5,-56,32,1,6,141,96
661,15,2,5,4,9,22,-46,3,0,163,50
661,16,2,5,4,9,22,54,5,4,185,104
661,17,4,3,9,4,-55,31,0,5,130,135
661,18,4,3,6,7,42,34,2,9,172,169
661,19,2,4,6,7,24,-57,6,2,196,112
661,20,2,4,4,9,22,45,8,7,218,157
661,21,3,5,4,9,31,-46,9,1,249,111
661,22,3,3,5,8,-68,35,1,6,181,146
661,23,2,4,5,8,23,-56,4,0,204,90
661,24,2,5,4,9,22,54,6,4,226,144
661,25,3,4,7,6,-66,42,0,6,160,186
661,26,5,2,10,3,55,21,5,7,215,207
661,27,2,5,6,7,24,52,9,9,239,259
661,28,3,4,4,9,-69,-55,0,4,170,204
661,29,4,2,8,5,44,23,4,7,214,227
661,30,2,5,4,9,22,-46,6,1,236,181
661,31,2,4,5,8,23,44,9,5,259,225
661,32,2,4,4,9,-78,-55,1,0,181,170
661,33,4,3,5,8,41,35,2,5,222,205
661,34,3,3,4,9,31,-64,3,1,253,141
661,35,3,3,7,6,34,33,7,4,287,174
661,36,5,2,9,4,-46,22,1,6,241,196
661,37,3,4,6,7,33,43,4,9,274,239
661,38,4,2,9,4,45,-78,9,1,319,161
661,39,3,3,7,6,-66,33,3,4,253,194
661,40,5,2,9,4,54,22,7,6,307,216
661,41,2,5,4,9,22,-46,9,0,329,170
661,42,3,4,5,8,-68,44,1,4,261,214
661,43,2,5,3,10,21,55,2,9,282,269
661,44,3,3,7,6,34,-67,6,2,316,202
661,45,5,2,8,5,53,23,9,5,369,225
661,46,4,4,5,8,-59,44,0,9,310,269
661,47,4,3,6,7,42,-66,2,3,352,203
661,48,3,4,2,11,-30,-53,2,0,322,150
661,49,4,3,9,4,45,31,7,1,367,181
661,50,3,3,4,9,31,36,8,7,398,217
661,51,3,4,5,8,-68,-56,0,1,330,161
661,52,3,3,5,8,32,35,2,6,362,196
661,53,3,4,5,8,32,-56,4,0,394,140
661,54,5,2,7,6,52,24,6,4,446,164
661,55,4,3,8,5,-56,32,0,6,390,196
661,56,2,4,6,7,24,43,4,9,414,239
661,57,3,3,5,8,32,-65,6,4,446,174
661,58,3,5,8,5,-65,50,1,4,381,224
661,59,4,2,9,4,45,22,6,6,426,246
661,60,3,4,5,8,32,-56,8,0,458,190
661,61,3,3,7,6,-66,33,2,3,392,223
661,62,4,3,8,5,44,32,6,5,436,255
661,63,2,4,4,9,22,-55,8,0,458,200
661,64,3,3,6,7,-67,34,1,4,391,234
661,65,4,3,6,7,42,34,3,8,433,268
661,66,4,3,5,8,41,-65,4,3,474,203
661,67,2,5,5,8,23,53,7,6,497,256
661,68,3,3,3,10,30,-63,7,3,527,193
662,1,6,2,10,3,64,21,4,1,64,21
662,2,3,3,6,7,33,34,7,5,97,55
662,3,3,5,6,7,-67,52,0,7,30,107
662,4,3,3,8,5,35,32,5,9,65,139
662,5,5,2,8,5,53,-77,8,2,118,62
662,6,3,4,5,8,-68,44,0,6,50,106
662,7,2,5,4,9,22,-46,2,0,72,60
662,8,4,3,7,6,43,33,5,3,115,93
662,9,3,3,5,8,32,35,7,8,147,128
662,10,5,2,8,5,-47,-77,0,1,100,51
662,11,4,2,6,7,42,25,2,6,142,76
662,12,3,3,8,5,35,32,7,8,177,108
662,13,4,3,7,6,-57,-67,0,1,120,41
662,14,4,2,8,5,44,23,4,4,164,64
662,15,2,5,5,8,23,53,7,7,187,117
662,16,3,3,8,5,-65,32,2,9,122,149
662,17,4,2,9,4,45,-78,7,1,167,71
662,18,5,2,9,4,-46,22,1,3,121,93
662,19,4,2,5,8,41,26,2,9,162,119
662,20,3,4,5,8,32,-56,4,3,194,63
662,21,3,3,6,7,33,34,7,7,227,97
662,22,2,4,6,7,-76,-57,1,0,151,40
662,23,3,3,5,8,32,35,3,5,183,75
662,24,4,2,10,3,46,21,9,6,229,96
662,25,5,2,10,3,-45,21,4,7,184,117
662,26,2,5,3,10,21,-45,5,2,205,72
662,27,2,6,4,9,22,63,7,5,227,135
662,28,4,3,10,3,-54,30,3,5,173,165
662,29,3,3,6,7,33,34,6,9,206,199
662,30,3,3,5,8,32,-65,8,4,238,134
662,31,2,4,2,11,20,-53,8,1,258,81
662,32,3,5,6,7,-67,52,1,3,191,133
662,33,2,4,5,8,23,44,4,7,214,177
662,34,4,2,9,4,45,22,9,9,259,199
662,35,2,4,5,8,-77,-56,2,3,182,143
662,36,2,5,4,9,22,54,4,7,204,197
662,37,2,6,3,10,21,-36,5,1,225,161
662,38,3,4,5,8,32,44,7,5,257,205
662,39,3,3,7,6,-66,33,1,8,191,238
662,40,4,2,7,6,43,-76,4,2,234,162
662,41,3,4,5,8,32,44,6,6,266,206
662,42,2,5,3,10,21,-45,7,1,287,161
662,43,3,4,5,8,32,44,9,5,319,205
662,44,2,4,5,8,-77,44,2,9,242,249
662,45,2,4,6,7,24,-57,6,2,266,192
662,46,5,2,10,3,-45,21,1,3,221,213
662,47,3,4,6,7,33,43,4,6,254,256
662,48,2,4,6,7,24,43,8,9,278,299
662,49,3,3,4,9,31,-64,9,5,309,235
662,50,5,2,9,4,-46,22,3,7,263,257
662,51,3,4,5,8,32,-56,5,1,295,201
662,52,5,2,9,4,54,22,9,3,349,223
662,53,2,4,5,8,-77,44,2,7,272,267
662,54,5,2,9,4,54,22,6,9,326,289
662,55,4,2,8,5,-56,-77,0,2,270,212
662,56,3,4,7,6,34,42,4,4,304,254
662,57,2,4,5,8,23,44,7,8,327,298
662,58,4,3,8,5,-56,-68,1,0,271,230
662,59,2,4,6,7,24,43,5,3,295,273
662,60,3,3,6,7,33,34,8,7,328,307
662,61,2,4,4,9,-78,-55,0,2,250,252
662,62,4,2,8,5,44,23,4,5,294,275
662,63,3,3,8,5,35,32,9,7,329,307
662,64,3,4,8,5,-65,41,4,8,264,348
662,65,3,3,5,8,32,-65,6,3,296,283
662,66,4,3,9,4,-55,31,1,4,241,314
662,67,4,3,9,4,45,31,6,5,286,345
662,68,3,4,8,5,-65,41,1,6,221,386
662,69,3,5,5,8,32,53,3,9,253,439
662,70,4,2,10,3,46,-79,9,0,299,360
662,71,3,4,5,8,-68,44,1,4,231,404
662,72,3,3,5,8,32,35,3,9,263,439
662,73,3,5,7,6,34,-49,7,0,297,390
662,74,3,3,6,7,-67,34,0,4,230,424
662,75,2,5,4,9,22,54,2,8,252,478
662,76,5,2,10,3,55,21,7,9,307,499
662,77,3,4,6,7,-67,-57,0,2,240,442
662,78,6,2,8,5,62,23,2,5,302,465
662,79,4,2,8,5,44,23,6,8,346,488
662,80,3,3,6,7,33,-66,9,2,379,422
662,81,5,3,7,6,-48,33,1,5,331,455
662,82,5,2,9,4,54,22,5,7,385,477
662,83,2,4,5,8,23,-56,8,1,408,421
662,84,4,2,6,7,-58,25,0,6,350,446
662,85,4,3,7,6,43,33,3,9,393,479
662,86,2,4,6,7,24,-57,7,2,417,422
662,87,3,4,4,9,31,45,8,7,448,467
662,88,3,3,5,8,-68,-65,0,2,380,402
662,89,3,4,6,7,33,43,3,5,413,445
662,90,3,4,4,9,31,-55,4,0,444,390
662,91,6,2,9,4,63,22,7,2,507,412
663,1,2,4,7,6,25,42,5,2,25,42
663,2,2,4,2,11,20,47,5,9,45,89
663,3,5,2,11,2,-44,20,1,9,1,109
663,4,3,4,5,8,32,-56,3,3,33,53
663,5,5,2,10,3,55,21,8,4,88,74
663,6,2,4,5,8,-77,44,1,8,11,118
663,7,3,3,9,4,36,31,7,9,47,149
663,8,4,4,7,6,-57,-58,0,1,-10,91
663,9,3,3,5,8,32,35,2,6,22,126
663,10,3,3,6,7,33,-66,5,0,55,60
663,11,4,3,10,3,-54,30,1,0,1,90
663,12,3,3,6,7,33,34,4,4,34,124
663,13,3,3,3,10,30,-63,4,1,64,61
663,14,2,4,7,6,25,42,9,3,89,103
663,15,4,3,6,7,-58,34,1,7,31,137
663,16,3,4,4,9,31,-55,2,2,62,82
663,17,4,2,8,5,44,23,6,5,106,105
663,18,4,3,7,6,43,33,9,8,149,138
663,19,4,3,8,5,-56,-68,3,0,93,70
663,20,3,3,5,8,32,35,5,5,125,105
663,21,2,4,4,9,22,-55,7,0,147,50
663,22,3,3,5,8,32,35,9,5,179,85
663,23,3,4,8,5,-65,41,4,6,114,126
663,24,4,2,8,5,44,23,8,9,158,149
663,25,3,4,4,9,31,-55,9,4,189,94
663,26,4,2,7,6,-57,24,2,8,132,118
663,27,3,4,5,8,32,-56,4,2,164,62
663,28,3,3,7,6,34,33,8,5,198,95
663,29,5,2,8,5,-47,23,1,8,151,118
663,30,4,2,5,8,41,-74,2,4,192,44
663,31,3,3,5,8,32,35,4,9,224,79
663,32,4,3,7,6,43,-67,7,2,267,12
663,33,4,3,9,4,-55,31,2,3,212,43
663,34,2,6,5,8,23,62,5,5,235,105
663,35,2,5,6,7,24,52,9,7,259,157
663,36,4,2,9,4,-55,22,4,9,204,179
663,37,5,3,9,4,54,-69,8,0,258,110
663,38,3,4,4,9,31,45,9,5,289,155
663,39,2,5,5,8,-77,53,2,8,212,208
663,40,5,2,9,4,54,-78,6,0,266,130
663,41,2,6,7,6,-75,60,1,0,191,190
663,42,2,5,4,9,22,54,3,4,213,244
663,43,2,5,2,11,20,-44,3,0,233,200
663,44,2,4,3,10,21,46,4,6,254,246
663,45,4,2,5,8,41,-74,5,2,295,172
663,46,3,4,4,9,31,45,6,7,326,217
663,47,3,4,7,6,-66,42,0,9,260,259
663,48,3,4,7,6,34,-58,4,1,294,201
663,49,6,2,10,3,64,21,8,2,358,222
663,50,2,5,4,9,-78,54,0,6,280,276
663,51,5,2,10,3,55,21,5,7,335,297
663,52,3,4,6,7,33,-57,8,0,368,240
663,53,2,4,6,7,-76,43,2,3,292,283
663,54,2,4,4,9,22,45,4,8,314,328
663,55,3,3,10,3,-63,30,1,8,251,358
663,56,2,4,6,7,24,-57,5,1,275,301
663,57,3,5,6,7,33,52,8,3,308,353
663,58,3,3,9,4,-64,31,4,4,244,384
663,59,3,3,5,8,32,35,6,9,276,419
663,60,4,3,6,7,42,-66,8,3,318,353
663,61,3,3,6,7,-67,34,1,7,251,387
663,62,4,2,6,7,42,-75,3,2,293,312
663,63,3,3,7,6,34,33,7,5,327,345
663,64,3,3,7,6,-66,33,1,8,261,378
663,65,4,4,5,8,41,-56,2,2,302,322
663,66,4,2,9,4,45,22,7,4,347,344
663,67,3,3,8,5,-65,32,2,6,282,376
663,68,2,5,5,8,23,53,5,9,305,429
663,69,3,4,7,6,34,-58,9,1,339,371
663,70,2,4,6,7,-76,43,3,4,263,414
663,71,3,4,4,9,31,45,4,9,294,459
663,72,4,3,8,5,44,-68,8,1,338,391
663,73,4,3,8,5,-56,32,2,3,282,423
663,74,4,3,7,6,43,33,5,6,325,456
663,75,4,3,6,7,42,-66,7,0,367,390
663,76,3,3,7,6,-66,33,1,3,301,423
663,77,3,3,5,8,32,35,3,8,333,458
663,78,4,3,9,4,45,31,8,9,378,489
663,79,4,2,7,6,-57,-76,1,3,321,413
663,80,5,2,8,5,53,23,4,6,374,436
663,81,5,2,7,6,52,-76,6,0,426,360
663,82,4,3,6,7,42,34,8,4,468,394
663,83,2,5,5,8,-77,53,1,7,391,447
663,84,2,4,5,8,23,-56,4,1,414,391
663,85,3,3,3,10,30,37,4,8,444,428
663,86,3,3,6,7,33,-66,7,2,477,362
663,87,3,4,5,8,32,44,9,6,509,406
664,1,3,4,5,8,32,44,2,4,32,44
664,2,3,3,5,8,32,35,4,9,64,79
664,3,4,3,6,7,42,-66,6,3,106,13
664,4,4,3,8,5,-56,32,0,5,50,45
664,5,2,5,3,10,21,-45,1,0,71,0
664,6,3,3,6,7,33,34,4,4,104,34
664,7,5,2,9,4,54,22,8,6,158,56
664,8,3,4,7,6,-66,42,2,8,92,98
664,9,2,4,3,10,21,-54,3,4,113,44
664,10,4,4,8,5,44,41,7,5,157,85
664,11,5,2,8,5,-47,23,0,8,110,108
664,12,3,3,5,8,32,-65,2,3,142,43
664,13,4,3,7,6,43,33,5,6,185,76
664,14,3,3,6,7,33,-66,8,0,218,10
664,15,3,3,6,7,-67,34,1,4,151,44
664,16,3,4,8,5,35,41,6,5,186,85
664,17,3,4,5,8,32,44,8,9,218,129
664,18,2,5,2,11,20,-44,8,5,238,85
664,19,2,5,5,8,-77,53,1,8,161,138
664,20,2,6,4,9,22,-37,3,1,183,101
664,21,3,3,6,7,33,34,6,5,216,135
664,22,3,3,7,6,-66,33,0,8,150,168
664,23,2,4,4,9,22,-55,2,3,172,113
664,24,4,4,4,9,40,45,2,8,212,158
664,25,3,4,4,9,31,-55,3,3,243,103
664,26,3,4,5,8,32,44,5,7,275,147
664,27,4,3,5,8,41,-65,6,2,316,82
664,28,2,5,7,6,-75,51,1,3,241,133
664,29,4,3,9,4,45,31,6,4,286,164
664,30,3,4,4,9,31,45,7,9,317,209
664,31,3,3,7,6,-66,-67,1,2,251,142
664,32,2,5,4,9,22,54,3,6,273,196
664,33,3,4,5,8,32,-56,5,0,305,140
664,34,3,5,6,7,33,52,8,2,338,192
664,35,4,3,6,7,-58,34,0,6,280,226
664,36,3,3,5,8,32,-65,2,1,312,161
664,37,3,3,8,5,35,32,7,3,347,193
664,38,2,4,4,9,22,45,9,8,369,238
664,39,3,4,6,7,-67,-57,2,1,302,181
664,40,3,3,8,5,35,32,7,3,337,213
664,41,2,4,5,8,-77,44,0,7,260,257
664,42,3,4,7,6,34,42,4,9,294,299
664,43,2,5,4,9,22,-46,6,3,316,253
664,44,4,2,8,5,-56,23,0,6,260,276
664,45,3,3,5,8,32,-65,2,1,292,211
664,46,3,5,6,7,33,52,5,3,325,263
664,47,5,2,9,4,54,22,9,5,379,285
664,48,4,3,8,5,-56,32,3,7,323,317
664,49,4,3,5,8,41,-65,4,2,364,252
664,50,2,4,6,7,24,43,8,5,388,295
664,51,3,5,5,8,-68,53,0,8,320,348
664,52,2,4,6,7,24,-57,4,1,344,291
664,53,3,3,6,7,33,34,7,5,377,325
664,54,3,4,5,8,32,44,9,9,409,369
664,55,4,4,6,7,-58,-57,1,2,351,312
664,56,3,3,6,7,33,34,4,6,384,346
664,57,5,2,9,4,54,22,8,8,438,368
664,58,3,3,8,5,-65,-68,3,0,373,300
664,59,3,3,7,6,34,33,7,3,407,333
664,60,2,4,6,7,-76,43,1,6,331,376
664,61,3,3,8,5,35,32,6,8,366,408
664,62,4,3,6,7,42,-66,8,2,408,342
664,63,2,5,3,10,21,55,9,7,429,397
664,64,2,5,5,8,-77,-47,2,0,352,350
664,65,4,3,8,5,44,32,6,2,396,382
664,66,3,4,4,9,31,45,7,7,427,427
664,67,2,4,5,8,-77,-56,0,1,350,371
664,68,4,3,6,7,42,34,2,5,392,405
664,69,5,2,9,4,54,22,6,7,446,427
664,70,4,2,7,6,43,-76,9,1,489,351
664,71,4,2,8,5,-56,23,3,4,433,374
664,72,5,2,9,4,54,22,7,6,487,396
664,73,3,4,5,8,32,-56,9,0,519,340
665,1,5,2,11,2,56,20,6,0,56,20
665,2,2,5,5,8,23,53,9,3,79,73
665,3,4,2,7,6,-57,24,2,7,22,97
665,4,2,4,3,10,21,-54,3,3,43,43
665,5,4,2,9,4,45,22,8,5,88,65
665,6,4,3,8,5,-56,32,2,7,32,97
665,7,5,2,11,2,56,20,8,7,88,117
665,8,4,3,5,8,41,-65,9,2,129,52
665,9,3,4,6,7,-67,43,2,5,62,95
665,10,2,5,6,7,24,52,6,7,86,147
665,11,3,3,6,7,33,-66,9,1,119,81
665,12,5,2,9,4,-46,22,3,3,73,103
665,13,5,2,8,5,53,23,6,6,126,126
665,14,4,3,9,4,-55,31,1,7,71,157
665,15,4,3,8,5,44,32,5,9,115,189
665,16,3,4,7,6,34,-58,9,1,149,131
665,17,4,2,10,3,-54,21,5,2,95,152
665,18,3,4,9,4,-64,40,1,2,31,192
665,19,3,3,7,6,34,33,5,5,65,225
665,20,3,3,3,10,30,-63,5,2,95,162
665,21,3,3,6,7,33,34,8,6,128,196
665,22,3,3,9,4,-64,31,4,7,64,227
665,23,4,3,7,6,43,-67,7,0,107,160
665,24,2,4,4,9,22,45,9,5,129,205
665,25,2,4,7,6,-75,42,4,7,54,247
665,26,2,6,3,10,21,-36,5,1,75,211
665,27,3,3,5,8,32,35,7,6,107,246
665,28,4,3,8,5,-56,32,1,8,51,278
665,29,3,3,9,4,36,31,7,9,87,309
665,30,2,4,6,7,-76,-57,1,2,11,252
665,31,3,3,8,5,35,32,6,4,46,284
665,32,3,3,5,8,32,35,8,9,78,319
665,33,2,5,3,10,21,-45,9,4,99,274
665,34,2,5,4,9,-78,54,1,8,21,328
665,35,4,3,8,5,44,-68,5,0,65,260
665,36,5,2,8,5,53,23,8,3,118,283
665,37,3,3,6,7,-67,34,1,7,51,317
665,38,3,4,6,7,33,-57,4,0,84,260
665,39,4,3,8,5,44,32,8,2,128,292
665,40,2,4,4,9,-78,45,0,7,50,337
665,41,3,4,5,8,32,-56,2,1,82,281
665,42,4,2,8,5,44,23,6,4,126,304
665,43,2,4,4,9,22,45,8,9,148,349
665,44,3,4,8,5,-65,-59,3,0,83,290
665,45,2,4,5,8,23,44,6,4,106,334
665,46,3,4,5,8,32,44,8,8,138,378
665,47,5,2,11,2,-44,20,4,8,94,398
665,48,4,2,7,6,43,-76,7,2,137,322
665,49,3,4,4,9,31,45,8,7,168,367
665,50,4,3,8,5,-56,32,2,9,112,399
665,51,4,2,6,7,42,-75,4,4,154,324
665,52,2,4,5,8,23,44,7,8,177,368
665,53,2,4,4,9,22,-55,9,3,199,313
665,54,4,3,8,5,-56,32,3,5,143,345
665,55,2,4,6,7,24,43,7,8,167,388
665,56,5,2,8,5,-47,-77,0,1,120,311
665,57,4,3,9,4,45,31,5,2,165,342
665,58,3,3,10,3,-63,30,2,2,102,372
665,59,3,3,5,8,32,35,4,7,134,407
665,60,3,4,3,10,30,-54,4,3,164,353
665,61,3,3,6,7,33,34,7,7,197,387
665,62,4,3,9,4,-55,31,2,8,142,418
665,63,3,3,6,7,33,-66,5,2,175,352
665,64,4,3,5,8,41,35,6,7,216,387
665,65,4,3,8,5,-56,32,0,9,160,419
665,66,3,3,5,8,32,-65,2,4,192,354
665,67,2,4,6,7,24,43,6,7,216,397
665,68,2,5,3,10,21,-45,7,2,237,352
665,69,4,2,11,2,-53,20,4,2,184,372
665,70,4,2,11,2,-53,20,1,2,131,392
665,71,3,3,8,5,35,32,6,4,166,424
665,72,4,3,5,8,41,35,7,9,207,459
665,73,2,4,4,9,22,-55,9,4,229,404
665,74,3,3,5,8,-68,35,1,9,161,439
665,75,3,3,5,8,32,-65,3,4,193,374
665,76,3,4,6,7,33,43,6,7,226,417
665,77,2,5,3,10,21,-45,7,2,247,372
665,78,2,5,4,9,22,54,9,6,269,426
665,79,5,2,8,5,-47,23,2,9,222,449
665,80,4,4,8,5,44,-59,6,0,266,390
665,81,3,3,6,7,33,34,9,4,299,424
665,82,3,3,5,8,-68,35,1,9,231,459
665,83,4,2,6,7,42,-75,3,4,273,384
665,84,3,3,7,6,34,33,7,7,307,417
665,85,2,5,6,7,-76,52,1,9,231,469
665,86,3,3,7,6,34,-67,5,2,265,402
665,87,2,6,4,9,22,63,7,5,287,465
665,88,2,4,4,9,22,-55,9,0,309,410
665,89,3,4,7,6,-66,42,3,2,243,452
665,90,3,4,4,9,31,45,4,7,274,497
665,91,5,2,8,5,53,-77,7,0,327,420
665,92,2,6,4,9,22,63,9,3,349,483
665,93,4,3,7,6,-57,33,2,6,292,516
666,1,6,2,10,3,64,21,4,1,64,21
666,2,3,3,5,8,32,35,6,6,96,56
666,3,4,3,7,6,43,33,9,9,139,89
666,4,3,3,8,5,-65,-68,4,1,74,21
666,5,4,3,5,8,41,35,5,6,115,56
666,6,3,3,8,5,-65,32,0,8,50,88
666,7,2,4,7,6,25,-58,5,0,75,30
666,8,4,2,9,4,-55,22,0,2,20,52
666,9,3,4,6,7,33,43,3,5,53,95
666,10,2,4,5,8,23,44,6,9,76,139
666,11,2,4,5,8,23,-56,9,3,99,83
666,12,3,4,7,6,-66,42,3,5,33,125
666,13,2,5,5,8,23,53,6,8,56,178
666,14,3,4,5,8,32,-56,8,2,88,122
666,15,4,2,7,6,-57,24,1,6,31,146
666,16,3,4,4,9,31,-55,2,1,62,91
666,17,2,4,7,6,25,42,7,3,87,133
666,18,3,3,8,5,-65,32,2,5,22,165
666,19,4,3,8,5,44,32,6,7,66,197
666,20,2,5,6,7,-76,52,0,9,-10,249
666,21,4,2,8,5,44,-77,4,2,34,172
666,22,5,2,10,3,55,21,9,3,89,193
666,23,3,4,7,6,-66,42,3,5,23,235
666,24,4,2,6,7,42,-75,5,0,65,160
666,25,2,4,4,9,22,45,7,5,87,205
666,26,3,4,7,6,-66,42,1,7,21,247
666,27,4,2,7,6,43,-76,4,1,64,171
666,28,2,4,6,7,24,43,8,4,88,214
666,29,4,3,7,6,-57,33,1,7,31,247
666,30,2,4,7,6,25,42,6,9,56,289
666,31,3,3,4,9,31,-64,7,5,87,225
666,32,4,2,6,7,42,-75,9,0,129,150
666,33,4,3,8,5,-56,32,3,2,73,182
666,34,3,4,9,4,36,40,9,2,109,222
666,35,2,4,4,9,-78,45,1,7,31,267
666,36,2,5,6,7,24,52,5,9,55,319
666,37,3,3,7,6,34,-67,9,2,89,252
666,38,2,5,4,9,-78,54,1,6,11,306
666,39,3,3,8,5,35,32,6,8,46,338
666,40,3,3,7,6,-66,-67,0,1,-20,271
666,41,5,2,7,6,52,24,2,5,32,295
666,42,4,3,8,5,44,32,6,7,76,327
666,43,3,3,8,5,-65,32,1,9,11,359
666,44,2,4,6,7,24,-57,5,2,35,302
666,45,3,3,5,8,32,35,7,7,67,337
666,46,2,4,6,7,-76,-57,1,0,-9,280
666,47,4,3,8,5,44,32,5,2,35,312
666,48,3,3,5,8,32,35,7,7,67,347
666,49,2,5,5,8,-77,-47,0,0,-10,300
666,50,2,4,4,9,22,45,2,5,12,345
666,51,2,4,6,7,24,43,6,8,36,388
666,52,4,2,7,6,43,-76,9,2,79,312
666,53,2,4,4,9,-78,45,1,7,1,357
666,54,4,2,9,4,45,22,6,9,46,379
666,55,4,3,8,5,-56,-68,0,1,-10,311
666,56,2,4,6,7,24,43,4,4,14,354
666,57,3,3,5,8,32,35,6,9,46,389
666,58,4,2,7,6,43,-76,9,3,89,313
666,59,3,3,8,5,-65,32,4,5,24,345
666,60,3,3,6,7,33,34,7,9,57,379
666,61,2,4,3,10,21,-54,8,5,78,325
666,62,4,3,8,5,-56,32,2,7,22,357
666,63,2,4,4,9,22,-55,4,2,44,302
666,64,3,4,4,9,31,45,5,7,75,347
666,65,4,2,5,8,41,-74,6,3,116,273
666,66,3,4,5,8,32,44,8,7,148,317
666,67,2,5,3,10,21,-45,9,2,169,272
666,68,3,3,7,6,-66,33,3,5,103,305
666,69,3,4,7,6,34,42,7,7,137,347
666,70,3,4,7,6,-66,42,1,9,71,389
666,71,2,6,3,10,21,-36,2,3,92,353
666,72,3,3,5,8,32,35,4,8,124,388
666,73,5,2,9,4,54,-78,8,0,178,310
666,74,5,2,11,2,-44,20,4,0,134,330
666,75,3,4,8,5,35,41,9,1,169,371
666,76,4,3,7,6,-57,33,2,4,112,404
666,77,5,2,11,2,56,20,8,4,168,424
666,78,6,2,9,4,-37,22,1,6,131,446
666,79,3,4,5,8,32,-56,3,0,163,390
666,80,2,4,4,9,22,45,5,5,185,435
666,81,2,4,4,9,22,-55,7,0,207,380
666,82,4,3,5,8,41,35,8,5,248,415
666,83,2,4,2,11,20,-53,8,2,268,362
666,84,3,3,5,8,-68,35,0,7,200,397
666,85,3,4,4,9,31,-55,1,2,231,342
666,86,2,4,2,11,20,47,1,9,251,389
666,87,3,4,5,8,32,-56,3,3,283,333
666,88,4,3,7,6,43,33,6,6,326,366
666,89,2,5,4,9,22,-46,8,0,348,320
666,90,5,2,10,3,-45,21,3,1,303,341
666,91,3,4,7,6,34,42,7,3,337,383
666,92,3,5,5,8,32,53,9,6,369,436
666,93,2,4,4,9,-78,-55,1,1,291,381
666,94,4,3,9,4,45,31,6,2,336,412
666,95,5,2,7,6,52,24,8,6,388,436
666,96,4,2,7,6,-57,-76,1,0,331,360
666,97,2,4,3,10,21,46,2,6,352,406
666,98,6,2,10,3,64,21,6,7,416,427
666,99,4,3,8,5,-56,32,0,9,360,459
666,100,5,2,9,4,54,-78,4,1,414,381
666,101,2,5,4,9,22,54,6,5,436,435
666,102,3,3,8,5,-65,32,1,7,371,467
666,103,4,2,9,4,45,22,6,9,416,489
666,104,3,4,4,9,31,-55,7,4,447,434
666,105,3,3,6,7,-67,34,0,8,380,468
666,106,4,3,4,9,40,-64,0,4,420,404
666,107,4,4,8,5,44,41,4,5,464,445
666,108,4,2,9,4,45,22,9,7,509,467
667,1,3,3,8,5,35,32,5,2,35,32
667,2,2,4,7,6,-75,42,0,4,-40,74
667,3,2,5,4,9,22,54,2,8,-18,128
667,4,4,3,7,6,43,-67,5,1,25,61
667,5,3,3,8,5,-65,32,0,3,-40,93
667,6,2,5,4,9,22,54,2,7,-18,147
667,7,4,3,6,7,42,-66,4,1,24,81
667,8,5,2,10,3,55,21,9,2,79,102
667,9,5,2,9,4,-46,22,3,4,33,124
667,10,5,2,9,4,54,22,7,6,87,146
667,11,3,4,4,9,31,-55,8,1,118,91
667,12,3,3,8,5,-65,32,3,3,53,123
667,13,4,3,4,9,40,36,3,9,93,159
667,14,4,3,6,7,42,-66,5,3,135,93
667,15,3,3,5,8,32,35,7,8,167,128
667,16,3,4,4,9,31,-55,8,3,198,73
667,17,4,2,10,3,-54,21,4,4,144,94
667,18,3,4,4,9,31,45,5,9,175,139
667,19,3,5,4,9,31,-46,6,3,206,93
667,20,3,4,3,10,30,46,6,9,236,139
667,21,5,2,9,4,-46,-78,0,1,190,61
667,22,3,4,7,6,34,42,4,3,224,103
667,23,2,4,6,7,24,43,8,6,248,146
667,24,5,2,11,2,-44,20,4,6,204,166
667,25,3,3,7,6,34,33,8,9,238,199
667,26,3,4,6,7,-67,-57,1,2,171,142
667,27,5,2,6,7,51,25,2,7,222,167
667,28,3,4,5,8,32,-56,4,1,254,111
667,29,4,3,5,8,41,35,5,6,295,146
667,30,4,3,7,6,43,33,8,9,338,179
667,31,3,4,6,7,-67,-57,1,2,271,122
667,32,6,2,10,3,64,21,5,3,335,143
667,33,3,4,7,6,34,42,9,5,369,185
667,34,4,3,10,3,-54,30,5,5,315,215
667,35,4,3,7,6,43,33,8,8,358,248
667,36,3,3,5,8,-68,-65,0,3,290,183
667,37,3,3,7,6,34,33,4,6,324,216
667,38,4,2,8,5,44,23,8,9,368,239
667,39,5,2,10,3,-45,-79,3,0,323,160
667,40,3,3,6,7,33,34,6,4,356,194
667,41,3,4,4,9,31,45,7,9,387,239
667,42,2,4,4,9,22,-55,9,4,409,184
667,43,3,4,7,6,-66,42,3,6,343,226
667,44,5,2,10,3,55,21,8,7,398,247
667,45,4,4,6,7,-58,-57,0,0,340,190
667,46,3,3,6,7,33,34,3,4,373,224
667,47,5,2,11,2,56,20,9,4,429,244
667,48,2,4,4,9,-78,45,1,9,351,289
667,49,2,5,4,9,22,-46,3,3,373,243
667,50,2,5,4,9,22,54,5,7,395,297
667,51,3,3,7,6,34,-67,9,0,429,230
667,52,3,3,6,7,-67,34,2,4,362,264
667,53,2,4,6,7,24,43,6,7,386,307
667,54,3,4,8,5,-65,41,1,8,321,348
667,55,4,2,7,6,43,-76,4,2,364,272
667,56,2,4,6,7,24,43,8,5,388,315
667,57,3,3,5,8,-68,-65,0,0,320,250
667,58,3,3,6,7,33,34,3,4,353,284
667,59,3,3,9,4,36,31,9,5,389,315
667,60,4,3,9,4,-55,31,4,6,334,346
667,61,6,2,10,3,64,21,8,7,398,367
667,62,5,2,9,4,-46,22,2,9,352,389
667,63,4,2,9,4,45,-78,7,1,397,311
667,64,2,4,7,6,-75,42,2,3,322,353
667,65,5,2,9,4,54,22,6,5,376,375
667,66,3,3,7,6,-66,33,0,8,310,408
667,67,3,3,5,8,32,-65,2,3,342,343
667,68,2,5,3,10,21,55,3,8,363,398
667,69,3,3,5,8,32,-65,5,3,395,333
667,70,4,2,6,7,42,25,7,8,437,358
667,71,4,3,6,7,42,-66,9,2,479,292
667,72,4,3,9,4,-55,31,4,3,424,323
667,73,2,5,3,10,21,55,5,8,445,378
667,74,4,2,8,5,44,-77,9,1,489,301
667,75,3,4,4,9,-69,45,0,6,420,346
667,76,4,2,11,2,47,20,7,6,467,366
667,77,4,2,7,6,-57,-76,0,0,410,290
667,78,4,2,4,9,40,27,0,7,450,317
667,79,2,4,4,9,22,-55,2,2,472,262
667,80,3,3,8,5,35,32,7,4,507,294
668,1,4,3,7,6,43,33,3,3,43,33
668,2,3,3,7,6,34,33,7,6,77,66
668,3,4,2,8,5,-56,23,1,9,21,89
668,4,3,3,5,8,32,-65,3,4,53,24
668,5,4,2,9,4,45,22,8,6,98,46
668,6,4,2,8,5,-56,23,2,9,42,69
668,7,3,3,8,5,35,-68,7,1,77,1
668,8,5,3,6,7,51,34,8,5,128,35
668,9,3,4,4,9,31,-55,9,0,159,-20
668,10,4,2,7,6,-57,24,2,4,102,4
668,11,2,5,5,8,23,53,5,7,125,57
668,12,3,3,6,7,33,-66,8,1,158,-9
668,13,4,3,7,6,-57,33,1,4,101,24
668,14,4,2,9,4,45,22,6,6,146,46
668,15,4,3,9,4,-55,31,1,7,91,77
668,16,5,2,8,5,53,-77,4,0,144,0
668,17,3,3,7,6,34,33,8,3,178,33
668,18,4,3,8,5,-56,32,2,5,122,65
668,19,3,4,6,7,33,43,5,8,155,108
668,20,4,4,8,5,44,41,9,9,199,149
668,21,3,3,7,6,-66,-67,3,2,133,82
668,22,4,3,5,8,41,35,4,7,174,117
668,23,2,6,2,11,20,-35,4,2,194,82
668,24,3,4,5,8,32,44,6,6,226,126
668,25,3,3,9,4,-64,31,2,7,162,157
668,26,4,3,7,6,43,-67,5,0,205,90
668,27,4,3,7,6,43,33,8,3,248,123
668,28,4,2,7,6,-57,24,1,7,191,147
668,29,3,3,7,6,34,-67,5,0,225,80
668,30,4,3,9,4,-55,31,0,1,170,111
668,31,3,3,5,8,32,35,2,6,202,146
668,32,5,2,11,2,56,20,8,6,258,166
668,33,2,5,6,7,-76,52,2,8,182,218
668,34,3,3,9,4,36,31,8,9,218,249
668,35,5,2,9,4,-46,-78,2,1,172,171
668,36,4,3,9,4,45,31,7,2,217,202
668,37,2,5,3,10,21,55,8,7,238,257
668,38,5,2,9,4,-46,22,2,9,192,279
668,39,3,3,5,8,32,-65,4,4,224,214
668,40,4,3,8,5,44,32,8,6,268,246
668,41,2,4,4,9,-78,-55,0,1,190,191
668,42,4,3,7,6,43,33,3,4,233,224
668,43,2,5,2,11,20,-44,3,0,253,180
668,44,2,5,4,9,22,54,5,4,275,234
668,45,5,2,10,3,-45,21,0,5,230,255
668,46,4,3,9,4,45,31,5,6,275,286
668,47,4,3,7,6,43,33,8,9,318,319
668,48,3,3,9,4,-64,-69,4,0,254,250
668,49,4,3,8,5,44,32,8,2,298,282
668,50,3,4,7,6,-66,42,2,4,232,324
668,51,2,4,4,9,22,45,4,9,254,369
668,52,2,5,4,9,22,-46,6,3,276,323
668,53,4,3,10,3,-54,30,2,3,222,353
668,54,3,4,5,8,32,44,4,7,254,397
668,55,4,3,8,5,44,32,8,9,298,429
668,56,5,2,10,3,-45,-79,3,0,253,350
668,57,2,4,5,8,23,44,6,4,276,394
668,58,4,2,7,6,43,24,9,8,319,418
668,59,3,4,7,6,-66,-58,3,0,253,360
668,60,3,4,9,4,36,40,9,0,289,400
668,61,3,4,9,4,-64,40,5,0,225,440
668,62,3,3,4,9,31,36,6,6,256,476
668,63,4,3,5,8,41,-65,7,1,297,411
668,64,2,4,4,9,22,45,9,6,319,456
668,65,2,5,6,7,-76,52,3,8,243,508
669,1,3,3,3,10,30,37,0,7,30,37
669,2,5,2,8,5,53,-77,3,0,83,-40
669,3,4,3,8,5,44,32,7,2,127,-8
669,4,3,3,8,5,-65,32,2,4,62,24
669,5,4,2,9,4,45,22,7,6,107,46
669,6,3,4,7,6,-66,42,1,8,41,88
669,7,2,4,6,7,24,-57,5,1,65,31
669,8,3,3,5,8,32,35,7,6,97,66
669,9,2,5,5,8,-77,53,0,9,20,119
669,10,3,4,7,6,34,-58,4,1,54,61
669,11,2,4,4,9,22,45,6,6,76,106
669,12,3,3,8,5,-65,32,1,8,11,138
669,13,4,3,8,5,44,-68,5,0,55,70
669,14,4,3,6,7,42,34,7,4,97,104
669,15,2,5,4,9,22,54,9,8,119,158
669,16,4,3,9,4,-55,31,4,9,64,189
669,17,3,4,6,7,33,-57,7,2,97,132
669,18,4,3,10,3,-54,30,3,2,43,162
669,19,5,3,10,3,55,30,8,2,98,192
669,20,2,4,6,7,-76,43,2,5,22,235
669,21,2,4,7,6,25,42,7,7,47,277
669,22,5,2,9,4,-46,22,1,9,1,299
669,23,3,4,6,7,33,-57,4,2,34,242
669,24,4,3,8,5,44,32,8,4,78,274
669,25,4,2,11,2,-53,20,5,4,25,294
669,26,3,3,5,8,32,35,7,9,57,329
669,27,4,3,9,4,-55,-69,2,0,2,260
669,28,2,5,4,9,22,54,4,4,24,314
669,29,3,4,6,7,33,43,7,7,57,357
669,30,5,2,9,4,-46,22,1,9,11,379
669,31,3,4,7,6,34,-58,5,1,45,321
669,32,3,3,6,7,33,34,8,5,78,355
669,33,4,3,7,6,-57,33,1,8,21,388
669,34,3,3,7,6,34,-67,5,1,55,321
669,35,4,3,10,3,-54,30,1,1,1,351
669,36,3,3,7,6,34,33,5,4,35,384
669,37,2,4,6,7,24,43,9,7,59,427
669,38,3,3,5,8,-68,-65,1,2,-9,362
669,39,5,2,9,4,54,22,5,4,45,384
669,40,3,4,7,6,34,42,9,6,79,426
669,41,2,5,3,10,-79,-45,0,1,0,381
669,42,3,4,5,8,32,44,2,5,32,425
669,43,3,3,5,8,32,-65,4,0,64,360
669,44,5,2,10,3,55,21,9,1,119,381
669,45,3,3,7,6,-66,33,3,4,53,414
669,46,3,3,5,8,32,35,5,9,85,449
669,47,5,2,11,2,-44,20,1,9,41,469
669,48,4,3,8,5,44,-68,5,1,85,401
669,49,2,4,6,7,24,43,9,4,109,444
669,50,3,4,6,7,-67,43,2,7,42,487
669,51,4,2,11,2,47,20,9,7,89,507
670,1,4,2,7,6,43,24,3,4,43,24
670,2,4,3,8,5,44,32,7,6,87,56
670,3,2,5,2,11,20,-44,7,2,107,12
670,4,3,3,5,8,32,35,9,7,139,47
670,5,3,3,4,9,-69,-64,0,3,70,-17
670,6,2,4,8,5,26,41,6,4,96,24
670,7,4,3,5,8,41,35,7,9,137,59
670,8,3,4,8,5,-65,-59,2,0,72,0
670,9,4,3,8,5,44,32,6,2,116,32
670,10,4,3,6,7,42,34,8,6,158,66
670,11,4,3,5,8,41,-65,9,1,199,1
670,12,3,3,9,4,-64,31,5,2,135,32
670,13,3,4,3,10,30,46,5,8,165,78
670,14,3,4,6,7,33,-57,8,1,198,21
670,15,2,4,3,10,21,46,9,7,219,67
670,16,5,3,7,6,-48,-67,1,0,171,0
670,17,5,2,7,6,52,24,3,4,223,24
670,18,3,3,5,8,32,35,5,9,255,59
670,19,2,5,3,10,21,-45,6,4,276,14
670,20,3,4,7,6,-66,42,0,6,210,56
670,21,2,4,3,10,21,-54,1,2,231,2
670,22,2,5,4,9,22,54,3,6,253,56
670,23,2,5,3,10,21,-45,4,1,274,11
670,24,4,3,10,3,-54,30,0,1,220,41
670,25,5,2,8,5,53,23,3,4,273,64
670,26,4,4,6,7,42,43,5,7,315,107
670,27,2,6,3,10,21,-36,6,1,336,71
670,28,2,5,3,10,21,55,7,6,357,126
670,29,2,4,4,9,22,-55,9,1,379,71
670,30,3,3,6,7,-67,34,2,5,312,105
670,31,4,3,8,5,44,32,6,7,356,137
670,32,2,4,4,9,22,-55,8,2,378,82
670,33,2,4,3,10,21,46,9,8,399,128
670,34,3,3,7,6,-66,-67,3,1,333,61
670,35,4,3,7,6,43,33,6,4,376,94
670,36,3,4,4,9,31,45,7,9,407,139
670,37,3,4,4,9,31,-55,8,4,438,84
670,38,3,3,5,8,-68,35,0,9,370,119
670,39,2,4,5,8,23,-56,3,3,393,63
670,40,4,2,7,6,43,24,6,7,436,87
670,41,4,3,9,4,-55,31,1,8,381,118
670,42,3,4,4,9,31,-55,2,3,412,63
670,43,3,4,7,6,34,42,6,5,446,105
670,44,3,4,6,7,33,43,9,8,479,148
670,45,5,2,9,4,-46,-78,3,0,433,70
670,46,3,4,6,7,33,43,6,3,466,113
670,47,2,4,4,9,22,45,8,8,488,158
670,48,2,4,5,8,-77,-56,1,2,411,102
670,49,2,5,3,10,21,55,2,7,432,157
670,50,4,2,8,5,44,-77,6,0,476,80
670,51,2,5,3,10,21,55,7,5,497,135
670,52,3,4,7,6,-66,42,1,7,431,177
670,53,4,4,6,7,42,-57,3,0,473,120
670,54,3,3,5,8,32,35,5,5,505,155
671,1,3,3,7,6,34,33,4,3,34,33
671,2,3,4,5,8,32,44,6,7,66,77
671,3,3,3,9,4,-64,31,2,8,2,108
671,4,4,4,5,8,41,-56,3,2,43,52
671,5,3,4,5,8,32,44,5,6,75,96
671,6,3,4,4,9,31,-55,6,1,106,41
671,7,4,2,9,4,-55,22,1,3,51,63
671,8,4,2,9,4,45,22,6,5,96,85
671,9,3,4,6,7,33,43,9,8,129,128
671,10,4,2,10,3,-54,21,5,9,75,149
671,11,4,2,4,9,40,-73,5,6,115,76
671,12,3,3,7,6,34,33,9,9,149,109
671,13,4,2,7,6,-57,-76,2,3,92,33
671,14,3,3,6,7,33,34,5,7,125,67
671,15,4,2,9,4,-55,22,0,9,70,89
671,16,5,3,8,5,53,-68,3,1,123,21
671,17,4,2,10,3,46,21,9,2,169,42
671,18,3,4,8,5,-65,41,4,3,104,83
671,19,3,3,6,7,33,34,7,7,137,117
671,20,3,3,7,6,-66,-67,1,0,71,50
671,21,3,3,9,4,36,31,7,1,107,81
671,22,2,5,6,7,-76,52,1,3,31,133
671,23,3,4,7,6,34,42,5,5,65,175
671,24,4,2,9,4,-55,22,0,7,10,197
671,25,3,5,3,10,30,-45,0,2,40,152
671,26,6,2,9,4,63,22,3,4,103,174
671,27,4,3,8,5,44,32,7,6,147,206
671,28,3,3,8,5,-65,32,2,8,82,238
671,29,2,5,6,7,24,-48,6,0,106,190
671,30,3,3,3,10,30,37,6,7,136,227
671,31,6,2,11,2,-35,20,1,7,101,247
671,32,5,2,8,5,53,-77,4,0,154,170
671,33,4,3,7,6,43,33,7,3,197,203
671,34,5,2,10,3,-45,21,2,4,152,224
671,35,4,2,11,2,47,20,9,4,199,244
671,36,3,3,6,7,-67,34,2,8,132,278
671,37,4,3,9,4,45,31,7,9,177,309
671,38,5,2,10,3,-45,-79,2,0,132,230
671,39,4,3,7,6,43,33,5,3,175,263
671,40,4,2,5,8,41,26,6,9,216,289
671,41,3,4,4,9,31,-55,7,4,247,234
671,42,2,4,3,10,21,-54,8,0,268,180
671,43,4,2,8,5,-56,23,2,3,212,203
671,44,2,5,3,10,21,55,3,8,233,258
671,45,2,4,6,7,24,-57,7,1,257,201
671,46,4,3,6,7,42,34,9,5,299,235
671,47,2,4,4,9,-78,-55,1,0,221,180
671,48,3,4,8,5,35,41,6,1,256,221
671,49,3,4,4,9,31,45,7,6,287,266
671,50,4,2,8,5,-56,23,1,9,231,289
671,51,2,4,3,10,21,-54,2,5,252,235
671,52,3,3,6,7,33,34,5,9,285,269
671,53,5,2,8,5,53,-77,8,2,338,192
671,54,3,3,8,5,-65,32,3,4,273,224
671,55,5,2,8,5,53,23,6,7,326,247
671,56,3,3,6,7,33,-66,9,1,359,181
671,57,2,4,7,6,-75,42,4,3,284,223
671,58,3,4,7,6,34,42,8,5,318,265
671,59,3,3,5,8,-68,-65,0,0,250,200
671,60,3,4,4,9,31,45,1,5,281,245
671,61,3,3,9,4,36,31,7,6,317,276
671,62,2,4,4,9,22,-55,9,1,339,221
671,63,4,2,7,6,-57,24,2,5,282,245
671,64,6,2,10,3,64,21,6,6,346,266
671,65,4,3,8,5,-56,32,0,8,290,298
671,66,3,4,7,6,34,-58,4,0,324,240
671,67,5,3,9,4,54,31,8,1,378,271
671,68,3,3,8,5,-65,32,3,3,313,303
671,69,5,2,11,2,56,20,9,3,369,323
671,70,3,3,6,7,-67,34,2,7,302,357
671,71,4,3,10,3,46,30,8,7,348,387
671,72,3,3,6,7,-67,-66,1,1,281,321
671,73,3,4,9,4,36,40,7,1,317,361
671,74,4,3,7,6,-57,33,0,4,260,394
671,75,5,2,10,3,55,21,5,5,315,415
671,76,3,4,8,5,-65,41,0,6,250,456
671,77,2,4,6,7,24,43,4,9,274,499
671,78,2,4,4,9,22,-55,6,4,296,444
671,79,6,2,10,3,-36,21,0,5,260,465
671,80,3,4,6,7,33,43,3,8,293,508
672,1,4,2,6,7,42,25,2,5,42,25
672,2,2,5,5,8,23,53,5,8,65,78
672,3,3,3,5,8,32,-65,7,3,97,13
672,4,2,4,3,10,21,46,8,9,118,59
672,5,3,4,7,6,-66,-58,2,1,52,1
672,6,2,4,6,7,24,43,6,4,76,44
672,7,2,4,8,5,-74,41,2,5,2,85
672,8,3,3,6,7,33,34,5,9,35,119
672,9,2,4,7,6,-75,-58,0,1,-40,61
672,10,3,3,9,4,36,31,6,2,-4,92
672,11,4,3,7,6,43,33,9,5,39,125
672,12,5,2,11,2,-44,20,5,5,-5,145
672,13,4,3,8,5,44,32,9,7,39,177
672,14,3,3,5,8,-68,-65,1,2,-29,112
672,15,4,3,8,5,44,32,5,4,15,144
672,16,2,6,5,8,23,62,8,6,38,206
672,17,4,2,6,7,-58,-75,0,1,-20,131
672,18,2,5,4,9,22,54,2,5,2,185
672,19,4,3,7,6,43,33,5,8,45,218
672,20,3,4,7,6,34,-58,9,0,79,160
672,21,3,4,7,6,-66,42,3,2,13,202
672,22,5,2,9,4,54,22,7,4,67,224
672,23,3,4,7,6,-66,42,1,6,1,266
672,24,2,5,4,9,22,-46,3,0,23,220
672,25,3,3,10,3,-63,30,0,0,-40,250
672,26,2,4,5,8,23,44,3,4,-17,294
672,27,2,6,4,9,22,63,5,7,5,357
672,28,2,4,5,8,23,-56,8,1,28,301
672,29,3,4,5,8,-68,44,0,5,-40,345
672,30,3,3,6,7,33,34,3,9,-7,379
672,31,3,3,6,7,33,-66,6,3,26,313
672,32,2,4,5,8,23,44,9,7,49,357
672,33,3,4,8,5,-65,41,4,8,-16,398
672,34,5,2,9,4,54,-78,8,0,38,320
672,35,5,2,9,4,-46,22,2,2,-8,342
672,36,3,5,5,8,32,53,4,5,24,395
672,37,2,5,6,7,24,52,8,7,48,447
672,38,3,3,5,8,-68,-65,0,2,-20,382
672,39,4,2,7,6,43,24,3,6,23,406
672,40,3,3,3,10,30,-63,3,3,53,343
672,41,4,2,9,4,45,22,8,5,98,365
672,42,4,4,7,6,-57,42,1,7,41,407
672,43,5,2,8,5,53,-77,4,0,94,330
672,44,3,3,8,5,35,32,9,2,129,362
672,45,4,2,8,5,-56,23,3,5,73,385
672,46,4,2,8,5,44,23,7,8,117,408
672,47,4,2,6,7,42,-75,9,3,159,333
672,48,2,4,6,7,-76,43,3,6,83,376
672,49,3,4,4,9,31,-55,4,1,114,321
672,50,4,2,9,4,45,22,9,3,159,343
672,51,3,4,8,5,-65,41,4,4,94,384
672,52,3,3,7,6,34,33,8,7,128,417
672,53,3,3,7,6,-66,-67,2,0,62,350
672,54,3,4,4,9,31,45,3,5,93,395
672,55,4,3,7,6,43,33,6,8,136,428
672,56,2,5,4,9,22,-46,8,2,158,382
672,57,2,5,4,9,-78,54,0,6,80,436
672,58,3,3,7,6,34,33,4,9,114,469
672,59,2,4,7,6,25,-58,9,1,139,411
672,60,4,2,9,4,-55,22,4,3,84,433
672,61,3,3,6,7,33,34,7,7,117,467
672,62,3,3,9,4,-64,31,3,8,53,498
672,63,3,5,5,8,32,-47,5,1,85,451
672,64,3,3,6,7,33,34,8,5,118,485
672,65,3,3,8,5,-65,32,3,7,53,517
673,1,3,4,4,9,31,45,1,5,31,45
673,2,4,3,7,6,43,33,4,8,74,78
673,3,4,3,6,7,42,-66,6,2,116,12
673,4,3,4,8,5,-65,41,1,3,51,53
673,5,4,4,8,5,44,41,5,4,95,94
673,6,4,2,8,5,44,23,9,7,139,117
673,7,3,3,7,6,-66,-67,3,0,73,50
673,8,2,5,2,11,20,56,3,6,93,106
673,9,4,2,11,2,-53,20,0,6,40,126
673,10,2,5,3,10,21,-45,1,1,61,81
673,11,5,2,8,5,53,23,4,4,114,104
673,12,4,3,9,4,45,31,9,5,159,135
673,13,2,6,4,9,-78,63,1,8,81,198
673,14,2,5,5,8,23,-47,4,1,104,151
673,15,5,2,10,3,55,21,9,2,159,172
673,16,4,2,8,5,-56,23,3,5,103,195
673,17,3,3,6,7,33,34,6,9,136,229
673,18,3,4,6,7,33,-57,9,2,169,172
673,19,3,3,8,5,-65,32,4,4,104,204
673,20,3,3,5,8,32,35,6,9,136,239
673,21,2,5,6,7,-76,-48,0,1,60,191
673,22,3,3,5,8,32,35,2,6,92,226
673,23,3,4,5,8,32,-56,4,0,124,170
673,24,3,5,5,8,32,53,6,3,156,223
673,25,2,5,4,9,22,54,8,7,178,277
673,26,4,3,6,7,-58,-66,0,1,120,211
673,27,4,3,8,5,44,32,4,3,164,243
673,28,2,5,3,10,21,55,5,8,185,298
673,29,5,2,9,4,54,-78,9,0,239,220
673,30,5,2,7,6,-48,24,1,4,191,244
673,31,5,2,9,4,54,22,5,6,245,266
673,32,5,2,8,5,53,23,8,9,298,289
673,33,4,2,8,5,-56,-77,2,2,242,212
673,34,3,4,8,5,35,41,7,3,277,253
673,35,4,2,8,5,-56,23,1,6,221,276
673,36,4,3,6,7,42,-66,3,0,263,210
673,37,4,2,10,3,46,21,9,1,309,231
673,38,2,5,3,10,-79,55,0,6,230,286
673,39,3,4,6,7,33,43,3,9,263,329
673,40,4,3,8,5,44,-68,7,1,307,261
673,41,3,3,8,5,-65,32,2,3,242,293
673,42,4,2,7,6,43,24,5,7,285,317
673,43,5,2,10,3,-45,21,0,8,240,338
673,44,3,4,6,7,33,-57,3,1,273,281
673,45,3,4,6,7,33,43,6,4,306,324
673,46,4,2,11,2,-53,20,3,4,253,344
673,47,5,2,10,3,55,21,8,5,308,365
673,48,3,3,5,8,-68,-65,0,0,240,300
673,49,2,4,5,8,23,44,3,4,263,344
673,50,3,3,5,8,32,35,5,9,295,379
673,51,4,2,10,3,-54,-79,1,0,241,300
673,52,2,4,8,5,26,41,7,1,267,341
673,53,3,4,7,6,-66,42,1,3,201,383
673,54,3,3,5,8,32,35,3,8,233,418
673,55,2,5,3,10,21,-45,4,3,254,373
673,56,4,3,9,4,45,31,9,4,299,404
673,57,3,3,8,5,-65,32,4,6,234,436
673,58,2,4,5,8,23,-56,7,0,257,380
673,59,4,2,10,3,-54,21,3,1,203,401
673,60,4,3,5,8,41,35,4,6,244,436
673,61,4,3,6,7,42,-66,6,0,286,370
673,62,3,3,9,4,-64,31,2,1,222,401
673,63,6,2,10,3,64,21,6,2,286,422
673,64,5,2,9,4,-46,22,0,4,240,444
673,65,4,3,7,6,43,33,3,7,283,477
673,66,3,3,8,5,35,32,8,9,318,509
674,1,4,3,9,4,45,31,5,1,45,31
674,2,3,4,5,8,32,44,7,5,77,75
674,3,2,4,3,10,21,-54,8,1,98,21
674,4,3,3,6,7,-67,34,1,5,31,55
674,5,4,3,9,4,45,31,6,6,76,86
674,6,5,2,6,7,51,-75,7,1,127,11
674,7,4,3,8,5,-56,32,1,3,71,43
674,8,4,3,5,8,41,35,2,8,112,78
674,9,3,4,4,9,31,-55,3,3,143,23
674,10,2,5,6,7,24,52,7,5,167,75
674,11,2,5,6,7,-76,52,1,7,91,127
674,12,4,2,9,4,45,22,6,9,136,149
674,13,4,3,8,5,-56,-68,0,1,80,81
674,14,2,4,5,8,23,44,3,5,103,125
674,15,5,2,8,5,53,23,6,8,156,148
674,16,3,4,6,7,33,-57,9,1,189,91
674,17,4,3,7,6,-57,33,2,4,132,124
674,18,3,4,5,8,32,44,4,8,164,168
674,19,3,3,5,8,32,-65,6,3,196,103
674,20,4,3,9,4,-55,31,1,4,141,134
674,21,3,3,5,8,32,35,3,9,173,169
674,22,2,5,5,8,23,-47,6,2,196,122
674,23,3,4,5,8,32,44,8,6,228,166
674,24,4,3,6,7,-58,-66,0,0,170,100
674,25,3,4,6,7,33,43,3,3,203,143
674,26,4,2,9,4,45,22,8,5,248,165
674,27,4,2,7,6,-57,24,1,9,191,189
674,28,3,3,5,8,32,-65,3,4,223,124
674,29,3,4,4,9,31,45,4,9,254,169
674,30,4,3,5,8,41,-65,5,4,295,104
674,31,3,3,5,8,32,35,7,9,327,139
674,32,4,3,8,5,-56,-68,1,1,271,71
674,33,4,3,7,6,43,33,4,4,314,104
674,34,2,5,5,8,23,53,7,7,337,157
674,35,5,2,10,3,-45,21,2,8,292,178
674,36,3,3,9,4,36,31,8,9,328,209
674,37,2,4,7,6,-75,-58,3,1,253,151
674,38,5,2,9,4,54,22,7,3,307,173
674,39,3,3,8,5,-65,32,2,5,242,205
674,40,4,3,7,6,43,33,5,8,285,238
674,41,4,2,8,5,44,-77,9,1,329,161
674,42,4,3,9,4,-55,31,4,2,274,192
674,43,3,3,5,8,32,35,6,7,306,227
674,44,2,5,3,10,21,-45,7,2,327,182
674,45,4,3,5,8,41,35,8,7,368,217
674,46,3,3,6,7,-67,-66,1,1,301,151
674,47,3,3,5,8,32,35,3,6,333,186
674,48,2,5,3,10,21,-45,4,1,354,141
674,49,2,4,5,8,23,44,7,5,377,185
674,50,4,3,7,6,-57,33,0,8,320,218
674,51,4,3,5,8,41,-65,1,3,361,153
674,52,2,4,3,10,21,46,2,9,382,199
674,53,2,6,3,10,21,-36,3,3,403,163
674,54,4,3,9,4,45,31,8,4,448,194
674,55,2,6,2,11,20,65,8,9,468,259
674,56,2,5,2,11,20,-44,8,5,488,215
674,57,4,2,6,7,-58,-75,0,0,430,140
674,58,3,3,8,5,35,32,5,2,465,172
674,59,3,3,8,5,-65,32,0,4,400,204
674,60,4,4,7,6,43,42,3,6,443,246
674,61,4,3,7,6,43,33,6,9,486,279
674,62,4,3,6,7,42,-66,8,3,528,213
675,1,4,2,8,5,44,23,4,3,44,23
675,2,3,3,7,6,34,33,8,6,78,56
675,3,3,3,5,8,-68,-65,0,1,10,-9
675,4,3,4,6,7,33,43,3,4,43,34
675,5,3,3,7,6,34,33,7,7,77,67
675,6,3,3,5,8,32,-65,9,2,109,2
675,7,2,4,6,7,-76,43,3,5,33,45
675,8,2,5,3,10,21,-45,4,0,54,0
675,9,4,4,8,5,44,41,8,1,98,41
675,10,4,3,6,7,-58,34,0,5,40,75
675,11,3,3,6,7,33,34,3,9,73,109
675,12,3,4,6,7,33,-57,6,2,106,52
675,13,3,4,7,6,-66,42,0,4,40,94
675,14,3,4,3,10,30,-54,0,0,70,40
675,15,4,3,10,3,46,30,6,0,116,70
675,16,3,4,6,7,33,43,9,3,149,113
675,17,2,5,2,11,20,56,9,9,169,169
675,18,5,2,9,4,-46,-78,3,1,123,91
675,19,3,3,5,8,32,35,5,6,155,126
675,20,3,5,4,9,31,-46,6,0,186,80
675,21,2,5,3,10,21,55,7,5,207,135
675,22,4,4,5,8,41,44,8,9,248,179
675,23,3,3,4,9,31,-64,9,5,279,115
675,24,3,3,7,6,-66,33,3,8,213,148
675,25,4,2,10,3,46,21,9,9,259,169
675,26,5,2,10,3,-45,-79,4,0,214,90
675,27,3,4,6,7,33,43,7,3,247,133
675,28,5,2,10,3,-45,21,2,4,202,154
675,29,3,4,6,7,33,43,5,7,235,197
675,30,2,5,5,8,23,-47,8,0,258,150
675,31,4,3,8,5,-56,32,2,2,202,182
675,32,2,5,2,11,20,56,2,8,222,238
675,33,2,4,4,9,22,-55,4,3,244,183
675,34,3,3,8,5,35,32,9,5,279,215
675,35,4,3,6,7,-58,34,1,9,221,249
675,36,3,3,5,8,32,-65,3,4,253,184
675,37,4,2,8,5,44,23,7,7,297,207
675,38,5,2,11,2,-44,20,3,7,253,227
675,39,2,4,5,8,23,-56,6,1,276,171
675,40,5,2,6,7,51,25,7,6,327,196
675,41,4,3,8,5,-56,32,1,8,271,228
675,42,3,3,7,6,34,-67,5,1,305,161
675,43,2,5,6,7,24,52,9,3,329,213
675,44,5,2,8,5,-47,23,2,6,282,236
675,45,4,2,9,4,45,22,7,8,327,258
675,46,4,3,9,4,-55,31,2,9,272,289
675,47,3,3,7,6,34,-67,6,2,306,222
675,48,3,4,8,5,-65,41,1,3,241,263
675,49,3,3,5,8,32,35,3,8,273,298
675,50,3,4,5,8,32,-56,5,2,305,242
675,51,4,3,5,8,41,35,6,7,346,277
675,52,3,4,6,7,33,-57,9,0,379,220
675,53,4,2,10,3,-54,21,5,1,325,241
675,54,3,4,7,6,34,42,9,3,359,283
675,55,2,5,6,7,-76,52,3,5,283,335
675,56,3,4,6,7,33,43,6,8,316,378
675,57,3,3,9,4,-64,31,2,9,252,409
675,58,4,2,8,5,44,-77,6,2,296,332
675,59,4,3,9,4,-55,31,1,3,241,363
675,60,3,3,6,7,33,34,4,7,274,397
675,61,3,3,8,5,35,32,9,9,309,429
675,62,5,2,8,5,-47,-77,2,2,262,352
675,63,5,2,10,3,55,21,7,3,317,373
675,64,4,2,8,5,-56,23,1,6,261,396
675,65,3,3,5,8,32,-65,3,1,293,331
675,66,3,3,7,6,34,33,7,4,327,364
675,67,5,3,9,4,-46,31,1,5,281,395
675,68,3,3,7,6,34,33,5,8,315,428
675,69,3,3,8,5,-65,-68,0,0,250,360
675,70,4,2,7,6,43,24,3,4,293,384
675,71,2,4,5,8,23,44,6,8,316,428
675,72,3,4,7,6,-66,-58,0,0,250,370
675,73,4,2,7,6,43,24,3,4,293,394
675,74,4,2,9,4,45,22,8,6,338,416
675,75,4,3,9,4,-55,31,3,7,283,447
675,76,2,5,3,10,21,-45,4,2,304,402
675,77,2,4,6,7,24,43,8,5,328,445
675,78,2,5,4,9,-78,54,0,9,250,499
675,79,3,5,6,7,33,-48,3,1,283,451
675,80,5,2,6,7,51,25,4,6,334,476
675,81,3,4,6,7,33,43,7,9,367,519
676,1,5,2,8,5,53,23,3,3,53,23
676,2,5,2,10,3,55,21,8,4,108,44
676,3,2,4,4,9,-78,45,0,9,30,89
676,4,3,4,6,7,33,-57,3,2,63,32
676,5,3,3,4,9,31,36,4,8,94,68
676,6,4,2,5,8,41,-74,5,4,135,-6
676,7,4,2,9,4,-55,22,0,6,80,16
676,8,3,4,5,8,32,-56,2,0,112,-40
676,9,3,3,5,8,32,35,4,5,144,-5
676,10,4,2,8,5,44,23,8,8,188,18
676,11,4,2,10,3,-54,21,4,9,134,39
676,12,4,3,9,4,45,-69,9,0,179,-30
676,13,3,4,7,6,-66,42,3,2,113,12
676,14,5,2,9,4,54,22,7,4,167,34
676,15,4,2,8,5,-56,23,1,7,111,57
676,16,3,3,4,9,31,-64,2,3,142,-7
676,17,5,2,8,5,53,23,5,6,195,16
676,18,3,3,7,6,34,33,9,9,229,49
676,19,2,4,6,7,-76,-57,3,2,153,-8
676,20,4,4,7,6,43,42,6,4,196,34
676,21,3,4,4,9,31,45,7,9,227,79
676,22,3,3,7,6,-66,-67,1,2,161,12
676,23,3,3,5,8,32,35,3,7,193,47
676,24,5,2,10,3,55,21,8,8,248,68
676,25,3,4,8,5,-65,41,3,9,183,109
676,26,2,4,6,7,24,-57,7,2,207,52
676,27,4,4,5,8,41,44,8,6,248,96
676,28,3,3,5,8,-68,-65,0,1,180,31
676,29,4,3,8,5,44,32,4,3,224,63
676,30,2,5,3,10,21,55,5,8,245,118
676,31,4,2,11,2,-53,20,2,8,192,138
676,32,4,2,8,5,44,-77,6,1,236,61
676,33,2,4,5,8,23,44,9,5,259,105
676,34,4,3,10,3,-54,30,5,5,205,135
676,35,3,4,5,8,32,44,7,9,237,179
676,36,3,3,4,9,31,-64,8,5,268,115
676,37,4,2,9,4,-55,22,3,7,213,137
676,38,3,3,9,4,36,31,9,8,249,168
676,39,4,4,7,6,-57,-58,2,0,192,110
676,40,3,4,7,6,34,42,6,2,226,152
676,41,2,4,5,8,23,44,9,6,249,196
676,42,3,4,9,4,-64,40,5,6,185,236
676,43,2,4,5,8,23,-56,8,0,208,180
676,44,4,3,9,4,-55,31,3,1,153,211
676,45,3,3,9,4,36,31,9,2,189,242
676,46,5,2,9,4,-46,22,3,4,143,264
676,47,2,4,5,8,23,44,6,8,166,308
676,48,3,3,6,7,33,-66,9,2,199,242
676,49,4,3,8,5,-56,32,3,4,143,274
676,50,2,5,4,9,22,54,5,8,165,328
676,51,3,4,4,9,31,-55,6,3,196,273
676,52,4,3,7,6,43,33,9,6,239,306
676,53,3,5,5,8,-68,53,1,9,171,359
676,54,5,2,10,3,55,-79,6,0,226,280
676,55,3,4,7,6,-66,42,0,2,160,322
676,56,3,3,5,8,32,35,2,7,192,357
676,57,3,4,6,7,33,-57,5,0,225,300
676,58,2,4,3,10,21,46,6,6,246,346
676,59,2,5,4,9,22,-46,8,0,268,300
676,60,3,4,8,5,-65,41,3,1,203,341
676,61,2,5,6,7,24,52,7,3,227,393
676,62,3,4,5,8,32,44,9,7,259,437
676,63,5,2,9,4,-46,22,3,9,213,459
676,64,5,2,7,6,52,-76,5,3,265,383
676,65,5,3,7,6,52,33,7,6,317,416
676,66,2,4,7,6,-75,42,2,8,242,458
676,67,4,3,7,6,43,-67,5,1,285,391
676,68,4,4,7,6,43,42,8,3,328,433
676,69,4,2,9,4,-55,22,3,5,273,455
676,70,3,3,6,7,33,34,6,9,306,489
676,71,3,4,4,9,31,-55,7,4,337,434
676,72,2,4,5,8,-77,44,0,8,260,478
676,73,2,4,5,8,23,-56,3,2,283,422
676,74,4,3,6,7,42,34,5,6,325,456
676,75,4,3,8,5,44,32,9,8,369,488
676,76,3,4,3,10,30,-54,9,4,399,434
676,77,3,4,5,8,-68,44,1,8,331,478
676,78,3,3,9,4,36,31,7,9,367,509
677,1,3,4,6,7,33,43,3,3,33,43
677,2,4,3,7,6,43,33,6,6,76,76
677,3,3,3,7,6,-66,33,0,9,10,109
677,4,3,4,4,9,31,-55,1,4,41,54
677,5,2,4,3,10,21,-54,2,0,62,0
677,6,2,5,4,9,22,54,4,4,84,54
677,7,2,4,5,8,23,44,7,8,107,98
677,8,4,3,8,5,-56,-68,1,0,51,30
677,9,3,3,7,6,34,33,5,3,85,63
677,10,4,2,8,5,44,23,9,6,129,86
677,11,2,5,3,10,-79,-45,0,1,50,41
677,12,3,4,6,7,33,43,3,4,83,84
677,13,2,4,5,8,23,44,6,8,106,128
677,14,5,2,8,5,53,-77,9,1,159,51
677,15,3,4,6,7,-67,43,2,4,92,94
677,16,4,2,9,4,45,22,7,6,137,116
677,17,2,5,5,8,-77,53,0,9,60,169
677,18,6,2,11,2,65,20,5,9,125,189
677,19,3,4,3,10,30,-54,5,5,155,135
677,20,3,4,4,9,31,-55,6,0,186,80
677,21,4,2,9,4,-55,22,1,2,131,102
677,22,4,2,6,7,42,25,3,7,173,127
677,23,4,2,4,9,40,-73,3,4,213,54
677,24,4,2,6,7,42,25,5,9,255,79
677,25,2,5,5,8,23,-47,8,2,278,32
677,26,3,4,7,6,-66,42,2,4,212,74
677,27,3,3,6,7,33,34,5,8,245,108
677,28,4,3,9,4,-55,31,0,9,190,139
677,29,2,6,4,9,22,-37,2,2,212,102
677,30,6,2,10,3,64,21,6,3,276,123
677,31,4,3,7,6,43,33,9,6,319,156
677,32,4,3,6,7,-58,-66,1,0,261,90
677,33,3,3,5,8,32,35,3,5,293,125
677,34,4,2,8,5,44,23,7,8,337,148
677,35,3,4,5,8,32,-56,9,2,369,92
677,36,3,3,7,6,-66,33,3,5,303,125
677,37,4,2,11,2,-53,20,0,5,250,145
677,38,4,4,8,5,44,41,4,6,294,186
677,39,3,4,7,6,34,42,8,8,328,228
677,40,3,3,5,8,-68,-65,0,3,260,163
677,41,2,4,8,5,26,41,6,4,286,204
677,42,4,3,6,7,42,34,8,8,328,238
677,43,4,3,10,3,-54,30,4,8,274,268
677,44,5,2,10,3,55,21,9,9,329,289
677,45,4,3,6,7,-58,-66,1,3,271,223
677,46,5,2,11,2,56,20,7,3,327,243
677,47,5,2,7,6,52,24,9,7,379,267
677,48,3,3,5,8,-68,-65,1,2,311,202
677,49,4,3,8,5,44,32,5,4,355,234
677,50,4,3,5,8,41,35,6,9,396,269
677,51,2,4,4,9,22,-55,8,4,418,214
677,52,2,5,5,8,-77,53,1,7,341,267
677,53,2,5,6,7,24,52,5,9,365,319
677,54,2,5,4,9,22,-46,7,3,387,273
677,55,3,3,4,9,31,36,8,9,418,309
677,56,3,4,7,6,-66,-58,2,1,352,251
677,57,3,3,8,5,35,32,7,3,387,283
677,58,2,6,2,11,20,65,7,8,407,348
677,59,2,4,7,6,-75,-58,2,0,332,290
677,60,3,4,4,9,31,45,3,5,363,335
677,61,3,4,5,8,32,44,5,9,395,379
677,62,3,4,5,8,32,-56,7,3,427,323
677,63,3,5,3,10,30,55,7,8,457,378
677,64,4,2,6,7,42,-75,9,3,499,303
677,65,4,3,6,7,-58,34,1,7,441,337
677,66,3,4,7,6,34,42,5,9,475,379
677,67,2,4,5,8,23,-56,8,3,498,323
677,68,4,2,8,5,-56,23,2,6,442,346
677,69,2,4,5,8,23,-56,5,0,465,290
677,70,3,4,5,8,32,44,7,4,497,334
677,71,3,4,5,8,32,44,9,8,529,378
678,1,3,3,7,6,34,33,4,3,34,33
678,2,3,4,4,9,31,45,5,8,65,78
678,3,4,3,9,4,-55,31,0,9,10,109
678,4,4,2,6,7,42,-75,2,4,52,34
678,5,4,3,5,8,41,35,3,9,93,69
678,6,4,3,7,6,43,-67,6,2,136,2
678,7,4,3,7,6,43,33,9,5,179,35
678,8,3,3,8,5,-65,32,4,7,114,67
678,9,3,3,4,9,31,-64,5,3,145,3
678,10,5,2,11,2,-44,20,1,3,101,23
678,11,2,4,4,9,22,45,3,8,123,68
678,12,3,4,5,8,32,-56,5,2,155,12
678,13,3,3,10,3,-63,30,2,2,92,42
678,14,4,3,9,4,45,31,7,3,137,73
678,15,4,2,6,7,42,25,9,8,179,98
678,16,4,3,8,5,-56,-68,3,0,123,30
678,17,3,4,8,5,35,41,8,1,158,71
678,18,3,4,7,6,-66,42,2,3,92,113
678,19,2,4,6,7,24,43,6,6,116,156
678,20,2,4,5,8,23,-56,9,0,139,100
678,21,3,3,7,6,-66,33,3,3,73,133
678,22,3,4,7,6,34,42,7,5,107,175
678,23,2,5,3,10,21,-45,8,0,128,130
678,24,2,4,6,7,-76,43,2,3,52,173
678,25,2,4,2,11,20,-53,2,0,72,120
678,26,2,5,5,8,23,53,5,3,95,173
678,27,4,2,10,3,-54,21,1,4,41,194
678,28,2,4,6,7,24,43,5,7,65,237
678,29,4,3,5,8,41,-65,6,2,106,172
678,30,2,5,5,8,23,53,9,5,129,225
678,31,4,2,10,3,-54,21,5,6,75,246
678,32,6,2,11,2,-35,20,0,6,40,266
678,33,3,4,6,7,33,43,3,9,73,309
678,34,2,5,4,9,22,-46,5,3,95,263
678,35,3,3,4,9,31,36,6,9,126,299
678,36,3,4,5,8,32,-56,8,3,158,243
678,37,5,2,8,5,-47,23,1,6,111,266
678,38,3,3,8,5,35,32,6,8,146,298
678,39,3,4,6,7,33,-57,9,1,179,241
678,40,4,2,9,4,-55,22,4,3,124,263
678,41,3,4,4,9,31,45,5,8,155,308
678,42,2,4,4,9,22,-55,7,3,177,253
678,43,4,3,7,6,-57,33,0,6,120,286
678,44,3,4,5,8,32,-56,2,0,152,230
678,45,4,2,8,5,44,23,6,3,196,253
678,46,3,3,5,8,32,35,8,8,228,288
678,47,3,3,9,4,-64,31,4,9,164,319
678,48,4,3,7,6,43,-67,7,2,207,252
678,49,4,2,8,5,-56,23,1,5,151,275
678,50,3,3,4,9,31,-64,2,1,182,211
678,51,3,3,8,5,35,32,7,3,217,243
678,52,3,4,9,4,-64,40,3,3,153,283
678,53,4,3,10,3,46,30,9,3,199,313
678,54,3,3,5,8,-68,35,1,8,131,348
678,55,2,5,5,8,23,-47,4,1,154,301
678,56,3,4,8,5,35,41,9,2,189,342
678,57,4,3,8,5,-56,32,3,4,133,374
678,58,4,3,6,7,42,34,5,8,175,408
678,59,2,4,5,8,23,-56,8,2,198,352
678,60,2,4,6,7,-76,43,2,5,122,395
678,61,3,3,5,8,32,-65,4,0,154,330
678,62,3,3,7,6,34,33,8,3,188,363
678,63,2,5,2,11,20,56,8,9,208,419
678,64,3,3,6,7,-67,-66,1,3,141,353
678,65,3,3,7,6,34,33,5,6,175,386
678,66,3,4,9,4,-64,40,1,6,111,426
678,67,5,2,9,4,54,22,5,8,165,448
678,68,2,5,4,9,22,-46,7,2,187,402
678,69,2,4,3,10,21,46,8,8,208,448
678,70,3,3,6,7,-67,-66,1,2,141,382
678,71,2,4,5,8,23,44,4,6,164,426
678,72,2,5,5,8,23,53,7,9,187,479
678,73,4,3,8,5,-56,-68,1,1,131,411
678,74,5,2,10,3,55,21,6,2,186,432
678,75,3,3,7,6,-66,33,0,5,120,465
678,76,4,3,9,4,45,31,5,6,165,496
678,77,2,5,4,9,22,-46,7,0,187,450
678,78,3,4,6,7,-67,43,0,3,120,493
678,79,4,3,5,8,41,35,1,8,161,528
679,1,3,4,5,8,32,44,2,4,32,44
679,2,3,4,8,5,35,41,7,5,67,85
679,3,4,2,8,5,-56,23,1,8,11,108
679,4,4,3,5,8,41,-65,2,3,52,43
679,5,5,2,11,2,56,20,8,3,108,63
679,6,5,2,11,2,-44,20,4,3,64,83
679,7,4,3,9,4,45,31,9,4,109,114
679,8,3,3,7,6,-66,33,3,7,43,147
679,9,4,3,7,6,43,-67,6,0,86,80
679,10,2,4,5,8,23,44,9,4,109,124
679,11,5,2,10,3,-45,21,4,5,64,145
679,12,4,3,5,8,41,-65,5,0,105,80
679,13,5,2,8,5,53,23,8,3,158,103
679,14,3,3,9,4,-64,31,4,4,94,134
679,15,3,3,5,8,32,35,6,9,126,169
679,16,4,2,6,7,42,-75,8,4,168,94
679,17,4,3,4,9,40,-64,8,0,208,30
679,18,3,4,8,5,-65,41,3,1,143,71
679,19,3,3,9,4,36,31,9,2,179,102
679,20,5,3,9,4,-46,31,3,3,133,133
679,21,4,2,10,3,46,21,9,4,179,154
679,22,3,4,7,6,-66,42,3,6,113,196
679,23,4,2,6,7,42,-75,5,1,155,121
679,24,3,3,6,7,33,34,8,5,188,155
679,25,4,3,9,4,-55,31,3,6,133,186
679,26,2,4,2,11,20,-53,3,3,153,133
679,27,2,4,2,11,20,-53,3,0,173,80
679,28,2,4,7,6,25,42,8,2,198,122
679,29,4,3,8,5,-56,32,2,4,142,154
679,30,3,3,5,8,32,35,4,9,174,189
679,31,4,2,7,6,43,-76,7,3,217,113
679,32,3,4,5,8,32,44,9,7,249,157
679,33,6,2,10,3,-36,21,3,8,213,178
679,34,6,2,9,4,63,-78,6,0,276,100
679,35,4,3,10,3,-54,30,2,0,222,130
679,36,2,5,3,10,21,55,3,5,243,185
679,37,3,4,3,10,30,-54,3,1,273,131
679,38,3,3,8,5,35,32,8,3,308,163
679,39,2,4,2,11,20,-53,8,0,328,110
679,40,4,2,9,4,-55,22,3,2,273,132
679,41,2,5,3,10,21,55,4,7,294,187
679,42,2,5,5,8,23,-47,7,0,317,140
679,43,3,3,8,5,-65,32,2,2,252,172
679,44,3,4,7,6,34,42,6,4,286,214
679,45,2,4,4,9,22,45,8,9,308,259
679,46,4,2,9,4,-55,-78,3,1,253,181
679,47,3,3,7,6,34,33,7,4,287,214
679,48,3,3,7,6,-66,33,1,7,221,247
679,49,3,4,8,5,35,41,6,8,256,288
679,50,2,6,3,10,21,-36,7,2,277,252
679,51,2,5,4,9,22,54,9,6,299,306
679,52,4,2,7,6,-57,-76,2,0,242,230
679,53,3,4,5,8,32,44,4,4,274,274
679,54,4,3,6,7,42,34,6,8,316,308
679,55,4,3,8,5,-56,-68,0,0,260,240
679,56,4,4,5,8,41,44,1,4,301,284
679,57,3,3,6,7,33,34,4,8,334,318
679,58,4,2,8,5,44,-77,8,1,378,241
679,59,3,3,8,5,-65,32,3,3,313,273
679,60,4,4,4,9,40,45,3,8,353,318
679,61,3,4,6,7,33,-57,6,1,386,261
679,62,5,3,8,5,53,32,9,3,439,293
679,63,4,3,7,6,-57,33,2,6,382,326
679,64,3,3,5,8,32,-65,4,1,414,261
679,65,3,4,7,6,34,42,8,3,448,303
679,66,2,4,8,5,-74,41,4,4,374,344
679,67,4,4,6,7,42,43,6,7,416,387
679,68,4,4,9,4,-55,40,1,7,361,427
679,69,6,2,10,3,64,21,5,8,425,448
679,70,3,3,6,7,33,-66,8,2,458,382
679,71,4,3,10,3,-54,30,4,2,404,412
679,72,3,3,4,9,31,36,5,8,435,448
679,73,3,4,7,6,34,-58,9,0,469,390
679,74,4,2,9,4,-55,22,4,2,414,412
679,75,3,3,6,7,33,34,7,6,447,446
679,76,3,4,5,8,32,-56,9,0,479,390
679,77,3,3,5,8,-68,35,1,5,411,425
679,78,2,6,2,11,20,-35,1,0,431,390
679,79,2,5,5,8,23,53,4,3,454,443
679,80,4,3,8,5,44,32,8,5,498,475
679,81,3,3,6,7,-67,34,1,9,431,509
680,1,3,4,8,5,35,41,5,1,35,41
680,2,3,3,6,7,33,34,8,5,68,75
680,3,5,2,9,4,-46,22,2,7,22,97
680,4,2,4,6,7,24,-57,6,0,46,40
680,5,2,4,8,5,-74,41,2,1,-28,81
680,6,4,2,6,7,42,25,4,6,14,106
680,7,3,3,8,5,35,32,9,8,49,138
680,8,3,4,5,8,-68,-56,1,2,-19,82
680,9,4,3,9,4,45,31,6,3,26,113
680,10,3,3,7,6,-66,33,0,6,-40,146
680,11,3,4,8,5,35,41,5,7,-5,187
680,12,5,2,11,2,-44,20,1,7,-49,207
680,13,2,5,4,9,22,-46,3,1,-27,161
680,14,4,2,6,7,42,25,5,6,15,186
680,15,3,3,7,6,34,33,9,9,49,219
680,16,5,2,8,5,-47,-77,2,2,2,142
680,17,2,5,5,8,23,53,5,5,25,195
680,18,3,3,7,6,34,33,9,8,59,228
680,19,4,2,8,5,-56,-77,3,1,3,151
680,20,2,5,4,9,22,54,5,5,25,205
680,21,3,3,4,9,31,-64,6,1,56,141
680,22,4,3,8,5,-56,32,0,3,0,173
680,23,4,2,8,5,44,23,4,6,44,196
680,24,5,2,11,2,-44,20,0,6,0,216
680,25,2,4,3,10,21,-54,1,2,21,162
680,26,4,3,7,6,43,33,4,5,64,195
680,27,5,2,7,6,52,24,6,9,116,219
680,28,2,4,5,8,23,-56,9,3,139,163
680,29,6,2,9,4,-37,22,2,5,102,185
680,30,2,5,7,6,25,51,7,6,127,236
680,31,3,3,7,6,-66,33,1,9,61,269
680,32,4,3,7,6,43,-67,4,2,104,202
680,33,3,3,8,5,35,32,9,4,139,234
680,34,6,2,9,4,-37,22,2,6,102,256
680,35,2,4,6,7,24,43,6,9,126,299
680,36,3,3,6,7,33,-66,9,3,159,233
680,37,4,3,4,9,40,36,9,9,199,269
680,38,4,2,7,6,-57,-76,2,3,142,193
680,39,4,2,7,6,43,24,5,7,185,217
680,40,3,3,5,8,32,-65,7,2,217,152
680,41,2,4,6,7,-76,43,1,5,141,195
680,42,5,2,9,4,54,22,5,7,195,217
680,43,4,2,6,7,42,-75,7,2,237,142
680,44,3,3,7,6,-66,33,1,5,171,175
680,45,4,2,9,4,45,22,6,7,216,197
680,46,5,2,10,3,-45,21,1,8,171,218
680,47,3,3,8,5,35,-68,6,0,206,150
680,48,3,3,6,7,33,34,9,4,239,184
680,49,4,2,6,7,-58,25,1,9,181,209
680,50,4,2,10,3,46,-79,7,0,227,130
680,51,2,4,6,7,-76,43,1,3,151,173
680,52,3,4,6,7,33,43,4,6,184,216
680,53,3,3,8,5,35,32,9,8,219,248
680,54,3,3,7,6,-66,-67,3,1,153,181
680,55,3,4,5,8,32,44,5,5,185,225
680,56,3,3,8,5,-65,32,0,7,120,257
680,57,2,5,6,7,24,52,4,9,144,309
680,58,4,3,9,4,45,-69,9,0,189,240
680,59,3,4,8,5,-65,41,4,1,124,281
680,60,3,4,4,9,31,45,5,6,155,326
680,61,3,3,8,5,-65,32,0,8,90,358
680,62,4,2,6,7,42,-75,2,3,132,283
680,63,4,2,9,4,45,22,7,5,177,305
680,64,4,2,7,6,-57,24,0,9,120,329
680,65,4,3,5,8,41,-65,1,4,161,264
680,66,2,5,4,9,22,54,3,8,183,318
680,67,2,4,6,7,24,-57,7,1,207,261
680,68,3,3,7,6,-66,33,1,4,141,294
680,69,5,2,10,3,55,21,6,5,196,315
680,70,5,2,9,4,-46,22,0,7,150,337
680,71,2,5,3,10,21,-45,1,2,171,292
680,72,2,5,3,10,21,55,2,7,192,347
680,73,5,3,6,7,51,-66,3,1,243,281
680,74,6,2,11,2,65,20,8,1,308,301
680,75,5,2,9,4,-46,22,2,3,262,323
680,76,4,3,6,7,42,34,4,7,304,357
680,77,3,3,6,7,33,-66,7,1,337,291
680,78,4,3,8,5,-56,32,1,3,281,323
680,79,3,3,5,8,32,35,3,8,313,358
680,80,3,5,5,8,32,-47,5,1,345,311
680,81,4,3,6,7,42,34,7,5,387,345
680,82,5,2,10,3,-45,21,2,6,342,366
680,83,4,3,7,6,43,33,5,9,385,399
680,84,3,4,6,7,33,-57,8,2,418,342
680,85,2,4,5,8,-77,44,1,6,341,386
680,86,4,3,8,5,44,32,5,8,385,418
680,87,5,2,6,7,51,-75,6,3,436,343
680,88,2,4,6,7,-76,43,0,6,360,386
680,89,3,4,6,7,33,43,3,9,393,429
680,90,3,4,4,9,31,-55,4,4,424,374
680,91,2,5,4,9,22,54,6,8,446,428
680,92,3,4,4,9,31,-55,7,3,477,373
680,93,5,2,8,5,-47,23,0,6,430,396
680,94,3,3,8,5,35,32,5,8,465,428
680,95,3,4,6,7,33,-57,8,1,498,371
680,96,5,2,10,3,-45,21,3,2,453,392
680,97,3,4,9,4,36,40,9,2,489,432
680,98,4,3,5,8,-59,35,0,7,430,467
680,99,2,4,3,10,21,-54,1,3,451,413
680,100,3,3,5,8,32,35,3,8,483,448
680,101,3,4,7,6,34,-58,7,0,517,390
681,1,5,2,10,3,55,21,5,1,55,21
681,2,5,2,10,3,-45,21,0,2,10,42
681,3,2,4,5,8,23,44,3,6,33,86
681,4,5,3,8,5,53,32,6,8,86,118
681,5,5,2,7,6,52,-76,8,2,138,42
681,6,3,4,4,9,31,45,9,7,169,87
681,7,4,3,8,5,-56,32,3,9,113,119
681,8,4,2,8,5,44,-77,7,2,157,42
681,9,3,3,6,7,-67,34,0,6,90,76
681,10,3,3,3,10,30,-63,0,3,120,13
681,11,3,4,6,7,33,43,3,6,153,56
681,12,4,3,8,5,44,32,7,8,197,88
681,13,2,6,2,11,20,-35,7,3,217,53
681,14,4,2,9,4,-55,22,2,5,162,75
681,15,4,3,9,4,45,31,7,6,207,106
681,16,3,4,3,10,30,-54,7,2,237,52
681,17,5,2,8,5,-47,23,0,5,190,75
681,18,3,3,7,6,34,33,4,8,224,108
681,19,2,4,7,6,25,-58,9,0,249,50
681,20,3,3,6,7,-67,34,2,4,182,84
681,21,4,3,9,4,45,31,7,5,227,115
681,22,4,3,6,7,42,34,9,9,269,149
681,23,2,5,6,7,-76,-48,3,1,193,101
681,24,4,3,8,5,44,32,7,3,237,133
681,25,3,3,5,8,32,35,9,8,269,168
681,26,5,2,11,2,-44,20,5,8,225,188
681,27,4,4,6,7,42,-57,7,1,267,131
681,28,3,4,8,5,-65,41,2,2,202,172
681,29,2,5,3,10,21,55,3,7,223,227
681,30,3,5,3,10,30,-45,3,2,253,182
681,31,4,3,9,4,45,31,8,3,298,213
681,32,5,2,10,3,-45,21,3,4,253,234
681,33,5,2,8,5,53,23,6,7,306,257
681,34,4,3,5,8,41,-65,7,2,347,192
681,35,3,3,7,6,-66,33,1,5,281,225
681,36,3,3,6,7,33,34,4,9,314,259
681,37,3,3,7,6,34,-67,8,2,348,192
681,38,3,4,8,5,-65,41,3,3,283,233
681,39,5,2,9,4,54,22,7,5,337,255
681,40,2,5,4,9,22,54,9,9,359,309
681,41,5,2,10,3,-45,-79,4,0,314,230
681,42,2,4,5,8,23,44,7,4,337,274
681,43,5,2,9,4,-46,22,1,6,291,296
681,44,4,2,6,7,42,-75,3,1,333,221
681,45,3,4,5,8,32,44,5,5,365,265
681,46,3,4,3,10,30,-54,5,1,395,211
681,47,3,4,7,6,34,42,9,3,429,253
681,48,5,3,6,7,-49,34,0,7,380,287
681,49,3,4,8,5,35,41,5,8,415,328
681,50,3,3,10,3,-63,30,2,8,352,358
681,51,4,2,9,4,45,-78,7,0,397,280
681,52,4,2,7,6,-57,24,0,4,340,304
681,53,4,2,9,4,45,22,5,6,385,326
681,54,3,3,4,9,31,-64,6,2,416,262
681,55,2,5,7,6,-75,51,1,3,341,313
681,56,3,4,5,8,32,44,3,7,373,357
681,57,3,4,7,6,34,42,7,9,407,399
681,58,4,2,6,7,42,-75,9,4,449,324
681,59,5,2,9,4,-46,22,3,6,403,346
681,60,3,4,5,8,32,-56,5,0,435,290
681,61,4,3,7,6,43,33,8,3,478,323
681,62,5,2,8,5,-47,23,1,6,431,346
681,63,4,4,7,6,43,42,4,8,474,388
681,64,5,2,7,6,52,-76,6,2,526,312
682,1,2,5,4,9,22,54,2,4,22,54
682,2,2,5,3,10,21,55,3,9,43,109
682,3,2,5,4,9,22,-46,5,3,65,63
682,4,4,3,9,4,-55,31,0,4,10,94
682,5,3,3,5,8,32,35,2,9,42,129
682,6,3,4,6,7,33,-57,5,2,75,72
682,7,2,4,8,5,-74,41,1,3,1,113
682,8,3,3,7,6,34,33,5,6,35,146
682,9,4,2,9,4,-55,22,0,8,-20,168
682,10,2,4,4,9,22,-55,2,3,2,113
682,11,4,3,6,7,42,34,4,7,44,147
682,12,4,2,7,6,43,-76,7,1,87,71
682,13,4,3,5,8,41,35,8,6,128,106
682,14,3,4,4,9,31,-55,9,1,159,51
682,15,2,5,3,10,-79,55,0,6,80,106
682,16,2,4,4,9,22,-55,2,1,102,51
682,17,3,3,5,8,32,35,4,6,134,86
682,18,4,3,6,7,42,-66,6,0,176,20
682,19,3,3,9,4,-64,31,2,1,112,51
682,20,3,4,7,6,34,42,6,3,146,93
682,21,4,2,7,6,43,24,9,7,189,117
682,22,3,3,7,6,-66,-67,3,0,123,50
682,23,4,2,10,3,46,21,9,1,169,71
682,24,3,4,3,10,30,46,9,7,199,117
682,25,3,4,7,6,-66,42,3,9,133,159
682,26,2,5,2,11,20,-44,3,5,153,115
682,27,4,2,7,6,43,24,6,9,196,139
682,28,3,3,8,5,-65,-68,1,1,131,71
682,29,4,3,7,6,43,33,4,4,174,104
682,30,4,2,10,3,-54,21,0,5,120,125
682,31,3,3,7,6,34,33,4,8,154,158
682,32,3,4,4,9,31,-55,5,3,185,103
682,33,3,4,6,7,33,43,8,6,218,146
682,34,3,3,5,8,-68,-65,0,1,150,81
682,35,3,3,6,7,33,34,3,5,183,115
682,36,5,2,10,3,55,21,8,6,238,136
682,37,2,4,5,8,-77,-56,1,0,161,80
682,38,4,3,7,6,43,33,4,3,204,113
682,39,4,2,8,5,44,23,8,6,248,136
682,40,2,5,3,10,21,-45,9,1,269,91
682,41,3,3,5,8,-68,35,1,6,201,126
682,42,3,3,10,3,37,30,8,6,238,156
682,43,2,5,6,7,-76,52,2,8,162,208
682,44,3,4,6,7,33,-57,5,1,195,151
682,45,3,3,4,9,31,36,6,7,226,187
682,46,3,4,4,9,31,-55,7,2,257,132
682,47,3,4,8,5,-65,41,2,3,192,173
682,48,2,5,5,8,23,53,5,6,215,226
682,49,4,2,7,6,43,-76,8,0,258,150
682,50,4,2,11,2,-53,20,5,0,205,170
682,51,2,5,3,10,21,55,6,5,226,225
682,52,3,4,6,7,33,43,9,8,259,268
682,53,3,3,4,9,-69,-64,0,4,190,204
682,54,3,3,5,8,32,35,2,9,222,239
682,55,3,4,5,8,32,-56,4,3,254,183
682,56,3,5,5,8,32,53,6,6,286,236
682,57,5,2,10,3,-45,21,1,7,241,257
682,58,4,3,5,8,41,-65,2,2,282,192
682,59,4,2,6,7,42,25,4,7,324,217
682,60,4,3,6,7,42,-66,6,1,366,151
682,61,3,3,10,3,-63,30,3,1,303,181
682,62,2,4,2,11,20,47,3,8,323,228
682,63,3,4,4,9,31,-55,4,3,354,173
682,64,3,3,3,10,30,-63,4,0,384,110
682,65,3,3,5,8,32,35,6,5,416,145
682,66,3,4,8,5,-65,41,1,6,351,186
682,67,3,3,8,5,35,32,6,8,386,218
682,68,2,6,5,8,23,-38,9,0,409,180
682,69,2,5,4,9,-78,54,1,4,331,234
682,70,4,3,9,4,45,31,6,5,376,265
682,71,4,2,8,5,-56,23,0,8,320,288
682,72,2,4,6,7,24,-57,4,1,344,231
682,73,4,2,8,5,44,23,8,4,388,254
682,74,3,3,8,5,-65,32,3,6,323,286
682,75,4,3,6,7,42,-66,5,0,365,220
682,76,3,4,5,8,32,44,7,4,397,264
682,77,6,2,11,2,-35,20,2,4,362,284
682,78,3,4,7,6,34,42,6,6,396,326
682,79,4,2,9,4,-55,22,1,8,341,348
682,80,2,5,3,10,21,-45,2,3,362,303
682,81,4,2,8,5,44,23,6,6,406,326
682,82,3,3,7,6,-66,33,0,9,340,359
682,83,4,3,6,7,42,-66,2,3,382,293
682,84,2,4,6,7,24,43,6,6,406,336
682,85,3,3,9,4,-64,31,2,7,342,367
682,86,5,2,9,4,54,22,6,9,396,389
682,87,5,3,8,5,53,-68,9,1,449,321
682,88,3,4,7,6,-66,42,3,3,383,363
682,89,5,2,8,5,53,23,6,6,436,386
682,90,3,4,6,7,33,43,9,9,469,429
682,91,2,4,5,8,-77,-56,2,3,392,373
682,92,3,4,5,8,32,44,4,7,424,417
682,93,3,3,8,5,35,32,9,9,459,449
682,94,4,2,10,3,-54,-79,5,0,405,370
682,95,4,3,7,6,43,33,8,3,448,403
682,96,4,2,10,3,-54,21,4,4,394,424
682,97,3,4,4,9,31,45,5,9,425,469
682,98,2,5,5,8,23,-47,8,2,448,422
682,99,3,4,5,8,-68,44,0,6,380,466
682,100,5,2,8,5,53,23,3,9,433,489
682,101,4,3,8,5,44,-68,7,1,477,421
682,102,3,4,4,9,31,45,8,6,508,466
683,1,4,2,9,4,45,22,5,2,45,22
683,2,3,3,3,10,30,37,5,9,75,59
683,3,3,4,9,4,-64,40,1,9,11,99
683,4,2,5,4,9,22,-46,3,3,33,53
683,5,2,5,6,7,24,52,7,5,57,105
683,6,2,6,4,9,22,63,9,8,79,168
683,7,4,3,8,5,-56,-68,3,0,23,100
683,8,2,5,3,10,21,55,4,5,44,155
683,9,4,3,6,7,42,34,6,9,86,189
683,10,5,2,10,3,-45,-79,1,0,41,110
683,11,3,3,5,8,32,35,3,5,73,145
683,12,4,2,9,4,45,22,8,7,118,167
683,13,5,2,8,5,-47,-77,1,0,71,90
683,14,3,4,6,7,33,43,4,3,104,133
683,15,3,3,5,8,32,35,6,8,136,168
683,16,4,2,7,6,43,-76,9,2,179,92
683,17,4,3,9,4,-55,31,4,3,124,123
683,18,3,4,4,9,31,45,5,8,155,168
683,19,3,3,7,6,34,-67,9,1,189,101
683,20,4,3,6,7,-58,34,1,5,131,135
683,21,3,3,4,9,31,-64,2,1,162,71
683,22,3,4,6,7,33,43,5,4,195,114
683,23,4,2,8,5,44,23,9,7,239,137
683,24,2,5,4,9,-78,-46,1,1,161,91
683,25,4,4,7,6,43,42,4,3,204,133
683,26,2,4,4,9,22,45,6,8,226,178
683,27,3,3,6,7,33,-66,9,2,259,112
683,28,4,2,8,5,-56,23,3,5,203,135
683,29,3,3,8,5,35,32,8,7,238,167
683,30,2,5,6,7,-76,52,2,9,162,219
683,31,2,5,5,8,23,-47,5,2,185,172
683,32,3,4,4,9,31,45,6,7,216,217
683,33,3,4,7,6,-66,42,0,9,150,259
683,34,4,2,8,5,44,-77,4,2,194,182
683,35,4,3,8,5,44,32,8,4,238,214
683,36,3,4,4,9,31,45,9,9,269,259
683,37,4,2,8,5,-56,-77,3,2,213,182
683,38,3,3,7,6,34,33,7,5,247,215
683,39,3,3,8,5,-65,32,2,7,182,247
683,40,4,2,9,4,45,22,7,9,227,269
683,41,4,3,7,6,-57,-67,0,2,170,202
683,42,4,2,10,3,46,21,6,3,216,223
683,43,3,3,4,9,31,36,7,9,247,259
683,44,4,3,9,4,-55,-69,2,0,192,190
683,45,4,3,8,5,44,32,6,2,236,222
683,46,3,4,6,7,33,43,9,5,269,265
683,47,4,2,5,8,-59,-74,0,1,210,191
683,48,3,3,7,6,34,33,4,4,244,224
683,49,3,4,6,7,33,43,7,7,277,267
683,50,3,3,8,5,-65,32,2,9,212,299
683,51,4,2,6,7,42,-75,4,4,254,224
683,52,3,4,6,7,33,43,7,7,287,267
683,53,4,3,7,6,-57,-67,0,0,230,200
683,54,5,2,9,4,54,22,4,2,284,222
683,55,5,2,9,4,54,22,8,4,338,244
683,56,2,4,6,7,-76,43,2,7,262,287
683,57,4,3,5,8,41,-65,3,2,303,222
683,58,3,4,8,5,35,41,8,3,338,263
683,59,4,3,9,4,-55,31,3,4,283,294
683,60,2,5,6,7,24,52,7,6,307,346
683,61,3,3,5,8,32,-65,9,1,339,281
683,62,2,6,2,11,20,65,9,6,359,346
683,63,4,2,9,4,-55,22,4,8,304,368
683,64,3,3,5,8,32,-65,6,3,336,303
683,65,2,5,6,7,-76,52,0,5,260,355
683,66,2,5,4,9,22,54,2,9,282,409
683,67,4,3,7,6,43,-67,5,2,325,342
683,68,2,5,6,7,24,52,9,4,349,394
683,69,5,2,7,6,-48,24,1,8,301,418
683,70,3,3,5,8,32,-65,3,3,333,353
683,71,4,2,6,7,42,25,5,8,375,378
683,72,3,4,7,6,34,-58,9,0,409,320
683,73,4,3,4,9,40,36,9,6,449,356
683,74,5,2,8,5,-47,23,2,9,402,379
683,75,3,4,9,4,36,40,8,9,438,419
683,76,3,4,5,8,-68,-56,0,3,370,363
683,77,4,2,8,5,44,23,4,6,414,386
683,78,2,4,6,7,24,43,8,9,438,429
683,79,3,4,5,8,-68,-56,0,3,370,373
683,80,4,3,7,6,43,33,3,6,413,406
683,81,3,3,7,6,34,33,7,9,447,439
683,82,4,2,7,6,-57,-76,0,3,390,363
683,83,3,4,6,7,33,43,3,6,423,406
683,84,3,4,5,8,32,-56,5,0,455,350
683,85,3,3,7,6,34,33,9,3,489,383
683,86,4,2,8,5,-56,23,3,6,433,406
683,87,3,4,7,6,34,42,7,8,467,448
683,88,3,4,5,8,32,-56,9,2,499,392
683,89,4,3,9,4,-55,31,4,3,444,423
683,90,5,2,9,4,54,22,8,5,498,445
683,91,5,2,7,6,-48,24,0,9,450,469
683,92,4,2,7,6,43,-76,3,3,493,393
683,93,3,4,9,4,36,40,9,3,529,433
684,1,5,2,9,4,54,22,4,2,54,22
684,2,3,3,4,9,31,36,5,8,85,58
684,3,3,3,8,5,-65,-68,0,0,20,-10
684,4,3,4,4,9,31,45,1,5,51,35
684,5,2,4,5,8,23,44,4,9,74,79
684,6,4,2,10,3,-54,-79,0,0,20,0
684,7,5,2,10,3,55,21,5,1,75,21
684,8,2,4,4,9,22,45,7,6,97,66
684,9,3,3,6,7,-67,-66,0,0,30,0
684,10,5,2,9,4,54,22,4,2,84,22
684,11,2,4,4,9,22,45,6,7,106,67
684,12,4,3,6,7,42,-66,8,1,148,1
684,13,2,4,7,6,-75,42,3,3,73,43
684,14,3,4,8,5,35,41,8,4,108,84
684,15,3,4,4,9,31,45,9,9,139,129
684,16,3,3,6,7,-67,-66,2,3,72,63
684,17,4,3,6,7,42,34,4,7,114,97
684,18,4,2,8,5,44,-77,8,0,158,20
684,19,3,4,6,7,-67,43,1,3,91,63
684,20,3,5,3,10,30,55,1,8,121,118
684,21,4,3,4,9,40,-64,1,4,161,54
684,22,4,3,7,6,43,33,4,7,204,87
684,23,4,3,9,4,45,31,9,8,249,118
684,24,4,2,8,5,-56,-77,3,1,193,41
684,25,3,4,7,6,34,42,7,3,227,83
684,26,2,5,3,10,21,55,8,8,248,138
684,27,4,3,9,4,-55,31,3,9,193,169
684,28,4,3,9,4,45,-69,8,0,238,100
684,29,3,3,10,3,-63,30,5,0,175,130
684,30,3,4,5,8,32,44,7,4,207,174
684,31,2,5,5,8,-77,53,0,7,130,227
684,32,4,2,7,6,43,-76,3,1,173,151
684,33,3,3,6,7,33,34,6,5,206,185
684,34,4,2,10,3,-54,21,2,6,152,206
684,35,2,5,2,11,20,-44,2,2,172,162
684,36,3,3,6,7,33,34,5,6,205,196
684,37,4,3,8,5,44,32,9,8,249,228
684,38,5,2,9,4,-46,-78,3,0,203,150
684,39,4,2,9,4,45,22,8,2,248,172
684,40,3,4,6,7,-67,43,1,5,181,215
684,41,3,3,8,5,35,32,6,7,216,247
684,42,3,3,7,6,-66,-67,0,0,150,180
684,43,2,4,4,9,22,45,2,5,172,225
684,44,2,4,3,10,21,-54,3,1,193,171
684,45,3,4,5,8,32,44,5,5,225,215
684,46,4,2,8,5,44,23,9,8,269,238
684,47,2,5,4,9,-78,-46,1,2,191,192
684,48,3,3,5,8,32,35,3,7,223,227
684,49,4,2,10,3,46,21,9,8,269,248
684,50,3,3,4,9,-69,-64,0,4,200,184
684,51,2,4,5,8,23,44,3,8,223,228
684,52,4,3,7,6,43,-67,6,1,266,161
684,53,4,3,7,6,43,33,9,4,309,194
684,54,3,4,8,5,-65,41,4,5,244,235
684,55,2,5,4,9,22,54,6,9,266,289
684,56,5,2,10,3,-45,-79,1,0,221,210
684,57,2,5,7,6,25,51,6,1,246,261
684,58,2,5,5,8,23,53,9,4,269,314
684,59,5,2,9,4,-46,22,3,6,223,336
684,60,4,2,6,7,42,-75,5,1,265,261
684,61,3,4,5,8,32,44,7,5,297,305
684,62,3,3,8,5,-65,32,2,7,232,337
684,63,4,4,8,5,44,41,6,8,276,378
684,64,4,3,10,3,-54,30,2,8,222,408
684,65,2,5,4,9,22,-46,4,2,244,362
684,66,5,3,7,6,52,33,6,5,296,395
684,67,6,2,11,2,-35,20,1,5,261,415
684,68,5,2,10,3,55,21,6,6,316,436
684,69,3,4,5,8,32,-56,8,0,348,380
684,70,3,3,9,4,-64,31,4,1,284,411
684,71,3,4,4,9,31,45,5,6,315,456
684,72,3,4,7,6,34,42,9,8,349,498
684,73,3,3,4,9,-69,-64,0,4,280,434
684,74,3,3,4,9,31,-64,1,0,311,370
684,75,2,4,2,11,20,47,1,7,331,417
684,76,4,3,8,5,44,32,5,9,375,449
684,77,4,3,6,7,42,-66,7,3,417,383
684,78,5,2,10,3,-45,21,2,4,372,404
684,79,4,3,8,5,44,32,6,6,416,436
684,80,4,3,6,7,42,-66,8,0,458,370
684,81,2,4,2,11,20,47,8,7,478,417
684,82,5,2,8,5,-47,-77,1,0,431,340
684,83,4,3,10,3,46,30,7,0,477,370
684,84,5,3,9,4,-46,31,1,1,431,401
684,85,4,2,6,7,42,25,3,6,473,426
684,86,5,2,10,3,55,21,8,7,528,447
685,1,4,2,8,5,44,23,4,3,44,23
685,2,4,2,9,4,45,22,9,5,89,45
685,3,3,4,7,6,-66,42,3,7,23,87
685,4,3,3,6,7,33,-66,6,1,56,21
685,5,3,3,8,5,-65,32,1,3,-9,53
685,6,4,3,7,6,43,33,4,6,34,86
685,7,4,3,7,6,43,33,7,9,77,119
685,8,3,3,9,4,-64,-69,3,0,13,50
685,9,4,2,6,7,42,25,5,5,55,75
685,10,4,3,9,4,-55,31,0,6,0,106
685,11,3,3,6,7,33,-66,3,0,33,40
685,12,4,3,9,4,45,31,8,1,78,71
685,13,2,5,3,10,21,55,9,6,99,126
685,14,5,2,7,6,-48,-76,1,0,51,50
685,15,4,3,7,6,43,33,4,3,94,83
685,16,2,4,3,10,21,46,5,9,115,129
685,17,5,2,10,3,-45,-79,0,0,70,50
685,18,4,2,9,4,45,22,5,2,115,72
685,19,5,2,9,4,54,22,9,4,169,94
685,20,3,3,6,7,-67,34,2,8,102,128
685,21,2,4,5,8,23,-56,5,2,125,72
685,22,2,4,4,9,22,45,7,7,147,117
685,23,4,3,6,7,42,-66,9,1,189,51
685,24,3,3,5,8,-68,35,1,6,121,86
685,25,3,4,8,5,35,41,6,7,156,127
685,26,4,3,8,5,-56,32,0,9,100,159
685,27,4,3,6,7,42,-66,2,3,142,93
685,28,3,4,4,9,31,45,3,8,173,138
685,29,4,2,8,5,44,-77,7,1,217,61
685,30,3,3,5,8,32,35,9,6,249,96
685,31,3,3,6,7,-67,-66,2,0,182,30
685,32,4,3,7,6,43,33,5,3,225,63
685,33,2,4,5,8,23,44,8,7,248,107
685,34,2,4,5,8,-77,-56,1,1,171,51
685,35,3,3,6,7,33,34,4,5,204,85
685,36,4,2,8,5,44,23,8,8,248,108
685,37,4,2,6,7,-58,-75,0,3,190,33
685,38,3,3,6,7,33,34,3,7,223,67
685,39,3,3,8,5,35,32,8,9,258,99
685,40,2,4,4,9,-78,-55,0,4,180,44
685,41,4,3,7,6,43,33,3,7,223,77
685,42,4,2,8,5,44,-77,7,0,267,0
685,43,2,5,6,7,-76,52,1,2,191,52
685,44,3,4,6,7,33,43,4,5,224,95
685,45,2,5,7,6,25,51,9,6,249,146
685,46,4,2,9,4,-55,22,4,8,194,168
685,47,4,2,8,5,44,-77,8,1,238,91
685,48,3,4,7,6,-66,42,2,3,172,133
685,49,2,5,3,10,21,55,3,8,193,188
685,50,4,3,9,4,45,31,8,9,238,219
685,51,4,2,5,8,41,-74,9,5,279,145
685,52,3,4,5,8,-68,44,1,9,211,189
685,53,5,2,8,5,53,-77,4,2,264,112
685,54,2,5,2,11,20,56,4,8,284,168
685,55,2,4,2,11,20,-53,4,5,304,115
685,56,3,3,4,9,31,-64,5,1,335,51
685,57,2,5,4,9,22,54,7,5,357,105
685,58,2,5,4,9,22,54,9,9,379,159
685,59,2,4,4,9,-78,-55,1,4,301,104
685,60,4,2,9,4,45,22,6,6,346,126
685,61,2,4,4,9,22,-55,8,1,368,71
685,62,3,3,6,7,-67,34,1,5,301,105
685,63,5,2,9,4,54,22,5,7,355,127
685,64,2,5,4,9,22,-46,7,1,377,81
685,65,5,2,8,5,-47,23,0,4,330,104
685,66,3,4,6,7,33,43,3,7,363,147
685,67,4,3,7,6,43,-67,6,0,406,80
685,68,3,3,7,6,-66,33,0,3,340,113
685,69,3,4,6,7,33,43,3,6,373,156
685,70,5,2,8,5,53,23,6,9,426,179
685,71,4,3,5,8,41,-65,7,4,467,114
685,72,3,3,5,8,32,35,9,9,499,149
685,73,3,3,8,5,-65,-68,4,1,434,81
685,74,3,4,5,8,32,44,6,5,466,125
685,75,4,3,6,7,42,34,8,9,508,159
686,1,4,2,10,3,46,21,6,1,46,21
686,2,2,4,8,5,-74,41,2,2,-28,62
686,3,2,4,4,9,22,45,4,7,-6,107
686,4,5,2,8,5,53,-77,7,0,47,30
686,5,3,3,4,9,31,36,8,6,78,66
686,6,3,4,6,7,-67,43,1,9,11,109
686,7,3,3,6,7,33,-66,4,3,44,43
686,8,6,2,10,3,64,21,8,4,108,64
686,9,4,2,5,8,41,-74,9,0,149,-10
686,10,3,3,5,8,-68,35,1,5,81,25
686,11,2,4,8,5,26,41,7,6,107,66
686,12,3,4,6,7,-67,43,0,9,40,109
686,13,4,3,9,4,45,-69,5,0,85,40
686,14,2,6,3,10,21,64,6,4,106,104
686,15,3,4,4,9,31,45,7,9,137,149
686,16,2,5,3,10,21,-45,8,4,158,104
686,17,3,3,6,7,-67,34,1,8,91,138
686,18,3,3,7,6,34,-67,5,1,125,71
686,19,3,4,4,9,31,45,6,6,156,116
686,20,4,3,10,3,-54,30,2,6,102,146
686,21,5,3,8,5,53,32,5,8,155,178
686,22,4,3,7,6,43,-67,8,1,198,111
686,23,3,4,5,8,-68,44,0,5,130,155
686,24,5,2,9,4,54,22,4,7,184,177
686,25,4,2,10,3,-54,21,0,8,130,198
686,26,3,4,4,9,31,-55,1,3,161,143
686,27,5,2,10,3,55,21,6,4,216,164
686,28,2,4,3,10,21,-54,7,0,237,110
686,29,3,4,8,5,-65,41,2,1,172,151
686,30,3,3,8,5,35,32,7,3,207,183
686,31,4,4,6,7,42,43,9,6,249,226
686,32,3,3,7,6,-66,33,3,9,183,259
686,33,5,2,10,3,55,-79,8,0,238,180
686,34,4,2,9,4,-55,22,3,2,183,202
686,35,2,4,5,8,23,44,6,6,206,246
686,36,4,2,9,4,-55,22,1,8,151,268
686,37,4,3,9,4,45,31,6,9,196,299
686,38,3,3,8,5,-65,-68,1,1,131,231
686,39,3,5,4,9,31,54,2,5,162,285
686,40,3,3,7,6,34,33,6,8,196,318
686,41,3,3,7,6,-66,-67,0,1,130,251
686,42,5,2,10,3,55,21,5,2,185,272
686,43,3,4,7,6,34,42,9,4,219,314
686,44,2,4,6,7,-76,43,3,7,143,357
686,45,2,5,4,9,22,-46,5,1,165,311
686,46,2,4,4,9,22,45,7,6,187,356
686,47,3,3,6,7,-67,-66,0,0,120,290
686,48,3,3,7,6,34,33,4,3,154,323
686,49,4,2,5,8,41,26,5,9,195,349
686,50,2,5,5,8,23,-47,8,2,218,302
686,51,4,3,5,8,41,35,9,7,259,337
686,52,4,2,6,7,-58,-75,1,2,201,262
686,53,2,4,4,9,22,45,3,7,223,307
686,54,5,2,10,3,55,21,8,8,278,328
686,55,2,4,4,9,-78,-55,0,3,200,273
686,56,2,4,4,9,22,45,2,8,222,318
686,57,4,3,8,5,44,-68,6,0,266,250
686,58,2,4,4,9,22,45,8,5,288,295
686,59,4,3,5,8,41,-65,9,0,329,230
686,60,3,4,7,6,-66,42,3,2,263,272
686,61,4,3,9,4,45,31,8,3,308,303
686,62,3,4,6,7,-67,43,1,6,241,346
686,63,2,4,5,8,23,-56,4,0,264,290
686,64,4,2,9,4,45,22,9,2,309,312
686,65,4,2,8,5,-56,23,3,5,253,335
686,66,2,4,5,8,23,44,6,9,276,379
686,67,4,3,8,5,-56,-68,0,1,220,311
686,68,4,3,6,7,42,34,2,5,262,345
686,69,2,5,4,9,22,54,4,9,284,399
686,70,3,3,5,8,32,-65,6,4,316,334
686,71,2,4,5,8,23,44,9,8,339,378
686,72,2,5,3,10,-79,-45,0,3,260,333
686,73,2,4,5,8,23,44,3,7,283,377
686,74,3,3,4,9,31,-64,4,3,314,313
686,75,4,2,7,6,43,24,7,7,357,337
686,76,3,4,7,6,-66,42,1,9,291,379
686,77,4,3,7,6,43,-67,4,2,334,312
686,78,3,4,4,9,31,45,5,7,365,357
686,79,5,2,8,5,53,-77,8,0,418,280
686,80,4,4,7,6,-57,42,1,2,361,322
686,81,4,2,8,5,44,23,5,5,405,345
686,82,4,2,9,4,-55,22,0,7,350,367
686,83,2,5,6,7,24,52,4,9,374,419
686,84,4,3,8,5,44,-68,8,1,418,351
686,85,3,4,5,8,-68,44,0,5,350,395
686,86,4,3,7,6,43,33,3,8,393,428
686,87,3,4,6,7,33,-57,6,1,426,371
686,88,3,3,8,5,-65,32,1,3,361,403
686,89,4,2,8,5,44,23,5,6,405,426
686,90,2,5,5,8,23,53,8,9,428,479
686,91,4,2,9,4,-55,-78,3,1,373,401
686,92,3,3,5,8,32,35,5,6,405,436
686,93,3,3,7,6,34,33,9,9,439,469
686,94,2,4,4,9,-78,-55,1,4,361,414
686,95,4,2,8,5,44,23,5,7,405,437
686,96,4,3,7,6,43,-67,8,0,448,370
686,97,4,2,8,5,-56,23,2,3,392,393
686,98,3,3,6,7,33,34,5,7,425,427
686,99,5,2,10,3,-45,21,0,8,380,448
686,100,4,2,8,5,44,-77,4,1,424,371
686,101,4,3,8,5,44,32,8,3,468,403
686,102,3,5,3,10,30,55,8,8,498,458
686,103,6,2,9,4,-37,-78,1,0,461,380
686,104,3,4,3,10,30,46,1,6,491,426
686,105,3,5,5,8,32,53,3,9,523,479
687,1,4,3,9,4,45,31,5,1,45,31
687,2,2,6,2,11,20,65,5,6,65,96
687,3,2,5,6,7,24,52,9,8,89,148
687,4,3,4,5,8,-68,-56,1,2,21,92
687,5,5,2,8,5,53,23,4,5,74,115
687,6,4,3,8,5,44,32,8,7,118,147
687,7,3,4,6,7,-67,-57,1,0,51,90
687,8,4,3,6,7,42,34,3,4,93,124
687,9,3,4,5,8,32,44,5,8,125,168
687,10,5,2,7,6,52,-76,7,2,177,92
687,11,4,3,7,6,-57,33,0,5,120,125
687,12,4,3,8,5,44,32,4,7,164,157
687,13,3,3,5,8,32,-65,6,2,196,92
687,14,3,3,6,7,33,34,9,6,229,126
687,15,3,4,8,5,-65,41,4,7,164,167
687,16,3,4,5,8,32,-56,6,1,196,111
687,17,3,4,6,7,33,43,9,4,229,154
687,18,6,2,11,2,-35,20,4,4,194,174
687,19,2,5,2,11,20,-44,4,0,214,130
687,20,3,3,8,5,35,32,9,2,249,162
687,21,4,2,7,6,-57,24,2,6,192,186
687,22,2,5,2,11,20,-44,2,2,212,142
687,23,2,5,2,11,20,56,2,8,232,198
687,24,2,5,3,10,21,-45,3,3,253,153
687,25,3,4,8,5,35,41,8,4,288,194
687,26,2,4,5,8,-77,44,1,8,211,238
687,27,5,2,9,4,54,-78,5,0,265,160
687,28,4,4,8,5,44,41,9,1,309,201
687,29,2,4,6,7,-76,43,3,4,233,244
687,30,4,3,7,6,43,33,6,7,276,277
687,31,4,3,8,5,-56,32,0,9,220,309
687,32,2,5,5,8,23,-47,3,2,243,262
687,33,5,2,11,2,56,20,9,2,299,282
687,34,3,3,5,8,-68,35,1,7,231,317
687,35,2,4,4,9,22,-55,3,2,253,262
687,36,3,3,4,9,31,36,4,8,284,298
687,37,4,3,9,4,45,31,9,9,329,329
687,38,5,2,10,3,-45,-79,4,0,284,250
687,39,4,4,4,9,40,45,4,5,324,295
687,40,3,3,8,5,35,32,9,7,359,327
687,41,3,4,4,9,-69,-55,0,2,290,272
687,42,2,5,2,11,20,56,0,8,310,328
687,43,2,4,5,8,23,-56,3,2,333,272
687,44,3,4,3,10,30,46,3,8,363,318
687,45,5,2,8,5,53,-77,6,1,416,241
687,46,5,2,8,5,53,23,9,4,469,264
687,47,3,3,5,8,-68,35,1,9,401,299
687,48,3,3,3,10,30,-63,1,6,431,236
687,49,3,3,8,5,35,32,6,8,466,268
687,50,3,4,4,9,31,-55,7,3,497,213
687,51,4,2,9,4,-55,22,2,5,442,235
687,52,3,3,6,7,33,34,5,9,475,269
687,53,3,3,6,7,33,-66,8,3,508,203
688,1,4,3,10,3,46,30,6,0,46,30
688,2,3,4,8,5,-65,41,1,1,-19,71
688,3,4,2,6,7,42,25,3,6,23,96
688,4,3,4,6,7,33,43,6,9,56,139
688,5,5,2,8,5,53,-77,9,2,109,62
688,6,4,2,8,5,-56,23,3,5,53,85
688,7,5,2,10,3,55,21,8,6,108,106
688,8,3,3,6,7,-67,-66,1,0,41,40
688,9,5,2,8,5,53,23,4,3,94,63
688,10,4,3,6,7,42,34,6,7,136,97
688,11,4,2,9,4,-55,22,1,9,81,119
688,12,2,6,4,9,22,-37,3,2,103,82
688,13,5,3,7,6,52,33,5,5,155,115
688,14,2,5,6,7,24,52,9,7,179,167
688,15,3,4,3,10,30,-54,9,3,209,113
688,16,2,5,2,11,20,56,9,9,229,169
688,17,3,3,8,5,-65,-68,4,1,164,101
688,18,2,5,6,7,24,52,8,3,188,153
688,19,4,2,9,4,-55,22,3,5,133,175
688,20,3,3,8,5,35,32,8,7,168,207
688,21,2,5,7,6,-75,51,3,8,93,258
688,22,3,4,8,5,35,41,8,9,128,299
688,23,3,3,4,9,31,-64,9,5,159,235
688,24,3,4,8,5,-65,41,4,6,94,276
688,25,3,4,9,4,-64,40,0,6,30,316
688,26,3,4,9,4,36,40,6,6,66,356
688,27,3,4,5,8,32,-56,8,0,98,300
688,28,3,4,7,6,-66,42,2,2,32,342
688,29,3,4,5,8,32,44,4,6,64,386
688,30,5,2,11,2,-44,20,0,6,20,406
688,31,4,3,7,6,43,33,3,9,63,439
688,32,2,5,3,10,21,-45,4,4,84,394
688,33,3,4,5,8,32,44,6,8,116,438
688,34,5,2,7,6,52,-76,8,2,168,362
688,35,5,2,10,3,-45,21,3,3,123,383
688,36,4,3,7,6,43,33,6,6,166,416
688,37,2,5,5,8,23,53,9,9,189,469
688,38,6,2,11,2,-35,20,4,9,154,489
688,39,2,4,4,9,22,-55,6,4,176,434
688,40,4,2,9,4,-55,22,1,6,121,456
688,41,3,4,6,7,33,43,4,9,154,499
688,42,3,4,7,6,34,-58,8,1,188,441
688,43,4,3,5,8,41,35,9,6,229,476
688,44,3,4,8,5,-65,41,4,7,164,517
689,1,4,2,10,3,46,21,6,1,46,21
689,2,5,2,9,4,-46,22,0,3,0,43
689,3,3,4,5,8,32,44,2,7,32,87
689,4,5,2,9,4,54,22,6,9,86,109
689,5,4,3,7,6,43,-67,9,2,129,42
689,6,5,2,8,5,-47,23,2,5,82,65
689,7,4,2,9,4,45,22,7,7,127,87
689,8,3,3,4,9,31,-64,8,3,158,23
689,9,5,2,9,4,-46,22,2,5,112,45
689,10,3,3,8,5,35,32,7,7,147,77
689,11,3,3,7,6,-66,-67,1,0,81,10
689,12,3,3,7,6,34,33,5,3,115,43
689,13,2,5,4,9,22,54,7,7,137,97
689,14,3,3,7,6,-66,-67,1,0,71,30
689,15,4,2,9,4,45,22,6,2,116,52
689,16,3,3,6,7,33,34,9,6,149,86
689,17,3,4,4,9,-69,-55,0,1,80,31
689,18,4,4,5,8,41,44,1,5,121,75
689,19,2,4,4,9,22,-55,3,0,143,20
689,20,5,2,8,5,53,23,6,3,196,43
689,21,4,2,8,5,-56,23,0,6,140,66
689,22,2,4,8,5,26,41,6,7,166,107
689,23,2,4,7,6,-75,42,1,9,91,149
689,24,3,3,8,5,35,-68,6,1,126,81
689,25,5,2,9,4,-46,22,0,3,80,103
689,26,4,3,7,6,43,33,3,6,123,136
689,27,2,4,6,7,24,43,7,9,147,179
689,28,4,3,6,7,42,-66,9,3,189,113
689,29,3,4,6,7,-67,43,2,6,122,156
689,30,2,5,2,11,20,-44,2,2,142,112
689,31,4,3,9,4,45,31,7,3,187,143
689,32,2,5,2,11,20,56,7,9,207,199
689,33,4,3,6,7,42,-66,9,3,249,133
689,34,3,4,9,4,-64,40,5,3,185,173
689,35,4,2,7,6,43,24,8,7,228,197
689,36,4,2,7,6,-57,-76,1,1,171,121
689,37,4,2,9,4,45,22,6,3,216,143
689,38,4,3,7,6,43,33,9,6,259,176
689,39,5,2,11,2,-44,20,5,6,215,196
689,40,4,3,8,5,44,32,9,8,259,228
689,41,2,4,3,10,-79,-54,0,4,180,174
689,42,3,4,5,8,32,44,2,8,212,218
689,43,5,2,9,4,54,-78,6,0,266,140
689,44,2,5,6,7,-76,52,0,2,190,192
689,45,3,3,8,5,35,32,5,4,225,224
689,46,4,2,10,3,-54,21,1,5,171,245
689,47,4,3,6,7,42,34,3,9,213,279
689,48,3,3,6,7,33,-66,6,3,246,213
689,49,2,5,6,7,-76,52,0,5,170,265
689,50,4,2,10,3,46,21,6,6,216,286
689,51,4,3,9,4,-55,31,1,7,161,317
689,52,3,3,6,7,33,-66,4,1,194,251
689,53,5,2,8,5,53,23,7,4,247,274
689,54,6,2,9,4,-37,22,0,6,210,296
689,55,3,4,5,8,32,-56,2,0,242,240
689,56,5,2,7,6,52,24,4,4,294,264
689,57,3,3,8,5,35,32,9,6,329,296
689,58,2,5,5,8,-77,53,2,9,252,349
689,59,4,2,7,6,43,-76,5,3,295,273
689,60,6,2,11,2,-35,20,0,3,260,293
689,61,3,4,5,8,32,44,2,7,292,337
689,62,2,5,5,8,23,-47,5,0,315,290
689,63,5,2,10,3,-45,21,0,1,270,311
689,64,2,4,6,7,24,43,4,4,294,354
689,65,3,3,5,8,32,35,6,9,326,389
689,66,3,3,7,6,-66,-67,0,2,260,322
689,67,3,4,7,6,34,42,4,4,294,364
689,68,4,3,8,5,44,32,8,6,338,396
689,69,3,3,8,5,-65,32,3,8,273,428
689,70,2,6,4,9,22,-37,5,1,295,391
689,71,3,4,3,10,30,46,5,7,325,437
689,72,4,3,8,5,44,32,9,9,369,469
689,73,3,3,7,6,-66,-67,3,2,303,402
689,74,3,3,6,7,33,34,6,6,336,436
689,75,2,4,6,7,-76,43,0,9,260,479
689,76,3,3,6,7,33,-66,3,3,293,413
689,77,3,3,5,8,32,35,5,8,325,448
689,78,2,4,7,6,-75,-58,0,0,250,390
689,79,2,4,6,7,24,43,4,3,274,433
689,80,2,4,3,10,21,46,5,9,295,479
689,81,3,4,9,4,-64,40,1,9,231,519
690,1,3,4,7,6,34,42,4,2,34,42
690,2,4,2,7,6,43,24,7,6,77,66
690,3,4,3,7,6,-57,33,0,9,20,99
690,4,2,5,4,9,22,-46,2,3,42,53
690,5,4,3,5,8,41,35,3,8,83,88
690,6,4,3,7,6,43,-67,6,1,126,21
690,7,4,3,7,6,43,33,9,4,169,54
690,8,4,3,9,4,-55,31,4,5,114,85
690,9,2,5,4,9,22,54,6,9,136,139
690,10,4,2,8,5,-56,-77,0,2,80,62
690,11,2,5,3,10,21,55,1,7,101,117
690,12,2,4,6,7,24,-57,5,0,125,60
690,13,2,4,8,5,-74,41,1,1,51,101
690,14,4,2,7,6,43,24,4,5,94,125
690,15,3,3,7,6,34,33,8,8,128,158
690,16,2,4,5,8,-77,-56,1,2,51,102
690,17,3,3,6,7,33,34,4,6,84,136
690,18,3,4,4,9,31,-55,5,1,115,81
690,19,4,3,6,7,42,34,7,5,157,115
690,20,3,3,4,9,31,-64,8,1,188,51
690,21,3,4,5,8,-68,44,0,5,120,95
690,22,3,3,4,9,31,-64,1,1,151,31
690,23,4,3,7,6,43,33,4,4,194,64
690,24,4,2,6,7,42,25,6,9,236,89
690,25,4,3,10,3,-54,30,2,9,182,119
690,26,2,5,6,7,24,-48,6,1,206,71
690,27,2,5,4,9,22,54,8,5,228,125
690,28,4,2,6,7,-58,-75,0,0,170,50
690,29,4,3,10,3,46,30,6,0,216,80
690,30,4,3,6,7,42,34,8,4,258,114
690,31,3,3,8,5,-65,32,3,6,193,146
690,32,5,2,10,3,55,21,8,7,248,167
690,33,3,3,8,5,-65,32,3,9,183,199
690,34,3,3,6,7,33,-66,6,3,216,133
690,35,4,3,5,8,41,35,7,8,257,168
690,36,3,4,8,5,-65,41,2,9,192,209
690,37,5,2,10,3,55,-79,7,0,247,130
690,38,5,2,7,6,52,24,9,4,299,154
690,39,5,2,8,5,-47,23,2,7,252,177
690,40,3,3,6,7,33,-66,5,1,285,111
690,41,4,3,8,5,44,32,9,3,329,143
690,42,4,2,10,3,-54,21,5,4,275,164
690,43,3,4,5,8,32,44,7,8,307,208
690,44,2,4,7,6,-75,-58,2,0,232,150
690,45,3,4,4,9,31,45,3,5,263,195
690,46,3,3,8,5,35,32,8,7,298,227
690,47,5,2,9,4,-46,22,2,9,252,249
690,48,4,2,9,4,45,-78,7,1,297,171
690,49,3,3,3,10,30,37,7,8,327,208
690,50,3,4,6,7,-67,-57,0,1,260,151
690,51,3,3,6,7,33,34,3,5,293,185
690,52,4,3,6,7,42,34,5,9,335,219
690,53,4,3,5,8,41,-65,6,4,376,154
690,54,4,3,9,4,-55,31,1,5,321,185
690,55,4,3,7,6,43,33,4,8,364,218
690,56,4,2,9,4,45,-78,9,0,409,140
690,57,3,4,6,7,-67,43,2,3,342,183
690,58,3,4,4,9,31,45,3,8,373,228
690,59,5,2,7,6,52,-76,5,2,425,152
690,60,2,6,4,9,22,63,7,5,447,215
690,61,4,2,9,4,-55,22,2,7,392,237
690,62,3,3,7,6,34,-67,6,0,426,170
690,63,4,3,7,6,43,33,9,3,469,203
690,64,3,4,7,6,-66,42,3,5,403,245
690,65,4,3,7,6,43,33,6,8,446,278
690,66,3,3,7,6,-66,-67,0,1,380,211
690,67,3,3,6,7,33,34,3,5,413,245
690,68,3,3,5,8,32,-65,5,0,445,180
690,69,4,2,8,5,44,23,9,3,489,203
690,70,4,3,8,5,-56,32,3,5,433,235
690,71,3,3,9,4,36,31,9,6,469,266
690,72,2,4,3,10,-79,-54,0,2,390,212
690,73,6,2,10,3,64,21,4,3,454,233
690,74,3,3,7,6,34,33,8,6,488,266
690,75,3,3,5,8,-68,-65,0,1,420,201
690,76,3,3,5,8,32,35,2,6,452,236
690,77,4,3,8,5,44,32,6,8,496,268
690,78,2,5,3,10,21,-45,7,3,517,223
691,1,2,4,6,7,24,43,4,3,24,43
691,2,3,3,7,6,34,33,8,6,58,76
691,3,4,3,5,8,41,-65,9,1,99,11
691,4,3,3,7,6,-66,33,3,4,33,44
691,5,3,3,8,5,35,32,8,6,68,76
691,6,4,3,6,7,-58,-66,0,0,10,10
691,7,4,3,6,7,42,34,2,4,52,44
691,8,3,3,8,5,35,32,7,6,87,76
691,9,6,2,11,2,-35,20,2,6,52,96
691,10,5,2,9,4,54,22,6,8,106,118
691,11,3,4,6,7,33,-57,9,1,139,61
691,12,4,3,9,4,-55,31,4,2,84,92
691,13,2,4,5,8,23,44,7,6,107,136
691,14,3,3,6,7,-67,-66,0,0,40,70
691,15,2,4,3,10,21,46,1,6,61,116
691,16,3,4,8,5,35,41,6,7,96,157
691,17,4,2,9,4,-55,22,1,9,41,179
691,18,2,5,5,8,23,-47,4,2,64,132
691,19,3,3,9,4,-64,31,0,3,0,163
691,20,3,3,8,5,35,32,5,5,35,195
691,21,3,4,5,8,32,44,7,9,67,239
691,22,5,2,10,3,-45,-79,2,0,22,160
691,23,5,2,8,5,53,23,5,3,75,183
691,24,4,2,10,3,-54,21,1,4,21,204
691,25,3,3,5,8,32,35,3,9,53,239
691,26,2,5,5,8,23,-47,6,2,76,192
691,27,4,3,8,5,-56,32,0,4,20,224
691,28,4,3,6,7,42,34,2,8,62,258
691,29,4,2,10,3,46,21,8,9,108,279
691,30,2,4,5,8,-77,-56,1,3,31,223
691,31,3,3,7,6,34,33,5,6,65,256
691,32,4,4,4,9,40,-55,5,1,105,201
691,33,4,3,6,7,42,34,7,5,147,235
691,34,2,4,5,8,-77,44,0,9,70,279
691,35,3,4,6,7,33,-57,3,2,103,222
691,36,5,2,7,6,52,24,5,6,155,246
691,37,2,5,4,9,22,-46,7,0,177,200
691,38,4,2,7,6,-57,24,0,4,120,224
691,39,2,5,2,11,20,-44,0,0,140,180
691,40,4,4,7,6,43,42,3,2,183,222
691,41,5,2,9,4,54,22,7,4,237,244
691,42,4,3,7,6,-57,33,0,7,180,277
691,43,4,3,8,5,44,32,4,9,224,309
691,44,4,3,9,4,45,-69,9,0,269,240
691,45,3,3,8,5,-65,32,4,2,204,272
691,46,4,3,8,5,44,32,8,4,248,304
691,47,4,2,8,5,-56,23,2,7,192,327
691,48,2,4,6,7,24,-57,6,0,216,270
691,49,4,2,9,4,-55,22,1,2,161,292
691,50,2,4,6,7,24,43,5,5,185,335
691,51,5,3,6,7,51,34,6,9,236,369
691,52,2,4,4,9,22,-55,8,4,258,314
691,53,4,3,7,6,-57,33,1,7,201,347
691,54,3,3,5,8,32,-65,3,2,233,282
691,55,2,4,3,10,21,46,4,8,254,328
691,56,2,4,6,7,24,-57,8,1,278,271
691,57,4,2,6,7,-58,25,0,6,220,296
691,58,4,3,9,4,45,31,5,7,265,327
691,59,3,5,5,8,32,-47,7,0,297,280
691,60,3,3,5,8,32,35,9,5,329,315
691,61,3,4,5,8,-68,44,1,9,261,359
691,62,3,4,6,7,33,-57,4,2,294,302
691,63,4,2,9,4,45,22,9,4,339,324
691,64,4,3,5,8,-59,35,0,9,280,359
691,65,3,4,5,8,32,-56,2,3,312,303
691,66,3,3,5,8,32,35,4,8,344,338
691,67,3,3,6,7,33,-66,7,2,377,272
691,68,3,4,6,7,-67,43,0,5,310,315
691,69,2,5,6,7,24,52,4,7,334,367
691,70,4,3,7,6,43,-67,7,0,377,300
691,71,4,3,7,6,-57,33,0,3,320,333
691,72,5,2,7,6,52,24,2,7,372,357
691,73,2,6,4,9,22,-37,4,0,394,320
691,74,3,3,6,7,33,34,7,4,427,354
691,75,4,3,5,8,41,35,8,9,468,389
691,76,3,4,4,9,31,-55,9,4,499,334
691,77,3,3,7,6,-66,33,3,7,433,367
691,78,4,3,6,7,42,-66,5,1,475,301
691,79,4,2,7,6,43,24,8,5,518,325
692,1,2,4,6,7,24,43,4,3,24,43
692,2,3,4,4,9,31,45,5,8,55,88
692,3,2,5,5,8,23,-47,8,1,78,41
692,4,2,5,6,7,-76,52,2,3,2,93
692,5,4,2,10,3,46,21,8,4,48,114
692,6,2,4,2,11,20,-53,8,1,68,61
692,7,4,3,8,5,-56,32,2,3,12,93
692,8,4,3,8,5,44,32,6,5,56,125
692,9,4,2,8,5,-56,23,0,8,0,148
692,10,2,4,6,7,24,-57,4,1,24,91
692,11,2,5,3,10,21,55,5,6,45,146
692,12,5,2,9,4,54,22,9,8,99,168
692,13,4,2,8,5,-56,-77,3,1,43,91
692,14,5,2,7,6,52,24,5,5,95,115
692,15,3,3,7,6,34,33,9,8,129,148
692,16,4,3,10,3,-54,30,5,8,75,178
692,17,3,3,8,5,-65,-68,0,0,10,110
692,18,5,2,9,4,54,22,4,2,64,132
692,19,2,5,4,9,22,54,6,6,86,186
692,20,2,5,5,8,23,53,9,9,109,239
692,21,3,3,6,7,-67,-66,2,3,42,173
692,22,2,5,5,8,23,53,5,6,65,226
692,23,4,3,8,5,44,32,9,8,109,258
692,24,3,3,4,9,-69,-64,0,4,40,194
692,25,2,4,4,9,22,45,2,9,62,239
692,26,3,3,7,6,34,-67,6,2,96,172
692,27,4,3,8,5,-56,32,0,4,40,204
692,28,3,4,5,8,32,44,2,8,72,248
692,29,5,2,9,4,54,-78,6,0,126,170
692,30,2,4,6,7,-76,43,0,3,50,213
692,31,3,4,4,9,31,45,1,8,81,258
692,32,2,4,7,6,25,-58,6,0,106,200
692,33,5,2,8,5,53,23,9,3,159,223
692,34,3,3,7,6,-66,33,3,6,93,256
692,35,2,4,5,8,23,-56,6,0,116,200
692,36,2,4,6,7,-76,43,0,3,40,243
692,37,4,3,8,5,44,32,4,5,84,275
692,38,2,4,7,6,25,42,9,7,109,317
692,39,3,3,5,8,-68,-65,1,2,41,252
692,40,3,4,8,5,35,41,6,3,76,293
692,41,4,2,8,5,-56,23,0,6,20,316
692,42,4,3,8,5,44,32,4,8,64,348
692,43,3,3,9,4,-64,31,0,9,0,379
692,44,5,2,9,4,54,-78,4,1,54,301
692,45,2,5,5,8,23,53,7,4,77,354
692,46,5,2,8,5,-47,23,0,7,30,377
692,47,4,2,6,7,42,-75,2,2,72,302
692,48,4,3,7,6,43,33,5,5,115,335
692,49,3,3,8,5,-65,32,0,7,50,367
692,50,2,5,2,11,20,-44,0,3,70,323
692,51,2,5,3,10,21,55,1,8,91,378
692,52,4,3,7,6,43,-67,4,1,134,311
692,53,4,3,7,6,43,33,7,4,177,344
692,54,3,4,6,7,-67,43,0,7,110,387
692,55,4,3,7,6,43,-67,3,0,153,320
692,56,3,4,7,6,34,42,7,2,187,362
692,57,5,2,9,4,-46,22,1,4,141,384
692,58,4,2,7,6,43,24,4,8,184,408
692,59,4,3,5,8,41,-65,5,3,225,343
692,60,3,3,8,5,-65,32,0,5,160,375
692,61,4,3,10,3,46,30,6,5,206,405
692,62,3,3,4,9,31,-64,7,1,237,341
692,63,2,4,4,9,22,45,9,6,259,386
692,64,2,5,5,8,-77,53,2,9,182,439
692,65,4,4,5,8,41,-56,3,3,223,383
692,66,3,3,6,7,33,34,6,7,256,417
692,67,5,2,8,5,53,-77,9,0,309,340
692,68,5,3,8,5,-47,32,2,2,262,372
692,69,3,5,5,8,32,53,4,5,294,425
692,70,3,3,6,7,33,34,7,9,327,459
692,71,2,4,5,8,-77,-56,0,3,250,403
692,72,2,5,4,9,22,54,2,7,272,457
692,73,3,3,9,4,36,31,8,8,308,488
692,74,4,3,7,6,-57,-67,1,1,251,421
692,75,3,5,4,9,31,54,2,5,282,475
692,76,3,4,5,8,32,44,4,9,314,519
693,1,3,4,6,7,33,43,3,3,33,43
693,2,2,4,7,6,25,42,8,5,58,85
693,3,2,4,3,10,21,-54,9,1,79,31
693,4,5,2,9,4,-46,22,3,3,33,53
693,5,3,4,6,7,33,43,6,6,66,96
693,6,5,2,9,4,-46,22,0,8,20,118
693,7,4,2,8,5,44,-77,4,1,64,41
693,8,2,5,4,9,22,54,6,5,86,95
693,9,3,3,8,5,-65,32,1,7,21,127
693,10,3,4,3,10,30,-54,1,3,51,73
693,11,4,2,7,6,43,24,4,7,94,97
693,12,4,3,8,5,44,32,8,9,138,129
693,13,3,4,4,9,31,-55,9,4,169,74
693,14,4,3,8,5,-56,32,3,6,113,106
693,15,3,4,5,8,32,-56,5,0,145,50
693,16,3,4,4,9,31,45,6,5,176,95
693,17,3,3,7,6,-66,33,0,8,110,128
693,18,4,3,6,7,42,-66,2,2,152,62
693,19,4,2,8,5,44,23,6,5,196,85
693,20,3,4,5,8,32,44,8,9,228,129
693,21,2,4,7,6,-75,-58,3,1,153,71
693,22,4,3,8,5,44,32,7,3,197,103
693,23,3,3,6,7,-67,34,0,7,130,137
693,24,4,2,10,3,46,21,6,8,176,158
693,25,4,2,7,6,43,-76,9,2,219,82
693,26,3,4,6,7,-67,43,2,5,152,125
693,27,3,3,6,7,33,34,5,9,185,159
693,28,2,5,3,10,21,-45,6,4,206,114
693,29,4,2,8,5,-56,23,0,7,150,137
693,30,4,3,9,4,45,31,5,8,195,168
693,31,2,4,8,5,-74,41,1,9,121,209
693,32,4,3,7,6,43,-67,4,2,164,142
693,33,4,2,9,4,45,22,9,4,209,164
693,34,4,2,7,6,-57,24,2,8,152,188
693,35,3,4,8,5,35,41,7,9,187,229
693,36,4,3,7,6,-57,-67,0,2,130,162
693,37,3,5,5,8,32,53,2,5,162,215
693,38,5,2,9,4,54,22,6,7,216,237
693,39,3,3,5,8,32,-65,8,2,248,172
693,40,4,3,9,4,-55,31,3,3,193,203
693,41,4,2,8,5,44,23,7,6,237,226
693,42,3,4,4,9,31,-55,8,1,268,171
693,43,3,3,10,3,-63,30,5,1,205,201
693,44,2,4,5,8,23,44,8,5,228,245
693,45,4,3,5,8,41,-65,9,0,269,180
693,46,2,4,4,9,-78,45,1,5,191,225
693,47,4,3,8,5,44,32,5,7,235,257
693,48,5,2,9,4,54,22,9,9,289,279
693,49,4,3,6,7,-58,-66,1,3,231,213
693,50,3,3,5,8,32,35,3,8,263,248
693,51,4,3,7,6,43,-67,6,1,306,181
693,52,3,3,7,6,-66,33,0,4,240,214
693,53,5,2,10,3,55,21,5,5,295,235
693,54,3,4,7,6,34,42,9,7,329,277
693,55,3,3,10,3,-63,30,6,7,266,307
693,56,2,4,7,6,-75,42,1,9,191,349
693,57,2,5,5,8,23,-47,4,2,214,302
693,58,4,3,5,8,41,35,5,7,255,337
693,59,3,3,6,7,33,-66,8,1,288,271
693,60,3,4,6,7,-67,43,1,4,221,314
693,61,5,2,9,4,54,22,5,6,275,336
693,62,2,4,6,7,24,43,9,9,299,379
693,63,3,3,7,6,-66,-67,3,2,233,312
693,64,2,5,2,11,20,56,3,8,253,368
693,65,3,4,8,5,35,41,8,9,288,409
693,66,3,5,7,6,-66,-49,2,0,222,360
693,67,5,2,8,5,53,23,5,3,275,383
693,68,3,4,7,6,34,42,9,5,309,425
693,69,3,3,7,6,-66,33,3,8,243,458
693,70,3,3,6,7,33,-66,6,2,276,392
693,71,3,3,7,6,-66,33,0,5,210,425
693,72,4,2,9,4,45,22,5,7,255,447
693,73,3,4,7,6,34,42,9,9,289,489
693,74,4,3,9,4,-55,-69,4,0,234,420
693,75,5,2,10,3,55,21,9,1,289,441
693,76,3,3,6,7,-67,34,2,5,222,475
693,77,4,4,5,8,41,44,3,9,263,519
694,1,4,2,9,4,45,22,5,2,45,22
694,2,3,3,9,4,-64,31,1,3,-19,53
694,3,3,4,4,9,31,45,2,8,12,98
694,4,5,2,7,6,52,-76,4,2,64,22
694,5,5,2,11,2,-44,20,0,2,20,42
694,6,2,5,6,7,24,52,4,4,44,94
694,7,5,2,9,4,54,22,8,6,98,116
694,8,3,3,7,6,-66,33,2,9,32,149
694,9,3,3,5,8,32,-65,4,4,64,84
694,10,3,3,3,10,30,-63,4,1,94,21
694,11,4,2,7,6,43,24,7,5,137,45
694,12,2,6,3,10,21,64,8,9,158,109
694,13,4,3,6,7,-58,-66,0,3,100,43
694,14,3,3,4,9,31,36,1,9,131,79
694,15,3,3,7,6,34,-67,5,2,165,12
694,16,3,3,7,6,34,33,9,5,199,45
694,17,2,4,3,10,-79,-54,0,1,120,-9
694,18,5,2,9,4,54,22,4,3,174,13
694,19,4,3,9,4,45,31,9,4,219,44
694,20,4,3,6,7,-58,34,1,8,161,78
694,21,4,2,7,6,43,-76,4,2,204,2
694,22,5,2,10,3,55,21,9,3,259,23
694,23,4,4,6,7,-58,43,1,6,201,66
694,24,3,3,7,6,34,33,5,9,235,99
694,25,2,4,7,6,-75,-58,0,1,160,41
694,26,3,3,6,7,33,34,3,5,193,75
694,27,5,2,10,3,55,21,8,6,248,96
694,28,4,2,7,6,-57,-76,1,0,191,20
694,29,4,3,5,8,41,35,2,5,232,55
694,30,5,2,9,4,54,22,6,7,286,77
694,31,4,3,5,8,41,-65,7,2,327,12
694,32,3,4,5,8,32,44,9,6,359,56
694,33,2,5,5,8,-77,53,2,9,282,109
694,34,2,5,2,11,20,-44,2,5,302,65
694,35,4,2,6,7,42,-75,4,0,344,-10
694,36,4,3,7,6,43,33,7,3,387,23
694,37,3,3,7,6,-66,33,1,6,321,56
694,38,3,4,6,7,33,43,4,9,354,99
694,39,4,2,7,6,43,-76,7,3,397,23
694,40,2,5,4,9,22,54,9,7,419,77
694,41,4,3,5,8,-59,-65,0,2,360,12
694,42,3,4,6,7,33,43,3,5,393,55
694,43,3,3,3,10,30,-63,3,2,423,-8
694,44,5,2,10,3,55,21,8,3,478,13
694,45,3,3,8,5,-65,32,3,5,413,45
694,46,3,4,5,8,32,44,5,9,445,89
694,47,4,3,5,8,41,-65,6,4,486,24
694,48,3,4,4,9,31,45,7,9,517,69
695,1,4,3,6,7,42,34,2,4,42,34
695,2,3,3,8,5,35,32,7,6,77,66
695,3,4,3,8,5,-56,32,1,8,21,98
695,4,4,3,8,5,44,-68,5,0,65,30
695,5,2,4,4,9,22,45,7,5,87,75
695,6,2,4,5,8,-77,44,0,9,10,119
695,7,3,4,4,9,31,-55,1,4,41,64
695,8,2,5,3,10,21,55,2,9,62,119
695,9,3,3,7,6,34,-67,6,2,96,52
695,10,4,2,7,6,43,24,9,6,139,76
695,11,3,4,6,7,-67,43,2,9,72,119
695,12,2,4,5,8,23,-56,5,3,95,63
695,13,4,2,6,7,42,25,7,8,137,88
695,14,3,3,9,4,-64,31,3,9,73,119
695,15,4,3,6,7,42,-66,5,3,115,53
695,16,4,3,7,6,43,33,8,6,158,86
695,17,4,2,8,5,-56,23,2,9,102,109
695,18,3,3,6,7,33,-66,5,3,135,43
695,19,2,5,6,7,24,52,9,5,159,95
695,20,3,3,7,6,-66,33,3,8,93,128
695,21,3,3,5,8,32,-65,5,3,125,63
695,22,4,3,9,4,-55,31,0,4,70,94
695,23,4,3,7,6,43,33,3,7,113,127
695,24,3,3,6,7,33,-66,6,1,146,61
695,25,5,2,7,6,52,24,8,5,198,85
695,26,3,4,5,8,-68,44,0,9,130,129
695,27,2,4,7,6,25,-58,5,1,155,71
695,28,4,2,11,2,-53,20,2,1,102,91
695,29,5,2,10,3,55,21,7,2,157,112
695,30,2,4,4,9,22,45,9,7,179,157
695,31,3,4,6,7,-67,-57,2,0,112,100
695,32,3,4,7,6,34,42,6,2,146,142
695,33,6,2,10,3,-36,21,0,3,110,163
695,34,4,2,7,6,43,24,3,7,153,187
695,35,3,4,6,7,33,-57,6,0,186,130
695,36,4,3,9,4,-55,31,1,1,131,161
695,37,4,3,9,4,45,31,6,2,176,192
695,38,6,2,9,4,63,22,9,4,239,214
695,39,4,3,10,3,-54,30,5,4,185,244
695,40,4,3,8,5,44,32,9,6,229,276
695,41,3,5,5,8,-68,53,1,9,161,329
695,42,4,2,10,3,46,-79,7,0,207,250
695,43,4,2,9,4,-55,22,2,2,152,272
695,44,4,3,8,5,44,32,6,4,196,304
695,45,3,4,4,9,31,45,7,9,227,349
695,46,5,2,7,6,52,-76,9,3,279,273
695,47,3,3,4,9,-69,36,0,9,210,309
695,48,4,3,7,6,43,-67,3,2,253,242
695,49,2,4,3,10,21,46,4,8,274,288
695,50,2,5,4,9,22,-46,6,2,296,242
695,51,4,2,7,6,43,24,9,6,339,266
695,52,5,2,9,4,-46,22,3,8,293,288
695,53,2,5,3,10,21,-45,4,3,314,243
695,54,3,4,5,8,32,44,6,7,346,287
695,55,4,3,5,8,41,-65,7,2,387,222
695,56,3,4,5,8,32,44,9,6,419,266
695,57,3,4,6,7,-67,43,2,9,352,309
695,58,4,3,6,7,42,-66,4,3,394,243
695,59,4,3,6,7,42,34,6,7,436,277
695,60,2,4,5,8,23,-56,9,1,459,221
695,61,4,3,9,4,-55,31,4,2,404,252
695,62,4,3,6,7,42,34,6,6,446,286
695,63,3,3,6,7,33,-66,9,0,479,220
695,64,3,4,4,9,-69,45,0,5,410,265
695,65,2,5,3,10,21,-45,1,0,431,220
695,66,2,5,6,7,24,52,5,2,455,272
695,67,4,3,5,8,41,35,6,7,496,307
695,68,3,3,4,9,31,-64,7,3,527,243
696,1,5,2,8,5,53,23,3,3,53,23
696,2,4,3,6,7,42,34,5,7,95,57
696,3,5,2,11,2,-44,20,1,7,51,77
696,4,3,4,6,7,33,-57,4,0,84,20
696,5,3,4,7,6,34,42,8,2,118,62
696,6,2,4,6,7,-76,43,2,5,42,105
696,7,5,2,9,4,54,22,6,7,96,127
696,8,3,4,10,3,-63,-40,3,7,33,87
696,9,3,3,8,5,35,32,8,9,68,119
696,10,3,3,6,7,-67,-66,1,3,1,53
696,11,4,3,5,8,41,35,2,8,42,88
696,12,3,3,5,8,32,-65,4,3,74,23
696,13,4,3,8,5,44,32,8,5,118,55
696,14,3,4,8,5,-65,41,3,6,53,96
696,15,5,2,11,2,56,20,9,6,109,116
696,16,4,2,6,7,-58,-75,1,1,51,41
696,17,4,2,10,3,46,21,7,2,97,62
696,18,2,5,4,9,22,54,9,6,119,116
696,19,4,2,6,7,-58,-75,1,1,61,41
696,20,5,2,9,4,54,22,5,3,115,63
696,21,5,2,8,5,53,23,8,6,168,86
696,22,3,3,7,6,-66,33,2,9,102,119
696,23,3,3,6,7,33,-66,5,3,135,53
696,24,4,2,10,3,-54,21,1,4,81,74
696,25,3,3,6,7,33,34,4,8,114,108
696,26,4,3,6,7,42,-66,6,2,156,42
696,27,3,4,7,6,-66,42,0,4,90,84
696,28,2,4,5,8,23,44,3,8,113,128
696,29,3,4,7,6,34,-58,7,0,147,70
696,30,3,3,7,6,-66,33,1,3,81,103
696,31,2,5,4,9,22,54,3,7,103,157
696,32,3,4,6,7,33,-57,6,0,136,100
696,33,3,4,5,8,32,44,8,4,168,144
696,34,3,4,5,8,-68,44,0,8,100,188
696,35,5,2,8,5,53,-77,3,1,153,111
696,36,4,3,9,4,45,31,8,2,198,142
696,37,2,4,6,7,-76,43,2,5,122,185
696,38,2,5,4,9,22,54,4,9,144,239
696,39,5,2,11,2,-44,20,0,9,100,259
696,40,3,4,2,11,-30,-53,0,6,70,206
696,41,3,3,6,7,33,-66,3,0,103,140
696,42,3,3,7,6,34,33,7,3,137,173
696,43,2,5,6,7,-76,52,1,5,61,225
696,44,4,4,7,6,43,42,4,7,104,267
696,45,2,5,5,8,23,-47,7,0,127,220
696,46,4,2,8,5,-56,23,1,3,71,243
696,47,3,3,7,6,34,33,5,6,105,276
696,48,4,3,8,5,44,32,9,8,149,308
696,49,3,4,5,8,-68,-56,1,2,81,252
696,50,3,4,4,9,31,45,2,7,112,297
696,51,2,4,7,6,25,42,7,9,137,339
696,52,4,2,11,2,-53,20,4,9,84,359
696,53,3,4,8,5,35,-59,9,0,119,300
696,54,4,2,9,4,-55,22,4,2,64,322
696,55,5,2,9,4,54,22,8,4,118,344
696,56,2,4,4,9,-78,45,0,9,40,389
696,57,3,3,5,8,32,-65,2,4,72,324
696,58,3,4,3,10,30,-54,2,0,102,270
696,59,4,2,10,3,46,21,8,1,148,291
696,60,4,3,5,8,41,35,9,6,189,326
696,61,4,3,6,7,-58,-66,1,0,131,260
696,62,4,3,8,5,44,32,5,2,175,292
696,63,3,4,4,9,31,45,6,7,206,337
696,64,5,3,5,8,50,-65,6,2,256,272
696,65,2,5,4,9,22,54,8,6,278,326
696,66,3,3,8,5,-65,32,3,8,213,358
696,67,3,4,5,8,32,-56,5,2,245,302
696,68,3,4,5,8,32,44,7,6,277,346
696,69,2,4,6,7,-76,43,1,9,201,389
696,70,2,6,3,10,21,-36,2,3,222,353
696,71,3,4,8,5,35,41,7,4,257,394
696,72,3,3,10,3,-63,30,4,4,194,424
696,73,3,3,6,7,33,34,7,8,227,458
696,74,4,2,6,7,42,-75,9,3,269,383
696,75,3,4,4,9,-69,45,0,8,200,428
696,76,3,3,7,6,34,-67,4,1,234,361
696,77,2,5,4,9,22,54,6,5,256,415
696,78,3,3,4,9,31,-64,7,1,287,351
696,79,5,2,8,5,-47,23,0,4,240,374
696,80,3,3,6,7,33,34,3,8,273,408
696,81,4,2,8,5,44,-77,7,1,317,331
696,82,3,3,6,7,-67,34,0,5,250,365
696,83,2,5,4,9,22,54,2,9,272,419
696,84,3,4,6,7,33,-57,5,2,305,362
696,85,4,3,8,5,44,32,9,4,349,394
696,86,4,3,8,5,-56,32,3,6,293,426
696,87,4,3,4,9,40,-64,3,2,333,362
696,88,3,3,6,7,33,34,6,6,366,396
696,89,4,3,7,6,43,33,9,9,409,429
696,90,3,3,6,7,-67,-66,2,3,342,363
696,91,4,2,8,5,44,23,6,6,386,386
696,92,2,4,4,9,22,-55,8,1,408,331
696,93,2,5,4,9,-78,54,0,5,330,385
696,94,4,3,5,8,41,-65,1,0,371,320
696,95,3,3,6,7,33,34,4,4,404,354
696,96,3,3,8,5,35,32,9,6,439,386
696,97,2,4,5,8,-77,-56,2,0,362,330
696,98,2,4,5,8,23,44,5,4,385,374
696,99,4,3,9,4,-55,31,0,5,330,405
696,100,5,2,9,4,54,22,4,7,384,427
696,101,3,4,7,6,34,42,8,9,418,469
696,102,3,3,6,7,-67,-66,1,3,351,403
696,103,3,4,3,10,30,46,1,9,381,449
696,104,3,3,9,4,36,-69,7,0,417,380
696,105,4,2,11,2,-53,20,4,0,364,400
696,106,4,3,8,5,44,32,8,2,408,432
696,107,4,3,9,4,-55,31,3,3,353,463
696,108,4,3,10,3,46,30,9,3,399,493
696,109,3,3,8,5,-65,32,4,5,334,525
697,1,5,2,8,5,53,23,3,3,53,23
697,2,3,4,7,6,34,42,7,5,87,65
697,3,5,2,6,7,51,-75,8,0,138,-10
697,4,3,3,5,8,-68,35,0,5,70,25
697,5,3,4,8,5,35,41,5,6,105,66
697,6,3,3,8,5,-65,32,0,8,40,98
697,7,3,3,6,7,33,-66,3,2,73,32
697,8,4,2,8,5,44,23,7,5,117,55
697,9,2,4,4,9,22,-55,9,0,139,0
697,10,3,4,8,5,-65,41,4,1,74,41
697,11,3,4,7,6,34,42,8,3,108,83
697,12,2,4,6,7,-76,43,2,6,32,126
697,13,5,2,9,4,54,22,6,8,86,148
697,14,3,3,10,3,-63,30,3,8,23,178
697,15,3,3,4,9,31,-64,4,4,54,114
697,16,5,2,8,5,53,23,7,7,107,137
697,17,2,5,6,7,-76,52,1,9,31,189
697,18,3,3,9,4,36,-69,7,0,67,120
697,19,4,4,5,8,41,44,8,4,108,164
697,20,3,4,6,7,-67,43,1,7,41,207
697,21,4,2,8,5,44,-77,5,0,85,130
697,22,4,2,7,6,43,24,8,4,128,154
697,23,5,2,6,7,51,25,9,9,179,179
697,24,3,3,4,9,-69,-64,0,5,110,115
697,25,3,4,6,7,33,43,3,8,143,158
697,26,2,5,4,9,22,-46,5,2,165,112
697,27,2,5,2,11,20,56,5,8,185,168
697,28,2,4,3,10,21,-54,6,4,206,114
697,29,3,3,6,7,33,34,9,8,239,148
697,30,3,3,6,7,-67,-66,2,2,172,82
697,31,4,3,9,4,45,31,7,3,217,113
697,32,4,3,8,5,-56,32,1,5,161,145
697,33,3,3,4,9,31,-64,2,1,192,81
697,34,3,4,5,8,32,44,4,5,224,125
697,35,3,3,4,9,31,-64,5,1,255,61
697,36,3,4,4,9,31,45,6,6,286,106
697,37,4,3,9,4,-55,31,1,7,231,137
697,38,2,4,7,6,25,42,6,9,256,179
697,39,3,3,5,8,32,-65,8,4,288,114
697,40,4,2,8,5,-56,23,2,7,232,137
697,41,2,4,7,6,25,42,7,9,257,179
697,42,3,3,7,6,-66,-67,1,2,191,112
697,43,3,4,4,9,31,45,2,7,222,157
697,44,2,4,3,10,21,-54,3,3,243,103
697,45,4,3,6,7,42,34,5,7,285,137
697,46,3,4,5,8,32,-56,7,1,317,81
697,47,3,4,6,7,-67,43,0,4,250,124
697,48,3,4,8,5,35,41,5,5,285,165
697,49,4,3,5,8,41,-65,6,0,326,100
697,50,3,4,5,8,32,44,8,4,358,144
697,51,3,4,5,8,-68,44,0,8,290,188
697,52,5,2,8,5,53,-77,3,1,343,111
697,53,4,3,10,3,46,30,9,1,389,141
697,54,2,4,3,10,-79,46,0,7,310,187
697,55,2,4,5,8,23,-56,3,1,333,131
697,56,3,3,8,5,35,32,8,3,368,163
697,57,4,2,7,6,-57,24,1,7,311,187
697,58,5,2,9,4,54,22,5,9,365,209
697,59,3,3,7,6,34,-67,9,2,399,142
697,60,2,5,4,9,-78,54,1,6,321,196
697,61,3,3,8,5,35,32,6,8,356,228
697,62,4,2,9,4,-55,-78,1,0,301,150
697,63,3,4,4,9,31,45,2,5,332,195
697,64,3,3,4,9,31,-64,3,1,363,131
697,65,3,4,6,7,33,43,6,4,396,174
697,66,3,3,5,8,32,35,8,9,428,209
697,67,4,2,6,7,-58,-75,0,4,370,134
697,68,2,5,5,8,23,53,3,7,393,187
697,69,5,2,10,3,55,21,8,8,448,208
697,70,3,3,8,5,-65,-68,3,0,383,140
697,71,5,2,10,3,55,21,8,1,438,161
697,72,3,3,7,6,-66,33,2,4,372,194
697,73,5,2,9,4,54,22,6,6,426,216
697,74,3,4,6,7,33,43,9,9,459,259
697,75,3,3,8,5,-65,-68,4,1,394,191
697,76,4,3,8,5,44,32,8,3,438,223
697,77,3,4,6,7,-67,43,1,6,371,266
697,78,3,3,5,8,32,-65,3,1,403,201
697,79,2,5,3,10,21,55,4,6,424,256
697,80,2,4,3,10,21,-54,5,2,445,202
697,81,5,2,9,4,54,22,9,4,499,224
697,82,5,2,9,4,-46,22,3,6,453,246
697,83,4,3,8,5,44,32,7,8,497,278
697,84,3,4,5,8,32,-56,9,2,529,222
698,1,2,5,7,6,25,51,5,1,25,51
698,2,5,2,11,2,-44,20,1,1,-19,71
698,3,5,2,9,4,54,22,5,3,35,93
698,4,3,3,7,6,34,33,9,6,69,126
698,5,4,3,6,7,-58,-66,1,0,11,60
698,6,3,3,7,6,34,33,5,3,45,93
698,7,5,3,7,6,52,33,7,6,97,126
698,8,3,3,6,7,-67,-66,0,0,30,60
698,9,2,4,4,9,22,45,2,5,52,105
698,10,3,4,9,4,36,40,8,5,88,145
698,11,2,5,3,10,21,-45,9,0,109,100
698,12,5,2,9,4,-46,22,3,2,63,122
698,13,4,3,7,6,43,33,6,5,106,155
698,14,2,4,5,8,23,44,9,9,129,199
698,15,3,3,8,5,-65,-68,4,1,64,131
698,16,5,2,9,4,54,22,8,3,118,153
698,17,4,3,7,6,-57,33,1,6,61,186
698,18,3,4,5,8,32,-56,3,0,93,130
698,19,5,2,9,4,54,22,7,2,147,152
698,20,2,4,5,8,-77,44,0,6,70,196
698,21,4,3,6,7,42,-66,2,0,112,130
698,22,3,4,5,8,32,44,4,4,144,174
698,23,3,4,4,9,31,45,5,9,175,219
698,24,3,3,5,8,32,-65,7,4,207,154
698,25,3,3,4,9,31,-64,8,0,238,90
698,26,5,2,8,5,-47,23,1,3,191,113
698,27,3,4,4,9,31,45,2,8,222,158
698,28,5,2,9,4,54,-78,6,0,276,80
698,29,3,3,4,9,31,36,7,6,307,116
698,30,3,4,5,8,32,-56,9,0,339,60
698,31,2,4,6,7,-76,43,3,3,263,103
698,32,5,2,8,5,53,23,6,6,316,126
698,33,3,3,5,8,32,-65,8,1,348,61
698,34,4,2,6,7,-58,25,0,6,290,86
698,35,5,2,6,7,51,-75,1,1,341,11
698,36,5,2,9,4,54,22,5,3,395,33
698,37,3,3,6,7,33,34,8,7,428,67
698,38,4,3,9,4,-55,31,3,8,373,98
698,39,3,3,5,8,32,-65,5,3,405,33
698,40,3,4,7,6,34,42,9,5,439,75
698,41,4,2,9,4,-55,22,4,7,384,97
698,42,2,4,4,9,22,-55,6,2,406,42
698,43,2,4,9,4,-73,40,3,2,333,82
698,44,4,3,6,7,42,34,5,6,375,116
698,45,3,3,7,6,34,33,9,9,409,149
698,46,2,5,3,10,-79,-45,0,4,330,104
698,47,4,3,9,4,45,31,5,5,375,135
698,48,4,3,7,6,43,33,8,8,418,168
698,49,4,3,8,5,-56,-68,2,0,362,100
698,50,2,5,3,10,21,55,3,5,383,155
698,51,3,3,4,9,31,-64,4,1,414,91
698,52,6,2,10,3,64,21,8,2,478,112
698,53,4,3,6,7,-58,34,0,6,420,146
698,54,4,3,9,4,45,31,5,7,465,177
698,55,4,4,8,5,44,41,9,8,509,218
699,1,3,3,8,5,35,32,5,2,35,32
699,2,2,4,3,10,21,46,6,8,56,78
699,3,5,3,5,8,50,-65,6,3,106,13
699,4,4,2,10,3,-54,21,2,4,52,34
699,5,4,2,11,2,47,20,9,4,99,54
699,6,2,4,4,9,-78,45,1,9,21,99
699,7,2,5,4,9,22,-46,3,3,43,53
699,8,2,4,5,8,23,44,6,7,66,97
699,9,4,3,10,3,-54,30,2,7,12,127
699,10,3,4,6,7,33,-57,5,0,45,70
699,11,4,3,9,4,-55,31,0,1,-10,101
699,12,5,2,10,3,55,21,5,2,45,122
699,13,5,2,7,6,52,24,7,6,97,146
699,14,2,5,3,10,21,-45,8,1,118,101
699,15,4,2,9,4,-55,22,3,3,63,123
699,16,3,3,7,6,34,33,7,6,97,156
699,17,3,3,4,9,31,-64,8,2,128,92
699,18,3,3,5,8,-68,35,0,7,60,127
699,19,5,2,7,6,52,-76,2,1,112,51
699,20,3,3,4,9,31,36,3,7,143,87
699,21,2,4,4,9,22,-55,5,2,165,32
699,22,2,4,4,9,22,45,7,7,187,77
699,23,3,3,3,10,30,-63,7,4,217,14
699,24,4,3,5,8,41,35,8,9,258,49
699,25,3,4,6,7,-67,-57,1,2,191,-8
699,26,4,3,8,5,44,32,5,4,235,24
699,27,3,4,4,9,31,45,6,9,266,69
699,28,3,3,9,4,-64,-69,2,0,202,0
699,29,2,5,2,11,20,56,2,6,222,56
699,30,5,2,8,5,53,23,5,9,275,79
699,31,3,3,8,5,-65,-68,0,1,210,11
699,32,3,3,5,8,32,35,2,6,242,46
699,33,3,3,7,6,34,33,6,9,276,79
699,34,3,3,7,6,-66,-67,0,2,210,12
699,35,4,2,9,4,45,22,5,4,255,34
699,36,4,3,6,7,42,34,7,8,297,68
699,37,3,3,6,7,-67,-66,0,2,230,2
699,38,4,3,6,7,42,34,2,6,272,36
699,39,4,3,7,6,43,33,5,9,315,69
699,40,4,4,6,7,42,-57,7,2,357,12
699,41,5,2,9,4,-46,22,1,4,311,34
699,42,4,2,7,6,43,24,4,8,354,58
699,43,2,4,4,9,22,-55,6,3,376,3
699,44,2,5,4,9,22,54,8,7,398,57
699,45,3,3,5,8,-68,-65,0,2,330,-8
699,46,3,4,3,10,30,46,0,8,360,38
699,47,3,3,8,5,35,-68,5,0,395,-30
699,48,3,3,6,7,33,34,8,4,428,4
699,49,3,4,7,6,-66,42,2,6,362,46
699,50,4,2,8,5,44,23,6,9,406,69
699,51,4,3,7,6,43,-67,9,2,449,2
699,52,3,3,6,7,-67,34,2,6,382,36
699,53,3,3,6,7,33,-66,5,0,415,-30
699,54,3,3,7,6,34,33,9,3,449,3
699,55,3,3,6,7,-67,34,2,7,382,37
699,56,4,3,4,9,40,-64,2,3,422,-27
699,57,3,3,7,6,34,33,6,6,456,6
699,58,5,2,8,5,53,23,9,9,509,29
700,1,2,5,3,10,21,55,1,5,21,55
700,2,2,4,3,10,21,-54,2,1,42,1
700,3,4,3,7,6,43,33,5,4,85,34
700,4,5,2,8,5,53,23,8,7,138,57
700,5,3,3,7,6,-66,-67,2,0,72,-10
700,6,4,3,5,8,41,35,3,5,113,25
700,7,4,2,8,5,44,23,7,8,157,48
700,8,3,3,8,5,-65,-68,2,0,92,-20
700,9,4,3,9,4,45,31,7,1,137,11
700,10,3,3,6,7,-67,34,0,5,70,45
700,11,5,2,10,3,55,21,5,6,125,66
700,12,4,2,9,4,-55,22,0,8,70,88
700,13,4,2,10,3,46,21,6,9,116,109
700,14,4,4,7,6,43,-58,9,1,159,51
700,15,3,4,5,8,-68,44,1,5,91,95
700,16,3,4,7,6,34,42,5,7,125,137
700,17,4,3,6,7,42,-66,7,1,167,71
700,18,4,3,10,3,-54,30,3,1,113,101
700,19,3,4,5,8,32,44,5,5,145,145
700,20,5,2,10,3,-45,21,0,6,100,166
700,21,4,2,5,8,41,-74,1,2,141,92
700,22,2,5,3,10,21,55,2,7,162,147
700,23,3,3,5,8,32,-65,4,2,194,82
700,24,4,3,6,7,42,34,6,6,236,116
700,25,5,3,8,5,53,32,9,8,289,148
700,26,5,2,9,4,-46,-78,3,0,243,70
700,27,3,5,8,5,35,50,8,0,278,120
700,28,3,3,5,8,-68,35,0,5,210,155
700,29,3,3,7,6,34,33,4,8,244,188
700,30,4,3,7,6,43,-67,7,1,287,121
700,31,4,2,6,7,42,25,9,6,329,146
700,32,4,3,10,3,-54,30,5,6,275,176
700,33,4,2,7,6,43,-76,8,0,318,100
700,34,4,3,9,4,-55,31,3,1,263,131
700,35,3,4,5,8,32,44,5,5,295,175
700,36,3,4,5,8,32,44,7,9,327,219
700,37,4,3,9,4,-55,-69,2,0,272,150
700,38,3,3,6,7,33,34,5,4,305,184
700,39,3,3,10,3,-63,30,2,4,242,214
700,40,3,4,5,8,32,44,4,8,274,258
700,41,3,4,6,7,33,-57,7,1,307,201
700,42,4,4,7,6,-57,42,0,3,250,243
700,43,5,2,10,3,55,21,5,4,305,264
700,44,4,4,6,7,42,43,7,7,347,307
700,45,4,3,8,5,-56,32,1,9,291,339
700,46,4,3,6,7,42,-66,3,3,333,273
700,47,2,4,6,7,24,43,7,6,357,316
700,48,3,4,5,8,32,-56,9,0,389,260
700,49,5,2,9,4,-46,22,3,2,343,282
700,50,5,2,10,3,55,21,8,3,398,303
700,51,2,4,6,7,-76,43,2,6,322,346
700,52,2,4,7,6,25,42,7,8,347,388
700,53,4,3,8,5,-56,-68,1,0,291,320
700,54,4,3,9,4,45,31,6,1,336,351
700,55,3,3,4,9,31,36,7,7,367,387
700,56,3,3,7,6,-66,-67,1,0,301,320
700,57,2,5,4,9,22,54,3,4,323,374
700,58,3,3,6,7,33,34,6,8,356,408
700,59,3,3,5,8,32,-65,8,3,388,343
700,60,3,3,6,7,-67,34,1,7,321,377
700,61,3,3,4,9,31,-64,2,3,352,313
700,62,2,4,6,7,24,43,6,6,376,356
700,63,4,3,10,3,-54,30,2,6,322,386
700,64,4,3,6,7,42,-66,4,0,364,320
700,65,2,4,6,7,24,43,8,3,388,363
700,66,6,2,8,5,-38,23,0,6,350,386
700,67,2,5,7,6,25,51,5,7,375,437
700,68,3,3,5,8,32,-65,7,2,407,372
700,69,5,2,7,6,52,24,9,6,459,396
700,70,3,3,8,5,-65,32,4,8,394,428
700,71,4,3,9,4,45,31,9,9,439,459
700,72,3,3,7,6,-66,-67,3,2,373,392
700,73,2,4,3,10,21,46,4,8,394,438
700,74,4,2,8,5,44,-77,8,1,438,361
700,75,4,4,8,5,-56,41,2,2,382,402
700,76,4,2,8,5,44,23,6,5,426,425
700,77,4,3,5,8,41,-65,7,0,467,360
700,78,4,2,7,6,-57,24,0,4,410,384
700,79,3,4,7,6,34,42,4,6,444,426
700,80,4,4,6,7,42,43,6,9,486,469
700,81,2,4,5,8,23,-56,9,3,509,413
701,1,2,6,5,8,23,62,3,2,23,62
701,2,4,2,9,4,45,22,8,4,68,84
701,3,3,3,10,3,-63,30,5,4,5,114
701,4,5,2,9,4,54,22,9,6,59,136
701,5,3,4,8,5,-65,41,4,7,-6,177
701,6,2,4,4,9,22,-55,6,2,16,122
701,7,3,4,5,8,32,44,8,6,48,166
701,8,4,2,9,4,-55,22,3,8,-7,188
701,9,5,2,9,4,54,-78,7,0,47,110
701,10,4,2,9,4,-55,22,2,2,-8,132
701,11,4,3,8,5,44,32,6,4,36,164
701,12,5,2,9,4,-46,22,0,6,-10,186
701,13,4,3,8,5,44,32,4,8,34,218
701,14,5,2,10,3,55,21,9,9,89,239
701,15,4,2,10,3,-54,-79,5,0,35,160
701,16,5,2,9,4,54,22,9,2,89,182
701,17,3,4,6,7,-67,43,2,5,22,225
701,18,3,3,5,8,32,-65,4,0,54,160
701,19,2,5,4,9,22,54,6,4,76,214
701,20,2,4,4,9,22,45,8,9,98,259
701,21,3,4,5,8,-68,-56,0,3,30,203
701,22,2,4,6,7,24,43,4,6,54,246
701,23,3,3,7,6,34,33,8,9,88,279
701,24,3,4,8,5,-65,-59,3,0,23,220
701,25,3,4,8,5,35,41,8,1,58,261
701,26,2,6,4,9,-78,63,0,4,-20,324
701,27,4,2,7,6,43,24,3,8,23,348
701,28,5,2,7,6,52,-76,5,2,75,272
701,29,4,2,7,6,43,24,8,6,118,296
701,30,3,4,9,4,-64,40,4,6,54,336
701,31,2,5,2,11,20,-44,4,2,74,292
701,32,3,4,4,9,31,45,5,7,105,337
701,33,3,4,5,8,32,-56,7,1,137,281
701,34,2,4,7,6,-75,42,2,3,62,323
701,35,4,2,6,7,42,25,4,8,104,348
701,36,4,3,7,6,43,-67,7,1,147,281
701,37,3,4,3,10,30,46,7,7,177,327
701,38,4,3,7,6,-57,-67,0,0,120,260
701,39,5,2,8,5,53,23,3,3,173,283
701,40,4,2,8,5,44,23,7,6,217,306
701,41,4,2,9,4,-55,22,2,8,162,328
701,42,2,4,5,8,23,-56,5,2,185,272
701,43,5,2,8,5,53,23,8,5,238,295
701,44,5,2,8,5,-47,23,1,8,191,318
701,45,2,4,6,7,24,-57,5,1,215,261
701,46,3,3,6,7,33,34,8,5,248,295
701,47,4,2,7,6,-57,24,1,9,191,319
701,48,3,3,7,6,34,-67,5,2,225,252
701,49,3,4,6,7,33,43,8,5,258,295
701,50,3,4,5,8,-68,44,0,9,190,339
701,51,5,2,10,3,55,-79,5,0,245,260
701,52,4,2,9,4,-55,22,0,2,190,282
701,53,2,4,4,9,22,45,2,7,212,327
701,54,4,3,6,7,42,-66,4,1,254,261
701,55,4,3,8,5,44,32,8,3,298,293
701,56,2,4,4,9,-78,45,0,8,220,338
701,57,2,4,5,8,23,-56,3,2,243,282
701,58,3,3,6,7,33,34,6,6,276,316
701,59,3,4,5,8,32,-56,8,0,308,260
701,60,3,3,5,8,-68,35,0,5,240,295
701,61,5,2,8,5,53,23,3,8,293,318
701,62,4,2,10,3,46,21,9,9,339,339
701,63,3,4,6,7,-67,-57,2,2,272,282
701,64,4,2,8,5,44,23,6,5,316,305
701,65,3,3,5,8,32,-65,8,0,348,240
701,66,3,5,7,6,-66,51,2,1,282,291
701,67,3,3,8,5,35,32,7,3,317,323
701,68,3,3,7,6,-66,33,1,6,251,356
701,69,2,4,7,6,25,42,6,8,276,398
701,70,4,2,8,5,-56,-77,0,1,220,321
701,71,4,2,8,5,44,23,4,4,264,344
701,72,2,4,5,8,23,44,7,8,287,388
701,73,2,4,7,6,-75,-58,2,0,212,330
701,74,4,3,7,6,43,33,5,3,255,363
701,75,3,3,9,4,-64,31,1,4,191,394
701,76,4,3,7,6,43,33,4,7,234,427
701,77,4,2,10,3,-54,21,0,8,180,448
701,78,3,4,4,9,31,-55,1,3,211,393
701,79,3,3,3,10,30,-63,1,0,241,330
701,80,4,2,8,5,44,23,5,3,285,353
701,81,5,3,8,5,53,32,8,5,338,385
701,82,3,4,8,5,-65,41,3,6,273,426
701,83,2,5,3,10,21,-45,4,1,294,381
701,84,3,3,7,6,34,33,8,4,328,414
701,85,3,4,6,7,-67,43,1,7,261,457
701,86,5,2,8,5,53,-77,4,0,314,380
701,87,5,2,10,3,55,21,9,1,369,401
701,88,3,4,4,9,-69,45,0,6,300,446
701,89,2,5,6,7,24,52,4,8,324,498
701,90,3,3,8,5,35,-68,9,0,359,430
701,91,2,5,5,8,-77,53,2,3,282,483
701,92,2,5,4,9,22,54,4,7,304,537
702,1,2,6,3,10,21,64,1,4,21,64
702,2,2,5,3,10,21,55,2,9,42,119
702,3,3,4,6,7,33,-57,5,2,75,62
702,4,4,3,9,4,-55,31,0,3,20,93
702,5,3,3,7,6,34,33,4,6,54,126
702,6,3,3,6,7,33,-66,7,0,87,60
702,7,3,4,5,8,32,44,9,4,119,104
702,8,5,2,10,3,-45,21,4,5,74,125
702,9,4,2,6,7,42,-75,6,0,116,50
702,10,4,3,6,7,42,34,8,4,158,84
702,11,4,3,7,6,-57,33,1,7,101,117
702,12,3,3,9,4,36,31,7,8,137,148
702,13,3,3,8,5,-65,-68,2,0,72,80
702,14,4,3,6,7,42,34,4,4,114,114
702,15,3,3,10,3,-63,30,1,4,51,144
702,16,3,3,6,7,33,34,4,8,84,178
702,17,4,3,6,7,42,-66,6,2,126,112
702,18,5,2,9,4,-46,22,0,4,80,134
702,19,3,4,7,6,34,42,4,6,114,176
702,20,3,3,5,8,32,-65,6,1,146,111
702,21,2,4,6,7,-76,43,0,4,70,154
702,22,3,3,9,4,36,31,6,5,106,185
702,23,5,2,11,2,-44,20,2,5,62,205
702,24,4,3,9,4,45,31,7,6,107,236
702,25,4,2,7,6,-57,-76,0,0,50,160
702,26,3,3,6,7,33,34,3,4,83,194
702,27,2,5,2,11,20,-44,3,0,103,150
702,28,3,4,4,9,31,45,4,5,134,195
702,29,2,4,3,10,21,-54,5,1,155,141
702,30,4,3,6,7,42,34,7,5,197,175
702,31,3,3,8,5,-65,32,2,7,132,207
702,32,3,3,8,5,35,32,7,9,167,239
702,33,2,4,3,10,21,-54,8,5,188,185
702,34,5,2,7,6,-48,24,0,9,140,209
702,35,3,3,6,7,33,-66,3,3,173,143
702,36,4,3,7,6,43,33,6,6,216,176
702,37,3,4,4,9,31,-55,7,1,247,121
702,38,4,3,7,6,-57,33,0,4,190,154
702,39,3,4,5,8,32,44,2,8,222,198
702,40,4,2,6,7,42,-75,4,3,264,123
702,41,2,5,4,9,22,54,6,7,286,177
702,42,4,3,6,7,42,-66,8,1,328,111
702,43,3,3,3,10,30,37,8,8,358,148
702,44,3,4,8,5,-65,41,3,9,293,189
702,45,2,4,6,7,24,-57,7,2,317,132
702,46,2,4,3,10,21,46,8,8,338,178
702,47,4,3,9,4,-55,31,3,9,283,209
702,48,3,4,6,7,33,-57,6,2,316,152
702,49,4,2,7,6,43,24,9,6,359,176
702,50,3,4,3,10,30,-54,9,2,389,122
702,51,2,6,2,11,20,65,9,7,409,187
702,52,3,3,6,7,-67,-66,2,1,342,121
702,53,3,3,7,6,34,33,6,4,376,154
702,54,5,2,8,5,53,23,9,7,429,177
702,55,4,2,7,6,-57,-76,2,1,372,101
702,56,3,3,6,7,33,34,5,5,405,135
702,57,3,4,5,8,32,44,7,9,437,179
702,58,4,2,9,4,-55,-78,2,1,382,101
702,59,3,4,4,9,31,45,3,6,413,146
702,60,4,3,8,5,44,32,7,8,457,178
702,61,2,4,7,6,-75,-58,2,0,382,120
702,62,4,4,5,8,41,44,3,4,423,164
702,63,4,3,7,6,43,33,6,7,466,197
702,64,3,3,6,7,33,-66,9,1,499,131
702,65,3,3,7,6,-66,33,3,4,433,164
702,66,3,3,6,7,33,34,6,8,466,198
702,67,3,3,7,6,-66,-67,0,1,400,131
702,68,2,4,5,8,23,44,3,5,423,175
702,69,2,5,3,10,21,-45,4,0,444,130
702,70,3,3,5,8,32,35,6,5,476,165
702,71,2,4,6,7,-76,43,0,8,400,208
702,72,4,2,8,5,44,-77,4,1,444,131
702,73,2,4,3,10,21,46,5,7,465,177
702,74,4,2,10,3,-54,21,1,8,411,198
702,75,3,3,4,9,31,-64,2,4,442,134
702,76,5,2,9,4,54,22,6,6,496,156
702,77,4,3,8,5,-56,32,0,8,440,188
702,78,4,2,11,2,47,20,7,8,487,208
702,79,5,2,9,4,-46,-78,1,0,441,130
702,80,2,5,5,8,23,53,4,3,464,183
702,81,6,2,11,2,65,20,9,3,529,203
703,1,2,5,6,7,24,52,4,2,24,52
703,2,4,2,7,6,43,24,7,6,67,76
703,3,2,5,4,9,22,-46,9,0,89,30
703,4,2,4,6,7,-76,43,3,3,13,73
703,5,5,3,8,5,53,32,6,5,66,105
703,6,4,3,9,4,-55,31,1,6,11,136
703,7,3,4,7,6,34,42,5,8,45,178
703,8,3,3,8,5,-65,-68,0,0,-20,110
703,9,3,4,5,8,32,44,2,4,12,154
703,10,3,3,5,8,32,35,4,9,44,189
703,11,4,4,8,5,44,-59,8,0,88,130
703,12,2,4,4,9,-78,45,0,5,10,175
703,13,2,4,6,7,24,43,4,8,34,218
703,14,3,3,9,4,-64,31,0,9,-30,249
703,15,2,5,2,11,20,-44,0,5,-10,205
703,16,3,4,6,7,33,43,3,8,23,248
703,17,3,4,6,7,33,-57,6,1,56,191
703,18,4,2,6,7,42,25,8,6,98,216
703,19,4,2,8,5,-56,23,2,9,42,239
703,20,3,4,7,6,34,-58,6,1,76,181
703,21,3,4,4,9,31,45,7,6,107,226
703,22,3,3,8,5,-65,32,2,8,42,258
703,23,2,5,4,9,22,-46,4,2,64,212
703,24,3,3,7,6,34,33,8,5,98,245
703,25,3,3,8,5,-65,32,3,7,33,277
703,26,4,3,8,5,44,32,7,9,77,309
703,27,2,5,6,7,-76,-48,1,1,1,261
703,28,2,5,4,9,22,54,3,5,23,315
703,29,4,2,9,4,45,22,8,7,68,337
703,30,3,3,6,7,-67,-66,1,1,1,271
703,31,2,5,4,9,22,54,3,5,23,325
703,32,3,3,7,6,34,33,7,8,57,358
703,33,2,4,7,6,-75,-58,2,0,-18,300
703,34,3,3,8,5,35,32,7,2,17,332
703,35,3,3,9,4,-64,31,3,3,-47,363
703,36,3,4,4,9,31,45,4,8,-16,408
703,37,3,3,5,8,32,-65,6,3,16,343
703,38,2,4,5,8,23,44,9,7,39,387
703,39,4,3,5,8,-59,-65,0,2,-20,322
703,40,4,3,9,4,45,31,5,3,25,353
703,41,3,3,7,6,34,33,9,6,59,386
703,42,4,3,11,2,-53,-30,6,6,6,356
703,43,2,4,3,10,21,-54,7,2,27,302
703,44,4,3,8,5,-56,32,1,4,-29,334
703,45,3,3,9,4,36,31,7,5,7,365
703,46,3,3,9,4,-64,31,3,6,-57,396
703,47,3,3,9,4,36,31,9,7,-21,427
703,48,2,5,5,8,-77,-47,2,0,-98,380
703,49,3,3,6,7,33,34,5,4,-65,414
703,50,4,3,5,8,41,35,6,9,-24,449
703,51,4,3,9,4,-55,-69,1,0,-79,380
703,52,5,2,9,4,54,22,5,2,-25,402
703,53,2,5,3,10,21,55,6,7,-4,457
703,54,3,3,6,7,33,-66,9,1,29,391
703,55,3,3,5,8,-68,35,1,6,-39,426
703,56,2,6,2,11,20,-35,1,1,-19,391
703,57,4,3,9,4,45,31,6,2,26,422
703,58,5,2,8,5,53,23,9,5,79,445
703,59,2,4,3,10,-79,-54,0,1,0,391
703,60,4,2,9,4,45,22,5,3,45,413
703,61,3,3,5,8,32,35,7,8,77,448
703,62,3,4,7,6,-66,-58,1,0,11,390
703,63,2,5,4,9,22,54,3,4,33,444
703,64,3,4,4,9,31,45,4,9,64,489
703,65,3,3,9,4,-64,-69,0,0,0,420
703,66,2,4,7,6,25,42,5,2,25,462
703,67,5,2,8,5,53,23,8,5,78,485
703,68,3,4,6,7,-67,43,1,8,11,528
704,1,2,5,5,8,23,53,3,3,23,53
704,2,5,2,7,6,52,24,5,7,75,77
704,3,5,2,9,4,54,22,9,9,129,99
704,4,2,4,6,7,-76,-57,3,2,53,42
704,5,4,3,6,7,42,34,5,6,95,76
704,6,2,4,4,9,22,-55,7,1,117,21
704,7,2,4,3,10,21,46,8,7,138,67
704,8,4,3,8,5,-56,32,2,9,82,99
704,9,4,3,8,5,44,-68,6,1,126,31
704,10,5,2,6,7,51,25,7,6,177,56
704,11,2,4,2,11,20,-53,7,3,197,3
704,12,4,4,3,10,-40,46,7,9,157,49
704,13,3,3,7,6,-66,-67,1,2,91,-18
704,14,3,4,6,7,33,43,4,5,124,25
704,15,3,3,10,3,-63,30,1,5,61,55
704,16,5,2,7,6,52,24,3,9,113,79
704,17,4,3,8,5,44,-68,7,1,157,11
704,18,5,2,8,5,-47,23,0,4,110,34
704,19,2,5,5,8,23,53,3,7,133,87
704,20,3,3,7,6,34,-67,7,0,167,20
704,21,3,4,5,8,32,44,9,4,199,64
704,22,3,3,7,6,-66,33,3,7,133,97
704,23,3,4,5,8,32,-56,5,1,165,41
704,24,3,3,5,8,32,35,7,6,197,76
704,25,3,3,7,6,-66,33,1,9,131,109
704,26,4,3,8,5,44,-68,5,1,175,41
704,27,2,5,4,9,22,54,7,5,197,95
704,28,4,3,7,6,-57,33,0,8,140,128
704,29,2,5,4,9,22,-46,2,2,162,82
704,30,2,5,3,10,21,55,3,7,183,137
704,31,4,2,7,6,43,-76,6,1,226,61
704,32,2,4,5,8,23,44,9,5,249,105
704,33,3,3,6,7,-67,34,2,9,182,139
704,34,4,2,6,7,42,-75,4,4,224,64
704,35,3,4,4,9,31,45,5,9,255,109
704,36,3,4,6,7,33,-57,8,2,288,52
704,37,2,5,5,8,-77,53,1,5,211,105
704,38,4,3,8,5,44,32,5,7,255,137
704,39,3,5,5,8,32,-47,7,0,287,90
704,40,5,2,10,3,-45,21,2,1,242,111
704,41,3,3,7,6,34,33,6,4,276,144
704,42,2,4,5,8,23,44,9,8,299,188
704,43,2,4,4,9,-78,-55,1,3,221,133
704,44,4,2,6,7,42,25,3,8,263,158
704,45,2,4,2,11,20,-53,3,5,283,105
704,46,5,2,10,3,55,21,8,6,338,126
704,47,2,5,5,8,-77,53,1,9,261,179
704,48,4,3,9,4,45,-69,6,0,306,110
704,49,4,3,8,5,-56,32,0,2,250,142
704,50,4,2,9,4,45,22,5,4,295,164
704,51,4,2,5,8,41,-74,6,0,336,90
704,52,4,3,10,3,-54,30,2,0,282,120
704,53,4,4,5,8,41,44,3,4,323,164
704,54,5,2,11,2,56,20,9,4,379,184
704,55,2,5,6,7,-76,52,3,6,303,236
704,56,4,2,9,4,45,22,8,8,348,258
704,57,3,3,7,6,-66,-67,2,1,282,191
704,58,4,3,6,7,42,34,4,5,324,225
704,59,3,3,7,6,34,33,8,8,358,258
704,60,3,4,6,7,-67,-57,1,1,291,201
704,61,2,6,3,10,21,64,2,5,312,265
704,62,4,3,6,7,42,34,4,9,354,299
704,63,2,4,6,7,24,-57,8,2,378,242
704,64,2,5,2,11,20,56,8,8,398,298
704,65,4,3,6,7,-58,-66,0,2,340,232
704,66,5,2,7,6,52,24,2,6,392,256
704,67,2,5,6,7,24,52,6,8,416,308
704,68,3,4,4,9,31,-55,7,3,447,253
704,69,3,5,3,10,30,55,7,8,477,308
704,70,3,3,5,8,32,-65,9,3,509,243
705,1,3,3,8,5,35,32,5,2,35,32
705,2,4,2,7,6,43,24,8,6,78,56
705,3,3,3,8,5,-65,32,3,8,13,88
705,4,4,2,5,8,41,-74,4,4,54,14
705,5,3,4,5,8,32,44,6,8,86,58
705,6,3,3,6,7,33,-66,9,2,119,-8
705,7,2,5,4,9,-78,54,1,6,41,46
705,8,3,3,6,7,33,-66,4,0,74,-20
705,9,2,5,6,7,24,52,8,2,98,32
705,10,4,2,8,5,-56,23,2,5,42,55
705,11,2,6,5,8,23,62,5,7,65,117
705,12,4,3,9,4,-55,31,0,8,10,148
705,13,4,3,4,9,40,-64,0,4,50,84
705,14,2,4,5,8,23,44,3,8,73,128
705,15,3,4,9,4,36,40,9,8,109,168
705,16,4,3,6,7,-58,-66,1,2,51,102
705,17,4,2,9,4,45,22,6,4,96,124
705,18,5,2,8,5,53,23,9,7,149,147
705,19,4,3,9,4,-55,31,4,8,94,178
705,20,2,5,2,11,20,-44,4,4,114,134
705,21,4,2,9,4,45,22,9,6,159,156
705,22,4,3,7,6,-57,33,2,9,102,189
705,23,5,2,7,6,52,-76,4,3,154,113
705,24,2,4,5,8,23,44,7,7,177,157
705,25,2,5,8,5,-74,50,3,7,103,207
705,26,3,4,8,5,35,41,8,8,138,248
705,27,2,4,3,10,21,-54,9,4,159,194
705,28,2,4,4,9,-78,45,1,9,81,239
705,29,3,4,7,6,34,-58,5,1,115,181
705,30,2,5,2,11,20,56,5,7,135,237
705,31,2,5,3,10,21,-45,6,2,156,192
705,32,3,5,5,8,32,53,8,5,188,245
705,33,3,3,6,7,-67,34,1,9,121,279
705,34,4,3,6,7,42,-66,3,3,163,213
705,35,4,2,8,5,44,23,7,6,207,236
705,36,5,2,9,4,-46,22,1,8,161,258
705,37,5,2,9,4,54,-78,5,0,215,180
705,38,3,4,4,9,31,45,6,5,246,225
705,39,3,3,7,6,-66,33,0,8,180,258
705,40,2,5,5,8,23,-47,3,1,203,211
705,41,3,3,6,7,33,34,6,5,236,245
705,42,2,4,6,7,-76,43,0,8,160,288
705,43,3,4,6,7,33,-57,3,1,193,231
705,44,2,5,3,10,21,55,4,6,214,286
705,45,3,3,8,5,35,32,9,8,249,318
705,46,2,5,5,8,-77,-47,2,1,172,271
705,47,4,4,8,5,44,41,6,2,216,312
705,48,3,3,8,5,-65,32,1,4,151,344
705,49,3,4,6,7,33,43,4,7,184,387
705,50,4,3,8,5,44,32,8,9,228,419
705,51,2,4,4,9,-78,-55,0,4,150,364
705,52,4,3,10,3,46,30,6,4,196,394
705,53,2,4,4,9,22,45,8,9,218,439
705,54,2,4,5,8,-77,-56,1,3,141,383
705,55,3,4,6,7,33,43,4,6,174,426
705,56,3,5,4,9,31,-46,5,0,205,380
705,57,3,4,5,8,32,44,7,4,237,424
705,58,3,3,6,7,-67,34,0,8,170,458
705,59,4,3,8,5,44,-68,4,0,214,390
705,60,4,2,7,6,43,24,7,4,257,414
705,61,4,3,8,5,-56,32,1,6,201,446
705,62,5,2,10,3,55,21,6,7,256,467
705,63,3,3,5,8,32,-65,8,2,288,402
705,64,5,2,9,4,-46,22,2,4,242,424
705,65,3,4,9,4,36,40,8,4,278,464
705,66,4,3,9,4,-55,31,3,5,223,495
705,67,5,2,9,4,54,22,7,7,277,517
706,1,3,4,5,8,32,44,2,4,32,44
706,2,5,2,7,6,52,24,4,8,84,68
706,3,2,5,5,8,23,-47,7,1,107,21
706,4,3,3,5,8,32,35,9,6,139,56
706,5,2,6,5,8,-77,62,2,8,62,118
706,6,3,4,4,9,31,-55,3,3,93,63
706,7,4,3,6,7,42,34,5,7,135,97
706,8,4,2,7,6,43,-76,8,1,178,21
706,9,4,2,10,3,-54,21,4,2,124,42
706,10,2,4,4,9,22,45,6,7,146,87
706,11,3,3,6,7,33,-66,9,1,179,21
706,12,4,2,11,2,-53,20,6,1,126,41
706,13,3,3,5,8,32,35,8,6,158,76
706,14,4,2,7,6,-57,-76,1,0,101,0
706,15,3,4,6,7,33,43,4,3,134,43
706,16,4,3,6,7,42,34,6,7,176,77
706,17,2,4,6,7,-76,-57,0,0,100,20
706,18,4,2,10,3,46,21,6,1,146,41
706,19,3,4,5,8,32,44,8,5,178,85
706,20,2,5,4,9,-78,54,0,9,100,139
706,21,2,5,4,9,22,-46,2,3,122,93
706,22,4,2,9,4,45,22,7,5,167,115
706,23,2,4,5,8,-77,44,0,9,90,159
706,24,3,4,6,7,33,-57,3,2,123,102
706,25,3,3,6,7,33,34,6,6,156,136
706,26,2,5,2,11,20,-44,6,2,176,92
706,27,3,4,5,8,32,44,8,6,208,136
706,28,2,5,4,9,-78,-46,0,0,130,90
706,29,2,4,4,9,22,45,2,5,152,135
706,30,2,5,3,10,21,-45,3,0,173,90
706,31,3,4,7,6,34,42,7,2,207,132
706,32,5,2,11,2,-44,20,3,2,163,152
706,33,2,5,2,11,20,56,3,8,183,208
706,34,4,4,6,7,42,-57,5,1,225,151
706,35,5,2,8,5,53,23,8,4,278,174
706,36,5,2,7,6,-48,24,0,8,230,198
706,37,2,4,7,6,25,-58,5,0,255,140
706,38,2,5,5,8,23,53,8,3,278,193
706,39,4,3,9,4,-55,31,3,4,223,224
706,40,2,4,3,10,21,-54,4,0,244,170
706,41,2,4,3,10,21,46,5,6,265,216
706,42,4,3,6,7,42,-66,7,0,307,150
706,43,2,4,7,6,-75,42,2,2,232,192
706,44,4,2,10,3,46,21,8,3,278,213
706,45,4,3,7,6,-57,33,1,6,221,246
706,46,5,2,9,4,54,22,5,8,275,268
706,47,3,4,4,9,31,-55,6,3,306,213
706,48,5,2,9,4,-46,22,0,5,260,235
706,49,5,2,9,4,54,22,4,7,314,257
706,50,4,3,7,6,43,-67,7,0,357,190
706,51,3,3,5,8,32,35,9,5,389,225
706,52,4,3,7,6,-57,33,2,8,332,258
706,53,3,4,6,7,33,-57,5,1,365,201
706,54,4,2,7,6,43,24,8,5,408,225
706,55,4,3,5,8,41,-65,9,0,449,160
706,56,3,3,7,6,-66,33,3,3,383,193
706,57,2,5,4,9,22,54,5,7,405,247
706,58,2,5,3,10,21,-45,6,2,426,202
706,59,4,3,5,8,41,35,7,7,467,237
706,60,6,2,12,1,-34,-20,3,7,433,217
706,61,4,2,5,8,41,-74,4,3,474,143
706,62,2,5,6,7,24,52,8,5,498,195
706,63,5,2,6,7,51,-75,9,0,549,120
707,1,2,4,4,9,22,45,2,5,22,45
707,2,5,2,9,4,54,22,6,7,76,67
707,3,2,4,7,6,-75,42,1,9,1,109
707,4,3,4,8,5,35,-59,6,0,36,50
707,5,3,4,5,8,32,44,8,4,68,94
707,6,3,4,5,8,-68,44,0,8,0,138
707,7,3,5,7,6,34,51,4,9,34,189
707,8,3,3,4,9,31,-64,5,5,65,125
707,9,4,4,6,7,42,43,7,8,107,168
707,10,3,3,5,8,32,-65,9,3,139,103
707,11,4,3,7,6,-57,33,2,6,82,136
707,12,4,3,5,8,41,-65,3,1,123,71
707,13,4,3,6,7,42,34,5,5,165,105
707,14,4,3,6,7,42,34,7,9,207,139
707,15,4,3,9,4,-55,-69,2,0,152,70
707,16,3,4,4,9,31,45,3,5,183,115
707,17,4,3,6,7,42,34,5,9,225,149
707,18,2,4,4,9,22,-55,7,4,247,94
707,19,3,4,6,7,-67,43,0,7,180,137
707,20,5,2,8,5,53,-77,3,0,233,60
707,21,3,3,6,7,33,34,6,4,266,94
707,22,4,2,7,6,43,24,9,8,309,118
707,23,5,2,5,8,50,-74,9,4,359,44
707,24,3,4,6,7,-67,43,2,7,292,87
707,25,4,3,9,4,45,31,7,8,337,118
707,26,3,4,5,8,32,-56,9,2,369,62
707,27,5,2,7,6,-48,24,1,6,321,86
707,28,5,2,11,2,56,20,7,6,377,106
707,29,4,2,5,8,41,-74,8,2,418,32
707,30,2,5,5,8,-77,53,1,5,341,85
707,31,3,4,6,7,33,43,4,8,374,128
707,32,3,3,6,7,33,-66,7,2,407,62
707,33,4,2,9,4,-55,22,2,4,352,84
707,34,3,3,6,7,33,34,5,8,385,118
707,35,3,3,5,8,32,-65,7,3,417,53
707,36,3,3,6,7,-67,34,0,7,350,87
707,37,4,2,10,3,46,21,6,8,396,108
707,38,5,2,8,5,53,-77,9,1,449,31
707,39,2,5,2,11,20,56,9,7,469,87
707,40,3,3,7,6,-66,-67,3,0,403,20
707,41,2,5,5,8,23,53,6,3,426,73
707,42,4,3,9,4,-55,31,1,4,371,104
707,43,4,2,6,7,42,25,3,9,413,129
707,44,3,4,5,8,32,-56,5,3,445,73
707,45,2,4,4,9,22,45,7,8,467,118
707,46,3,4,6,7,-67,-57,0,1,400,61
707,47,4,2,7,6,43,24,3,5,443,85
707,48,4,2,10,3,46,21,9,6,489,106
707,49,2,4,7,6,-75,42,4,8,414,148
707,50,2,5,7,6,25,51,9,9,439,199
707,51,4,3,8,5,-56,-68,3,1,383,131
707,52,3,3,5,8,32,35,5,6,415,166
707,53,5,2,10,3,-45,21,0,7,370,187
707,54,2,6,4,9,22,-37,2,0,392,150
707,55,3,3,4,9,31,36,3,6,423,186
707,56,2,5,5,8,23,53,6,9,446,239
707,57,4,3,6,7,42,-66,8,3,488,173
707,58,5,2,8,5,-47,23,1,6,441,196
707,59,3,3,9,4,36,31,7,7,477,227
707,60,3,3,4,9,31,-64,8,3,508,163
708,1,3,3,4,9,31,36,1,6,31,36
708,2,4,2,6,7,42,-75,3,1,73,-39
708,3,3,3,5,8,32,35,5,6,105,-4
708,4,4,4,7,6,43,42,8,8,148,38
708,5,2,4,5,8,-77,-56,1,2,71,-18
708,6,4,3,5,8,41,35,2,7,112,17
708,7,4,3,5,8,41,-65,3,2,153,-48
708,8,2,5,4,9,22,54,5,6,175,6
708,9,4,3,8,5,44,32,9,8,219,38
708,10,2,5,5,8,-77,-47,2,1,142,-9
708,11,4,3,7,6,43,33,5,4,185,24
708,12,3,4,5,8,32,44,7,8,217,68
708,13,3,3,6,7,-67,-66,0,2,150,2
708,14,3,3,6,7,33,34,3,6,183,36
708,15,3,3,6,7,33,-66,6,0,216,-30
708,16,3,3,6,7,33,34,9,4,249,4
708,17,2,4,3,10,-79,-54,0,0,170,-50
708,18,3,3,6,7,33,34,3,4,203,-16
708,19,5,2,8,5,53,23,6,7,256,7
708,20,3,3,8,5,-65,32,1,9,191,39
708,21,4,3,8,5,44,-68,5,1,235,-29
708,22,4,2,6,7,42,25,7,6,277,-4
708,23,3,3,7,6,-66,33,1,9,211,29
708,24,5,2,10,3,55,-79,6,0,266,-50
708,25,2,5,3,10,21,55,7,5,287,5
708,26,2,4,6,7,-76,43,1,8,211,48
708,27,2,5,4,9,22,-46,3,2,233,2
708,28,4,3,8,5,44,32,7,4,277,34
708,29,3,3,5,8,32,35,9,9,309,69
708,30,4,3,8,5,-56,-68,3,1,253,1
708,31,5,2,7,6,52,24,5,5,305,25
708,32,4,2,10,3,-54,21,1,6,251,46
708,33,4,3,9,4,45,31,6,7,296,77
708,34,5,2,11,2,-44,20,2,7,252,97
708,35,2,4,7,6,25,42,7,9,277,139
708,36,2,5,4,9,22,-46,9,3,299,93
708,37,5,3,8,5,-47,32,2,5,252,125
708,38,2,5,3,10,21,-45,3,0,273,80
708,39,2,5,6,7,24,52,7,2,297,132
708,40,2,4,6,7,-76,43,1,5,221,175
708,41,2,4,5,8,23,44,4,9,244,219
708,42,2,5,4,9,22,-46,6,3,266,173
708,43,2,4,7,6,-75,42,1,5,191,215
708,44,2,4,3,10,21,-54,2,1,212,161
708,45,3,4,7,6,34,42,6,3,246,203
708,46,3,4,6,7,33,43,9,6,279,246
708,47,2,5,3,10,-79,-45,0,1,200,201
708,48,4,3,6,7,42,34,2,5,242,235
708,49,4,3,6,7,42,34,4,9,284,269
708,50,3,3,7,6,34,-67,8,2,318,202
708,51,4,4,6,7,-58,43,0,5,260,245
708,52,3,3,4,9,31,-64,1,1,291,181
708,53,4,3,6,7,42,34,3,5,333,215
708,54,5,2,7,6,52,24,5,9,385,239
708,55,4,3,8,5,44,-68,9,1,429,171
708,56,5,2,11,2,-44,20,5,1,385,191
708,57,4,3,7,6,43,33,8,4,428,224
708,58,3,3,5,8,-68,35,0,9,360,259
708,59,3,3,8,5,35,-68,5,1,395,191
708,60,5,2,9,4,54,22,9,3,449,213
708,61,3,4,3,10,30,46,9,9,479,259
708,62,3,4,8,5,-65,-59,4,0,414,200
708,63,3,3,6,7,33,34,7,4,447,234
708,64,3,4,9,4,-64,40,3,4,383,274
708,65,2,5,5,8,23,53,6,7,406,327
708,66,3,3,8,5,-65,32,1,9,341,359
708,67,2,5,4,9,22,-46,3,3,363,313
708,68,4,3,6,7,42,34,5,7,405,347
708,69,3,4,4,9,31,-55,6,2,436,292
708,70,2,5,7,6,-75,51,1,3,361,343
708,71,3,3,6,7,33,34,4,7,394,377
708,72,3,4,8,5,35,41,9,8,429,418
708,73,4,4,7,6,-57,-58,2,0,372,360
708,74,3,4,6,7,33,43,5,3,405,403
708,75,4,2,10,3,-54,21,1,4,351,424
708,76,2,5,3,10,21,55,2,9,372,479
708,77,4,3,8,5,44,-68,6,1,416,411
708,78,3,4,3,10,30,46,6,7,446,457
708,79,3,4,4,9,31,-55,7,2,477,402
708,80,4,3,8,5,-56,32,1,4,421,434
708,81,2,5,5,8,23,53,4,7,444,487
708,82,4,2,6,7,42,-75,6,2,486,412
708,83,5,2,9,4,-46,22,0,4,440,434
708,84,4,2,8,5,44,23,4,7,484,457
708,85,3,3,5,8,32,-65,6,2,516,392
709,1,2,5,3,10,21,55,1,5,21,55
709,2,2,4,4,9,22,-55,3,0,43,0
709,3,3,4,6,7,33,43,6,3,76,43
709,4,3,3,8,5,-65,32,1,5,11,75
709,5,2,5,6,7,24,52,5,7,35,127
709,6,4,2,10,3,-54,21,1,8,-19,148
709,7,3,3,9,4,36,31,7,9,17,179
709,8,3,4,5,8,32,-56,9,3,49,123
709,9,4,3,7,6,-57,33,2,6,-8,156
709,10,4,2,8,5,44,23,6,9,36,179
709,11,2,4,3,10,21,-54,7,5,57,125
709,12,3,4,8,5,-65,41,2,6,-8,166
709,13,5,2,10,3,55,21,7,7,47,187
709,14,5,2,10,3,-45,21,2,8,2,208
709,15,3,4,5,8,32,-56,4,2,34,152
709,16,2,4,4,9,22,45,6,7,56,197
709,17,3,3,6,7,33,-66,9,1,89,131
709,18,3,3,8,5,-65,32,4,3,24,163
709,19,5,2,10,3,55,21,9,4,79,184
709,20,4,3,9,4,-55,31,4,5,24,215
709,21,4,3,8,5,44,32,8,7,68,247
709,22,5,3,8,5,-47,32,1,9,21,279
709,23,5,2,7,6,52,-76,3,3,73,203
709,24,3,4,4,9,31,45,4,8,104,248
709,25,4,2,9,4,45,-78,9,0,149,170
709,26,4,3,6,7,-58,34,1,4,91,204
709,27,3,5,3,10,30,55,1,9,121,259
709,28,3,3,4,9,31,-64,2,5,152,195
709,29,2,5,4,9,22,54,4,9,174,249
709,30,5,2,8,5,53,-77,7,2,227,172
709,31,4,3,8,5,-56,32,1,4,171,204
709,32,2,4,5,8,23,44,4,8,194,248
709,33,3,3,9,4,-64,31,0,9,130,279
709,34,4,3,8,5,44,-68,4,1,174,211
709,35,4,3,6,7,42,34,6,5,216,245
709,36,3,3,5,8,32,-65,8,0,248,180
709,37,3,3,8,5,-65,32,3,2,183,212
709,38,4,4,9,4,45,40,8,2,228,252
709,39,3,4,6,7,-67,43,1,5,161,295
709,40,3,3,10,3,37,30,8,5,198,325
709,41,3,4,5,8,-68,44,0,9,130,369
709,42,2,4,6,7,24,-57,4,2,154,312
709,43,4,3,8,5,44,32,8,4,198,344
709,44,2,4,6,7,-76,43,2,7,122,387
709,45,3,4,7,6,34,42,6,9,156,429
709,46,2,4,5,8,23,-56,9,3,179,373
709,47,4,3,7,6,-57,33,2,6,122,406
709,48,3,3,6,7,33,-66,5,0,155,340
709,49,5,2,8,5,53,23,8,3,208,363
709,50,5,2,7,6,-48,24,0,7,160,387
709,51,3,3,8,5,35,32,5,9,195,419
709,52,4,2,9,4,-55,-78,0,1,140,341
709,53,3,4,7,6,34,42,4,3,174,383
709,54,5,3,9,4,54,31,8,4,228,414
709,55,4,2,7,6,-57,24,1,8,171,438
709,56,3,4,5,8,32,-56,3,2,203,382
709,57,5,2,10,3,55,21,8,3,258,403
709,58,4,3,6,7,-58,34,0,7,200,437
709,59,2,4,3,10,21,-54,1,3,221,383
709,60,4,3,9,4,45,31,6,4,266,414
709,61,2,5,4,9,22,54,8,8,288,468
709,62,3,3,6,7,-67,-66,1,2,221,402
709,63,4,3,9,4,45,31,6,3,266,433
709,64,3,4,6,7,33,43,9,6,299,476
709,65,2,5,3,10,-79,-45,0,1,220,431
709,66,4,2,7,6,43,24,3,5,263,455
709,67,2,6,5,8,23,62,6,7,286,517
710,1,2,5,4,9,22,54,2,4,22,54
710,2,3,3,8,5,35,32,7,6,57,86
710,3,3,3,7,6,-66,33,1,9,-9,119
710,4,3,3,9,4,36,-69,7,0,27,50
710,5,3,3,8,5,-65,32,2,2,-38,82
710,6,2,4,3,10,21,46,3,8,-17,128
710,7,4,3,10,3,46,30,9,8,29,158
710,8,4,3,9,4,-55,31,4,9,-26,189
710,9,3,3,8,5,35,-68,9,1,9,121
710,10,2,4,5,8,-77,44,2,5,-68,165
710,11,4,2,8,5,44,23,6,8,-24,188
710,12,5,2,11,2,-44,20,2,8,-68,208
710,13,4,2,6,7,42,-75,4,3,-26,133
710,14,4,2,9,4,45,22,9,5,19,155
710,15,3,4,4,9,-69,-55,0,0,-50,100
710,16,4,2,7,6,43,24,3,4,-7,124
710,17,5,2,8,5,53,23,6,7,46,147
710,18,4,2,10,3,-54,21,2,8,-8,168
710,19,3,4,6,7,33,-57,5,1,25,111
710,20,4,3,8,5,44,32,9,3,69,143
710,21,2,4,2,11,20,-53,9,0,89,90
710,22,4,2,8,5,-56,23,3,3,33,113
710,23,3,3,5,8,32,35,5,8,65,148
710,24,4,3,8,5,44,-68,9,0,109,80
710,25,2,4,7,6,-75,42,4,2,34,122
710,26,5,2,11,2,-44,20,0,2,-10,142
710,27,3,3,7,6,34,33,4,5,24,175
710,28,2,5,4,9,22,54,6,9,46,229
710,29,3,4,6,7,33,-57,9,2,79,172
710,30,4,3,9,4,-55,31,4,3,24,203
710,31,4,2,10,3,-54,21,0,4,-30,224
710,32,4,3,8,5,44,32,4,6,14,256
710,33,3,4,7,6,34,42,8,8,48,298
710,34,4,3,5,8,41,-65,9,3,89,233
710,35,4,2,7,6,-57,24,2,7,32,257
710,36,5,2,7,6,52,-76,4,1,84,181
710,37,3,4,8,5,35,41,9,2,119,222
710,38,2,5,4,9,-78,54,1,6,41,276
710,39,4,2,11,2,47,20,8,6,88,296
710,40,3,4,6,7,-67,43,1,9,21,339
710,41,3,3,6,7,33,-66,4,3,54,273
710,42,4,2,7,6,43,24,7,7,97,297
710,43,4,3,8,5,-56,32,1,9,41,329
710,44,4,4,8,5,44,-59,5,0,85,270
710,45,3,3,6,7,33,34,8,4,118,304
710,46,3,5,5,8,-68,53,0,7,50,357
710,47,5,2,10,3,55,21,5,8,105,378
710,48,4,2,7,6,43,-76,8,2,148,302
710,49,3,4,5,8,-68,44,0,6,80,346
710,50,2,4,7,6,25,42,5,8,105,388
710,51,3,4,3,10,30,-54,5,4,135,334
710,52,2,4,7,6,-75,42,0,6,60,376
710,53,3,3,6,7,33,-66,3,0,93,310
710,54,3,3,8,5,35,32,8,2,128,342
710,55,3,3,6,7,-67,34,1,6,61,376
710,56,3,4,7,6,34,42,5,8,95,418
710,57,4,2,7,6,43,-76,8,2,138,342
710,58,3,4,4,9,31,45,9,7,169,387
710,59,3,3,6,7,-67,-66,2,1,102,321
710,60,2,4,5,8,23,44,5,5,125,365
710,61,3,3,8,5,-65,32,0,7,60,397
710,62,3,3,8,5,35,32,5,9,95,429
710,63,3,3,7,6,34,-67,9,2,129,362
710,64,3,3,5,8,-68,35,1,7,61,397
710,65,3,3,5,8,32,-65,3,2,93,332
710,66,2,5,3,10,21,55,4,7,114,387
710,67,4,2,9,4,45,22,9,9,159,409
710,68,2,5,5,8,-77,-47,2,2,82,362
710,69,2,4,6,7,24,43,6,5,106,405
710,70,4,3,8,5,-56,32,0,7,50,437
710,71,2,5,3,10,21,-45,1,2,71,392
710,72,3,3,6,7,33,34,4,6,104,426
710,73,3,3,4,9,31,-64,5,2,135,362
710,74,3,3,6,7,33,34,8,6,168,396
710,75,4,3,6,7,-58,-66,0,0,110,330
710,76,2,4,4,9,22,45,2,5,132,375
710,77,4,2,8,5,44,23,6,8,176,398
710,78,3,3,6,7,33,-66,9,2,209,332
710,79,4,3,8,5,-56,32,3,4,153,364
710,80,3,3,5,8,32,35,5,9,185,399
710,81,4,2,8,5,44,-77,9,2,229,322
710,82,2,4,3,10,-79,46,0,8,150,368
710,83,4,3,8,5,44,-68,4,0,194,300
710,84,2,4,4,9,22,45,6,5,216,345
710,85,4,2,7,6,43,24,9,9,259,369
710,86,2,5,2,11,20,-44,9,5,279,325
710,87,2,5,3,10,-79,-45,0,0,200,280
710,88,4,2,9,4,45,22,5,2,245,302
710,89,2,5,4,9,22,54,7,6,267,356
710,90,2,4,4,9,22,-55,9,1,289,301
710,91,4,3,8,5,-56,32,3,3,233,333
710,92,2,5,6,7,24,52,7,5,257,385
710,93,4,3,5,8,41,-65,8,0,298,320
710,94,2,5,3,10,21,55,9,5,319,375
710,95,4,2,6,7,-58,-75,1,0,261,300
710,96,3,4,3,10,30,46,1,6,291,346
710,97,4,3,7,6,43,33,4,9,334,379
710,98,3,4,6,7,33,-57,7,2,367,322
710,99,2,6,3,10,21,64,8,6,388,386
710,100,3,4,6,7,-67,43,1,9,321,429
710,101,5,2,9,4,54,-78,5,1,375,351
710,102,3,4,5,8,32,44,7,5,407,395
710,103,3,5,4,9,31,54,8,9,438,449
710,104,2,4,4,9,-78,-55,0,4,360,394
710,105,2,5,2,11,20,-44,0,0,380,350
710,106,2,4,5,8,23,44,3,4,403,394
710,107,3,4,8,5,35,41,8,5,438,435
710,108,2,4,8,5,-74,41,4,6,364,476
710,109,3,3,8,5,35,32,9,8,399,508
711,1,3,3,6,7,33,34,3,4,33,34
711,2,3,4,6,7,33,43,6,7,66,77
711,3,3,4,6,7,33,-57,9,0,99,20
711,4,5,2,7,6,-48,24,1,4,51,44
711,5,4,2,6,7,42,25,3,9,93,69
711,6,2,4,7,6,25,-58,8,1,118,11
711,7,4,2,7,6,-57,24,1,5,61,35
711,8,2,4,6,7,24,43,5,8,85,78
711,9,3,3,6,7,33,-66,8,2,118,12
711,10,2,4,6,7,-76,43,2,5,42,55
711,11,3,3,7,6,34,33,6,8,76,88
711,12,3,4,4,9,31,-55,7,3,107,33
711,13,3,3,5,8,32,35,9,8,139,68
711,14,3,4,3,10,30,-54,9,4,169,14
711,15,2,4,5,8,-77,44,2,8,92,58
711,16,3,4,4,9,31,-55,3,3,123,3
711,17,3,4,5,8,32,44,5,7,155,47
711,18,2,5,2,11,20,-44,5,3,175,3
711,19,5,2,10,3,-45,21,0,4,130,24
711,20,3,4,5,8,32,44,2,8,162,68
711,21,4,3,4,9,40,-64,2,4,202,4
711,22,5,3,5,8,50,35,2,9,252,39
711,23,4,3,8,5,44,-68,6,1,296,-29
711,24,5,2,8,5,53,23,9,4,349,-6
711,25,4,3,7,6,-57,33,2,7,292,27
711,26,3,3,8,5,35,32,7,9,327,59
711,27,2,5,3,10,21,-45,8,4,348,14
711,28,3,4,4,9,31,45,9,9,379,59
711,29,5,2,8,5,-47,-77,2,2,332,-18
711,30,4,2,6,7,42,25,4,7,374,7
711,31,3,3,6,7,33,-66,7,1,407,-59
711,32,4,2,8,5,-56,23,1,4,351,-36
711,33,3,3,9,4,36,31,7,5,387,-5
711,34,2,4,4,9,22,-55,9,0,409,-60
711,35,3,3,9,4,-64,31,5,1,345,-29
711,36,2,5,4,9,22,54,7,5,367,25
711,37,2,4,5,8,-77,44,0,9,290,69
711,38,3,3,6,7,33,-66,3,3,323,3
711,39,3,3,5,8,32,35,5,8,355,38
711,40,4,2,10,3,-54,21,1,9,301,59
711,41,4,2,9,4,45,-78,6,1,346,-19
711,42,3,4,6,7,33,43,9,4,379,24
711,43,3,3,8,5,-65,32,4,6,314,56
711,44,3,4,7,6,34,42,8,8,348,98
711,45,5,2,8,5,-47,-77,1,1,301,21
711,46,4,4,6,7,42,43,3,4,343,64
711,47,3,3,4,9,31,-64,4,0,374,0
711,48,3,4,4,9,31,45,5,5,405,45
711,49,2,4,8,5,-74,41,1,6,331,86
711,50,3,4,8,5,35,41,6,7,366,127
711,51,3,3,7,6,-66,-67,0,0,300,60
711,52,4,3,9,4,45,31,5,1,345,91
711,53,3,3,9,4,-64,31,1,2,281,122
711,54,3,3,7,6,34,33,5,5,315,155
711,55,2,6,4,9,22,63,7,8,337,218
711,56,3,4,6,7,-67,-57,0,1,270,161
711,57,3,3,3,10,30,37,0,8,300,198
711,58,4,2,7,6,43,-76,3,2,343,122
711,59,4,3,6,7,42,34,5,6,385,156
711,60,3,3,5,8,32,-65,7,1,417,91
711,61,4,3,9,4,-55,31,2,2,362,122
711,62,3,4,7,6,34,42,6,4,396,164
711,63,4,3,6,7,42,34,8,8,438,198
711,64,2,4,4,9,-78,-55,0,3,360,143
711,65,3,3,7,6,34,33,4,6,394,176
711,66,2,4,5,8,23,-56,7,0,417,120
711,67,4,3,7,6,-57,33,0,3,360,153
711,68,5,2,9,4,54,22,4,5,414,175
711,69,4,2,8,5,44,23,8,8,458,198
711,70,3,3,6,7,-67,-66,1,2,391,132
711,71,3,3,7,6,34,33,5,5,425,165
711,72,4,2,9,4,-55,22,0,7,370,187
711,73,2,4,4,9,22,-55,2,2,392,132
711,74,3,4,7,6,34,42,6,4,426,174
711,75,4,2,8,5,-56,23,0,7,370,197
711,76,3,5,8,5,35,50,5,7,405,247
711,77,2,4,6,7,24,-57,9,0,429,190
711,78,4,3,8,5,-56,32,3,2,373,222
711,79,2,4,5,8,23,44,6,6,396,266
711,80,4,3,8,5,-56,32,0,8,340,298
711,81,4,3,8,5,44,-68,4,0,384,230
711,82,3,3,6,7,33,34,7,4,417,264
711,83,3,4,5,8,32,44,9,8,449,308
711,84,3,3,7,6,-66,-67,3,1,383,241
711,85,2,5,2,11,20,56,3,7,403,297
711,86,3,3,5,8,32,-65,5,2,435,232
711,87,3,4,7,6,34,42,9,4,469,274
711,88,3,3,7,6,-66,33,3,7,403,307
711,89,4,3,8,5,44,32,7,9,447,339
711,90,4,3,9,4,-55,-69,2,0,392,270
711,91,3,3,5,8,32,35,4,5,424,305
711,92,4,3,8,5,44,32,8,7,468,337
711,93,2,5,5,8,-77,-47,1,0,391,290
711,94,2,4,3,10,21,46,2,6,412,336
711,95,3,3,8,5,35,32,7,8,447,368
711,96,3,3,8,5,-65,-68,2,0,382,300
711,97,2,4,4,9,22,45,4,5,404,345
711,98,3,4,7,6,34,42,8,7,438,387
711,99,4,3,6,7,-58,-66,0,1,380,321
711,100,3,4,4,9,31,45,1,6,411,366
711,101,3,3,6,7,33,-66,4,0,444,300
711,102,3,4,7,6,34,42,8,2,478,342
711,103,5,2,11,2,-44,20,4,2,434,362
711,104,5,2,10,3,55,21,9,3,489,383
711,105,3,4,8,5,-65,41,4,4,424,424
711,106,4,3,6,7,42,34,6,8,466,458
711,107,4,2,8,5,-56,-77,0,1,410,381
711,108,3,3,6,7,33,34,3,5,443,415
711,109,2,4,3,10,21,-54,4,1,464,361
711,110,2,4,2,11,20,47,4,8,484,408
711,111,2,4,5,8,23,-56,7,2,507,352
712,1,3,5,3,10,30,55,0,5,30,55
712,2,3,4,6,7,33,43,3,8,63,98
712,3,4,2,7,6,43,-76,6,2,106,22
712,4,3,4,4,9,31,45,7,7,137,67
712,5,4,2,6,7,42,-75,9,2,179,-8
712,6,3,3,7,6,-66,33,3,5,113,25
712,7,4,2,8,5,44,23,7,8,157,48
712,8,4,2,7,6,-57,-76,0,2,100,-28
712,9,2,5,4,9,22,54,2,6,122,26
712,10,2,5,4,9,22,-46,4,0,144,-20
712,11,2,4,6,7,24,43,8,3,168,23
712,12,3,4,5,8,-68,44,0,7,100,67
712,13,5,2,11,2,56,20,6,7,156,87
712,14,4,2,6,7,42,-75,8,2,198,12
712,15,5,2,9,4,-46,22,2,4,152,34
712,16,3,4,6,7,33,43,5,7,185,77
712,17,5,2,10,3,-45,21,0,8,140,98
712,18,5,3,6,7,51,-66,1,2,191,32
712,19,3,4,6,7,33,43,4,5,224,75
712,20,4,2,7,6,43,24,7,9,267,99
712,21,5,2,9,4,-46,-78,1,1,221,21
712,22,3,4,5,8,32,44,3,5,253,65
712,23,5,2,7,6,52,24,5,9,305,89
712,24,4,4,8,5,44,-59,9,0,349,30
712,25,2,5,5,8,-77,53,2,3,272,83
712,26,4,3,6,7,42,34,4,7,314,117
712,27,3,3,7,6,34,-67,8,0,348,50
712,28,3,3,6,7,-67,34,1,4,281,84
712,29,4,3,6,7,42,34,3,8,323,118
712,30,4,2,5,8,41,-74,4,4,364,44
712,31,3,4,5,8,32,44,6,8,396,88
712,32,3,5,7,6,-66,51,0,9,330,139
712,33,4,3,5,8,41,-65,1,4,371,74
712,34,3,4,4,9,31,45,2,9,402,119
712,35,2,5,7,6,25,-49,7,0,427,70
712,36,3,4,5,8,32,44,9,4,459,114
712,37,2,5,4,9,-78,54,1,8,381,168
712,38,3,4,5,8,32,-56,3,2,413,112
712,39,3,3,9,4,36,31,9,3,449,143
712,40,2,4,5,8,-77,44,2,7,372,187
712,41,4,2,5,8,41,-74,3,3,413,113
712,42,2,5,4,9,22,54,5,7,435,167
712,43,4,3,7,6,43,-67,8,0,478,100
712,44,3,4,4,9,31,45,9,5,509,145
713,1,3,3,7,6,34,33,4,3,34,33
713,2,3,3,4,9,31,36,5,9,65,69
713,3,2,5,2,11,20,-44,5,5,85,25
713,4,3,3,6,7,33,34,8,9,118,59
713,5,3,4,7,6,-66,-58,2,1,52,1
713,6,6,2,10,3,64,21,6,2,116,22
713,7,4,3,7,6,43,33,9,5,159,55
713,8,3,3,4,9,-69,-64,0,1,90,-9
713,9,4,3,4,9,40,36,0,7,130,27
713,10,3,3,7,6,34,-67,4,0,164,-40
713,11,2,5,3,10,21,55,5,5,185,15
713,12,5,2,11,2,-44,20,1,5,141,35
713,13,2,5,4,9,22,54,3,9,163,89
713,14,4,3,9,4,45,-69,8,0,208,20
713,15,3,4,5,8,-68,44,0,4,140,64
713,16,3,4,4,9,31,45,1,9,171,109
713,17,2,4,4,9,22,-55,3,4,193,54
713,18,2,4,5,8,23,44,6,8,216,98
713,19,4,2,9,4,-55,-78,1,0,161,20
713,20,4,3,9,4,45,31,6,1,206,51
713,21,4,3,5,8,41,35,7,6,247,86
713,22,5,2,9,4,-46,22,1,8,201,108
713,23,2,4,8,5,26,41,7,9,227,149
713,24,3,5,4,9,31,-46,8,3,258,103
713,25,2,4,6,7,-76,43,2,6,182,146
713,26,2,4,5,8,23,-56,5,0,205,90
713,27,3,4,6,7,33,43,8,3,238,133
713,28,4,3,6,7,-58,34,0,7,180,167
713,29,3,3,6,7,33,-66,3,1,213,101
713,30,2,4,6,7,24,43,7,4,237,144
713,31,4,2,7,6,-57,24,0,8,180,168
713,32,3,3,7,6,34,-67,4,1,214,101
713,33,3,4,6,7,33,43,7,4,247,144
713,34,6,2,10,3,-36,21,1,5,211,165
713,35,3,4,4,9,31,-55,2,0,242,110
713,36,4,2,8,5,44,23,6,3,286,133
713,37,5,2,9,4,-46,22,0,5,240,155
713,38,2,5,3,10,21,-45,1,0,261,110
713,39,5,2,8,5,53,23,4,3,314,133
713,40,4,2,10,3,-54,21,0,4,260,154
713,41,2,4,5,8,23,44,3,8,283,198
713,42,4,3,7,6,43,-67,6,1,326,131
713,43,2,5,5,8,23,53,9,4,349,184
713,44,2,5,4,9,-78,54,1,8,271,238
713,45,5,2,11,2,56,20,7,8,327,258
713,46,3,4,8,5,-65,41,2,9,262,299
713,47,5,2,7,6,52,-76,4,3,314,223
713,48,3,3,4,9,31,36,5,9,345,259
713,49,3,3,5,8,32,-65,7,4,377,194
713,50,3,3,5,8,32,35,9,9,409,229
713,51,3,3,7,6,-66,-67,3,2,343,162
713,52,5,2,8,5,53,23,6,5,396,185
713,53,5,2,8,5,53,23,9,8,449,208
713,54,3,4,3,10,30,-54,9,4,479,154
713,55,2,4,3,10,-79,-54,0,0,400,100
713,56,3,4,5,8,32,44,2,4,432,144
713,57,3,4,5,8,32,44,4,8,464,188
713,58,5,2,9,4,54,-78,8,0,518,110
714,1,2,4,5,8,23,44,3,4,23,44
714,2,4,3,7,6,43,33,6,7,66,77
714,3,4,3,5,8,41,-65,7,2,107,12
714,4,3,4,5,8,32,44,9,6,139,56
714,5,4,3,7,6,-57,33,2,9,82,89
714,6,4,2,8,5,44,-77,6,2,126,12
714,7,4,3,8,5,-56,32,0,4,70,44
714,8,3,4,7,6,34,42,4,6,104,86
714,9,2,5,6,7,24,52,8,8,128,138
714,10,3,4,5,8,-68,-56,0,2,60,82
714,11,4,2,7,6,43,24,3,6,103,106
714,12,2,4,5,8,23,-56,6,0,126,50
714,13,2,4,3,10,21,46,7,6,147,96
714,14,3,4,7,6,-66,42,1,8,81,138
714,15,3,3,8,5,35,-68,6,0,116,70
714,16,3,4,3,10,30,46,6,6,146,116
714,17,3,4,4,9,31,-55,7,1,177,61
714,18,3,4,6,7,-67,43,0,4,110,104
714,19,2,5,3,10,21,55,1,9,131,159
714,20,3,3,8,5,35,-68,6,1,166,91
714,21,2,4,5,8,23,44,9,5,189,135
714,22,3,3,6,7,-67,34,2,9,122,169
714,23,4,3,8,5,44,-68,6,1,166,101
714,24,3,3,6,7,33,34,9,5,199,135
714,25,4,3,8,5,-56,32,3,7,143,167
714,26,3,3,9,4,36,31,9,8,179,198
714,27,2,5,6,7,-76,-48,3,0,103,150
714,28,5,2,8,5,53,23,6,3,156,173
714,29,2,4,6,7,-76,43,0,6,80,216
714,30,3,3,4,9,31,-64,1,2,111,152
714,31,3,4,4,9,31,45,2,7,142,197
714,32,4,2,6,7,42,-75,4,2,184,122
714,33,3,4,8,5,35,41,9,3,219,163
714,34,4,4,8,5,-56,41,3,4,163,204
714,35,3,4,8,5,35,41,8,5,198,245
714,36,3,3,7,6,-66,33,2,8,132,278
714,37,4,3,6,7,42,-66,4,2,174,212
714,38,4,3,8,5,44,32,8,4,218,244
714,39,4,3,8,5,-56,32,2,6,162,276
714,40,3,4,3,10,30,-54,2,2,192,222
714,41,3,3,8,5,35,32,7,4,227,254
714,42,4,4,5,8,41,44,8,8,268,298
714,43,3,4,7,6,-66,-58,2,0,202,240
714,44,2,5,5,8,23,53,5,3,225,293
714,45,2,6,4,9,22,63,7,6,247,356
714,46,3,4,7,6,-66,42,1,8,181,398
714,47,2,4,7,6,25,-58,6,0,206,340
714,48,3,4,5,8,32,44,8,4,238,384
714,49,3,3,9,4,-64,31,4,5,174,415
714,50,4,3,8,5,44,32,8,7,218,447
714,51,4,3,5,8,41,-65,9,2,259,382
714,52,2,4,9,4,-73,40,6,2,186,422
714,53,3,3,8,5,-65,32,1,4,121,454
714,54,4,3,9,4,45,31,6,5,166,485
714,55,4,2,8,5,-56,23,0,8,110,508
715,1,4,2,9,4,45,22,5,2,45,22
715,2,4,3,6,7,42,34,7,6,87,56
715,3,4,2,6,7,42,-75,9,1,129,-19
715,4,2,5,3,10,-79,55,0,6,50,36
715,5,2,4,5,8,23,-56,3,0,73,-20
715,6,2,5,4,9,22,54,5,4,95,34
715,7,3,4,5,8,32,44,7,8,127,78
715,8,3,4,5,8,32,-56,9,2,159,22
715,9,3,4,7,6,-66,42,3,4,93,64
715,10,4,3,8,5,44,32,7,6,137,96
715,11,3,3,7,6,-66,33,1,9,71,129
715,12,3,3,8,5,35,-68,6,1,106,61
715,13,4,2,7,6,43,24,9,5,149,85
715,14,3,4,8,5,-65,41,4,6,84,126
715,15,2,5,4,9,22,-46,6,0,106,80
715,16,2,5,3,10,21,55,7,5,127,135
715,17,4,3,7,6,-57,33,0,8,70,168
715,18,4,2,8,5,44,-77,4,1,114,91
715,19,4,2,9,4,45,22,9,3,159,113
715,20,2,6,4,9,-78,63,1,6,81,176
715,21,3,4,8,5,35,41,6,7,116,217
715,22,3,4,9,4,-64,40,2,7,52,257
715,23,3,3,8,5,35,32,7,9,87,289
715,24,2,4,8,5,-74,-59,3,0,13,230
715,25,5,2,9,4,54,22,7,2,67,252
715,26,3,3,5,8,32,35,9,7,99,287
715,27,3,4,6,7,-67,-57,2,0,32,230
715,28,3,3,9,4,36,31,8,1,68,261
715,29,2,5,2,11,20,56,8,7,88,317
715,30,3,4,8,5,-65,41,3,8,23,358
715,31,5,2,8,5,53,-77,6,1,76,281
715,32,3,4,4,9,31,45,7,6,107,326
715,33,6,2,8,5,62,23,9,9,169,349
715,34,5,2,8,5,-47,-77,2,2,122,272
715,35,4,2,8,5,44,23,6,5,166,295
715,36,3,3,8,5,-65,32,1,7,101,327
715,37,3,3,7,6,34,-67,5,0,135,260
715,38,4,2,7,6,43,24,8,4,178,284
715,39,3,3,6,7,-67,34,1,8,111,318
715,40,4,2,8,5,44,-77,5,1,155,241
715,41,2,5,5,8,23,53,8,4,178,294
715,42,4,3,7,6,-57,33,1,7,121,327
715,43,3,3,7,6,34,-67,5,0,155,260
715,44,3,4,8,5,-65,41,0,1,90,301
715,45,3,4,6,7,33,43,3,4,123,344
715,46,2,4,5,8,23,44,6,8,146,388
715,47,2,4,4,9,22,-55,8,3,168,333
715,48,5,2,8,5,-47,23,1,6,121,356
715,49,5,2,9,4,54,22,5,8,175,378
715,50,3,3,8,5,-65,-68,0,0,110,310
715,51,3,4,3,10,30,46,0,6,140,356
715,52,4,3,8,5,44,32,4,8,184,388
715,53,3,3,6,7,33,-66,7,2,217,322
715,54,3,3,9,4,-64,31,3,3,153,353
715,55,3,4,6,7,33,43,6,6,186,396
715,56,4,4,4,9,40,-55,6,1,226,341
715,57,2,4,6,7,-76,43,0,4,150,384
715,58,5,2,8,5,53,23,3,7,203,407
715,59,4,3,9,4,45,31,8,8,248,438
715,60,4,3,7,6,-57,-67,1,1,191,371
715,61,3,4,5,8,32,44,3,5,223,415
715,62,4,2,8,5,44,23,7,8,267,438
715,63,5,2,6,7,51,-75,8,3,318,363
715,64,3,3,8,5,-65,32,3,5,253,395
715,65,4,3,9,4,45,31,8,6,298,426
715,66,3,4,7,6,-66,42,2,8,232,468
715,67,3,4,7,6,34,-58,6,0,266,410
715,68,4,2,9,4,-55,22,1,2,211,432
715,69,4,2,8,5,44,23,5,5,255,455
715,70,2,4,2,11,20,-53,5,2,275,402
715,71,5,2,7,6,52,24,7,6,327,426
715,72,2,5,3,10,21,-45,8,1,348,381
715,73,4,2,7,6,-57,24,1,5,291,405
715,74,3,3,6,7,33,34,4,9,324,439
715,75,3,3,8,5,35,-68,9,1,359,371
715,76,3,4,8,5,-65,41,4,2,294,412
715,77,3,4,7,6,34,42,8,4,328,454
715,78,2,4,5,8,-77,44,1,8,251,498
715,79,3,3,8,5,35,-68,6,0,286,430
715,80,4,2,9,4,-55,22,1,2,231,452
715,81,2,5,6,7,24,52,5,4,255,504
716,1,2,4,8,5,26,41,6,1,26,41
716,2,3,3,5,8,32,35,8,6,58,76
716,3,4,3,9,4,-55,31,3,7,3,107
716,4,3,3,6,7,33,-66,6,1,36,41
716,5,4,3,9,4,-55,31,1,2,-19,72
716,6,2,5,5,8,23,53,4,5,4,125
716,7,3,4,7,6,34,42,8,7,38,167
716,8,2,5,5,8,-77,-47,1,0,-39,120
716,9,3,4,6,7,33,43,4,3,-6,163
716,10,4,3,6,7,42,34,6,7,36,197
716,11,3,3,6,7,33,-66,9,1,69,131
716,12,2,4,5,8,-77,44,2,5,-8,175
716,13,2,5,4,9,22,54,4,9,14,229
716,14,2,4,6,7,24,-57,8,2,38,172
716,15,2,4,5,8,-77,44,1,6,-39,216
716,16,2,4,4,9,22,-55,3,1,-17,161
716,17,3,3,5,8,32,35,5,6,15,196
716,18,4,2,8,5,44,23,9,9,59,219
716,19,2,4,4,9,-78,-55,1,4,-19,164
716,20,3,3,7,6,34,33,5,7,15,197
716,21,4,3,7,6,43,-67,8,0,58,130
716,22,4,2,10,3,-54,21,4,1,4,151
716,23,4,3,6,7,42,34,6,5,46,185
716,24,4,3,7,6,43,33,9,8,89,218
716,25,3,4,4,9,-69,-55,0,3,20,163
716,26,3,3,9,4,36,31,6,4,56,194
716,27,4,3,10,3,-54,30,2,4,2,224
716,28,3,5,7,6,34,51,6,5,36,275
716,29,4,2,7,6,43,24,9,9,79,299
716,30,4,3,6,7,-58,-66,1,3,21,233
716,31,2,5,4,9,22,54,3,7,43,287
716,32,2,4,5,8,23,-56,6,1,66,231
716,33,3,3,5,8,32,35,8,6,98,266
716,34,3,4,6,7,-67,43,1,9,31,309
716,35,3,3,7,6,34,-67,5,2,65,242
716,36,5,2,6,7,51,25,6,7,116,267
716,37,5,2,10,3,-45,21,1,8,71,288
716,38,3,3,8,5,35,-68,6,0,106,220
716,39,2,4,3,10,21,46,7,6,127,266
716,40,2,5,4,9,22,-46,9,0,149,220
716,41,4,2,5,8,-59,26,0,6,90,246
716,42,2,4,5,8,23,-56,3,0,113,190
716,43,3,4,7,6,34,42,7,2,147,232
716,44,2,5,3,10,21,55,8,7,168,287
716,45,4,3,7,6,-57,-67,1,0,111,220
716,46,6,2,9,4,63,22,4,2,174,242
716,47,4,2,6,7,42,25,6,7,216,267
716,48,3,3,5,8,32,-65,8,2,248,202
716,49,3,4,5,8,-68,44,0,6,180,246
716,50,4,2,9,4,45,22,5,8,225,268
716,51,2,4,8,5,-74,41,1,9,151,309
716,52,5,2,9,4,54,-78,5,1,205,231
716,53,5,3,7,6,52,33,7,4,257,264
716,54,2,6,3,10,21,64,8,8,278,328
716,55,3,3,5,8,-68,-65,0,3,210,263
716,56,3,4,6,7,33,43,3,6,243,306
716,57,2,4,5,8,23,-56,6,0,266,250
716,58,3,3,6,7,33,34,9,4,299,284
716,59,3,4,6,7,-67,43,2,7,232,327
716,60,3,3,5,8,32,-65,4,2,264,262
716,61,4,3,7,6,43,33,7,5,307,295
716,62,6,2,10,3,-36,21,1,6,271,316
716,63,5,3,10,3,55,30,6,6,326,346
716,64,2,5,4,9,22,-46,8,0,348,300
716,65,5,2,9,4,-46,22,2,2,302,322
716,66,5,2,9,4,54,22,6,4,356,344
716,67,4,4,6,7,42,43,8,7,398,387
716,68,3,3,8,5,-65,32,3,9,333,419
716,69,4,2,7,6,43,-76,6,3,376,343
716,70,3,3,8,5,-65,32,1,5,311,375
716,71,3,3,5,8,32,-65,3,0,343,310
716,72,2,4,4,9,22,45,5,5,365,355
716,73,3,3,5,8,32,-65,7,0,397,290
716,74,5,2,7,6,52,24,9,4,449,314
716,75,2,5,3,10,-79,55,0,9,370,369
716,76,2,5,6,7,24,-48,4,1,394,321
716,77,2,4,8,5,-74,41,0,2,320,362
716,78,2,4,3,10,21,46,1,8,341,408
716,79,5,2,7,6,52,-76,3,2,393,332
716,80,3,3,3,10,30,37,3,9,423,369
716,81,4,3,8,5,44,-68,7,1,467,301
716,82,4,2,9,4,-55,22,2,3,412,323
716,83,3,3,6,7,33,34,5,7,445,357
716,84,2,5,5,8,23,-47,8,0,468,310
716,85,3,4,5,8,-68,44,0,4,400,354
716,86,3,3,5,8,32,35,2,9,432,389
716,87,3,3,6,7,33,-66,5,3,465,323
716,88,4,2,7,6,43,24,8,7,508,347
717,1,3,3,8,5,35,32,5,2,35,32
717,2,3,4,5,8,32,44,7,6,67,76
717,3,4,2,11,2,-53,20,4,6,14,96
717,4,3,3,5,8,32,-65,6,1,46,31
717,5,3,3,8,5,-65,32,1,3,-19,63
717,6,4,4,8,5,44,41,5,4,25,104
717,7,4,2,10,3,-54,21,1,5,-29,125
717,8,3,4,9,4,36,40,7,5,7,165
717,9,2,5,5,8,-77,53,0,8,-70,218
717,10,4,3,6,7,42,-66,2,2,-28,152
717,11,2,4,6,7,24,43,6,5,-4,195
717,12,3,4,7,6,-66,42,0,7,-70,237
717,13,5,2,8,5,53,-77,3,0,-17,160
717,14,2,5,4,9,22,54,5,4,5,214
717,15,2,4,4,9,22,45,7,9,27,259
717,16,3,3,9,4,-64,-69,3,0,-37,190
717,17,4,2,6,7,42,25,5,5,5,215
717,18,2,5,2,11,20,-44,5,1,25,171
717,19,4,2,8,5,44,23,9,4,69,194
717,20,2,4,7,6,-75,42,4,6,-6,236
717,21,3,4,6,7,33,43,7,9,27,279
717,22,4,2,8,5,-56,-77,1,2,-29,202
717,23,5,2,10,3,55,21,6,3,26,223
717,24,2,4,8,5,-74,41,2,4,-48,264
717,25,2,6,3,10,21,64,3,8,-27,328
717,26,4,2,9,4,45,-78,8,0,18,250
717,27,2,5,2,11,20,56,8,6,38,306
717,28,4,2,6,7,-58,-75,0,1,-20,231
717,29,4,3,7,6,43,33,3,4,23,264
717,30,2,4,3,10,21,-54,4,0,44,210
717,31,3,4,7,6,34,42,8,2,78,252
717,32,3,3,9,4,-64,31,4,3,14,283
717,33,5,2,8,5,53,23,7,6,67,306
717,34,3,3,3,10,30,-63,7,3,97,243
717,35,4,3,6,7,42,34,9,7,139,277
717,36,5,2,7,6,-48,-76,1,1,91,201
717,37,2,5,3,10,21,55,2,6,112,256
717,38,5,2,10,3,55,21,7,7,167,277
717,39,2,5,6,7,-76,52,1,9,91,329
717,40,2,4,3,10,21,-54,2,5,112,275
717,41,3,3,7,6,34,33,6,8,146,308
717,42,3,4,6,7,33,-57,9,1,179,251
717,43,4,3,9,4,-55,31,4,2,124,282
717,44,4,2,10,3,-54,21,0,3,70,303
717,45,3,3,6,7,33,34,3,7,103,337
717,46,3,4,4,9,31,-55,4,2,134,282
717,47,2,4,3,10,21,46,5,8,155,328
717,48,3,3,5,8,32,-65,7,3,187,263
717,49,4,2,4,9,40,-73,7,0,227,190
717,50,3,3,9,4,-64,31,3,1,163,221
717,51,4,3,8,5,44,32,7,3,207,253
717,52,4,3,9,4,-55,31,2,4,152,284
717,53,4,2,9,4,45,22,7,6,197,306
717,54,2,4,3,10,21,-54,8,2,218,252
717,55,4,2,10,3,-54,21,4,3,164,273
717,56,4,2,9,4,45,22,9,5,209,295
717,57,2,6,4,9,-78,63,1,8,131,358
717,58,2,4,3,10,21,-54,2,4,152,304
717,59,3,3,5,8,32,35,4,9,184,339
717,60,4,2,8,5,44,-77,8,2,228,262
717,61,3,3,8,5,-65,32,3,4,163,294
717,62,2,6,5,8,23,62,6,6,186,356
717,63,4,2,8,5,-56,23,0,9,130,379
717,64,3,3,6,7,33,-66,3,3,163,313
717,65,3,3,7,6,34,33,7,6,197,346
717,66,3,3,5,8,32,-65,9,1,229,281
717,67,3,4,8,5,-65,41,4,2,164,322
717,68,3,3,8,5,35,32,9,4,199,354
717,69,2,5,4,9,-78,54,1,8,121,408
717,70,5,2,10,3,55,21,6,9,176,429
717,71,2,4,5,8,23,-56,9,3,199,373
717,72,4,3,7,6,-57,33,2,6,142,406
717,73,3,4,4,9,31,-55,3,1,173,351
717,74,2,6,5,8,23,62,6,3,196,413
717,75,3,3,5,8,32,35,8,8,228,448
717,76,4,3,5,8,41,-65,9,3,269,383
717,77,2,5,3,10,-79,55,0,8,190,438
717,78,2,4,6,7,24,-57,4,1,214,381
717,79,3,4,7,6,34,42,8,3,248,423
717,80,2,4,3,10,21,46,9,9,269,469
717,81,2,4,5,8,-77,-56,2,3,192,413
717,82,2,4,6,7,24,43,6,6,216,456
717,83,5,2,8,5,53,23,9,9,269,479
717,84,2,5,3,10,-79,-45,0,4,190,434
717,85,4,2,8,5,44,23,4,7,234,457
717,86,2,5,8,5,-74,50,0,7,160,507
718,1,3,4,3,10,30,46,0,6,30,46
718,2,6,2,10,3,64,21,4,7,94,67
718,3,3,4,5,8,32,-56,6,1,126,11
718,4,5,2,11,2,-44,20,2,1,82,31
718,5,2,4,4,9,22,45,4,6,104,76
718,6,3,4,3,10,30,-54,4,2,134,22
718,7,3,3,7,6,34,33,8,5,168,55
718,8,4,3,6,7,-58,34,0,9,110,89
718,9,4,2,9,4,45,-78,5,1,155,11
718,10,2,5,5,8,23,53,8,4,178,64
718,11,5,2,9,4,-46,22,2,6,132,86
718,12,4,2,5,8,41,-74,3,2,173,12
718,13,4,3,8,5,44,32,7,4,217,44
718,14,2,4,5,8,-77,44,0,8,140,88
718,15,3,3,5,8,32,-65,2,3,172,23
718,16,2,5,5,8,23,53,5,6,195,76
718,17,3,3,6,7,33,-66,8,0,228,10
718,18,3,4,7,6,-66,42,2,2,162,52
718,19,3,4,8,5,35,41,7,3,197,93
718,20,5,2,8,5,-47,23,0,6,150,116
718,21,2,5,4,9,22,-46,2,0,172,70
718,22,2,4,5,8,23,44,5,4,195,114
718,23,3,4,4,9,31,45,6,9,226,159
718,24,2,5,7,6,-75,-49,1,0,151,110
718,25,2,5,6,7,24,52,5,2,175,162
718,26,3,4,4,9,31,45,6,7,206,207
718,27,2,5,2,11,20,-44,6,3,226,163
718,28,3,3,6,7,33,34,9,7,259,197
718,29,5,2,8,5,-47,-77,2,0,212,120
718,30,6,2,11,2,65,20,7,0,277,140
718,31,4,3,8,5,-56,32,1,2,221,172
718,32,5,2,10,3,55,21,6,3,276,193
718,33,3,4,5,8,32,44,8,7,308,237
718,34,4,3,8,5,-56,32,2,9,252,269
718,35,2,5,4,9,22,-46,4,3,274,223
718,36,5,2,8,5,53,23,7,6,327,246
718,37,3,4,5,8,32,-56,9,0,359,190
718,38,4,3,6,7,-58,34,1,4,301,224
718,39,3,4,4,9,31,45,2,9,332,269
718,40,4,3,9,4,45,-69,7,0,377,200
718,41,3,4,5,8,32,44,9,4,409,244
718,42,3,3,5,8,-68,35,1,9,341,279
718,43,4,2,5,8,41,-74,2,5,382,205
718,44,3,3,4,9,31,-64,3,1,413,141
718,45,4,3,6,7,42,34,5,5,455,175
718,46,3,3,5,8,32,-65,7,0,487,110
718,47,2,5,4,9,22,54,9,4,509,164
719,1,4,3,7,6,43,33,3,3,43,33
719,2,6,2,11,2,65,20,8,3,108,53
719,3,5,2,10,3,-45,21,3,4,63,74
719,4,4,4,7,6,43,42,6,6,106,116
719,5,5,3,9,4,-46,31,0,7,60,147
719,6,4,3,8,5,44,32,4,9,104,179
719,7,3,3,7,6,34,-67,8,2,138,112
719,8,3,4,7,6,-66,42,2,4,72,154
719,9,3,4,5,8,32,44,4,8,104,198
719,10,3,3,9,4,-64,31,0,9,40,229
719,11,3,3,5,8,32,-65,2,4,72,164
719,12,2,5,3,10,21,55,3,9,93,219
719,13,2,5,5,8,23,-47,6,2,116,172
719,14,4,2,7,6,43,24,9,6,159,196
719,15,4,3,9,4,-55,31,4,7,104,227
719,16,2,4,7,6,25,42,9,9,129,269
719,17,4,2,10,3,-54,-79,5,0,75,190
719,18,2,6,5,8,23,62,8,2,98,252
719,19,4,2,7,6,-57,24,1,6,41,276
719,20,4,4,9,4,45,40,6,6,86,316
719,21,4,2,6,7,42,-75,8,1,128,241
719,22,3,3,6,7,-67,34,1,5,61,275
719,23,2,5,4,9,22,54,3,9,83,329
719,24,5,2,9,4,54,-78,7,1,137,251
719,25,3,4,6,7,-67,43,0,4,70,294
719,26,4,3,8,5,44,32,4,6,114,326
719,27,3,3,4,9,31,-64,5,2,145,262
719,28,4,3,6,7,42,34,7,6,187,296
719,29,5,2,11,2,-44,20,3,6,143,316
719,30,3,4,5,8,32,-56,5,0,175,260
719,31,2,5,2,11,20,56,5,6,195,316
719,32,4,3,7,6,43,33,8,9,238,349
719,33,2,5,5,8,-77,-47,1,2,161,302
719,34,3,3,8,5,35,32,6,4,196,334
719,35,2,4,7,6,-75,42,1,6,121,376
719,36,3,4,4,9,31,-55,2,1,152,321
719,37,4,2,9,4,45,22,7,3,197,343
719,38,3,3,4,9,31,36,8,9,228,379
719,39,2,5,4,9,-78,-46,0,3,150,333
719,40,3,4,7,6,34,42,4,5,184,375
719,41,4,3,9,4,45,31,9,6,229,406
719,42,2,4,3,10,-79,-54,0,2,150,352
719,43,3,4,8,5,35,41,5,3,185,393
719,44,4,3,7,6,43,33,8,6,228,426
719,45,3,4,8,5,-65,41,3,7,163,467
719,46,3,3,3,10,30,-63,3,4,193,404
719,47,2,5,5,8,23,53,6,7,216,457
719,48,3,4,7,6,-66,42,0,9,150,499
719,49,4,3,8,5,44,-68,4,1,194,431
719,50,4,3,8,5,44,32,8,3,238,463
719,51,2,5,5,8,-77,53,1,6,161,516
720,1,3,3,7,6,34,33,4,3,34,33
720,2,4,4,8,5,44,41,8,4,78,74
720,3,3,3,7,6,-66,33,2,7,12,107
720,4,4,3,9,4,45,31,7,8,57,138
720,5,2,4,7,6,-75,-58,2,0,-18,80
720,6,4,3,7,6,43,33,5,3,25,113
720,7,3,3,6,7,33,34,8,7,58,147
720,8,3,4,6,7,-67,-57,1,0,-9,90
720,9,3,3,5,8,32,35,3,5,23,125
720,10,2,5,3,10,21,-45,4,0,44,80
720,11,2,4,3,10,21,46,5,6,65,126
720,12,4,2,10,3,-54,21,1,7,11,147
720,13,2,4,3,10,21,-54,2,3,32,93
720,14,3,3,9,4,36,31,8,4,68,124
720,15,3,5,7,6,-66,51,2,5,2,175
720,16,4,3,7,6,43,33,5,8,45,208
720,17,5,2,9,4,54,-78,9,0,99,130
720,18,2,4,6,7,-76,43,3,3,23,173
720,19,4,2,6,7,42,25,5,8,65,198
720,20,4,2,9,4,-55,-78,0,0,10,120
720,21,3,4,6,7,33,43,3,3,43,163
720,22,3,4,8,5,35,41,8,4,78,204
720,23,3,5,4,9,31,54,9,8,109,258
720,24,2,4,8,5,-74,41,5,9,35,299
720,25,4,4,5,8,41,-56,6,3,76,243
720,26,3,4,6,7,33,43,9,6,109,286
720,27,3,4,7,6,-66,42,3,8,43,328
720,28,3,3,7,6,34,-67,7,1,77,261
720,29,3,4,4,9,31,45,8,6,108,306
720,30,4,2,10,3,-54,21,4,7,54,327
720,31,2,5,4,9,22,-46,6,1,76,281
720,32,4,2,8,5,-56,23,0,4,20,304
720,33,2,5,3,10,21,55,1,9,41,359
720,34,3,3,5,8,32,-65,3,4,73,294
720,35,3,4,3,10,30,-54,3,0,103,240
720,36,2,6,3,10,21,64,4,4,124,304
720,37,2,4,6,7,24,43,8,7,148,347
720,38,3,4,4,9,31,-55,9,2,179,292
720,39,2,4,7,6,-75,42,4,4,104,334
720,40,2,4,2,11,20,-53,4,1,124,281
720,41,2,4,6,7,24,43,8,4,148,324
720,42,3,3,7,6,-66,33,2,7,82,357
720,43,2,4,4,9,22,-55,4,2,104,302
720,44,3,3,7,6,34,33,8,5,138,335
720,45,3,4,5,8,-68,44,0,9,70,379
720,46,3,4,9,4,36,40,6,9,106,419
720,47,3,3,6,7,33,-66,9,3,139,353
720,48,3,3,10,3,-63,30,6,3,76,383
720,49,4,3,5,8,41,35,7,8,117,418
720,50,5,2,10,3,-45,21,2,9,72,439
720,51,2,5,5,8,23,-47,5,2,95,392
720,52,3,4,7,6,34,42,9,4,129,434
720,53,4,3,7,6,-57,33,2,7,72,467
720,54,4,2,7,6,43,-76,5,1,115,391
720,55,2,4,4,9,22,45,7,6,137,436
720,56,2,4,5,8,-77,-56,0,0,60,380
720,57,4,3,5,8,41,35,1,5,101,415
720,58,4,3,9,4,45,31,6,6,146,446
720,59,4,2,10,3,-54,21,2,7,92,467
720,60,3,3,6,7,33,-66,5,1,125,401
720,61,4,3,5,8,41,35,6,6,166,436
720,62,3,3,6,7,33,-66,9,0,199,370
720,63,3,3,8,5,-65,32,4,2,134,402
720,64,3,3,6,7,33,34,7,6,167,436
720,65,3,4,5,8,32,-56,9,0,199,380
720,66,3,3,6,7,-67,34,2,4,132,414
720,67,3,5,4,9,31,54,3,8,163,468
720,68,3,4,5,8,32,-56,5,2,195,412
720,69,5,2,7,6,52,24,7,6,247,436
720,70,3,4,6,7,-67,43,0,9,180,479
720,71,3,3,6,7,33,-66,3,3,213,413
720,72,3,3,7,6,34,33,7,6,247,446
720,73,3,3,8,5,-65,32,2,8,182,478
720,74,3,3,8,5,35,-68,7,0,217,410
720,75,2,4,4,9,22,45,9,5,239,455
720,76,2,4,7,6,-75,42,4,7,164,497
720,77,4,3,9,4,45,31,9,8,209,528
721,1,3,3,9,4,36,31,6,1,36,31
721,2,4,2,10,3,-54,21,2,2,-18,52
721,3,4,3,6,7,42,34,4,6,24,86
721,4,2,4,4,9,22,-55,6,1,46,31
721,5,3,3,7,6,-66,33,0,4,-20,64
721,6,3,3,6,7,33,34,3,8,13,98
721,7,2,5,4,9,22,-46,5,2,35,52
721,8,3,3,3,10,30,37,5,9,65,89
721,9,4,2,10,3,-54,-79,1,0,11,10
721,10,4,2,7,6,43,24,4,4,54,34
721,11,3,3,10,3,-63,30,1,4,-9,64
721,12,2,5,6,7,24,52,5,6,15,116
721,13,4,3,7,6,43,33,8,9,58,149
721,14,4,2,8,5,-56,-77,2,2,2,72
721,15,5,2,9,4,54,22,6,4,56,94
721,16,4,2,7,6,43,24,9,8,99,118
721,17,2,4,7,6,-75,-58,4,0,24,60
721,18,5,2,7,6,52,24,6,4,76,84
721,19,5,3,7,6,52,33,8,7,128,117
721,20,4,3,6,7,-58,-66,0,1,70,51
721,21,3,3,6,7,33,34,3,5,103,85
721,22,3,3,7,6,34,33,7,8,137,118
721,23,3,3,7,6,-66,-67,1,1,71,51
721,24,3,3,7,6,34,33,5,4,105,84
721,25,4,3,8,5,44,32,9,6,149,116
721,26,4,2,9,4,-55,22,4,8,94,138
721,27,4,2,6,7,42,-75,6,3,136,63
721,28,4,3,8,5,-56,32,0,5,80,95
721,29,3,3,8,5,35,32,5,7,115,127
721,30,2,6,4,9,22,-37,7,0,137,90
721,31,6,2,10,3,-36,21,1,1,101,111
721,32,4,3,8,5,44,32,5,3,145,143
721,33,3,3,5,8,32,35,7,8,177,178
721,34,3,4,5,8,32,-56,9,2,209,122
721,35,2,5,4,9,-78,54,1,6,131,176
721,36,3,4,5,8,32,-56,3,0,163,120
721,37,3,3,7,6,34,33,7,3,197,153
721,38,3,3,5,8,32,35,9,8,229,188
721,39,3,4,6,7,-67,-57,2,1,162,131
721,40,3,3,5,8,32,35,4,6,194,166
721,41,4,2,8,5,44,23,8,9,238,189
721,42,2,4,8,5,-74,-59,4,0,164,130
721,43,2,5,3,10,21,55,5,5,185,185
721,44,6,2,11,2,-35,20,0,5,150,205
721,45,5,2,9,4,54,22,4,7,204,227
721,46,3,3,7,6,34,-67,8,0,238,160
721,47,3,4,6,7,-67,43,1,3,171,203
721,48,2,5,5,8,23,53,4,6,194,256
721,49,4,3,8,5,44,32,8,8,238,288
721,50,5,2,9,4,-46,-78,2,0,192,210
721,51,2,6,4,9,22,63,4,3,214,273
721,52,2,5,3,10,21,55,5,8,235,328
721,53,2,5,5,8,23,-47,8,1,258,281
721,54,5,2,11,2,-44,20,4,1,214,301
721,55,4,2,8,5,44,23,8,4,258,324
721,56,3,3,7,6,-66,33,2,7,192,357
721,57,4,3,6,7,42,-66,4,1,234,291
721,58,4,4,6,7,42,43,6,4,276,334
721,59,4,3,8,5,-56,32,0,6,220,366
721,60,3,3,8,5,35,32,5,8,255,398
721,61,4,3,9,4,-55,31,0,9,200,429
721,62,3,3,5,8,32,-65,2,4,232,364
721,63,3,3,7,6,34,33,6,7,266,397
721,64,4,2,7,6,43,-76,9,1,309,321
721,65,4,2,8,5,-56,23,3,4,253,344
721,66,4,2,7,6,43,24,6,8,296,368
721,67,2,4,3,10,21,-54,7,4,317,314
721,68,3,3,6,7,-67,34,0,8,250,348
721,69,3,3,7,6,34,-67,4,1,284,281
721,70,2,6,3,10,21,64,5,5,305,345
721,71,3,3,8,5,-65,32,0,7,240,377
721,72,3,3,5,8,32,-65,2,2,272,312
721,73,3,4,6,7,33,43,5,5,305,355
721,74,2,4,6,7,24,43,9,8,329,398
721,75,3,5,6,7,-67,-48,2,0,262,350
721,76,4,2,6,7,42,25,4,5,304,375
721,77,4,3,8,5,44,32,8,7,348,407
721,78,3,4,7,6,-66,42,2,9,282,449
721,79,4,3,8,5,44,-68,6,1,326,381
721,80,3,3,9,4,-64,31,2,2,262,412
721,81,4,3,4,9,40,36,2,8,302,448
721,82,3,3,10,3,37,30,9,8,339,478
721,83,3,4,7,6,-66,-58,3,0,273,420
721,84,4,2,8,5,44,23,7,3,317,443
721,85,3,3,6,7,-67,34,0,7,250,477
721,86,5,2,7,6,52,-76,2,1,302,401
721,87,2,4,8,5,26,41,8,2,328,442
721,88,2,4,6,7,-76,43,2,5,252,485
721,89,3,3,6,7,33,34,5,9,285,519
722,1,3,4,5,8,32,44,2,4,32,44
722,2,3,3,5,8,32,35,4,9,64,79
722,3,4,3,6,7,42,-66,6,3,106,13
722,4,4,2,10,3,-54,21,2,4,52,34
722,5,4,3,8,5,44,32,6,6,96,66
722,6,2,4,6,7,-76,43,0,9,20,109
722,7,2,5,3,10,21,-45,1,4,41,64
722,8,4,2,5,8,41,-74,2,0,82,-10
722,9,2,4,6,7,24,43,6,3,106,33
722,10,2,4,5,8,23,44,9,7,129,77
722,11,3,3,6,7,-67,-66,2,1,62,11
722,12,3,4,4,9,31,45,3,6,93,56
722,13,4,2,4,9,40,-73,3,3,133,-17
722,14,4,3,9,4,45,31,8,4,178,14
722,15,5,3,9,4,-46,31,2,5,132,45
722,16,2,4,5,8,23,44,5,9,155,89
722,17,2,4,7,6,-75,-58,0,1,80,31
722,18,3,3,9,4,36,31,6,2,116,62
722,19,4,3,7,6,43,33,9,5,159,95
722,20,3,3,8,5,-65,32,4,7,94,127
722,21,4,2,6,7,42,-75,6,2,136,52
722,22,3,4,5,8,32,44,8,6,168,96
722,23,3,3,9,4,-64,31,4,7,104,127
722,24,4,3,8,5,44,32,8,9,148,159
722,25,2,4,5,8,-77,-56,1,3,71,103
722,26,2,4,5,8,23,44,4,7,94,147
722,27,4,2,9,4,45,22,9,9,139,169
722,28,3,3,8,5,-65,-68,4,1,74,101
722,29,4,3,7,6,43,33,7,4,117,134
722,30,4,3,6,7,42,34,9,8,159,168
722,31,3,4,5,8,-68,-56,1,2,91,112
722,32,3,4,8,5,35,41,6,3,126,153
722,33,4,3,8,5,-56,32,0,5,70,185
722,34,3,4,6,7,33,43,3,8,103,228
722,35,3,3,6,7,33,-66,6,2,136,162
722,36,3,4,4,9,31,45,7,7,167,207
722,37,3,3,4,9,31,-64,8,3,198,143
722,38,4,2,8,5,-56,23,2,6,142,166
722,39,3,4,5,8,32,-56,4,0,174,110
722,40,3,3,9,4,-64,31,0,1,110,141
722,41,3,3,7,6,34,33,4,4,144,174
722,42,3,3,5,8,32,35,6,9,176,209
722,43,2,6,5,8,23,-38,9,1,199,171
722,44,4,2,7,6,-57,24,2,5,142,195
722,45,2,4,6,7,24,43,6,8,166,238
722,46,5,2,8,5,53,-77,9,1,219,161
722,47,3,3,5,8,-68,35,1,6,151,196
722,48,2,5,4,9,22,-46,3,0,173,150
722,49,6,2,8,5,62,23,5,3,235,173
722,50,3,4,4,9,31,45,6,8,266,218
722,51,4,2,6,7,42,-75,8,3,308,143
722,52,4,3,6,7,-58,34,0,7,250,177
722,53,2,5,3,10,21,-45,1,2,271,132
722,54,2,5,4,9,22,54,3,6,293,186
722,55,3,5,4,9,31,-46,4,0,324,140
722,56,5,2,8,5,53,23,7,3,377,163
722,57,6,2,10,3,-36,21,1,4,341,184
722,58,2,4,7,6,25,42,6,6,366,226
722,59,4,2,6,7,42,-75,8,1,408,151
722,60,3,3,4,9,31,36,9,7,439,187
722,61,3,3,4,9,-69,-64,0,3,370,123
722,62,4,3,7,6,43,33,3,6,413,156
722,63,3,4,3,10,30,-54,3,2,443,102
722,64,2,5,3,10,21,55,4,7,464,157
722,65,4,3,10,3,-54,30,0,7,410,187
722,66,4,3,6,7,42,-66,2,1,452,121
722,67,3,3,4,9,31,36,3,7,483,157
722,68,5,2,9,4,54,22,7,9,537,179
723,1,3,4,8,5,35,41,5,1,35,41
723,2,3,3,7,6,34,33,9,4,69,74
723,3,3,3,6,7,-67,34,2,8,2,108
723,4,3,4,8,5,35,41,7,9,37,149
723,5,5,2,7,6,52,-76,9,3,89,73
723,6,4,4,5,8,-59,44,0,7,30,117
723,7,4,3,8,5,44,32,4,9,74,149
723,8,3,4,4,9,31,-55,5,4,105,94
723,9,2,4,4,9,22,45,7,9,127,139
723,10,4,3,10,3,-54,30,3,9,73,169
723,11,3,4,5,8,32,-56,5,3,105,113
723,12,3,3,9,4,-64,31,1,4,41,144
723,13,2,4,4,9,22,45,3,9,63,189
723,14,2,5,3,10,21,-45,4,4,84,144
723,15,3,4,7,6,34,42,8,6,118,186
723,16,3,3,5,8,-68,-65,0,1,50,121
723,17,3,3,6,7,33,34,3,5,83,155
723,18,4,3,7,6,43,33,6,8,126,188
723,19,2,5,5,8,23,-47,9,1,149,141
723,20,2,5,4,9,-78,54,1,5,71,195
723,21,4,2,8,5,44,23,5,8,115,218
723,22,4,3,7,6,43,-67,8,1,158,151
723,23,3,4,5,8,-68,44,0,5,90,195
723,24,4,2,6,7,42,-75,2,0,132,120
723,25,5,2,9,4,54,22,6,2,186,142
723,26,2,4,4,9,22,45,8,7,208,187
723,27,4,3,8,5,-56,32,2,9,152,219
723,28,4,2,8,5,44,-77,6,2,196,142
723,29,4,3,10,3,-54,30,2,2,142,172
723,30,2,4,2,11,20,47,2,9,162,219
723,31,2,4,5,8,23,-56,5,3,185,163
723,32,2,5,4,9,22,54,7,7,207,217
723,33,4,3,7,6,-57,-67,0,0,150,150
723,34,2,5,6,7,24,52,4,2,174,202
723,35,3,4,5,8,32,44,6,6,206,246
723,36,4,4,5,8,41,-56,7,0,247,190
723,37,3,3,6,7,-67,34,0,4,180,224
723,38,3,3,8,5,35,32,5,6,215,256
723,39,2,5,2,11,20,-44,5,2,235,212
723,40,3,3,6,7,33,34,8,6,268,246
723,41,3,4,7,6,-66,42,2,8,202,288
723,42,3,4,4,9,31,-55,3,3,233,233
723,43,3,4,4,9,31,45,4,8,264,278
723,44,5,3,8,5,53,-68,7,0,317,210
723,45,2,5,4,9,22,54,9,4,339,264
723,46,5,2,9,4,-46,22,3,6,293,286
723,47,6,2,10,3,64,21,7,7,357,307
723,48,3,4,6,7,-67,-57,0,0,290,250
723,49,5,2,7,6,52,24,2,4,342,274
723,50,3,3,6,7,33,34,5,8,375,308
723,51,3,4,4,9,31,-55,6,3,406,253
723,52,3,4,5,8,32,44,8,7,438,297
723,53,3,4,6,7,-67,-57,1,0,371,240
723,54,2,4,5,8,23,44,4,4,394,284
723,55,2,4,7,6,25,42,9,6,419,326
723,56,3,4,6,7,-67,43,2,9,352,369
723,57,3,4,6,7,33,-57,5,2,385,312
723,58,5,3,6,7,51,34,6,6,436,346
723,59,3,4,3,10,30,-54,6,2,466,292
723,60,3,5,4,9,31,54,7,6,497,346
723,61,4,2,10,3,-54,21,3,7,443,367
723,62,3,4,4,9,31,-55,4,2,474,312
723,63,3,4,7,6,34,42,8,4,508,354
724,1,3,3,6,7,33,34,3,4,33,34
724,2,6,2,11,2,65,20,8,4,98,54
724,3,2,4,4,9,-78,45,0,9,20,99
724,4,3,3,7,6,34,-67,4,2,54,32
724,5,3,4,6,7,33,43,7,5,87,75
724,6,2,4,5,8,-77,44,0,9,10,119
724,7,2,4,4,9,22,-55,2,4,32,64
724,8,2,4,4,9,22,45,4,9,54,109
724,9,4,2,7,6,43,-76,7,3,97,33
724,10,2,4,4,9,22,45,9,8,119,78
724,11,2,4,6,7,-76,-57,3,1,43,21
724,12,4,3,9,4,45,31,8,2,88,52
724,13,3,3,5,8,-68,35,0,7,20,87
724,14,3,5,5,8,32,-47,2,0,52,40
724,15,4,2,8,5,44,23,6,3,96,63
724,16,4,3,10,3,-54,30,2,3,42,93
724,17,3,3,6,7,33,34,5,7,75,127
724,18,3,4,7,6,34,42,9,9,109,169
724,19,4,3,7,6,-57,-67,2,2,52,102
724,20,3,3,9,4,36,31,8,3,88,133
724,21,2,5,3,10,21,55,9,8,109,188
724,22,3,3,7,6,-66,-67,3,1,43,121
724,23,4,3,9,4,45,31,8,2,88,152
724,24,3,3,7,6,-66,33,2,5,22,185
724,25,5,2,9,4,54,22,6,7,76,207
724,26,3,3,7,6,-66,-67,0,0,10,140
724,27,3,3,6,7,33,34,3,4,43,174
724,28,4,3,7,6,43,33,6,7,86,207
724,29,3,4,5,8,32,-56,8,1,118,151
724,30,3,3,9,4,-64,31,4,2,54,182
724,31,4,2,6,7,42,25,6,7,96,207
724,32,4,3,8,5,-56,32,0,9,40,239
724,33,3,4,6,7,33,-57,3,2,73,182
724,34,3,4,7,6,34,42,7,4,107,224
724,35,2,5,3,10,21,55,8,9,128,279
724,36,3,4,6,7,-67,-57,1,2,61,222
724,37,4,3,9,4,45,31,6,3,106,253
724,38,3,3,9,4,-64,31,2,4,42,284
724,39,4,3,7,6,43,33,5,7,85,317
724,40,3,4,8,5,-65,41,0,8,20,358
724,41,3,3,5,8,32,-65,2,3,52,293
724,42,3,4,5,8,32,44,4,7,84,337
724,43,3,3,7,6,34,-67,8,0,118,270
724,44,3,4,8,5,-65,41,3,1,53,311
724,45,3,4,5,8,32,44,5,5,85,355
724,46,3,3,7,6,34,33,9,8,119,388
724,47,2,5,4,9,-78,-46,1,2,41,342
724,48,4,3,9,4,45,31,6,3,86,373
724,49,2,4,5,8,23,44,9,7,109,417
724,50,3,4,5,8,-68,-56,1,1,41,361
724,51,3,3,7,6,34,33,5,4,75,394
724,52,2,5,6,7,24,52,9,6,99,446
724,53,3,3,8,5,-65,32,4,8,34,478
724,54,3,4,7,6,34,-58,8,0,68,420
724,55,5,2,8,5,-47,23,1,3,21,443
724,56,3,3,9,4,36,31,7,4,57,474
724,57,4,3,9,4,-55,31,2,5,2,505
725,1,2,4,4,9,22,45,2,5,22,45
725,2,2,4,4,9,22,-55,4,0,44,-10
725,3,3,3,6,7,33,34,7,4,77,24
725,4,2,4,6,7,-76,43,1,7,1,67
725,5,3,4,3,10,30,-54,1,3,31,13
725,6,4,3,5,8,41,35,2,8,72,48
725,7,4,3,6,7,42,-66,4,2,114,-18
725,8,2,4,8,5,-74,41,0,3,40,23
725,9,3,4,8,5,35,41,5,4,75,64
725,10,3,4,6,7,33,43,8,7,108,107
725,11,2,4,4,9,-78,-55,0,2,30,52
725,12,2,5,6,7,24,52,4,4,54,104
725,13,4,3,10,3,-54,30,0,4,0,134
725,14,2,4,3,10,21,-54,1,0,21,80
725,15,4,2,9,4,45,22,6,2,66,102
725,16,3,4,5,8,32,44,8,6,98,146
725,17,3,4,3,10,30,-54,8,2,128,92
725,18,4,3,7,6,-57,33,1,5,71,125
725,19,3,3,10,3,37,30,8,5,108,155
725,20,2,4,3,10,21,-54,9,1,129,101
725,21,3,4,7,6,-66,42,3,3,63,143
725,22,3,3,8,5,35,32,8,5,98,175
725,23,4,3,7,6,-57,33,1,8,41,208
725,24,3,3,8,5,35,-68,6,0,76,140
725,25,3,3,7,6,-66,33,0,3,10,173
725,26,4,3,8,5,44,32,4,5,54,205
725,27,2,5,4,9,22,54,6,9,76,259
725,28,5,2,10,3,-45,-79,1,0,31,180
725,29,5,2,10,3,55,21,6,1,86,201
725,30,2,4,8,5,-74,41,2,2,12,242
725,31,2,4,5,8,23,44,5,6,35,286
725,32,3,4,3,10,30,-54,5,2,65,232
725,33,4,3,6,7,42,34,7,6,107,266
725,34,3,3,8,5,-65,32,2,8,42,298
725,35,4,3,5,8,41,-65,3,3,83,233
725,36,3,3,7,6,34,33,7,6,117,266
725,37,4,3,9,4,-55,31,2,7,62,297
725,38,3,5,5,8,32,-47,4,0,94,250
725,39,4,3,9,4,45,31,9,1,139,281
725,40,4,3,9,4,-55,31,4,2,84,312
725,41,3,4,5,8,32,44,6,6,116,356
725,42,2,5,4,9,22,-46,8,0,138,310
725,43,4,2,8,5,-56,23,2,3,82,333
725,44,4,3,5,8,41,35,3,8,123,368
725,45,3,3,7,6,34,-67,7,1,157,301
725,46,4,3,8,5,-56,32,1,3,101,333
725,47,4,3,5,8,41,35,2,8,142,368
725,48,2,5,6,7,24,-48,6,0,166,320
725,49,4,3,7,6,43,33,9,3,209,353
725,50,4,2,5,8,-59,26,0,9,150,379
725,51,3,3,8,5,35,-68,5,1,185,311
725,52,2,5,3,10,21,55,6,6,206,366
725,53,4,3,8,5,-56,32,0,8,150,398
725,54,2,4,8,5,26,41,6,9,176,439
725,55,4,3,8,5,-56,-68,0,1,120,371
725,56,3,4,7,6,34,42,4,3,154,413
725,57,2,4,6,7,24,43,8,6,178,456
725,58,4,3,8,5,-56,32,2,8,122,488
725,59,2,5,6,7,24,-48,6,0,146,440
725,60,4,2,6,7,42,25,8,5,188,465
725,61,4,2,7,6,-57,24,1,9,131,489
725,62,3,4,4,9,31,-55,2,4,162,434
725,63,3,4,4,9,31,45,3,9,193,479
725,64,3,3,5,8,32,-65,5,4,225,414
725,65,3,3,9,4,-64,31,1,5,161,445
725,66,4,2,8,5,44,23,5,8,205,468
725,67,6,2,10,3,64,21,9,9,269,489
725,68,3,4,8,5,-65,-59,4,0,204,430
725,69,3,3,7,6,34,33,8,3,238,463
725,70,2,4,3,10,21,46,9,9,259,509
726,1,4,3,6,7,42,34,2,4,42,34
726,2,3,3,6,7,33,34,5,8,75,68
726,3,2,4,6,7,24,-57,9,1,99,11
726,4,5,2,9,4,-46,22,3,3,53,33
726,5,2,4,7,6,25,42,8,5,78,75
726,6,4,3,6,7,-58,34,0,9,20,109
726,7,4,2,6,7,42,-75,2,4,62,34
726,8,5,2,10,3,55,21,7,5,117,55
726,9,4,2,9,4,-55,22,2,7,62,77
726,10,4,4,8,5,44,41,6,8,106,118
726,11,5,2,9,4,-46,-78,0,0,60,40
726,12,3,3,5,8,32,35,2,5,92,75
726,13,4,2,9,4,45,22,7,7,137,97
726,14,3,5,5,8,32,-47,9,0,169,50
726,15,2,5,4,9,-78,54,1,4,91,104
726,16,3,3,10,3,37,30,8,4,128,134
726,17,3,4,5,8,-68,44,0,8,60,178
726,18,2,5,2,11,20,-44,0,4,80,134
726,19,4,3,9,4,45,31,5,5,125,165
726,20,3,3,8,5,-65,32,0,7,60,197
726,21,4,3,6,7,42,-66,2,1,102,131
726,22,2,4,6,7,24,43,6,4,126,174
726,23,3,4,7,6,-66,42,0,6,60,216
726,24,3,4,4,9,31,-55,1,1,91,161
726,25,5,2,9,4,54,22,5,3,145,183
726,26,2,6,3,10,21,64,6,7,166,247
726,27,4,2,6,7,42,-75,8,2,208,172
726,28,2,5,3,10,21,55,9,7,229,227
726,29,3,3,4,9,-69,-64,0,3,160,163
726,30,4,2,7,6,43,24,3,7,203,187
726,31,3,4,7,6,34,42,7,9,237,229
726,32,4,2,9,4,-55,-78,2,1,182,151
726,33,2,5,4,9,22,54,4,5,204,205
726,34,2,4,7,6,25,42,9,7,229,247
726,35,2,5,5,8,-77,-47,2,0,152,200
726,36,4,3,6,7,42,34,4,4,194,234
726,37,2,5,6,7,24,52,8,6,218,286
726,38,5,2,8,5,-47,23,1,9,171,309
726,39,3,3,9,4,36,-69,7,0,207,240
726,40,4,2,9,4,-55,22,2,2,152,262
726,41,3,3,5,8,32,35,4,7,184,297
726,42,4,2,7,6,43,-76,7,1,227,221
726,43,4,2,10,3,-54,21,3,2,173,242
726,44,3,3,8,5,35,32,8,4,208,274
726,45,3,4,6,7,-67,43,1,7,141,317
726,46,4,3,7,6,43,-67,4,0,184,250
726,47,3,4,8,5,35,41,9,1,219,291
726,48,4,3,8,5,-56,32,3,3,163,323
726,49,2,5,4,9,22,54,5,7,185,377
726,50,3,4,5,8,32,-56,7,1,217,321
726,51,3,3,8,5,-65,32,2,3,152,353
726,52,3,4,5,8,32,44,4,7,184,397
726,53,2,5,6,7,24,52,8,9,208,449
726,54,2,4,8,5,-74,-59,4,0,134,390
726,55,3,3,6,7,33,34,7,4,167,424
726,56,4,3,7,6,-57,33,0,7,110,457
726,57,2,4,4,9,22,-55,2,2,132,402
726,58,3,4,7,6,34,42,6,4,166,444
726,59,4,2,7,6,43,24,9,8,209,468
726,60,3,4,7,6,-66,-58,3,0,143,410
726,61,3,3,7,6,34,33,7,3,177,443
726,62,4,2,6,7,42,25,9,8,219,468
726,63,2,5,3,10,-79,-45,0,3,140,423
726,64,4,2,5,8,41,26,1,9,181,449
726,65,2,5,3,10,21,-45,2,4,202,404
726,66,4,3,8,5,44,32,6,6,246,436
726,67,2,4,3,10,21,-54,7,2,267,382
726,68,4,3,8,5,-56,32,1,4,211,414
726,69,4,2,6,7,42,25,3,9,253,439
726,70,5,2,8,5,53,-77,6,2,306,362
726,71,2,5,3,10,21,55,7,7,327,417
726,72,3,3,6,7,-67,-66,0,1,260,351
726,73,4,2,7,6,43,24,3,5,303,375
726,74,3,3,6,7,33,34,6,9,336,409
726,75,4,3,7,6,43,-67,9,2,379,342
726,76,2,4,5,8,-77,44,2,6,302,386
726,77,4,3,7,6,43,33,5,9,345,419
726,78,4,3,7,6,43,-67,8,2,388,352
726,79,3,4,6,7,-67,43,1,5,321,395
726,80,3,4,6,7,33,43,4,8,354,438
726,81,2,5,6,7,24,-48,8,0,378,390
726,82,3,3,7,6,-66,33,2,3,312,423
726,83,4,3,8,5,44,32,6,5,356,455
726,84,4,3,9,4,-55,31,1,6,301,486
726,85,4,2,8,5,44,23,5,9,345,509
727,1,4,2,9,4,45,22,5,2,45,22
727,2,2,6,6,7,24,61,9,3,69,83
727,3,2,4,6,7,-76,43,3,6,-7,126
727,4,3,4,6,7,33,43,6,9,26,169
727,5,5,3,9,4,-46,-69,0,0,-20,100
727,6,2,4,5,8,23,44,3,4,3,144
727,7,4,2,7,6,43,24,6,8,46,168
727,8,4,3,9,4,-55,31,1,9,-9,199
727,9,6,2,11,2,65,20,6,9,56,219
727,10,3,4,4,9,31,-55,7,4,87,164
727,11,2,4,4,9,22,45,9,9,109,209
727,12,2,5,4,9,-78,-46,1,3,31,163
727,13,2,5,4,9,22,54,3,7,53,217
727,14,2,4,4,9,22,-55,5,2,75,162
727,15,3,4,4,9,31,45,6,7,106,207
727,16,2,5,2,11,20,-44,6,3,126,163
727,17,3,4,5,8,32,44,8,7,158,207
727,18,5,2,7,6,-48,-76,0,1,110,131
727,19,4,2,8,5,44,23,4,4,154,154
727,20,5,2,10,3,55,21,9,5,209,175
727,21,3,4,4,9,-69,-55,0,0,140,120
727,22,2,4,6,7,24,43,4,3,164,163
727,23,4,2,8,5,44,23,8,6,208,186
727,24,3,5,3,10,30,-45,8,1,238,141
727,25,4,2,4,9,40,27,8,8,278,168
727,26,3,3,4,9,31,-64,9,4,309,104
727,27,2,4,4,9,-78,45,1,9,231,149
727,28,4,3,9,4,45,-69,6,0,276,80
727,29,2,6,3,10,21,64,7,4,297,144
727,30,3,3,8,5,-65,32,2,6,232,176
727,31,3,4,7,6,34,42,6,8,266,218
727,32,2,5,3,10,21,-45,7,3,287,173
727,33,4,3,5,8,41,35,8,8,328,208
727,34,4,3,8,5,-56,-68,2,0,272,140
727,35,4,3,10,3,46,30,8,0,318,170
727,36,3,3,7,6,-66,33,2,3,252,203
727,37,3,4,4,9,31,45,3,8,283,248
727,38,3,3,6,7,33,-66,6,2,316,182
727,39,3,4,4,9,31,45,7,7,347,227
727,40,4,3,9,4,-55,31,2,8,292,258
727,41,2,4,5,8,23,-56,5,2,315,202
727,42,5,2,10,3,-45,21,0,3,270,223
727,43,2,4,4,9,22,45,2,8,292,268
727,44,5,2,10,3,55,21,7,9,347,289
727,45,3,4,8,5,-65,-59,2,0,282,230
727,46,2,5,7,6,25,51,7,1,307,281
727,47,3,3,7,6,-66,33,1,4,241,314
727,48,5,2,11,2,56,20,7,4,297,334
727,49,2,5,3,10,21,55,8,9,318,389
727,50,4,2,8,5,-56,-77,2,2,262,312
727,51,2,4,6,7,24,43,6,5,286,355
727,52,4,2,8,5,-56,23,0,8,230,378
727,53,4,2,8,5,44,-77,4,1,274,301
727,54,4,2,6,7,42,25,6,6,316,326
727,55,4,3,8,5,-56,32,0,8,260,358
727,56,3,4,5,8,32,-56,2,2,292,302
727,57,4,2,10,3,46,21,8,3,338,323
727,58,2,5,6,7,-76,52,2,5,262,375
727,59,3,4,6,7,33,43,5,8,295,418
727,60,4,2,5,8,41,-74,6,4,336,344
727,61,2,5,4,9,22,54,8,8,358,398
727,62,4,3,6,7,-58,-66,0,2,300,332
727,63,4,3,5,8,41,35,1,7,341,367
727,64,2,5,3,10,21,-45,2,2,362,322
727,65,3,4,6,7,33,43,5,5,395,365
727,66,2,5,6,7,24,52,9,7,419,417
727,67,5,2,7,6,-48,-76,1,1,371,341
727,68,5,2,9,4,54,22,5,3,425,363
727,69,3,5,5,8,32,53,7,6,457,416
727,70,3,3,8,5,-65,32,2,8,392,448
727,71,4,3,5,8,41,-65,3,3,433,383
727,72,5,2,7,6,52,24,5,7,485,407
727,73,3,3,9,4,-64,31,1,8,421,438
727,74,5,2,8,5,53,-77,4,1,474,361
727,75,4,3,10,3,-54,30,0,1,420,391
727,76,4,3,9,4,45,31,5,2,465,422
727,77,4,3,9,4,-55,31,0,3,410,453
727,78,4,2,6,7,42,25,2,8,452,478
727,79,3,4,6,7,33,-57,5,1,485,421
727,80,4,3,5,8,41,35,6,6,526,456
728,1,4,2,9,4,45,22,5,2,45,22
728,2,5,2,6,7,51,25,6,7,96,47
728,3,4,2,8,5,-56,-77,0,0,40,-30
728,4,2,5,5,8,23,53,3,3,63,23
728,5,3,3,9,4,36,31,9,4,99,54
728,6,4,2,5,8,-59,-74,0,0,40,-20
728,7,3,3,9,4,36,31,6,1,76,11
728,8,3,4,5,8,32,44,8,5,108,55
728,9,4,3,5,8,41,-65,9,0,149,-10
728,10,3,3,8,5,-65,32,4,2,84,22
728,11,3,4,7,6,34,42,8,4,118,64
728,12,3,3,7,6,-66,33,2,7,52,97
728,13,3,3,9,4,36,31,8,8,88,128
728,14,4,2,6,7,-58,-75,0,3,30,53
728,15,3,3,5,8,32,35,2,8,62,88
728,16,2,4,2,11,20,-53,2,5,82,35
728,17,3,3,7,6,34,33,6,8,116,68
728,18,3,4,9,4,-64,40,2,8,52,108
728,19,4,3,10,3,46,30,8,8,98,138
728,20,2,5,2,11,20,-44,8,4,118,94
728,21,2,4,4,9,-78,45,0,9,40,139
728,22,3,3,6,7,33,-66,3,3,73,73
728,23,2,5,5,8,23,53,6,6,96,126
728,24,4,3,8,5,-56,32,0,8,40,158
728,25,2,4,3,10,21,-54,1,4,61,104
728,26,3,4,4,9,31,45,2,9,92,149
728,27,5,2,9,4,54,-78,6,1,146,71
728,28,3,3,5,8,32,35,8,6,178,106
728,29,2,4,6,7,-76,43,2,9,102,149
728,30,4,2,9,4,45,-78,7,1,147,71
728,31,3,4,6,7,-67,43,0,4,80,114
728,32,2,5,3,10,21,55,1,9,101,169
728,33,3,4,8,5,35,-59,6,0,136,110
728,34,3,3,7,6,-66,33,0,3,70,143
728,35,5,2,10,3,55,21,5,4,125,164
728,36,4,4,7,6,43,42,8,6,168,206
728,37,4,3,10,3,-54,30,4,6,114,236
728,38,3,3,7,6,34,33,8,9,148,269
728,39,3,4,7,6,-66,-58,2,1,82,211
728,40,3,3,9,4,36,31,8,2,118,242
728,41,4,3,7,6,-57,33,1,5,61,275
728,42,3,4,7,6,34,42,5,7,95,317
728,43,4,2,9,4,-55,22,0,9,40,339
728,44,4,3,7,6,43,-67,3,2,83,272
728,45,2,5,4,9,22,54,5,6,105,326
728,46,5,3,9,4,54,31,9,7,159,357
728,47,4,2,6,7,-58,-75,1,2,101,282
728,48,4,3,8,5,44,32,5,4,145,314
728,49,2,4,8,5,-74,41,1,5,71,355
728,50,2,4,6,7,24,43,5,8,95,398
728,51,5,2,7,6,52,-76,7,2,147,322
728,52,4,3,10,3,-54,30,3,2,93,352
728,53,3,4,8,5,35,41,8,3,128,393
728,54,3,4,4,9,31,45,9,8,159,438
728,55,4,3,6,7,-58,-66,1,2,101,372
728,56,2,5,4,9,22,54,3,6,123,426
728,57,4,3,7,6,43,33,6,9,166,459
728,58,3,4,6,7,33,-57,9,2,199,402
728,59,5,2,7,6,-48,24,1,6,151,426
728,60,3,3,7,6,34,33,5,9,185,459
728,61,5,2,9,4,54,-78,9,1,239,381
728,62,3,3,6,7,-67,34,2,5,172,415
728,63,2,4,7,6,25,42,7,7,197,457
728,64,2,4,5,8,-77,-56,0,1,120,401
728,65,3,3,5,8,32,35,2,6,152,436
728,66,2,4,4,9,22,-55,4,1,174,381
728,67,2,4,5,8,23,44,7,5,197,425
728,68,2,4,5,8,-77,44,0,9,120,469
728,69,3,5,4,9,31,-46,1,3,151,423
728,70,2,5,4,9,22,54,3,7,173,477
728,71,5,2,8,5,53,-77,6,0,226,400
728,72,5,2,8,5,53,23,9,3,279,423
728,73,4,2,7,6,-57,24,2,7,222,447
728,74,5,2,9,4,54,22,6,9,276,469
728,75,2,5,3,10,21,-45,7,4,297,424
728,76,3,5,6,7,-67,52,0,6,230,476
728,77,4,3,7,6,43,33,3,9,273,509
729,1,5,2,9,4,54,22,4,2,54,22
729,2,2,5,4,9,22,54,6,6,76,76
729,3,6,2,10,3,-36,21,0,7,40,97
729,4,4,2,11,2,47,20,7,7,87,117
729,5,2,5,4,9,22,-46,9,1,109,71
729,6,5,2,8,5,-47,23,2,4,62,94
729,7,3,3,9,4,36,31,8,5,98,125
729,8,4,3,8,5,-56,32,2,7,42,157
729,9,2,5,3,10,21,-45,3,2,63,112
729,10,4,3,5,8,41,35,4,7,104,147
729,11,5,2,10,3,55,21,9,8,159,168
729,12,2,5,4,9,-78,-46,1,2,81,122
729,13,5,2,10,3,55,21,6,3,136,143
729,14,3,4,8,5,-65,41,1,4,71,184
729,15,4,2,10,3,46,21,7,5,117,205
729,16,3,4,5,8,32,44,9,9,149,249
729,17,3,3,9,4,-64,-69,5,0,85,180
729,18,4,3,5,8,41,35,6,5,126,215
729,19,3,3,5,8,32,-65,8,0,158,150
729,20,2,6,3,10,21,64,9,4,179,214
729,21,4,2,9,4,-55,22,4,6,124,236
729,22,3,4,7,6,34,42,8,8,158,278
729,23,4,2,8,5,-56,-77,2,1,102,201
729,24,4,4,6,7,42,43,4,4,144,244
729,25,2,4,5,8,23,44,7,8,167,288
729,26,3,4,4,9,31,-55,8,3,198,233
729,27,2,5,4,9,-78,54,0,7,120,287
729,28,2,4,5,8,23,-56,3,1,143,231
729,29,4,3,7,6,43,33,6,4,186,264
729,30,3,3,5,8,32,35,8,9,218,299
729,31,2,5,4,9,-78,-46,0,3,140,253
729,32,3,3,8,5,35,32,5,5,175,285
729,33,2,4,7,6,-75,42,0,7,100,327
729,34,3,4,6,7,33,-57,3,0,133,270
729,35,3,3,8,5,35,32,8,2,168,302
729,36,5,2,8,5,-47,23,1,5,121,325
729,37,2,4,6,7,24,43,5,8,145,368
729,38,4,2,9,4,-55,-78,0,0,90,290
729,39,4,2,7,6,43,24,3,4,133,314
729,40,3,4,5,8,32,44,5,8,165,358
729,41,4,2,10,3,-54,21,1,9,111,379
729,42,4,3,7,6,43,-67,4,2,154,312
729,43,5,2,9,4,54,22,8,4,208,334
729,44,3,4,4,9,31,45,9,9,239,379
729,45,2,4,7,6,-75,-58,4,1,164,321
729,46,4,2,9,4,45,22,9,3,209,343
729,47,2,5,7,6,-75,51,4,4,134,394
729,48,3,4,6,7,33,43,7,7,167,437
729,49,3,3,8,5,-65,32,2,9,102,469
729,50,5,2,7,6,52,-76,4,3,154,393
729,51,4,3,8,5,44,32,8,5,198,425
729,52,4,3,6,7,-58,34,0,9,140,459
729,53,3,3,8,5,35,-68,5,1,175,391
729,54,2,4,4,9,22,45,7,6,197,436
729,55,2,4,4,9,22,-55,9,1,219,381
729,56,4,2,7,6,-57,24,2,5,162,405
729,57,3,3,7,6,34,33,6,8,196,438
729,58,3,3,10,3,-63,30,3,8,133,468
729,59,5,2,7,6,52,-76,5,2,185,392
729,60,4,3,5,8,41,35,6,7,226,427
729,61,2,4,6,7,-76,-57,0,0,150,370
729,62,4,2,5,8,41,26,1,6,191,396
729,63,5,2,9,4,54,22,5,8,245,418
729,64,4,2,8,5,44,-77,9,1,289,341
729,65,4,3,8,5,-56,32,3,3,233,373
729,66,3,3,9,4,36,31,9,4,269,404
729,67,3,3,5,8,-68,35,1,9,201,439
729,68,5,2,8,5,53,-77,4,2,254,362
729,69,3,4,7,6,34,42,8,4,288,404
729,70,3,3,9,4,-64,31,4,5,224,435
729,71,2,4,5,8,23,44,7,9,247,479
729,72,5,2,10,3,-45,-79,2,0,202,400
729,73,4,2,9,4,45,22,7,2,247,422
729,74,2,5,7,6,-75,51,2,3,172,473
729,75,5,2,8,5,53,23,5,6,225,496
729,76,2,5,4,9,22,-46,7,0,247,450
729,77,2,5,5,8,-77,53,0,3,170,503
730,1,3,3,6,7,33,34,3,4,33,34
730,2,4,2,9,4,45,22,8,6,78,56
730,3,2,5,5,8,-77,53,1,9,1,109
730,4,3,3,5,8,32,-65,3,4,33,44
730,5,5,2,10,3,55,21,8,5,88,65
730,6,2,4,4,9,-78,-55,0,0,10,10
730,7,3,3,6,7,33,34,3,4,43,44
730,8,4,2,10,3,46,21,9,5,89,65
730,9,3,4,4,9,-69,-55,0,0,20,10
730,10,3,4,5,8,32,44,2,4,52,54
730,11,2,5,5,8,23,53,5,7,75,107
730,12,2,5,3,10,21,-45,6,2,96,62
730,13,3,3,8,5,-65,32,1,4,31,94
730,14,4,3,7,6,43,33,4,7,74,127
730,15,3,3,7,6,34,-67,8,0,108,60
730,16,2,5,3,10,21,55,9,5,129,115
730,17,4,2,7,6,-57,24,2,9,72,139
730,18,4,3,8,5,44,-68,6,1,116,71
730,19,3,4,6,7,33,43,9,4,149,114
730,20,2,4,6,7,-76,43,3,7,73,157
730,21,3,4,7,6,34,42,7,9,107,199
730,22,4,3,6,7,42,-66,9,3,149,133
730,23,4,3,7,6,-57,33,2,6,92,166
730,24,3,3,7,6,34,33,6,9,126,199
730,25,4,4,8,5,-56,-59,0,0,70,140
730,26,2,5,5,8,23,53,3,3,93,193
730,27,2,4,7,6,25,42,8,5,118,235
730,28,4,3,9,4,-55,31,3,6,63,266
730,29,3,3,4,9,31,-64,4,2,94,202
730,30,2,5,5,8,23,53,7,5,117,255
730,31,2,5,4,9,22,54,9,9,139,309
730,32,3,3,7,6,-66,-67,3,2,73,242
730,33,3,3,7,6,34,33,7,5,107,275
730,34,3,4,7,6,-66,42,1,7,41,317
730,35,3,4,7,6,34,42,5,9,75,359
730,36,5,2,10,3,-45,-79,0,0,30,280
730,37,2,5,3,10,21,55,1,5,51,335
730,38,6,2,7,6,61,24,2,9,112,359
730,39,3,4,5,8,32,-56,4,3,144,303
730,40,4,3,6,7,42,34,6,7,186,337
730,41,5,2,9,4,-46,22,0,9,140,359
730,42,3,4,5,8,32,-56,2,3,172,303
730,43,3,3,5,8,32,35,4,8,204,338
730,44,3,4,5,8,32,-56,6,2,236,282
730,45,3,3,6,7,33,34,9,6,269,316
730,46,3,3,7,6,-66,33,3,9,203,349
730,47,3,4,5,8,32,-56,5,3,235,293
730,48,4,2,9,4,-55,22,0,5,180,315
730,49,2,4,7,6,25,42,5,7,205,357
730,50,3,3,5,8,32,-65,7,2,237,292
730,51,3,3,5,8,32,35,9,7,269,327
730,52,3,3,8,5,-65,32,4,9,204,359
730,53,2,6,4,9,22,-37,6,2,226,322
730,54,2,5,3,10,21,55,7,7,247,377
730,55,3,3,6,7,-67,-66,0,1,180,311
730,56,2,5,4,9,22,54,2,5,202,365
730,57,4,2,9,4,45,22,7,7,247,387
730,58,2,4,5,8,-77,-56,0,1,170,331
730,59,4,3,8,5,44,32,4,3,214,363
730,60,3,3,5,8,32,35,6,8,246,398
730,61,2,4,4,9,22,-55,8,3,268,343
730,62,4,2,9,4,-55,22,3,5,213,365
730,63,2,5,6,7,24,52,7,7,237,417
730,64,3,4,8,5,-65,41,2,8,172,458
730,65,5,2,11,2,56,20,8,8,228,478
730,66,2,4,4,9,-78,-55,0,3,150,423
730,67,4,3,9,4,45,31,5,4,195,454
730,68,3,5,4,9,31,54,6,8,226,508
731,1,2,4,5,8,23,44,3,4,23,44
731,2,3,4,7,6,34,42,7,6,57,86
731,3,2,4,5,8,-77,-56,0,0,-20,30
731,4,4,2,7,6,43,24,3,4,23,54
731,5,5,2,8,5,53,23,6,7,76,77
731,6,2,4,7,6,-75,42,1,9,1,119
731,7,2,4,6,7,24,-57,5,2,25,62
731,8,3,3,6,7,33,34,8,6,58,96
731,9,4,3,6,7,-58,-66,0,0,0,30
731,10,4,2,8,5,44,23,4,3,44,53
731,11,4,4,5,8,41,44,5,7,85,97
731,12,3,4,6,7,33,-57,8,0,118,40
731,13,4,2,7,6,-57,24,1,4,61,64
731,14,3,4,7,6,34,42,5,6,95,106
731,15,4,3,5,8,41,-65,6,1,136,41
731,16,4,3,4,9,40,36,6,7,176,77
731,17,3,3,8,5,-65,32,1,9,111,109
731,18,3,4,5,8,32,-56,3,3,143,53
731,19,4,3,9,4,45,31,8,4,188,84
731,20,2,4,6,7,-76,43,2,7,112,127
731,21,3,3,5,8,32,-65,4,2,144,62
731,22,3,4,8,5,35,41,9,3,179,103
731,23,3,3,7,6,-66,33,3,6,113,136
731,24,5,3,6,7,51,-66,4,0,164,70
731,25,3,5,6,7,33,52,7,2,197,122
731,26,5,2,10,3,-45,21,2,3,152,143
731,27,3,3,9,4,36,31,8,4,188,174
731,28,5,2,10,3,-45,21,3,5,143,195
731,29,5,2,9,4,54,22,7,7,197,217
731,30,6,2,10,3,-36,21,1,8,161,238
731,31,4,3,6,7,42,-66,3,2,203,172
731,32,4,3,9,4,45,31,8,3,248,203
731,33,4,2,9,4,-55,22,3,5,193,225
731,34,3,4,7,6,34,42,7,7,227,267
731,35,3,3,7,6,-66,-67,1,0,161,200
731,36,3,4,8,5,35,41,6,1,196,241
731,37,2,4,6,7,-76,43,0,4,120,284
731,38,4,3,8,5,44,32,4,6,164,316
731,39,4,2,9,4,45,22,9,8,209,338
731,40,3,3,8,5,-65,-68,4,0,144,270
731,41,2,4,3,10,21,46,5,6,165,316
731,42,2,4,4,9,22,-55,7,1,187,261
731,43,3,4,3,10,30,46,7,7,217,307
731,44,3,4,6,7,-67,-57,0,0,150,250
731,45,3,3,8,5,35,32,5,2,185,282
731,46,4,2,9,4,-55,22,0,4,130,304
731,47,3,3,7,6,34,33,4,7,164,337
731,48,2,5,9,4,-73,-50,1,7,91,287
731,49,3,3,4,9,31,-64,2,3,122,223
731,50,3,3,8,5,35,32,7,5,157,255
731,51,4,2,10,3,-54,21,3,6,103,276
731,52,4,3,6,7,42,-66,5,0,145,210
731,53,3,4,5,8,32,44,7,4,177,254
731,54,4,2,9,4,-55,22,2,6,122,276
731,55,4,3,8,5,44,32,6,8,166,308
731,56,2,4,6,7,-76,-57,0,1,90,251
731,57,4,3,8,5,44,32,4,3,134,283
731,58,3,4,4,9,31,45,5,8,165,328
731,59,3,3,4,9,31,-64,6,4,196,264
731,60,4,3,7,6,43,33,9,7,239,297
731,61,2,5,5,8,-77,-47,2,0,162,250
731,62,6,2,11,2,65,20,7,0,227,270
731,63,2,5,5,8,-77,53,0,3,150,323
731,64,3,4,4,9,31,45,1,8,181,368
731,65,3,4,3,10,30,-54,1,4,211,314
731,66,4,4,7,6,43,42,4,6,254,356
731,67,4,3,6,7,42,-66,6,0,296,290
731,68,2,5,3,10,21,55,7,5,317,345
731,69,3,3,8,5,-65,32,2,7,252,377
731,70,3,4,4,9,31,-55,3,2,283,322
731,71,2,5,4,9,22,54,5,6,305,376
731,72,3,4,8,5,-65,41,0,7,240,417
731,73,2,5,4,9,22,-46,2,1,262,371
731,74,3,3,9,4,36,31,8,2,298,402
731,75,2,5,4,9,-78,54,0,6,220,456
731,76,4,2,10,3,46,21,6,7,266,477
731,77,3,3,7,6,-66,-67,0,0,200,410
731,78,4,3,7,6,43,33,3,3,243,443
731,79,4,3,8,5,44,32,7,5,287,475
731,80,2,5,5,8,-77,53,0,8,210,528
732,1,4,3,7,6,43,33,3,3,43,33
732,2,4,2,9,4,45,22,8,5,88,55
732,3,3,3,7,6,-66,33,2,8,22,88
732,4,2,4,6,7,24,-57,6,1,46,31
732,5,3,4,7,6,-66,42,0,3,-20,73
732,6,3,3,6,7,33,34,3,7,13,107
732,7,2,5,4,9,22,-46,5,1,35,61
732,8,2,4,5,8,23,44,8,5,58,105
732,9,4,3,7,6,-57,33,1,8,1,138
732,10,4,3,7,6,43,-67,4,1,44,71
732,11,3,4,7,6,34,42,8,3,78,113
732,12,2,5,4,9,-78,54,0,7,0,167
732,13,3,3,7,6,34,-67,4,0,34,100
732,14,2,4,6,7,24,43,8,3,58,143
732,15,3,4,6,7,-67,43,1,6,-9,186
732,16,3,4,6,7,33,43,4,9,24,229
732,17,4,3,9,4,45,-69,9,0,69,160
732,18,5,2,11,2,-44,20,5,0,25,180
732,19,3,3,5,8,32,35,7,5,57,215
732,20,5,2,8,5,-47,23,0,8,10,238
732,21,4,2,10,3,46,21,6,9,56,259
732,22,4,4,9,4,-55,40,1,9,1,299
732,23,2,4,8,5,26,-59,7,0,27,240
732,24,3,4,6,7,-67,43,0,3,-40,283
732,25,5,2,9,4,54,22,4,5,14,305
732,26,3,3,8,5,35,32,9,7,49,337
732,27,2,5,3,10,-79,-45,0,2,-30,292
732,28,3,3,7,6,34,33,4,5,4,325
732,29,2,5,6,7,24,52,8,7,28,377
732,30,4,3,5,8,41,-65,9,2,69,312
732,31,2,6,4,9,-78,63,1,5,-9,375
732,32,3,4,7,6,34,42,5,7,25,417
732,33,4,2,5,8,41,-74,6,3,66,343
732,34,2,4,7,6,-75,42,1,5,-9,385
732,35,4,3,7,6,43,33,4,8,34,418
732,36,4,2,6,7,42,-75,6,3,76,343
732,37,3,4,8,5,-65,41,1,4,11,384
732,38,5,2,11,2,56,20,7,4,67,404
732,39,3,3,9,4,-64,31,3,5,3,435
732,40,3,3,8,5,35,32,8,7,38,467
732,41,6,2,9,4,-37,22,1,9,1,489
732,42,3,4,8,5,35,-59,6,0,36,430
732,43,3,3,7,6,-66,33,0,3,-30,463
732,44,5,2,10,3,55,21,5,4,25,484
732,45,2,4,6,7,24,43,9,7,49,527
733,1,3,4,4,9,31,45,1,5,31,45
733,2,3,4,5,8,32,44,3,9,63,89
733,3,3,4,3,10,30,-54,3,5,93,35
733,4,3,4,7,6,34,42,7,7,127,77
733,5,5,2,9,4,-46,22,1,9,81,99
733,6,4,2,7,6,43,-76,4,3,124,23
733,7,3,4,7,6,34,42,8,5,158,65
733,8,4,3,5,8,41,-65,9,0,199,0
733,9,3,3,6,7,-67,34,2,4,132,34
733,10,4,2,8,5,44,23,6,7,176,57
733,11,2,4,5,8,23,-56,9,1,199,1
733,12,2,4,5,8,-77,44,2,5,122,45
733,13,5,2,8,5,53,23,5,8,175,68
733,14,3,3,9,4,-64,31,1,9,111,99
733,15,3,3,8,5,35,-68,6,1,146,31
733,16,4,2,9,4,-55,22,1,3,91,53
733,17,4,4,7,6,43,42,4,5,134,95
733,18,3,3,6,7,33,34,7,9,167,129
733,19,4,2,9,4,-55,-78,2,1,112,51
733,20,4,2,6,7,42,25,4,6,154,76
733,21,4,2,8,5,44,23,8,9,198,99
733,22,3,4,5,8,-68,-56,0,3,130,43
733,23,2,6,2,11,20,65,0,8,150,108
733,24,4,3,7,6,43,-67,3,1,193,41
733,25,3,3,7,6,34,33,7,4,227,74
733,26,4,2,9,4,-55,22,2,6,172,96
733,27,3,3,8,5,35,32,7,8,207,128
733,28,5,2,8,5,-47,-77,0,1,160,51
733,29,5,2,9,4,54,22,4,3,214,73
733,30,2,5,6,7,24,52,8,5,238,125
733,31,3,4,5,8,-68,44,0,9,170,169
733,32,4,2,7,6,43,-76,3,3,213,93
733,33,4,4,8,5,44,41,7,4,257,134
733,34,3,3,7,6,-66,33,1,7,191,167
733,35,3,4,5,8,32,-56,3,1,223,111
733,36,2,5,5,8,23,53,6,4,246,164
733,37,4,3,6,7,42,34,8,8,288,198
733,38,3,3,6,7,-67,-66,1,2,221,132
733,39,2,4,4,9,22,45,3,7,243,177
733,40,5,2,10,3,55,21,8,8,298,198
733,41,3,3,4,9,31,-64,9,4,329,134
733,42,3,3,8,5,-65,32,4,6,264,166
733,43,3,4,8,5,35,41,9,7,299,207
733,44,2,5,3,10,-79,-45,0,2,220,162
733,45,4,2,9,4,45,22,5,4,265,184
733,46,2,5,3,10,21,55,6,9,286,239
733,47,5,2,9,4,-46,-78,0,1,240,161
733,48,2,4,7,6,25,42,5,3,265,203
733,49,2,4,4,9,22,45,7,8,287,248
733,50,5,2,10,3,-45,21,2,9,242,269
733,51,4,3,9,4,45,-69,7,0,287,200
733,52,5,2,10,3,-45,21,2,1,242,221
733,53,4,3,8,5,44,32,6,3,286,253
733,54,3,4,4,9,31,45,7,8,317,298
733,55,3,3,8,5,-65,-68,2,0,252,230
733,56,4,3,9,4,45,31,7,1,297,261
733,57,6,2,11,2,-35,20,2,1,262,281
733,58,3,4,5,8,32,44,4,5,294,325
733,59,3,3,8,5,35,32,9,7,329,357
733,60,2,4,5,8,-77,-56,2,1,252,301
733,61,2,4,7,6,25,42,7,3,277,343
733,62,3,4,5,8,32,44,9,7,309,387
733,63,3,5,5,8,-68,-47,1,0,241,340
733,64,4,3,3,10,-40,37,1,7,201,377
733,65,3,3,7,6,34,-67,5,0,235,310
733,66,5,2,8,5,53,23,8,3,288,333
733,67,4,3,9,4,-55,31,3,4,233,364
733,68,5,2,10,3,55,21,8,5,288,385
733,69,4,3,7,6,-57,33,1,8,231,418
733,70,3,4,8,5,35,41,6,9,266,459
733,71,3,4,5,8,32,-56,8,3,298,403
733,72,4,3,10,3,-54,30,4,3,244,433
733,73,5,2,10,3,55,21,9,4,299,454
733,74,3,3,8,5,-65,32,4,6,234,486
733,75,4,2,10,3,-54,21,0,7,180,507
734,1,4,3,6,7,42,34,2,4,42,34
734,2,2,5,4,9,22,54,4,8,64,88
734,3,4,2,8,5,44,-77,8,1,108,11
734,4,2,4,5,8,-77,44,1,5,31,55
734,5,4,3,10,3,46,30,7,5,77,85
734,6,3,3,6,7,-67,34,0,9,10,119
734,7,4,3,9,4,45,-69,5,0,55,50
734,8,4,3,9,4,-55,31,0,1,0,81
734,9,3,3,7,6,34,33,4,4,34,114
734,10,3,4,3,10,30,-54,4,0,64,60
734,11,3,3,5,8,32,35,6,5,96,95
734,12,4,2,8,5,-56,23,0,8,40,118
734,13,2,5,2,11,20,-44,0,4,60,74
734,14,3,3,8,5,35,32,5,6,95,106
734,15,6,2,8,5,62,23,7,9,157,129
734,16,3,4,5,8,32,-56,9,3,189,73
734,17,2,4,5,8,-77,44,2,7,112,117
734,18,3,3,8,5,35,32,7,9,147,149
734,19,2,5,2,11,20,-44,7,5,167,105
734,20,4,3,7,6,-57,33,0,8,110,138
734,21,5,2,10,3,55,21,5,9,165,159
734,22,4,2,8,5,44,-77,9,2,209,82
734,23,3,4,6,7,-67,43,2,5,142,125
734,24,3,4,7,6,34,42,6,7,176,167
734,25,3,4,4,9,31,-55,7,2,207,112
734,26,3,4,8,5,-65,41,2,3,142,153
734,27,2,4,5,8,23,44,5,7,165,197
734,28,3,4,8,5,-65,41,0,8,100,238
734,29,2,6,3,10,21,-36,1,2,121,202
734,30,3,3,7,6,34,33,5,5,155,235
734,31,5,2,11,2,-44,20,1,5,111,255
734,32,3,4,5,8,32,44,3,9,143,299
734,33,3,3,7,6,34,-67,7,2,177,232
734,34,4,3,8,5,-56,32,1,4,121,264
734,35,2,6,3,10,21,64,2,8,142,328
734,36,3,3,6,7,33,-66,5,2,175,262
734,37,3,3,8,5,-65,32,0,4,110,294
734,38,3,4,7,6,34,42,4,6,144,336
734,39,3,3,6,7,33,-66,7,0,177,270
734,40,4,3,8,5,-56,32,1,2,121,302
734,41,3,3,4,9,31,36,2,8,152,338
734,42,4,3,7,6,43,-67,5,1,195,271
734,43,3,3,7,6,34,33,9,4,229,304
734,44,3,4,6,7,-67,43,2,7,162,347
734,45,3,3,7,6,34,-67,6,0,196,280
734,46,2,5,4,9,22,54,8,4,218,334
734,47,4,3,7,6,-57,33,1,7,161,367
734,48,4,2,6,7,42,-75,3,2,203,292
734,49,5,2,9,4,54,22,7,4,257,314
734,50,3,3,5,8,32,35,9,9,289,349
734,51,4,3,5,8,-59,-65,0,4,230,284
734,52,5,2,8,5,53,23,3,7,283,307
734,53,3,4,4,9,31,-55,4,2,314,252
734,54,2,5,5,8,23,53,7,5,337,305
734,55,4,3,7,6,-57,33,0,8,280,338
734,56,4,2,9,4,45,-78,5,0,325,260
734,57,4,3,8,5,44,32,9,2,369,292
734,58,6,2,11,2,-35,20,4,2,334,312
734,59,2,5,2,11,20,56,4,8,354,368
734,60,2,4,7,6,25,-58,9,0,379,310
734,61,3,4,6,7,-67,43,2,3,312,353
734,62,3,4,6,7,33,43,5,6,345,396
734,63,3,3,6,7,33,-66,8,0,378,330
734,64,4,2,9,4,-55,22,3,2,323,352
734,65,4,2,9,4,45,22,8,4,368,374
734,66,5,2,11,2,-44,20,4,4,324,394
734,67,3,3,4,9,31,-64,5,0,355,330
734,68,3,4,6,7,33,43,8,3,388,373
734,69,4,3,8,5,-56,32,2,5,332,405
734,70,4,3,6,7,42,34,4,9,374,439
734,71,2,5,5,8,23,-47,7,2,397,392
734,72,3,3,6,7,-67,34,0,6,330,426
734,73,3,5,4,9,31,-46,1,0,361,380
734,74,2,5,2,11,20,56,1,6,381,436
734,75,2,4,2,11,20,-53,1,3,401,383
734,76,3,3,6,7,33,34,4,7,434,417
734,77,3,4,9,4,-64,40,0,7,370,457
734,78,4,2,9,4,45,22,5,9,415,479
734,79,3,4,8,5,-65,-59,0,0,350,420
734,80,5,2,11,2,56,20,6,0,406,440
734,81,2,4,6,7,-76,43,0,3,330,483
734,82,2,6,2,11,20,65,0,8,350,548
735,1,3,4,9,4,36,40,6,0,36,40
735,2,4,2,7,6,43,24,9,4,79,64
735,3,3,3,7,6,-66,33,3,7,13,97
735,4,2,5,5,8,23,-47,6,0,36,50
735,5,4,2,8,5,-56,23,0,3,-20,73
735,6,4,3,8,5,44,32,4,5,24,105
735,7,3,5,2,11,-30,-44,4,1,-6,61
735,8,3,4,6,7,33,43,7,4,27,104
735,9,2,4,3,10,21,-54,8,0,48,50
735,10,3,4,7,6,-66,42,2,2,-18,92
735,11,3,3,5,8,32,35,4,7,14,127
735,12,3,3,6,7,33,-66,7,1,47,61
735,13,4,3,7,6,-57,33,0,4,-10,94
735,14,2,5,4,9,22,54,2,8,12,148
735,15,3,3,3,10,30,-63,2,5,42,85
735,16,3,3,4,9,31,-64,3,1,73,21
735,17,2,5,5,8,23,53,6,4,96,74
735,18,5,2,7,6,52,24,8,8,148,98
735,19,2,5,3,10,21,-45,9,3,169,53
735,20,3,4,6,7,-67,43,2,6,102,96
735,21,2,5,4,9,22,-46,4,0,124,50
735,22,4,2,9,4,45,22,9,2,169,72
735,23,4,2,8,5,-56,23,3,5,113,95
735,24,3,3,8,5,35,32,8,7,148,127
735,25,3,4,6,7,-67,-57,1,0,81,70
735,26,3,3,6,7,33,34,4,4,114,104
735,27,2,4,5,8,23,44,7,8,137,148
735,28,3,4,4,9,31,-55,8,3,168,93
735,29,2,5,4,9,-78,54,0,7,90,147
735,30,4,3,7,6,43,-67,3,0,133,80
735,31,4,2,8,5,44,23,7,3,177,103
735,32,3,4,6,7,-67,43,0,6,110,146
735,33,4,3,8,5,44,32,4,8,154,178
735,34,4,2,8,5,44,-77,8,1,198,101
735,35,2,4,6,7,-76,43,2,4,122,144
735,36,2,4,3,10,21,-54,3,0,143,90
735,37,2,4,4,9,22,45,5,5,165,135
735,38,6,2,8,5,62,23,7,8,227,158
735,39,4,3,8,5,-56,-68,1,0,171,90
735,40,2,4,3,10,21,46,2,6,192,136
735,41,4,2,10,3,46,21,8,7,238,157
735,42,2,5,4,9,-78,-46,0,1,160,111
735,43,2,4,2,11,20,47,0,8,180,158
735,44,3,4,4,9,31,-55,1,3,211,103
735,45,4,4,6,7,42,43,3,6,253,146
735,46,3,3,6,7,33,-66,6,0,286,80
735,47,4,4,8,5,-56,41,0,1,230,121
735,48,4,2,7,6,43,24,3,5,273,145
735,49,3,4,4,9,31,-55,4,0,304,90
735,50,3,3,7,6,34,33,8,3,338,123
735,51,3,5,4,9,31,54,9,7,369,177
735,52,3,4,5,8,-68,-56,1,1,301,121
735,53,2,5,4,9,22,54,3,5,323,175
735,54,3,4,8,5,35,41,8,6,358,216
735,55,5,2,10,3,-45,21,3,7,313,237
735,56,4,3,6,7,42,-66,5,1,355,171
735,57,3,3,6,7,33,34,8,5,388,205
735,58,4,2,9,4,-55,22,3,7,333,227
735,59,2,4,6,7,24,-57,7,0,357,170
735,60,2,5,3,10,21,55,8,5,378,225
735,61,3,3,8,5,-65,32,3,7,313,257
735,62,5,2,11,2,56,20,9,7,369,277
735,63,3,4,5,8,-68,-56,1,1,301,221
735,64,3,3,5,8,32,35,3,6,333,256
735,65,3,3,6,7,33,-66,6,0,366,190
735,66,3,4,6,7,33,43,9,3,399,233
735,67,4,3,9,4,-55,31,4,4,344,264
735,68,5,2,7,6,52,24,6,8,396,288
735,69,3,3,7,6,-66,-67,0,1,330,221
735,70,5,3,9,4,54,31,4,2,384,252
735,71,4,2,8,5,44,23,8,5,428,275
735,72,4,3,9,4,-55,31,3,6,373,306
735,73,4,3,6,7,42,-66,5,0,415,240
735,74,2,4,5,8,23,44,8,4,438,284
735,75,4,3,8,5,-56,32,2,6,382,316
735,76,3,3,7,6,34,33,6,9,416,349
735,77,3,3,6,7,33,-66,9,3,449,283
735,78,3,4,6,7,-67,43,2,6,382,326
735,79,5,2,10,3,55,21,7,7,437,347
735,80,3,3,7,6,-66,-67,1,0,371,280
735,81,3,3,6,7,33,34,4,4,404,314
735,82,3,3,10,3,-63,30,1,4,341,344
735,83,2,4,7,6,25,42,6,6,366,386
735,84,4,2,6,7,42,-75,8,1,408,311
735,85,6,2,8,5,-38,23,0,4,370,334
735,86,3,3,8,5,35,32,5,6,405,366
735,87,2,4,6,7,24,43,9,9,429,409
735,88,3,3,6,7,-67,-66,2,3,362,343
735,89,4,2,9,4,45,22,7,5,407,365
735,90,4,3,6,7,42,34,9,9,449,399
735,91,4,3,9,4,-55,-69,4,0,394,330
735,92,5,2,8,5,53,23,7,3,447,353
735,93,6,2,11,2,-35,20,2,3,412,373
735,94,3,4,5,8,32,44,4,7,444,417
735,95,4,3,7,6,43,-67,7,0,487,350
735,96,5,2,8,5,-47,23,0,3,440,373
735,97,2,4,6,7,24,43,4,6,464,416
735,98,3,3,8,5,35,32,9,8,499,448
735,99,2,4,5,8,-77,-56,2,2,422,392
735,100,3,3,9,4,36,31,8,3,458,423
735,101,4,3,8,5,-56,32,2,5,402,455
735,102,4,3,7,6,43,33,5,8,445,488
735,103,5,2,7,6,52,-76,7,2,497,412
735,104,2,4,5,8,-77,44,0,6,420,456
735,105,4,3,8,5,44,32,4,8,464,488
735,106,5,2,7,6,52,-76,6,2,516,412
736,1,4,2,6,7,42,25,2,5,42,25
736,2,3,3,4,9,31,-64,3,1,73,-39
736,3,4,3,9,4,45,31,8,2,118,-8
736,4,2,5,6,7,-76,52,2,4,42,44
736,5,3,3,7,6,34,33,6,7,76,77
736,6,3,3,9,4,-64,31,2,8,12,108
736,7,4,3,10,3,46,30,8,8,58,138
736,8,2,5,2,11,20,-44,8,4,78,94
736,9,2,5,3,10,21,55,9,9,99,149
736,10,4,3,9,4,-55,-69,4,0,44,80
736,11,3,5,4,9,31,54,5,4,75,134
736,12,2,6,2,11,20,65,5,9,95,199
736,13,4,2,8,5,44,-77,9,2,139,122
736,14,5,2,9,4,-46,22,3,4,93,144
736,15,5,3,8,5,53,32,6,6,146,176
736,16,4,3,6,7,42,-66,8,0,188,110
736,17,4,2,9,4,-55,22,3,2,133,132
736,18,4,3,8,5,44,32,7,4,177,164
736,19,3,5,5,8,32,53,9,7,209,217
736,20,3,4,4,9,-69,-55,0,2,140,162
736,21,2,4,6,7,24,43,4,5,164,205
736,22,3,3,7,6,34,33,8,8,198,238
736,23,4,2,7,6,-57,-76,1,2,141,162
736,24,4,3,5,8,41,35,2,7,182,197
736,25,5,2,10,3,55,21,7,8,237,218
736,26,2,5,4,9,22,-46,9,2,259,172
736,27,2,5,6,7,-76,52,3,4,183,224
736,28,6,2,11,2,65,20,8,4,248,244
736,29,3,3,6,7,-67,34,1,8,181,278
736,30,3,3,5,8,32,-65,3,3,213,213
736,31,3,4,3,10,30,46,3,9,243,259
736,32,2,5,3,10,21,-45,4,4,264,214
736,33,4,3,6,7,42,34,6,8,306,248
736,34,2,5,5,8,23,-47,9,1,329,201
736,35,5,2,9,4,-46,22,3,3,283,223
736,36,4,3,9,4,45,31,8,4,328,254
736,37,2,5,2,11,20,-44,8,0,348,210
736,38,4,3,7,6,-57,33,1,3,291,243
736,39,3,3,5,8,32,35,3,8,323,278
736,40,4,3,6,7,42,-66,5,2,365,212
736,41,3,3,5,8,32,35,7,7,397,247
736,42,3,3,8,5,-65,32,2,9,332,279
736,43,5,2,8,5,53,-77,5,2,385,202
736,44,4,3,9,4,-55,31,0,3,330,233
736,45,3,4,8,5,35,41,5,4,365,274
736,46,4,2,7,6,43,24,8,8,408,298
736,47,3,4,5,8,-68,-56,0,2,340,242
736,48,3,3,4,9,31,36,1,8,371,278
736,49,5,2,9,4,54,-78,5,0,425,200
736,50,2,5,5,8,23,53,8,3,448,253
736,51,6,2,8,5,-38,23,0,6,410,276
736,52,3,4,7,6,34,42,4,8,444,318
736,53,2,4,3,10,21,-54,5,4,465,264
736,54,4,2,9,4,-55,22,0,6,410,286
736,55,2,5,5,8,23,53,3,9,433,339
736,56,2,5,2,11,20,-44,3,5,453,295
736,57,3,3,3,10,30,-63,3,2,483,232
736,58,2,5,5,8,23,53,6,5,506,285
737,1,3,3,7,6,34,33,4,3,34,33
737,2,3,4,3,10,30,46,4,9,64,79
737,3,3,4,6,7,33,-57,7,2,97,22
737,4,3,4,6,7,-67,43,0,5,30,65
737,5,3,4,5,8,32,44,2,9,62,109
737,6,3,3,6,7,33,-66,5,3,95,43
737,7,3,3,5,8,32,35,7,8,127,78
737,8,2,4,8,5,-74,41,3,9,53,119
737,9,4,2,10,3,46,-79,9,0,99,40
737,10,4,2,9,4,-55,22,4,2,44,62
737,11,5,2,10,3,55,21,9,3,99,83
737,12,3,4,4,9,-69,45,0,8,30,128
737,13,2,5,4,9,22,-46,2,2,52,82
737,14,4,2,7,6,43,24,5,6,95,106
737,15,2,4,4,9,22,-55,7,1,117,51
737,16,3,4,7,6,-66,42,1,3,51,93
737,17,4,4,7,6,43,42,4,5,94,135
737,18,4,2,6,7,42,-75,6,0,136,60
737,19,4,3,5,8,41,35,7,5,177,95
737,20,4,3,6,7,42,34,9,9,219,129
737,21,4,3,6,7,-58,-66,1,3,161,63
737,22,2,4,4,9,22,45,3,8,183,108
737,23,4,3,6,7,42,-66,5,2,225,42
737,24,4,3,8,5,44,32,9,4,269,74
737,25,4,2,9,4,-55,22,4,6,214,96
737,26,3,4,5,8,32,-56,6,0,246,40
737,27,2,4,5,8,23,44,9,4,269,84
737,28,3,3,8,5,-65,32,4,6,204,116
737,29,5,2,8,5,53,23,7,9,257,139
737,30,4,3,5,8,41,-65,8,4,298,74
737,31,4,3,8,5,-56,32,2,6,242,106
737,32,3,3,5,8,32,-65,4,1,274,41
737,33,3,3,8,5,35,32,9,3,309,73
737,34,3,3,8,5,-65,32,4,5,244,105
737,35,4,3,5,8,41,-65,5,0,285,40
737,36,2,4,6,7,24,43,9,3,309,83
737,37,4,3,9,4,-55,31,4,4,254,114
737,38,5,2,8,5,53,23,7,7,307,137
737,39,3,4,8,5,-65,41,2,8,242,178
737,40,4,3,8,5,44,-68,6,0,286,110
737,41,4,2,6,7,42,25,8,5,328,135
737,42,3,4,5,8,-68,44,0,9,260,179
737,43,3,3,9,4,36,-69,6,0,296,110
737,44,3,3,8,5,-65,32,1,2,231,142
737,45,2,5,5,8,23,53,4,5,254,195
737,46,4,3,7,6,43,33,7,8,297,228
737,47,4,2,8,5,-56,-77,1,1,241,151
737,48,4,4,5,8,41,44,2,5,282,195
737,49,4,2,9,4,45,22,7,7,327,217
737,50,5,2,7,6,52,-76,9,1,379,141
737,51,2,5,7,6,-75,51,4,2,304,192
737,52,2,5,3,10,21,55,5,7,325,247
737,53,3,4,4,9,31,-55,6,2,356,192
737,54,4,3,6,7,42,34,8,6,398,226
737,55,2,4,4,9,-78,-55,0,1,320,171
737,56,3,4,6,7,33,43,3,4,353,214
737,57,2,4,5,8,23,44,6,8,376,258
737,58,4,2,7,6,43,-76,9,2,419,182
737,59,5,2,9,4,-46,22,3,4,373,204
737,60,3,3,9,4,36,31,9,5,409,235
737,61,3,3,8,5,-65,32,4,7,344,267
737,62,3,3,6,7,33,-66,7,1,377,201
737,63,2,4,5,8,-77,44,0,5,300,245
737,64,5,2,9,4,54,22,4,7,354,267
737,65,5,2,7,6,52,-76,6,1,406,191
737,66,4,2,6,7,42,25,8,6,448,216
737,67,5,2,9,4,-46,22,2,8,402,238
737,68,4,2,6,7,42,-75,4,3,444,163
737,69,4,2,9,4,45,22,9,5,489,185
737,70,4,3,9,4,-55,31,4,6,434,216
737,71,3,4,4,9,31,-55,5,1,465,161
737,72,2,6,2,11,20,65,5,6,485,226
737,73,4,3,6,7,42,-66,7,0,527,160
738,1,2,5,4,9,22,54,2,4,22,54
738,2,2,6,4,9,22,63,4,7,44,117
738,3,5,2,9,4,54,22,8,9,98,139
738,4,4,2,8,5,-56,-77,2,2,42,62
738,5,5,2,8,5,53,23,5,5,95,85
738,6,2,4,6,7,24,43,9,8,119,128
738,7,2,5,3,10,-79,-45,0,3,40,83
738,8,5,2,8,5,53,23,3,6,93,106
738,9,4,2,7,6,43,-76,6,0,136,30
738,10,3,3,6,7,33,34,9,4,169,64
738,11,3,3,7,6,-66,33,3,7,103,97
738,12,3,4,6,7,33,-57,6,0,136,40
738,13,3,3,4,9,31,36,7,6,167,76
738,14,2,4,5,8,-77,-56,0,0,90,20
738,15,2,6,3,10,21,64,1,4,111,84
738,16,3,4,4,9,31,45,2,9,142,129
738,17,5,2,8,5,53,-77,5,2,195,52
738,18,3,3,8,5,-65,32,0,4,130,84
738,19,3,3,9,4,36,31,6,5,166,115
738,20,4,2,8,5,-56,23,0,8,110,138
738,21,2,4,6,7,24,-57,4,1,134,81
738,22,4,3,7,6,43,33,7,4,177,114
738,23,4,3,7,6,-57,33,0,7,120,147
738,24,3,4,8,5,35,41,5,8,155,188
738,25,2,4,6,7,24,-57,9,1,179,131
738,26,4,3,6,7,-58,34,1,5,121,165
738,27,4,2,7,6,43,24,4,9,164,189
738,28,5,2,9,4,54,-78,8,1,218,111
738,29,3,3,8,5,-65,32,3,3,153,143
738,30,5,2,9,4,54,22,7,5,207,165
738,31,4,2,6,7,42,-75,9,0,249,90
738,32,2,4,6,7,-76,43,3,3,173,133
738,33,4,3,7,6,43,33,6,6,216,166
738,34,4,2,10,3,-54,21,2,7,162,187
738,35,3,4,6,7,33,-57,5,0,195,130
738,36,4,3,6,7,42,34,7,4,237,164
738,37,2,5,2,11,20,-44,7,0,257,120
738,38,4,3,7,6,-57,33,0,3,200,153
738,39,3,3,8,5,35,32,5,5,235,185
738,40,2,4,4,9,22,-55,7,0,257,130
738,41,2,5,6,7,-76,52,1,2,181,182
738,42,3,3,6,7,33,34,4,6,214,216
738,43,3,4,4,9,31,-55,5,1,245,161
738,44,3,4,6,7,33,43,8,4,278,204
738,45,4,2,7,6,-57,24,1,8,221,228
738,46,4,2,6,7,42,-75,3,3,263,153
738,47,2,5,4,9,22,54,5,7,285,207
738,48,5,2,9,4,54,22,9,9,339,229
738,49,3,4,7,6,-66,-58,3,1,273,171
738,50,3,3,7,6,34,33,7,4,307,204
738,51,2,4,3,10,21,-54,8,0,328,150
738,52,2,5,3,10,21,55,9,5,349,205
738,53,3,4,5,8,-68,44,1,9,281,249
738,54,4,3,7,6,43,-67,4,2,324,182
738,55,4,2,8,5,44,23,8,5,368,205
738,56,4,3,7,6,-57,33,1,8,311,238
738,57,2,4,7,6,25,-58,6,0,336,180
738,58,5,2,10,3,-45,21,1,1,291,201
738,59,2,4,5,8,23,44,4,5,314,245
738,60,5,2,11,2,-44,20,0,5,270,265
738,61,4,2,7,6,43,24,3,9,313,289
738,62,2,4,5,8,23,-56,6,3,336,233
738,63,3,3,8,5,-65,32,1,5,271,265
738,64,3,3,6,7,33,34,4,9,304,299
738,65,2,4,4,9,22,-55,6,4,326,244
738,66,2,4,3,10,21,-54,7,0,347,190
738,67,2,4,5,8,-77,44,0,4,270,234
738,68,2,5,3,10,21,55,1,9,291,289
738,69,2,6,2,11,20,-35,1,4,311,254
738,70,3,3,4,9,31,-64,2,0,342,190
738,71,4,2,6,7,42,25,4,5,384,215
738,72,3,5,6,7,33,52,7,7,417,267
738,73,3,3,5,8,32,-65,9,2,449,202
738,74,2,6,2,11,20,65,9,7,469,267
738,75,2,5,2,11,20,-44,9,3,489,223
738,76,3,3,5,8,-68,35,1,8,421,258
738,77,5,2,7,6,52,-76,3,2,473,182
738,78,3,3,8,5,35,32,8,4,508,214
739,1,3,4,9,4,36,40,6,0,36,40
739,2,2,4,5,8,23,44,9,4,59,84
739,3,6,2,10,3,-36,21,3,5,23,105
739,4,3,4,6,7,33,43,6,8,56,148
739,5,3,3,8,5,-65,-68,1,0,-9,80
739,6,5,2,9,4,54,22,5,2,45,102
739,7,3,3,7,6,34,33,9,5,79,135
739,8,3,5,5,8,-68,53,1,8,11,188
739,9,4,3,5,8,41,-65,2,3,52,123
739,10,3,4,3,10,30,46,2,9,82,169
739,11,3,3,7,6,34,-67,6,2,116,102
739,12,3,3,8,5,-65,32,1,4,51,134
739,13,3,3,6,7,33,34,4,8,84,168
739,14,3,4,5,8,32,-56,6,2,116,112
739,15,5,2,10,3,-45,21,1,3,71,133
739,16,3,3,7,6,34,33,5,6,105,166
739,17,4,3,6,7,42,-66,7,0,147,100
739,18,2,5,5,8,-77,53,0,3,70,153
739,19,3,3,7,6,34,33,4,6,104,186
739,20,4,2,10,3,-54,21,0,7,50,207
739,21,2,6,2,11,20,-35,0,2,70,172
739,22,3,3,4,9,31,36,1,8,101,208
739,23,5,2,9,4,54,-78,5,0,155,130
739,24,2,4,4,9,22,45,7,5,177,175
739,25,2,4,5,8,-77,44,0,9,100,219
739,26,3,4,4,9,31,-55,1,4,131,164
739,27,3,4,7,6,34,42,5,6,165,206
739,28,3,3,6,7,33,-66,8,0,198,140
739,29,2,4,5,8,-77,44,1,4,121,184
739,30,3,4,6,7,33,43,4,7,154,227
739,31,3,4,7,6,34,42,8,9,188,269
739,32,4,3,3,10,-40,-63,8,6,148,206
739,33,2,5,5,8,-77,53,1,9,71,259
739,34,2,4,4,9,22,-55,3,4,93,204
739,35,4,2,7,6,43,24,6,8,136,228
739,36,3,3,7,6,-66,-67,0,1,70,161
739,37,3,4,3,10,30,46,0,7,100,207
739,38,3,4,6,7,33,-57,3,0,133,150
739,39,5,2,7,6,52,24,5,4,185,174
739,40,3,5,4,9,31,54,6,8,216,228
739,41,3,4,5,8,32,-56,8,2,248,172
739,42,5,2,9,4,-46,22,2,4,202,194
739,43,3,3,8,5,35,32,7,6,237,226
739,44,4,3,7,6,-57,33,0,9,180,259
739,45,4,2,8,5,44,-77,4,2,224,182
739,46,4,3,8,5,44,32,8,4,268,214
739,47,3,3,6,7,-67,34,1,8,201,248
739,48,4,2,10,3,46,21,7,9,247,269
739,49,3,3,6,7,-67,-66,0,3,180,203
739,50,3,3,7,6,34,33,4,6,214,236
739,51,3,4,9,4,-64,40,0,6,150,276
739,52,3,4,4,9,31,-55,1,1,181,221
739,53,3,3,8,5,35,32,6,3,216,253
739,54,4,4,8,5,-56,41,0,4,160,294
739,55,4,3,9,4,45,31,5,5,205,325
739,56,4,3,8,5,44,32,9,7,249,357
739,57,4,2,9,4,-55,22,4,9,194,379
739,58,5,2,10,3,55,-79,9,0,249,300
739,59,4,3,4,9,40,36,9,6,289,336
739,60,3,3,4,9,-69,-64,0,2,220,272
739,61,4,2,6,7,42,25,2,7,262,297
739,62,5,2,7,6,52,-76,4,1,314,221
739,63,3,4,5,8,32,44,6,5,346,265
739,64,4,3,8,5,-56,32,0,7,290,297
739,65,4,3,5,8,41,-65,1,2,331,232
739,66,2,5,6,7,24,52,5,4,355,284
739,67,4,3,7,6,43,33,8,7,398,317
739,68,2,5,4,9,-78,-46,0,1,320,271
739,69,4,3,9,4,45,31,5,2,365,302
739,70,3,3,4,9,31,36,6,8,396,338
739,71,4,3,5,8,41,-65,7,3,437,273
739,72,4,3,6,7,42,34,9,7,479,307
739,73,3,4,8,5,-65,41,4,8,414,348
739,74,3,3,8,5,35,-68,9,0,449,280
739,75,4,3,8,5,-56,32,3,2,393,312
739,76,4,3,5,8,41,35,4,7,434,347
739,77,3,4,5,8,32,-56,6,1,466,291
739,78,3,3,6,7,33,34,9,5,499,325
739,79,2,5,5,8,-77,53,2,8,422,378
739,80,3,3,5,8,32,-65,4,3,454,313
739,81,5,2,8,5,53,23,7,6,507,336
740,1,4,2,9,4,45,22,5,2,45,22
740,2,3,3,3,10,30,37,5,9,75,59
740,3,2,4,4,9,22,-55,7,4,97,4
740,4,4,2,10,3,-54,21,3,5,43,25
740,5,3,3,7,6,34,33,7,8,77,58
740,6,3,3,9,4,-64,31,3,9,13,89
740,7,3,3,9,4,36,-69,9,0,49,20
740,8,3,3,6,7,-67,34,2,4,-18,54
740,9,4,3,5,8,41,35,3,9,23,89
740,10,4,2,10,3,46,-79,9,0,69,10
740,11,2,5,5,8,-77,53,2,3,-8,63
740,12,2,5,5,8,23,53,5,6,15,116
740,13,3,3,6,7,33,-66,8,0,48,50
740,14,3,4,8,5,-65,41,3,1,-17,91
740,15,2,5,3,10,21,55,4,6,4,146
740,16,5,2,10,3,55,21,9,7,59,167
740,17,4,3,6,7,-58,-66,1,1,1,101
740,18,3,3,7,6,34,33,5,4,35,134
740,19,3,3,4,9,31,-64,6,0,66,70
740,20,3,3,3,10,30,37,6,7,96,107
740,21,4,3,6,7,42,-66,8,1,138,41
740,22,2,6,2,11,20,65,8,6,158,106
740,23,2,5,5,8,-77,53,1,9,81,159
740,24,3,4,9,4,36,40,7,9,117,199
740,25,4,2,8,5,-56,-77,1,2,61,122
740,26,4,3,5,8,41,35,2,7,102,157
740,27,3,3,8,5,35,32,7,9,137,189
740,28,2,5,8,5,-74,50,3,9,63,239
740,29,2,4,5,8,23,-56,6,3,86,183
740,30,4,3,7,6,43,33,9,6,129,216
740,31,2,5,2,11,20,-44,9,2,149,172
740,32,3,3,7,6,-66,33,3,5,83,205
740,33,3,3,8,5,35,32,8,7,118,237
740,34,2,4,4,9,-78,-55,0,2,40,182
740,35,4,3,6,7,42,34,2,6,82,216
740,36,2,5,4,9,22,-46,4,0,104,170
740,37,2,5,5,8,23,53,7,3,127,223
740,38,3,3,9,4,-64,31,3,4,63,254
740,39,4,3,8,5,44,32,7,6,107,286
740,40,4,3,7,6,-57,33,0,9,50,319
740,41,2,4,3,10,21,-54,1,5,71,265
740,42,2,5,4,9,22,54,3,9,93,319
740,43,4,3,8,5,44,-68,7,1,137,251
740,44,6,2,11,2,-35,20,2,1,102,271
740,45,2,5,6,7,24,52,6,3,126,323
740,46,2,4,8,5,-74,41,2,4,52,364
740,47,4,3,8,5,44,32,6,6,96,396
740,48,3,3,8,5,-65,32,1,8,31,428
740,49,3,4,4,9,31,-55,2,3,62,373
740,50,3,4,9,4,36,40,8,3,98,413
740,51,3,4,6,7,-67,43,1,6,31,456
740,52,5,2,6,7,51,-75,2,1,82,381
740,53,2,4,8,5,26,41,8,2,108,422
740,54,2,5,5,8,-77,53,1,5,31,475
740,55,4,3,8,5,44,32,5,7,75,507
741,1,4,2,8,5,44,23,4,3,44,23
741,2,5,2,10,3,55,21,9,4,99,44
741,3,3,3,8,5,-65,32,4,6,34,76
741,4,3,3,5,8,32,-65,6,1,66,11
741,5,2,5,5,8,23,53,9,4,89,64
741,6,4,2,8,5,-56,23,3,7,33,87
741,7,3,4,5,8,32,-56,5,1,65,31
741,8,3,3,8,5,-65,32,0,3,0,63
741,9,4,2,8,5,44,23,4,6,44,86
741,10,2,5,6,7,24,52,8,8,68,138
741,11,4,2,5,8,41,-74,9,4,109,64
741,12,4,2,6,7,-58,25,1,9,51,89
741,13,4,4,9,4,45,40,6,9,96,129
741,14,3,3,8,5,-65,-68,1,1,31,61
741,15,3,3,7,6,34,33,5,4,65,94
741,16,3,3,7,6,34,33,9,7,99,127
741,17,2,4,7,6,-75,42,4,9,24,169
741,18,4,3,6,7,42,-66,6,3,66,103
741,19,3,4,6,7,33,43,9,6,99,146
741,20,5,2,8,5,-47,23,2,9,52,169
741,21,4,2,9,4,45,-78,7,1,97,91
741,22,3,4,4,9,31,45,8,6,128,136
741,23,2,4,7,6,-75,42,3,8,53,178
741,24,2,6,3,10,21,-36,4,2,74,142
741,25,3,4,4,9,31,45,5,7,105,187
741,26,2,5,5,8,23,-47,8,0,128,140
741,27,3,4,7,6,-66,42,2,2,62,182
741,28,3,4,6,7,33,43,5,5,95,225
741,29,5,2,10,3,-45,21,0,6,50,246
741,30,3,4,8,5,35,41,5,7,85,287
741,31,2,4,3,10,21,-54,6,3,106,233
741,32,2,4,7,6,-75,42,1,5,31,275
741,33,4,3,6,7,42,34,3,9,73,309
741,34,3,4,3,10,30,-54,3,5,103,255
741,35,4,4,5,8,41,44,4,9,144,299
741,36,3,5,4,9,31,-46,5,3,175,253
741,37,4,3,9,4,-55,31,0,4,120,284
741,38,3,4,7,6,34,42,4,6,154,326
741,39,4,3,8,5,44,32,8,8,198,358
741,40,2,4,5,8,-77,-56,1,2,121,302
741,41,3,4,8,5,35,41,6,3,156,343
741,42,2,4,3,10,21,46,7,9,177,389
741,43,4,2,9,4,-55,-78,2,1,122,311
741,44,4,4,9,4,45,40,7,1,167,351
741,45,3,4,6,7,-67,43,0,4,100,394
741,46,2,4,3,10,21,-54,1,0,121,340
741,47,3,3,6,7,33,34,4,4,154,374
741,48,3,3,4,9,31,-64,5,0,185,310
741,49,4,2,8,5,44,23,9,3,229,333
741,50,4,2,6,7,-58,25,1,8,171,358
741,51,5,3,7,6,52,-67,3,1,223,291
741,52,3,3,4,9,31,36,4,7,254,327
741,53,2,4,5,8,23,-56,7,1,277,271
741,54,4,2,8,5,-56,23,1,4,221,294
741,55,3,3,7,6,34,33,5,7,255,327
741,56,3,3,6,7,33,-66,8,1,288,261
741,57,4,3,8,5,-56,32,2,3,232,293
741,58,4,3,6,7,42,34,4,7,274,327
741,59,4,2,8,5,44,-77,8,0,318,250
741,60,2,4,8,5,-74,41,4,1,244,291
741,61,2,4,6,7,24,43,8,4,268,334
741,62,2,4,4,9,-78,45,0,9,190,379
741,63,3,4,6,7,33,-57,3,2,223,322
741,64,4,3,9,4,45,31,8,3,268,353
741,65,2,4,8,5,-74,41,4,4,194,394
741,66,5,2,10,3,55,21,9,5,249,415
741,67,6,2,9,4,-37,22,2,7,212,437
741,68,3,3,4,9,31,-64,3,3,243,373
741,69,2,4,3,10,21,46,4,9,264,419
741,70,4,3,5,8,41,-65,5,4,305,354
741,71,3,3,9,4,-64,31,1,5,241,385
741,72,5,3,8,5,53,32,4,7,294,417
741,73,3,3,5,8,32,-65,6,2,326,352
741,74,2,5,3,10,21,55,7,7,347,407
741,75,2,4,5,8,-77,-56,0,1,270,351
741,76,3,3,8,5,35,32,5,3,305,383
741,77,2,4,2,11,20,-53,5,0,325,330
741,78,3,5,5,8,32,53,7,3,357,383
741,79,3,3,8,5,-65,32,2,5,292,415
741,80,2,5,3,10,21,-45,3,0,313,370
741,81,3,3,6,7,33,34,6,4,346,404
741,82,3,4,6,7,33,43,9,7,379,447
741,83,4,2,6,7,-58,-75,1,2,321,372
741,84,4,2,7,6,43,24,4,6,364,396
741,85,3,3,4,9,31,-64,5,2,395,332
741,86,3,3,6,7,33,34,8,6,428,366
741,87,3,3,5,8,-68,-65,0,1,360,301
741,88,3,3,7,6,34,33,4,4,394,334
741,89,3,3,4,9,31,-64,5,0,425,270
741,90,2,4,5,8,23,44,8,4,448,314
741,91,2,4,6,7,-76,43,2,7,372,357
741,92,4,2,9,4,45,22,7,9,417,379
741,93,4,3,7,6,-57,-67,0,2,360,312
741,94,2,4,4,9,22,45,2,7,382,357
741,95,5,2,9,4,54,22,6,9,436,379
741,96,2,5,5,8,23,-47,9,2,459,332
741,97,4,3,7,6,-57,33,2,5,402,365
741,98,4,2,5,8,41,-74,3,1,443,291
741,99,3,3,6,7,33,34,6,5,476,325
741,100,5,2,10,3,-45,21,1,6,431,346
741,101,2,4,5,8,23,-56,4,0,454,290
741,102,4,3,7,6,43,33,7,3,497,323
741,103,3,3,7,6,-66,33,1,6,431,356
741,104,3,3,5,8,32,-65,3,1,463,291
741,105,3,4,3,10,30,46,3,7,493,337
741,106,3,3,5,8,32,-65,5,2,525,272
742,1,2,5,3,10,21,55,1,5,21,55
742,2,3,4,8,5,35,41,6,6,56,96
742,3,4,3,7,6,43,33,9,9,99,129
742,4,2,6,3,10,-79,-36,0,3,20,93
742,5,4,2,9,4,45,22,5,5,65,115
742,6,4,3,10,3,-54,30,1,5,11,145
742,7,3,3,6,7,33,34,4,9,44,179
742,8,4,2,9,4,45,-78,9,1,89,101
742,9,2,4,6,7,-76,43,3,4,13,144
742,10,4,3,6,7,42,34,5,8,55,178
742,11,4,2,10,3,-54,21,1,9,1,199
742,12,3,4,7,6,34,-58,5,1,35,141
742,13,4,2,8,5,44,23,9,4,79,164
742,14,4,3,8,5,-56,32,3,6,23,196
742,15,2,6,6,7,24,61,7,7,47,257
742,16,5,2,10,3,-45,21,2,8,2,278
742,17,3,4,3,10,30,-54,2,4,32,224
742,18,2,6,3,10,21,64,3,8,53,288
742,19,4,2,7,6,43,-76,6,2,96,212
742,20,4,3,8,5,-56,32,0,4,40,244
742,21,2,4,6,7,24,43,4,7,64,287
742,22,3,4,7,6,34,42,8,9,98,329
742,23,3,4,8,5,-65,-59,3,0,33,270
742,24,3,3,5,8,32,35,5,5,65,305
742,25,5,2,11,2,-44,20,1,5,21,325
742,26,4,3,10,3,46,30,7,5,67,355
742,27,4,3,10,3,-54,30,3,5,13,385
742,28,3,4,6,7,33,43,6,8,46,428
742,29,4,2,9,4,-55,-78,1,0,-9,350
742,30,2,4,5,8,23,44,4,4,14,394
742,31,3,4,4,9,31,45,5,9,45,439
742,32,2,5,4,9,22,-46,7,3,67,393
742,33,3,4,9,4,-64,40,3,3,3,433
742,34,4,2,9,4,45,22,8,5,48,455
742,35,5,2,6,7,51,-75,9,0,99,380
742,36,3,3,9,4,-64,31,5,1,35,411
742,37,2,5,5,8,23,53,8,4,58,464
742,38,3,5,6,7,-67,52,1,6,-9,516
743,1,3,3,7,6,34,33,4,3,34,33
743,2,2,5,6,7,24,52,8,5,58,85
743,3,2,4,8,5,-74,41,4,6,-16,126
743,4,3,4,5,8,32,-56,6,0,16,70
743,5,3,3,6,7,33,34,9,4,49,104
743,6,4,3,9,4,-55,31,4,5,-6,135
743,7,5,2,7,6,52,24,6,9,46,159
743,8,2,5,5,8,23,-47,9,2,69,112
743,9,3,4,3,10,30,46,9,8,99,158
743,10,3,3,8,5,-65,-68,4,0,34,90
743,11,2,5,4,9,22,54,6,4,56,144
743,12,2,5,4,9,22,54,8,8,78,198
743,13,5,2,11,2,-44,20,4,8,34,218
743,14,2,5,4,9,22,-46,6,2,56,172
743,15,2,4,4,9,22,45,8,7,78,217
743,16,3,3,8,5,-65,32,3,9,13,249
743,17,3,4,5,8,32,-56,5,3,45,193
743,18,2,5,6,7,24,52,9,5,69,245
743,19,2,4,4,9,-78,-55,1,0,-9,190
743,20,3,3,7,6,34,33,5,3,25,223
743,21,3,3,7,6,34,33,9,6,59,256
743,22,2,4,4,9,-78,-55,1,1,-19,201
743,23,5,2,7,6,52,24,3,5,33,225
743,24,4,3,8,5,44,32,7,7,77,257
743,25,3,4,4,9,31,-55,8,2,108,202
743,26,3,3,7,6,-66,33,2,5,42,235
743,27,4,3,5,8,41,-65,3,0,83,170
743,28,4,2,7,6,43,24,6,4,126,194
743,29,3,3,5,8,32,35,8,9,158,229
743,30,5,2,7,6,-48,-76,0,3,110,153
743,31,3,4,5,8,32,44,2,7,142,197
743,32,5,2,5,8,50,-74,2,3,192,123
743,33,4,2,8,5,44,23,6,6,236,146
743,34,3,4,4,9,31,-55,7,1,267,91
743,35,3,3,4,9,31,36,8,7,298,127
743,36,4,3,8,5,-56,32,2,9,242,159
743,37,2,4,4,9,22,-55,4,4,264,104
743,38,3,4,4,9,31,45,5,9,295,149
743,39,4,2,6,7,42,-75,7,4,337,74
743,40,3,4,8,5,-65,41,2,5,272,115
743,41,3,4,6,7,33,43,5,8,305,158
743,42,4,3,6,7,42,-66,7,2,347,92
743,43,2,4,6,7,-76,43,1,5,271,135
743,44,4,3,8,5,44,32,5,7,315,167
743,45,4,3,6,7,42,-66,7,1,357,101
743,46,3,3,8,5,-65,32,2,3,292,133
743,47,4,3,7,6,43,33,5,6,335,166
743,48,3,3,6,7,33,-66,8,0,368,100
743,49,2,6,6,7,-76,61,2,1,292,161
743,50,3,4,6,7,33,43,5,4,325,204
743,51,2,6,4,9,22,63,7,7,347,267
743,52,3,3,5,8,32,-65,9,2,379,202
743,53,2,4,6,7,-76,43,3,5,303,245
743,54,3,3,6,7,33,34,6,9,336,279
743,55,3,4,8,5,-65,-59,1,0,271,220
743,56,3,3,7,6,34,33,5,3,305,253
743,57,3,3,5,8,32,35,7,8,337,288
743,58,3,3,7,6,-66,-67,1,1,271,221
743,59,2,4,4,9,22,45,3,6,293,266
743,60,3,4,7,6,34,42,7,8,327,308
743,61,5,2,10,3,-45,21,2,9,282,329
743,62,2,6,5,8,23,-38,5,1,305,291
743,63,5,2,8,5,53,23,8,4,358,314
743,64,3,4,6,7,-67,43,1,7,291,357
743,65,3,4,7,6,34,42,5,9,325,399
743,66,2,5,3,10,21,-45,6,4,346,354
743,67,4,2,8,5,-56,23,0,7,290,377
743,68,3,3,6,7,33,-66,3,1,323,311
743,69,2,4,8,5,26,41,9,2,349,352
743,70,3,4,3,10,30,46,9,8,379,398
743,71,4,3,6,7,-58,-66,1,2,321,332
743,72,2,6,2,11,20,65,1,7,341,397
743,73,6,2,9,4,63,22,4,9,404,419
743,74,6,2,10,3,64,-79,8,0,468,340
743,75,2,4,7,6,-75,42,3,2,393,382
743,76,2,6,4,9,22,63,5,5,415,445
743,77,4,2,6,7,42,-75,7,0,457,370
743,78,2,4,5,8,-77,44,0,4,380,414
743,79,3,3,8,5,35,32,5,6,415,446
743,80,6,2,9,4,63,22,8,8,478,468
743,81,5,3,7,6,-48,-67,0,1,430,401
743,82,4,2,10,3,46,21,6,2,476,422
743,83,6,2,11,2,-35,20,1,2,441,442
743,84,3,3,7,6,34,33,5,5,475,475
743,85,3,4,5,8,32,44,7,9,507,519
744,1,4,2,10,3,46,21,6,1,46,21
744,2,5,2,10,3,-45,21,1,2,1,42
744,3,3,4,8,5,35,41,6,3,36,83
744,4,3,3,4,9,31,36,7,9,67,119
744,5,4,2,7,6,-57,-76,0,3,10,43
744,6,4,3,7,6,43,33,3,6,53,76
744,7,3,3,7,6,34,33,7,9,87,109
744,8,4,2,7,6,-57,-76,0,3,30,33
744,9,3,3,9,4,36,31,6,4,66,64
744,10,2,5,3,10,21,55,7,9,87,119
744,11,4,2,9,4,-55,-78,2,1,32,41
744,12,3,3,9,4,36,31,8,2,68,72
744,13,3,4,3,10,30,46,8,8,98,118
744,14,5,2,7,6,-48,-76,0,2,50,42
744,15,3,3,9,4,36,31,6,3,86,73
744,16,3,3,5,8,32,35,8,8,118,108
744,17,2,4,7,6,-75,-58,3,0,43,50
744,18,3,3,6,7,33,34,6,4,76,84
744,19,3,3,4,9,31,-64,7,0,107,20
744,20,4,2,10,3,-54,21,3,1,53,41
744,21,3,3,4,9,31,36,4,7,84,77
744,22,4,4,8,5,44,41,8,8,128,118
744,23,4,3,7,6,-57,-67,1,1,71,51
744,24,3,4,6,7,33,43,4,4,104,94
744,25,2,5,5,8,23,53,7,7,127,147
744,26,3,3,4,9,31,-64,8,3,158,83
744,27,3,5,6,7,-67,52,1,5,91,135
744,28,4,3,8,5,44,32,5,7,135,167
744,29,3,3,8,5,-65,32,0,9,70,199
744,30,4,2,6,7,42,-75,2,4,112,124
744,31,4,3,7,6,43,33,5,7,155,157
744,32,4,2,8,5,44,-77,9,0,199,80
744,33,3,3,10,3,-63,30,6,0,136,110
744,34,5,2,7,6,52,24,8,4,188,134
744,35,4,2,10,3,-54,21,4,5,134,155
744,36,3,3,7,6,34,33,8,8,168,188
744,37,4,3,8,5,-56,-68,2,0,112,120
744,38,5,2,7,6,52,24,4,4,164,144
744,39,2,4,4,9,22,45,6,9,186,189
744,40,3,3,6,7,33,-66,9,3,219,123
744,41,5,2,10,3,-45,21,4,4,174,144
744,42,3,4,5,8,32,44,6,8,206,188
744,43,4,2,8,5,-56,-77,0,1,150,111
744,44,4,3,5,8,41,35,1,6,191,146
744,45,2,5,3,10,21,-45,2,1,212,101
744,46,3,3,6,7,33,34,5,5,245,135
744,47,4,3,7,6,43,33,8,8,288,168
744,48,2,5,5,8,-77,-47,1,1,211,121
744,49,5,2,8,5,53,23,4,4,264,144
744,50,2,5,3,10,21,55,5,9,285,199
744,51,2,4,5,8,23,-56,8,3,308,143
744,52,4,2,10,3,-54,21,4,4,254,164
744,53,4,4,5,8,41,44,5,8,295,208
744,54,5,2,9,4,54,-78,9,0,349,130
744,55,3,4,7,6,-66,42,3,2,283,172
744,56,2,4,4,9,22,45,5,7,305,217
744,57,2,4,5,8,23,-56,8,1,328,161
744,58,4,3,10,3,-54,30,4,1,274,191
744,59,2,5,5,8,23,53,7,4,297,244
744,60,4,3,8,5,-56,32,1,6,241,276
744,61,2,4,7,6,25,42,6,8,266,318
744,62,3,3,7,6,-66,-67,0,1,200,251
744,63,4,3,4,9,40,36,0,7,240,287
744,64,4,3,8,5,44,32,4,9,284,319
744,65,4,3,9,4,45,-69,9,0,329,250
744,66,4,4,6,7,-58,43,1,3,271,293
744,67,4,2,8,5,44,23,5,6,315,316
744,68,3,3,6,7,33,-66,8,0,348,250
744,69,6,2,10,3,-36,21,2,1,312,271
744,70,6,2,11,2,65,20,7,1,377,291
744,71,4,2,6,7,42,25,9,6,419,316
744,72,5,2,11,2,-44,20,5,6,375,336
744,73,3,4,4,9,31,-55,6,1,406,281
744,74,4,2,7,6,43,24,9,5,449,305
744,75,4,2,9,4,-55,22,4,7,394,327
744,76,3,3,5,8,32,-65,6,2,426,262
744,77,5,2,10,3,-45,21,1,3,381,283
744,78,3,3,7,6,34,33,5,6,415,316
744,79,3,4,6,7,33,43,8,9,448,359
744,80,3,3,10,3,-63,30,5,9,385,389
744,81,4,2,10,3,-54,-79,1,0,331,310
744,82,4,3,5,8,41,35,2,5,372,345
744,83,2,4,6,7,24,43,6,8,396,388
744,84,4,4,6,7,42,-57,8,1,438,331
744,85,4,3,9,4,-55,31,3,2,383,362
744,86,3,4,3,10,30,46,3,8,413,408
744,87,4,2,10,3,46,21,9,9,459,429
744,88,2,4,5,8,-77,-56,2,3,382,373
744,89,4,3,6,7,42,34,4,7,424,407
744,90,5,2,9,4,54,22,8,9,478,429
744,91,3,3,5,8,-68,-65,0,4,410,364
744,92,6,2,8,5,62,23,2,7,472,387
744,93,2,4,5,8,23,-56,5,1,495,331
744,94,3,4,3,10,30,46,5,7,525,377
745,1,3,4,8,5,35,41,5,1,35,41
745,2,2,6,1,12,-20,66,5,7,15,107
745,3,3,4,5,8,32,-56,7,1,47,51
745,4,4,3,5,8,41,35,8,6,88,86
745,5,3,4,6,7,-67,43,1,9,21,129
745,6,4,2,6,7,42,-75,3,4,63,54
745,7,3,3,5,8,32,35,5,9,95,89
745,8,4,3,4,9,40,-64,5,5,135,25
745,9,4,3,6,7,42,34,7,9,177,59
745,10,3,4,6,7,-67,-57,0,2,110,2
745,11,2,5,7,6,25,51,5,3,135,53
745,12,4,3,5,8,41,35,6,8,176,88
745,13,4,3,7,6,43,-67,9,1,219,21
745,14,5,3,7,6,-48,33,1,4,171,54
745,15,4,3,9,4,45,31,6,5,216,85
745,16,2,4,3,10,21,-54,7,1,237,31
745,17,3,4,7,6,-66,42,1,3,171,73
745,18,5,2,11,2,56,20,7,3,227,93
745,19,4,3,9,4,-55,31,2,4,172,124
745,20,2,5,3,10,21,55,3,9,193,179
745,21,3,4,4,9,31,-55,4,4,224,124
745,22,3,3,5,8,32,35,6,9,256,159
745,23,3,3,5,8,32,-65,8,4,288,94
745,24,3,3,6,7,-67,34,1,8,221,128
745,25,4,3,6,7,42,-66,3,2,263,62
745,26,3,3,7,6,34,33,7,5,297,95
745,27,2,6,2,11,20,-35,7,0,317,60
745,28,4,2,10,3,-54,21,3,1,263,81
745,29,4,3,6,7,42,34,5,5,305,115
745,30,5,2,9,4,54,22,9,7,359,137
745,31,2,4,4,9,-78,-55,1,2,281,82
745,32,4,3,6,7,42,34,3,6,323,116
745,33,3,4,6,7,33,43,6,9,356,159
745,34,3,4,6,7,33,-57,9,2,389,102
745,35,4,3,7,6,-57,33,2,5,332,135
745,36,4,3,9,4,45,31,7,6,377,166
745,37,3,3,8,5,-65,32,2,8,312,198
745,38,2,4,8,5,26,41,8,9,338,239
745,39,3,4,7,6,-66,-58,2,1,272,181
745,40,4,2,9,4,45,22,7,3,317,203
745,41,3,4,4,9,31,45,8,8,348,248
745,42,2,4,5,8,-77,-56,1,2,271,192
745,43,3,4,6,7,33,43,4,5,304,235
745,44,3,3,4,9,31,-64,5,1,335,171
745,45,3,4,6,7,33,43,8,4,368,214
745,46,4,3,10,3,-54,30,4,4,314,244
745,47,3,3,6,7,33,34,7,8,347,278
745,48,3,4,8,5,-65,41,2,9,282,319
745,49,3,3,7,6,34,-67,6,2,316,252
745,50,7,2,10,3,73,21,9,3,389,273
745,51,4,3,6,7,-58,34,1,7,331,307
745,52,3,4,4,9,31,-55,2,2,362,252
745,53,3,4,6,7,33,43,5,5,395,295
745,54,5,2,8,5,53,23,8,8,448,318
745,55,2,5,4,9,-78,-46,0,2,370,272
745,56,3,4,5,8,32,44,2,6,402,316
745,57,3,3,8,5,35,32,7,8,437,348
745,58,4,3,9,4,-55,31,2,9,382,379
745,59,2,4,6,7,24,-57,6,2,406,322
745,60,4,3,8,5,-56,32,0,4,350,354
745,61,3,3,7,6,34,33,4,7,384,387
745,62,6,2,9,4,63,22,7,9,447,409
745,63,3,3,9,4,-64,-69,3,0,383,340
745,64,3,3,5,8,32,35,5,5,415,375
745,65,4,3,7,6,43,33,8,8,458,408
745,66,4,3,8,5,-56,-68,2,0,402,340
745,67,4,3,7,6,43,33,5,3,445,373
745,68,3,3,6,7,33,34,8,7,478,407
745,69,4,2,8,5,-56,-77,2,0,422,330
745,70,3,4,7,6,34,42,6,2,456,372
745,71,3,3,5,8,32,35,8,7,488,407
745,72,2,5,5,8,-77,-47,1,0,411,360
745,73,2,5,4,9,22,54,3,4,433,414
745,74,2,4,4,9,22,45,5,9,455,459
745,75,3,4,6,7,33,-57,8,2,488,402
745,76,3,4,5,8,-68,44,0,6,420,446
745,77,3,4,7,6,34,42,4,8,454,488
745,78,3,3,6,7,33,-66,7,2,487,422
745,79,3,3,8,5,-65,32,2,4,422,454
745,80,3,4,4,9,31,45,3,9,453,499
745,81,2,6,2,11,20,-35,3,4,473,464
745,82,2,4,5,8,23,44,6,8,496,508
746,1,4,2,7,6,43,24,3,4,43,24
746,2,3,3,5,8,32,35,5,9,75,59
746,3,4,3,9,4,-55,-69,0,0,20,-10
746,4,3,3,6,7,33,34,3,4,53,24
746,5,2,5,4,9,22,54,5,8,75,78
746,6,3,3,8,5,-65,-68,0,0,10,10
746,7,3,4,3,10,30,46,0,6,40,56
746,8,3,3,6,7,33,-66,3,0,73,-10
746,9,2,5,4,9,22,54,5,4,95,44
746,10,3,3,5,8,32,35,7,9,127,79
746,11,2,5,6,7,-76,-48,1,1,51,31
746,12,3,4,7,6,34,42,5,3,85,73
746,13,2,6,3,10,21,64,6,7,106,137
746,14,3,3,7,6,-66,-67,0,0,40,70
746,15,4,2,6,7,42,25,2,5,82,95
746,16,3,4,9,4,36,40,8,5,118,135
746,17,4,3,8,5,-56,32,2,7,62,167
746,18,5,2,9,4,54,22,6,9,116,189
746,19,4,3,8,5,-56,-68,0,1,60,121
746,20,5,2,9,4,54,22,4,3,114,143
746,21,4,2,6,7,42,25,6,8,156,168
746,22,3,4,8,5,-65,41,1,9,91,209
746,23,3,3,5,8,32,-65,3,4,123,144
746,24,2,4,5,8,23,44,6,8,146,188
746,25,4,3,8,5,-56,-68,0,0,90,120
746,26,5,3,10,3,55,30,5,0,145,150
746,27,2,6,2,11,20,65,5,5,165,215
746,28,3,3,6,7,33,34,8,9,198,249
746,29,3,3,3,10,30,-63,8,6,228,186
746,30,4,2,7,6,-57,-76,1,0,171,110
746,31,4,2,8,5,44,23,5,3,215,133
746,32,2,5,3,10,21,55,6,8,236,188
746,33,4,3,6,7,42,-66,8,2,278,122
746,34,2,5,5,8,-77,53,1,5,201,175
746,35,4,2,9,4,45,22,6,7,246,197
746,36,3,3,7,6,-66,-67,0,0,180,130
746,37,4,3,6,7,42,34,2,4,222,164
746,38,4,2,9,4,45,22,7,6,267,186
746,39,2,4,5,8,-77,-56,0,0,190,130
746,40,3,4,6,7,33,43,3,3,223,173
746,41,3,3,9,4,36,31,9,4,259,204
746,42,4,3,8,5,-56,32,3,6,203,236
746,43,3,4,3,10,30,-54,3,2,233,182
746,44,4,3,5,8,41,35,4,7,274,217
746,45,3,3,4,9,31,-64,5,3,305,153
746,46,5,2,7,6,52,24,7,7,357,177
746,47,5,3,7,6,52,-67,9,0,409,110
746,48,4,3,5,8,-59,35,0,5,350,145
746,49,2,5,3,10,21,-45,1,0,371,100
746,50,3,4,5,8,32,44,3,4,403,144
746,51,2,6,3,10,21,64,4,8,424,208
746,52,3,4,4,9,31,-55,5,3,455,153
746,53,3,3,6,7,33,34,8,7,488,187
746,54,2,5,3,10,21,-45,9,2,509,142
747,1,3,3,5,8,32,35,2,5,32,35
747,2,4,3,9,4,45,31,7,6,77,66
747,3,3,4,4,9,31,-55,8,1,108,11
747,4,2,4,6,7,-76,43,2,4,32,54
747,5,6,2,10,3,64,21,6,5,96,75
747,6,4,2,4,9,40,-73,6,2,136,2
747,7,5,2,9,4,-46,22,0,4,90,24
747,8,4,2,9,4,45,22,5,6,135,46
747,9,5,2,9,4,54,22,9,8,189,68
747,10,4,2,7,6,-57,-76,2,2,132,-8
747,11,2,5,4,9,22,54,4,6,154,46
747,12,4,3,7,6,43,33,7,9,197,79
747,13,3,3,6,7,-67,-66,0,3,130,13
747,14,3,4,7,6,34,42,4,5,164,55
747,15,3,3,7,6,34,33,8,8,198,88
747,16,4,3,6,7,-58,-66,0,2,140,22
747,17,6,2,11,2,65,20,5,2,205,42
747,18,5,2,8,5,53,23,8,5,258,65
747,19,4,2,8,5,-56,23,2,8,202,88
747,20,3,5,5,8,32,-47,4,1,234,41
747,21,5,2,9,4,54,22,8,3,288,63
747,22,5,2,10,3,-45,21,3,4,243,84
747,23,5,2,8,5,53,23,6,7,296,107
747,24,4,3,8,5,-56,32,0,9,240,139
747,25,3,4,7,6,34,-58,4,1,274,81
747,26,5,3,8,5,53,32,7,3,327,113
747,27,2,4,8,5,-74,41,3,4,253,154
747,28,4,3,7,6,43,33,6,7,296,187
747,29,2,5,5,8,23,-47,9,0,319,140
747,30,2,5,6,7,-76,52,3,2,243,192
747,31,3,4,7,6,34,42,7,4,277,234
747,32,3,3,4,9,31,-64,8,0,308,170
747,33,4,3,6,7,-58,34,0,4,250,204
747,34,2,5,4,9,22,54,2,8,272,258
747,35,5,2,10,3,55,21,7,9,327,279
747,36,3,3,6,7,-67,-66,0,3,260,213
747,37,5,2,9,4,54,22,4,5,314,235
747,38,5,2,10,3,55,21,9,6,369,256
747,39,5,2,8,5,-47,23,2,9,322,279
747,40,4,3,9,4,45,-69,7,0,367,210
747,41,5,2,9,4,-46,22,1,2,321,232
747,42,3,4,5,8,32,44,3,6,353,276
747,43,3,4,4,9,31,-55,4,1,384,221
747,44,3,3,9,4,-64,31,0,2,320,252
747,45,4,3,6,7,42,34,2,6,362,286
747,46,5,2,10,3,55,21,7,7,417,307
747,47,4,2,11,2,-53,20,4,7,364,327
747,48,2,5,4,9,22,-46,6,1,386,281
747,49,2,5,6,7,-76,52,0,3,310,333
747,50,4,2,9,4,45,22,5,5,355,355
747,51,3,3,7,6,34,33,9,8,389,388
747,52,3,3,9,4,-64,31,5,9,325,419
747,53,3,4,6,7,33,-57,8,2,358,362
747,54,4,3,6,7,-58,34,0,6,300,396
747,55,3,4,5,8,32,-56,2,0,332,340
747,56,2,4,6,7,24,43,6,3,356,383
747,57,3,3,9,4,-64,31,2,4,292,414
747,58,2,5,2,11,20,-44,2,0,312,370
747,59,3,5,4,9,31,54,3,4,343,424
747,60,4,2,10,3,46,21,9,5,389,445
747,61,6,2,10,3,-36,21,3,6,353,466
747,62,4,3,10,3,46,30,9,6,399,496
747,63,3,4,7,6,-66,42,3,8,333,538
748,1,3,3,9,4,36,31,6,1,36,31
748,2,6,2,10,3,-36,21,0,2,0,52
748,3,3,4,6,7,33,43,3,5,33,95
748,4,3,4,6,7,33,43,6,8,66,138
748,5,4,2,9,4,-55,-78,1,0,11,60
748,6,4,3,6,7,42,34,3,4,53,94
748,7,2,5,4,9,22,54,5,8,75,148
748,8,4,3,7,6,43,-67,8,1,118,81
748,9,4,2,8,5,-56,23,2,4,62,104
748,10,2,5,4,9,22,54,4,8,84,158
748,11,5,2,10,3,55,21,9,9,139,179
748,12,2,5,7,6,-75,-49,4,0,64,130
748,13,4,2,9,4,45,22,9,2,109,152
748,14,3,3,6,7,-67,34,2,6,42,186
748,15,4,3,5,8,41,-65,3,1,83,121
748,16,6,2,9,4,63,22,6,3,146,143
748,17,3,3,6,7,33,34,9,7,179,177
748,18,2,5,5,8,-77,-47,2,0,102,130
748,19,5,3,7,6,52,33,4,3,154,163
748,20,4,3,9,4,45,31,9,4,199,194
748,21,4,3,7,6,-57,33,2,7,142,227
748,22,4,3,8,5,44,32,6,9,186,259
748,23,4,2,6,7,42,-75,8,4,228,184
748,24,4,3,9,4,-55,31,3,5,173,215
748,25,4,3,6,7,42,34,5,9,215,249
748,26,3,3,5,8,32,-65,7,4,247,184
748,27,4,3,8,5,-56,32,1,6,191,216
748,28,4,3,9,4,45,31,6,7,236,247
748,29,2,4,4,9,22,-55,8,2,258,192
748,30,4,3,9,4,-55,31,3,3,203,223
748,31,2,5,5,8,23,53,6,6,226,276
748,32,4,3,6,7,42,-66,8,0,268,210
748,33,2,5,5,8,-77,53,1,3,191,263
748,34,2,6,5,8,23,62,4,5,214,325
748,35,2,5,3,10,21,-45,5,0,235,280
748,36,3,3,8,5,-65,32,0,2,170,312
748,37,2,5,4,9,22,54,2,6,192,366
748,38,3,3,7,6,34,33,6,9,226,399
748,39,2,5,3,10,21,-45,7,4,247,354
748,40,3,3,7,6,-66,33,1,7,181,387
748,41,4,2,8,5,44,-77,5,0,225,310
748,42,2,4,4,9,22,45,7,5,247,355
748,43,3,3,7,6,-66,33,1,8,181,388
748,44,3,4,7,6,34,-58,5,0,215,330
748,45,3,4,6,7,33,43,8,3,248,373
748,46,2,6,4,9,-78,63,0,6,170,436
748,47,3,3,8,5,35,32,5,8,205,468
748,48,5,2,8,5,53,-77,8,1,258,391
748,49,4,2,11,2,-53,20,5,1,205,411
748,50,5,2,9,4,54,22,9,3,259,433
748,51,3,4,5,8,-68,44,1,7,191,477
748,52,3,4,7,6,34,42,5,9,225,519
749,1,2,5,3,10,21,55,1,5,21,55
749,2,5,2,10,3,55,21,6,6,76,76
749,3,3,4,7,6,-66,42,0,8,10,118
749,4,3,3,6,7,33,-66,3,2,43,52
749,5,3,4,5,8,32,44,5,6,75,96
749,6,4,2,8,5,44,23,9,9,119,119
749,7,5,2,9,4,-46,-78,3,1,73,41
749,8,2,4,8,5,26,41,9,2,99,82
749,9,4,3,10,3,-54,30,5,2,45,112
749,10,3,4,8,5,-65,41,0,3,-20,153
749,11,3,3,7,6,34,33,4,6,14,186
749,12,5,2,8,5,53,23,7,9,67,209
749,13,4,3,5,8,41,-65,8,4,108,144
749,14,3,4,6,7,-67,43,1,7,41,187
749,15,5,3,6,7,51,-66,2,1,92,121
749,16,5,2,9,4,54,22,6,3,146,143
749,17,3,3,4,9,31,36,7,9,177,179
749,18,2,5,5,8,-77,-47,0,2,100,132
749,19,3,3,6,7,33,34,3,6,133,166
749,20,3,3,8,5,35,32,8,8,168,198
749,21,2,5,5,8,-77,-47,1,1,91,151
749,22,3,3,9,4,36,31,7,2,127,182
749,23,2,5,4,9,22,54,9,6,149,236
749,24,4,3,8,5,-56,32,3,8,93,268
749,25,3,3,7,6,34,-67,7,1,127,201
749,26,2,5,4,9,22,54,9,5,149,255
749,27,4,2,9,4,-55,22,4,7,94,277
749,28,4,2,5,8,41,-74,5,3,135,203
749,29,2,4,5,8,23,44,8,7,158,247
749,30,2,5,5,8,-77,-47,1,0,81,200
749,31,3,3,6,7,33,34,4,4,114,234
749,32,3,3,6,7,33,34,7,8,147,268
749,33,3,3,5,8,32,-65,9,3,179,203
749,34,2,4,7,6,-75,42,4,5,104,245
749,35,3,3,6,7,33,34,7,9,137,279
749,36,4,3,7,6,-57,-67,0,2,80,212
749,37,2,5,6,7,24,52,4,4,104,264
749,38,3,3,7,6,34,33,8,7,138,297
749,39,5,2,11,2,-44,20,4,7,94,317
749,40,4,2,9,4,45,22,9,9,139,339
749,41,3,4,6,7,-67,-57,2,2,72,282
749,42,4,2,7,6,43,24,5,6,115,306
749,43,4,2,9,4,-55,22,0,8,60,328
749,44,3,3,5,8,32,-65,2,3,92,263
749,45,5,2,7,6,52,24,4,7,144,287
749,46,3,4,7,6,34,42,8,9,178,329
749,47,4,3,6,7,-58,-66,0,3,120,263
749,48,4,3,6,7,42,34,2,7,162,297
749,49,4,2,10,3,46,21,8,8,208,318
749,50,5,2,11,2,-44,20,4,8,164,338
749,51,4,3,8,5,44,-68,8,0,208,270
749,52,4,3,7,6,-57,33,1,3,151,303
749,53,2,4,6,7,24,43,5,6,175,346
749,54,5,2,8,5,53,23,8,9,228,369
749,55,5,2,9,4,-46,-78,2,1,182,291
749,56,3,3,8,5,35,32,7,3,217,323
749,57,4,3,8,5,-56,32,1,5,161,355
749,58,3,4,5,8,32,44,3,9,193,399
749,59,2,4,6,7,24,-57,7,2,217,342
749,60,2,4,7,6,-75,42,2,4,142,384
749,61,2,5,4,9,22,54,4,8,164,438
749,62,5,2,11,2,-44,20,0,8,120,458
749,63,6,2,10,3,64,21,4,9,184,479
749,64,4,3,7,6,43,-67,7,2,227,412
749,65,5,2,8,5,-47,23,0,5,180,435
749,66,3,3,7,6,34,33,4,8,214,468
749,67,4,2,8,5,44,-77,8,1,258,391
749,68,4,3,7,6,-57,33,1,4,201,424
749,69,2,4,3,10,21,-54,2,0,222,370
749,70,3,4,7,6,34,42,6,2,256,412
749,71,5,2,7,6,52,24,8,6,308,436
749,72,3,3,7,6,-66,33,2,9,242,469
749,73,3,4,7,6,34,-58,6,1,276,411
749,74,4,3,5,8,41,35,7,6,317,446
749,75,3,4,5,8,32,-56,9,0,349,390
749,76,2,5,3,10,-79,55,0,5,270,445
749,77,4,2,10,3,46,21,6,6,316,466
749,78,4,3,7,6,43,33,9,9,359,499
749,79,3,3,5,8,-68,-65,1,4,291,434
749,80,6,2,9,4,63,22,4,6,354,456
749,81,4,2,8,5,44,23,8,9,398,479
749,82,3,3,9,4,-64,-69,4,0,334,410
749,83,3,4,8,5,35,41,9,1,369,451
749,84,3,4,5,8,-68,44,1,5,301,495
749,85,5,2,9,4,54,22,5,7,355,517
750,1,3,4,5,8,32,44,2,4,32,44
750,2,3,3,6,7,33,34,5,8,65,78
750,3,2,4,6,7,24,-57,9,1,89,21
750,4,3,3,7,6,-66,33,3,4,23,54
750,5,4,3,5,8,41,35,4,9,64,89
750,6,2,4,6,7,24,-57,8,2,88,32
750,7,2,5,5,8,-77,53,1,5,11,85
750,8,4,2,10,3,46,21,7,6,57,106
750,9,2,5,4,9,22,-46,9,0,79,60
750,10,3,3,7,6,-66,33,3,3,13,93
750,11,3,3,7,6,34,33,7,6,47,126
750,12,3,4,4,9,31,-55,8,1,78,71
750,13,4,2,8,5,-56,23,2,4,22,94
750,14,3,3,4,9,31,-64,3,0,53,30
750,15,2,5,2,11,20,56,3,6,73,86
750,16,3,4,8,5,35,41,8,7,108,127
750,17,3,3,8,5,-65,32,3,9,43,159
750,18,5,2,6,7,51,-75,4,4,94,84
750,19,3,3,5,8,32,35,6,9,126,119
750,20,3,4,6,7,33,-57,9,2,159,62
750,21,5,2,10,3,-45,21,4,3,114,83
750,22,3,3,6,7,33,34,7,7,147,117
750,23,3,3,8,5,-65,32,2,9,82,149
750,24,4,3,6,7,42,-66,4,3,124,83
750,25,2,4,4,9,22,45,6,8,146,128
750,26,3,3,7,6,-66,-67,0,1,80,61
750,27,4,3,6,7,42,34,2,5,122,95
750,28,4,2,7,6,43,24,5,9,165,119
750,29,2,4,4,9,22,-55,7,4,187,64
750,30,3,3,7,6,-66,33,1,7,121,97
750,31,3,4,4,9,31,-55,2,2,152,42
750,32,2,4,6,7,24,43,6,5,176,85
750,33,4,3,8,5,-56,32,0,7,120,117
750,34,4,2,9,4,45,22,5,9,165,139
750,35,3,3,9,4,-64,-69,1,0,101,70
750,36,4,3,5,8,41,35,2,5,142,105
750,37,5,2,9,4,54,22,6,7,196,127
750,38,2,4,5,8,23,-56,9,1,219,71
750,39,4,4,4,9,40,45,9,6,259,116
750,40,4,3,7,6,-57,33,2,9,202,149
750,41,5,2,8,5,53,-77,5,2,255,72
750,42,3,3,6,7,33,34,8,6,288,106
750,43,4,3,7,6,-57,33,1,9,231,139
750,44,2,5,5,8,23,-47,4,2,254,92
750,45,2,4,4,9,22,45,6,7,276,137
750,46,2,6,3,10,21,-36,7,1,297,101
750,47,5,2,8,5,-47,23,0,4,250,124
750,48,4,3,10,3,46,30,6,4,296,154
750,49,3,3,6,7,33,34,9,8,329,188
750,50,2,4,5,8,-77,-56,2,2,252,132
750,51,3,3,7,6,34,33,6,5,286,165
750,52,4,2,8,5,-56,23,0,8,230,188
750,53,4,3,9,4,45,31,5,9,275,219
750,54,2,4,5,8,23,-56,8,3,298,163
750,55,2,4,4,9,-78,45,0,8,220,208
750,56,2,6,4,9,22,-37,2,1,242,171
750,57,4,3,5,8,41,35,3,6,283,206
750,58,5,2,7,6,52,-76,5,0,335,130
750,59,4,3,9,4,-55,31,0,1,280,161
750,60,3,4,3,10,30,46,0,7,310,207
750,61,4,3,7,6,43,-67,3,0,353,140
750,62,4,3,9,4,45,31,8,1,398,171
750,63,2,4,4,9,-78,45,0,6,320,216
750,64,2,4,6,7,24,43,4,9,344,259
750,65,3,3,5,8,32,-65,6,4,376,194
750,66,2,4,4,9,22,45,8,9,398,239
750,67,3,4,5,8,-68,-56,0,3,330,183
750,68,2,4,3,10,21,46,1,9,351,229
750,69,3,3,6,7,33,-66,4,3,384,163
750,70,3,4,4,9,31,45,5,8,415,208
750,71,2,6,3,10,21,-36,6,2,436,172
750,72,3,4,5,8,32,44,8,6,468,216
750,73,3,3,9,4,-64,31,4,7,404,247
750,74,3,3,7,6,34,-67,8,0,438,180
750,75,5,2,8,5,-47,23,1,3,391,203
750,76,4,3,8,5,44,32,5,5,435,235
750,77,5,3,8,5,53,32,8,7,488,267
750,78,4,3,8,5,-56,32,2,9,432,299
750,79,3,3,6,7,33,-66,5,3,465,233
750,80,3,4,5,8,32,44,7,7,497,277
750,81,3,4,5,8,32,-56,9,1,529,221
751,1,5,2,8,5,53,23,3,3,53,23
751,2,4,3,7,6,43,33,6,6,96,56
751,3,3,4,3,10,30,-54,6,2,126,2
751,4,3,3,6,7,33,34,9,6,159,36
751,5,3,3,7,6,-66,33,3,9,93,69
751,6,3,3,7,6,34,-67,7,2,127,2
751,7,2,4,2,11,20,47,7,9,147,49
751,8,3,4,7,6,-66,-58,1,1,81,-9
751,9,5,2,11,2,56,20,7,1,137,11
751,10,3,3,5,8,32,35,9,6,169,46
751,11,3,3,8,5,-65,32,4,8,104,78
751,12,4,3,8,5,44,-68,8,0,148,10
751,13,4,3,8,5,-56,32,2,2,92,42
751,14,3,3,6,7,33,34,5,6,125,76
751,15,5,2,10,3,-45,21,0,7,80,97
751,16,4,3,7,6,43,-67,3,0,123,30
751,17,2,4,5,8,23,44,6,4,146,74
751,18,4,2,11,2,-53,20,3,4,93,94
751,19,4,2,11,2,-53,20,0,4,40,114
751,20,3,3,5,8,32,35,2,9,72,149
751,21,2,5,3,10,21,-45,3,4,93,104
751,22,3,3,6,7,33,34,6,8,126,138
751,23,2,5,4,9,22,-46,8,2,148,92
751,24,4,3,5,8,41,35,9,7,189,127
751,25,4,3,9,4,-55,31,4,8,134,158
751,26,4,2,9,4,45,-78,9,0,179,80
751,27,4,2,10,3,-54,21,5,1,125,101
751,28,5,2,8,5,53,23,8,4,178,124
751,29,3,4,8,5,-65,41,3,5,113,165
751,30,3,3,5,8,32,-65,5,0,145,100
751,31,3,3,8,5,-65,32,0,2,80,132
751,32,3,4,7,6,34,42,4,4,114,174
751,33,4,3,8,5,44,32,8,6,158,206
751,34,4,2,6,7,-58,-75,0,1,100,131
751,35,3,3,7,6,34,33,4,4,134,164
751,36,3,3,7,6,34,33,8,7,168,197
751,37,5,2,11,2,-44,20,4,7,124,217
751,38,2,5,2,11,20,-44,4,3,144,173
751,39,5,2,10,3,55,21,9,4,199,194
751,40,4,3,5,8,-59,35,0,9,140,229
751,41,4,3,8,5,44,-68,4,1,184,161
751,42,4,3,7,6,43,33,7,4,227,194
751,43,6,2,7,6,61,24,8,8,288,218
751,44,3,3,9,4,-64,31,4,9,224,249
751,45,2,5,4,9,22,-46,6,3,246,203
751,46,2,5,4,9,22,54,8,7,268,257
751,47,3,3,6,7,-67,-66,1,1,201,191
751,48,5,2,9,4,54,22,5,3,255,213
751,49,2,5,5,8,23,53,8,6,278,266
751,50,4,3,9,4,-55,31,3,7,223,297
751,51,2,5,2,11,20,-44,3,3,243,253
751,52,4,3,7,6,43,33,6,6,286,286
751,53,3,3,10,3,-63,30,3,6,223,316
751,54,3,3,8,5,35,32,8,8,258,348
751,55,3,3,6,7,-67,-66,1,2,191,282
751,56,3,4,5,8,32,44,3,6,223,326
751,57,2,4,5,8,23,-56,6,0,246,270
751,58,2,5,4,9,22,54,8,4,268,324
751,59,3,4,6,7,-67,43,1,7,201,367
751,60,6,2,9,4,63,22,4,9,264,389
751,61,2,4,3,10,21,-54,5,5,285,335
751,62,3,4,6,7,33,43,8,8,318,378
751,63,4,2,7,6,-57,-76,1,2,261,302
751,64,5,2,10,3,55,21,6,3,316,323
751,65,2,4,4,9,22,45,8,8,338,368
751,66,4,3,6,7,-58,-66,0,2,280,302
751,67,4,3,8,5,44,32,4,4,324,334
751,68,2,5,3,10,21,55,5,9,345,389
751,69,3,3,5,8,32,-65,7,4,377,324
751,70,4,2,7,6,-57,24,0,8,320,348
751,71,2,6,6,7,24,61,4,9,344,409
751,72,2,4,5,8,23,-56,7,3,367,353
751,73,3,4,8,5,-65,41,2,4,302,394
751,74,4,2,8,5,44,23,6,7,346,417
751,75,3,4,8,5,-65,41,1,8,281,458
751,76,3,3,8,5,35,-68,6,0,316,390
751,77,2,4,7,6,-75,42,1,2,241,432
751,78,3,3,6,7,33,34,4,6,274,466
751,79,6,2,9,4,63,22,7,8,337,488
751,80,2,4,7,6,-75,-58,2,0,262,430
751,81,4,3,7,6,43,33,5,3,305,463
751,82,4,2,6,7,42,25,7,8,347,488
751,83,3,3,4,9,31,-64,8,4,378,424
751,84,2,5,3,10,21,55,9,9,399,479
751,85,3,4,5,8,-68,-56,1,3,331,423
751,86,5,2,9,4,54,22,5,5,385,445
751,87,3,3,5,8,32,-65,7,0,417,380
751,88,2,4,4,9,22,45,9,5,439,425
751,89,4,2,8,5,-56,23,3,8,383,448
751,90,2,5,3,10,21,-45,4,3,404,403
751,91,2,5,3,10,21,55,5,8,425,458
751,92,3,3,4,9,31,-64,6,4,456,394
751,93,2,4,6,7,-76,43,0,7,380,437
751,94,3,3,7,6,34,-67,4,0,414,370
751,95,5,2,9,4,54,22,8,2,468,392
751,96,4,4,9,4,-55,40,3,2,413,432
751,97,4,4,7,6,43,42,6,4,456,474
751,98,4,3,7,6,43,33,9,7,499,507
752,1,3,4,7,6,34,42,4,2,34,42
752,2,2,4,4,9,22,45,6,7,56,87
752,3,3,4,6,7,33,-57,9,0,89,30
752,4,3,3,5,8,-68,35,1,5,21,65
752,5,4,3,9,4,45,31,6,6,66,96
752,6,2,5,4,9,22,-46,8,0,88,50
752,7,3,4,7,6,-66,42,2,2,22,92
752,8,2,4,4,9,22,45,4,7,44,137
752,9,4,3,8,5,44,32,8,9,88,169
752,10,2,5,5,8,-77,-47,1,2,11,122
752,11,5,2,6,7,51,25,2,7,62,147
752,12,4,3,8,5,44,32,6,9,106,179
752,13,3,4,6,7,33,-57,9,2,139,122
752,14,5,2,10,3,-45,21,4,3,94,143
752,15,3,4,4,9,31,45,5,8,125,188
752,16,4,2,11,2,-53,20,2,8,72,208
752,17,5,2,9,4,54,-78,6,0,126,130
752,18,4,3,6,7,42,34,8,4,168,164
752,19,4,2,11,2,-53,20,5,4,115,184
752,20,3,3,6,7,33,34,8,8,148,218
752,21,3,3,9,4,-64,31,4,9,84,249
752,22,3,4,6,7,33,-57,7,2,117,192
752,23,4,2,10,3,-54,21,3,3,63,213
752,24,3,5,5,8,32,53,5,6,95,266
752,25,3,3,4,9,31,-64,6,2,126,202
752,26,4,3,6,7,42,34,8,6,168,236
752,27,4,4,5,8,41,-56,9,0,209,180
752,28,3,4,6,7,-67,43,2,3,142,223
752,29,2,4,7,6,25,42,7,5,167,265
752,30,3,4,5,8,32,44,9,9,199,309
752,31,4,3,9,4,-55,-69,4,0,144,240
752,32,5,2,10,3,55,21,9,1,199,261
752,33,5,2,7,6,-48,24,1,5,151,285
752,34,2,5,6,7,24,52,5,7,175,337
752,35,5,2,7,6,52,-76,7,1,227,261
752,36,4,3,7,6,-57,33,0,4,170,294
752,37,5,2,6,7,51,25,1,9,221,319
752,38,4,2,9,4,45,-78,6,1,266,241
752,39,5,2,9,4,-46,22,0,3,220,263
752,40,2,4,7,6,25,42,5,5,245,305
752,41,4,2,7,6,43,24,8,9,288,329
752,42,4,3,8,5,-56,-68,2,1,232,261
752,43,2,5,4,9,22,54,4,5,254,315
752,44,3,4,6,7,33,43,7,8,287,358
752,45,4,2,6,7,42,-75,9,3,329,283
752,46,3,4,7,6,-66,42,3,5,263,325
752,47,5,2,10,3,55,21,8,6,318,346
752,48,4,3,9,4,-55,31,3,7,263,377
752,49,4,3,8,5,44,32,7,9,307,409
752,50,4,2,7,6,-57,-76,0,3,250,333
752,51,2,4,6,7,24,43,4,6,274,376
752,52,2,5,7,6,25,51,9,7,299,427
752,53,2,6,3,10,-79,-36,0,1,220,391
752,54,5,2,8,5,53,23,3,4,273,414
752,55,3,4,7,6,34,42,7,6,307,456
752,56,2,6,5,8,-77,62,0,8,230,518
753,1,4,2,8,5,44,23,4,3,44,23
753,2,2,4,6,7,24,43,8,6,68,66
753,3,4,3,7,6,-57,33,1,9,11,99
753,4,4,3,6,7,42,-66,3,3,53,33
753,5,3,3,5,8,32,35,5,8,85,68
753,6,2,4,4,9,22,-55,7,3,107,13
753,7,4,4,5,8,41,44,8,7,148,57
753,8,3,4,4,9,31,-55,9,2,179,2
753,9,4,3,5,8,-59,35,0,7,120,37
753,10,4,2,9,4,45,22,5,9,165,59
753,11,3,4,9,4,-64,40,1,9,101,99
753,12,2,5,4,9,22,-46,3,3,123,53
753,13,3,3,6,7,33,34,6,7,156,87
753,14,3,5,4,9,31,-46,7,1,187,41
753,15,2,5,4,9,22,54,9,5,209,95
753,16,5,2,8,5,-47,23,2,8,162,118
753,17,2,5,2,11,20,-44,2,4,182,74
753,18,2,6,3,10,21,64,3,8,203,138
753,19,2,4,5,8,23,-56,6,2,226,82
753,20,3,4,4,9,31,45,7,7,257,127
753,21,2,5,3,10,21,-45,8,2,278,82
753,22,2,5,3,10,21,55,9,7,299,137
753,23,2,4,8,5,-74,41,5,8,225,178
753,24,3,3,6,7,33,-66,8,2,258,112
753,25,3,3,8,5,-65,32,3,4,193,144
753,26,2,5,6,7,24,52,7,6,217,196
753,27,4,2,7,6,-57,-76,0,0,160,120
753,28,4,2,6,7,42,25,2,5,202,145
753,29,2,5,5,8,23,53,5,8,225,198
753,30,3,4,5,8,32,-56,7,2,257,142
753,31,3,3,9,4,-64,31,3,3,193,173
753,32,5,2,7,6,52,24,5,7,245,197
753,33,3,4,6,7,33,-57,8,0,278,140
753,34,3,4,5,8,-68,44,0,4,210,184
753,35,4,3,6,7,42,34,2,8,252,218
753,36,2,4,7,6,25,-58,7,0,277,160
753,37,5,2,9,4,-46,22,1,2,231,182
753,38,3,4,6,7,33,43,4,5,264,225
753,39,4,3,7,6,43,33,7,8,307,258
753,40,3,3,6,7,-67,-66,0,2,240,192
753,41,3,3,8,5,35,32,5,4,275,224
753,42,3,4,7,6,34,42,9,6,309,266
753,43,2,5,5,8,-77,53,2,9,232,319
753,44,6,2,10,3,64,-79,6,0,296,240
753,45,3,4,7,6,-66,42,0,2,230,282
753,46,3,4,6,7,33,43,3,5,263,325
753,47,3,3,6,7,33,34,6,9,296,359
753,48,2,4,8,5,-74,-59,2,0,222,300
753,49,4,3,7,6,43,33,5,3,265,333
753,50,4,3,9,4,-55,31,0,4,210,364
753,51,3,4,9,4,36,40,6,4,246,404
753,52,3,4,8,5,-65,41,1,5,181,445
753,53,3,3,7,6,34,33,5,8,215,478
753,54,3,4,6,7,33,-57,8,1,248,421
753,55,6,2,11,2,-35,20,3,1,213,441
753,56,3,4,9,4,36,40,9,1,249,481
753,57,4,3,5,8,-59,35,0,6,190,516
754,1,3,3,6,7,33,34,3,4,33,34
754,2,4,2,9,4,45,22,8,6,78,56
754,3,4,3,7,6,-57,33,1,9,21,89
754,4,5,2,11,2,56,20,7,9,77,109
754,5,2,5,4,9,22,-46,9,3,99,63
754,6,5,3,6,7,-49,34,0,7,50,97
754,7,3,4,6,7,33,-57,3,0,83,40
754,8,3,3,7,6,34,33,7,3,117,73
754,9,4,3,6,7,42,34,9,7,159,107
754,10,3,3,7,6,-66,-67,3,0,93,40
754,11,3,4,7,6,34,42,7,2,127,82
754,12,2,4,4,9,22,45,9,7,149,127
754,13,2,5,4,9,-78,-46,1,1,71,81
754,14,2,6,2,11,20,65,1,6,91,146
754,15,3,3,5,8,32,-65,3,1,123,81
754,16,2,4,5,8,23,44,6,5,146,125
754,17,4,3,10,3,-54,30,2,5,92,155
754,18,2,4,4,9,22,-55,4,0,114,100
754,19,3,3,5,8,32,35,6,5,146,135
754,20,2,5,3,10,21,-45,7,0,167,90
754,21,5,3,6,7,51,34,8,4,218,124
754,22,4,3,8,5,-56,32,2,6,162,156
754,23,2,4,7,6,25,42,7,8,187,198
754,24,3,4,4,9,31,-55,8,3,218,143
754,25,4,2,8,5,-56,23,2,6,162,166
754,26,3,3,4,9,31,-64,3,2,193,102
754,27,3,4,8,5,35,41,8,3,228,143
754,28,3,3,5,8,-68,35,0,8,160,178
754,29,3,5,4,9,31,-46,1,2,191,132
754,30,3,3,9,4,36,31,7,3,227,163
754,31,3,3,6,7,-67,34,0,7,160,197
754,32,3,3,8,5,35,32,5,9,195,229
754,33,4,3,4,9,40,-64,5,5,235,165
754,34,2,4,3,10,21,-54,6,1,256,111
754,35,2,5,2,11,20,56,6,7,276,167
754,36,3,4,6,7,33,-57,9,0,309,110
754,37,2,4,4,9,-78,45,1,5,231,155
754,38,5,2,8,5,53,23,4,8,284,178
754,39,4,2,9,4,45,-78,9,0,329,100
754,40,2,6,4,9,-78,63,1,3,251,163
754,41,3,3,9,4,36,31,7,4,287,194
754,42,3,4,7,6,-66,42,1,6,221,236
754,43,4,2,6,7,42,-75,3,1,263,161
754,44,3,3,5,8,32,35,5,6,295,196
754,45,2,5,3,10,21,-45,6,1,316,151
754,46,3,4,6,7,33,43,9,4,349,194
754,47,3,4,3,10,30,-54,9,0,379,140
754,48,4,2,9,4,-55,22,4,2,324,162
754,49,6,2,11,2,65,20,9,2,389,182
754,50,3,3,4,9,-69,36,0,8,320,218
754,51,2,4,5,8,23,-56,3,2,343,162
754,52,4,2,8,5,44,23,7,5,387,185
754,53,3,4,5,8,32,44,9,9,419,229
754,54,3,5,5,8,-68,-47,1,2,351,182
754,55,4,2,7,6,43,24,4,6,394,206
754,56,2,5,4,9,22,-46,6,0,416,160
754,57,4,3,6,7,42,34,8,4,458,194
754,58,3,5,6,7,-67,52,1,6,391,246
754,59,5,2,10,3,55,21,6,7,446,267
754,60,5,2,7,6,52,-76,8,1,498,191
754,61,4,3,4,9,40,36,8,7,538,227
755,1,2,4,3,10,21,46,1,6,21,46
755,2,3,3,6,7,33,-66,4,0,54,-20
755,3,3,3,5,8,32,35,6,5,86,15
755,4,2,4,5,8,23,44,9,9,109,59
755,5,4,2,7,6,-57,-76,2,3,52,-17
755,6,4,3,9,4,45,31,7,4,97,14
755,7,3,3,6,7,-67,34,0,8,30,48
755,8,3,4,4,9,31,-55,1,3,61,-7
755,9,2,5,4,9,22,54,3,7,83,47
755,10,3,3,6,7,33,-66,6,1,116,-19
755,11,4,2,7,6,43,24,9,5,159,5
755,12,4,2,9,4,-55,22,4,7,104,27
755,13,2,4,6,7,24,-57,8,0,128,-30
755,14,2,4,6,7,-76,43,2,3,52,13
755,15,4,3,5,8,41,35,3,8,93,48
755,16,3,3,5,8,32,-65,5,3,125,-17
755,17,3,4,3,10,30,46,5,9,155,29
755,18,3,3,5,8,32,-65,7,4,187,-36
755,19,3,3,6,7,-67,34,0,8,120,-2
755,20,4,3,8,5,44,-68,4,0,164,-70
755,21,4,2,6,7,42,25,6,5,206,-45
755,22,3,3,8,5,-65,32,1,7,141,-13
755,23,3,3,9,4,36,31,7,8,177,18
755,24,4,3,7,6,-57,-67,0,1,120,-49
755,25,4,3,6,7,42,34,2,5,162,-15
755,26,4,3,7,6,43,33,5,8,205,18
755,27,2,4,3,10,21,-54,6,4,226,-36
755,28,4,3,8,5,-56,32,0,6,170,-4
755,29,5,2,9,4,54,22,4,8,224,18
755,30,4,3,7,6,43,-67,7,1,267,-49
755,31,4,3,6,7,42,34,9,5,309,-15
755,32,4,2,10,3,-54,21,5,6,255,6
755,33,2,5,4,9,22,-46,7,0,277,-40
755,34,3,4,9,4,-64,40,3,0,213,0
755,35,3,3,3,10,30,37,3,7,243,37
755,36,3,4,5,8,32,-56,5,1,275,-19
755,37,4,3,7,6,43,33,8,4,318,14
755,38,5,2,9,4,-46,22,2,6,272,36
755,39,4,3,10,3,46,30,8,6,318,66
755,40,3,4,6,7,-67,43,1,9,251,109
755,41,2,5,4,9,22,-46,3,3,273,63
755,42,5,2,11,2,56,20,9,3,329,83
755,43,3,4,6,7,-67,43,2,6,262,126
755,44,4,3,8,5,44,32,6,8,306,158
755,45,4,2,9,4,-55,-78,1,0,251,80
755,46,4,4,5,8,41,44,2,4,292,124
755,47,4,2,8,5,44,23,6,7,336,147
755,48,5,2,10,3,-45,21,1,8,291,168
755,49,3,3,6,7,33,-66,4,2,324,102
755,50,2,4,5,8,23,44,7,6,347,146
755,51,3,4,3,10,30,-54,7,2,377,92
755,52,3,4,5,8,32,44,9,6,409,136
755,53,3,4,6,7,-67,43,2,9,342,179
755,54,5,2,9,4,54,-78,6,1,396,101
755,55,3,4,7,6,-66,42,0,3,330,143
755,56,4,3,9,4,45,31,5,4,375,174
755,57,2,5,7,6,-75,51,0,5,300,225
755,58,4,2,7,6,43,24,3,9,343,249
755,59,6,2,11,2,65,20,8,9,408,269
755,60,3,4,6,7,-67,-57,1,2,341,212
755,61,4,2,7,6,43,24,4,6,384,236
755,62,3,3,8,5,35,32,9,8,419,268
755,63,4,3,7,6,-57,-67,2,1,362,201
755,64,3,3,7,6,34,33,6,4,396,234
755,65,4,2,11,2,-53,20,3,4,343,254
755,66,3,3,7,6,34,33,7,7,377,287
755,67,3,4,5,8,32,-56,9,1,409,231
755,68,4,3,4,9,40,36,9,7,449,267
755,69,6,2,9,4,-37,22,2,9,412,289
755,70,4,3,5,8,41,-65,3,4,453,224
755,71,4,2,7,6,43,24,6,8,496,248
755,72,3,3,9,4,-64,31,2,9,432,279
755,73,3,4,4,9,31,-55,3,4,463,224
755,74,5,2,10,3,55,21,8,5,518,245
756,1,5,2,7,6,52,24,2,4,52,24
756,2,4,3,5,8,41,35,3,9,93,59
756,3,3,3,6,7,33,-66,6,3,126,-7
756,4,4,3,8,5,-56,32,0,5,70,25
756,5,3,4,7,6,34,42,4,7,104,67
756,6,4,3,10,3,-54,30,0,7,50,97
756,7,2,4,5,8,23,-56,3,1,73,41
756,8,6,2,9,4,63,22,6,3,136,63
756,9,3,4,8,5,-65,41,1,4,71,104
756,10,2,4,2,11,20,-53,1,1,91,51
756,11,3,4,6,7,33,43,4,4,124,94
756,12,4,3,7,6,43,33,7,7,167,127
756,13,3,4,7,6,-66,42,1,9,101,169
756,14,3,3,6,7,33,-66,4,3,134,103
756,15,3,3,9,4,-64,31,0,4,70,134
756,16,4,3,8,5,44,32,4,6,114,166
756,17,2,4,5,8,23,-56,7,0,137,110
756,18,4,3,8,5,-56,32,1,2,81,142
756,19,2,5,3,10,21,55,2,7,102,197
756,20,3,3,9,4,36,31,8,8,138,228
756,21,4,2,9,4,-55,-78,3,0,83,150
756,22,2,4,8,5,26,41,9,1,109,191
756,23,3,3,5,8,-68,35,1,6,41,226
756,24,5,2,8,5,53,23,4,9,94,249
756,25,3,5,5,8,32,-47,6,2,126,202
756,26,5,2,11,2,-44,20,2,2,82,222
756,27,5,2,10,3,55,21,7,3,137,243
756,28,2,5,6,7,-76,52,1,5,61,295
756,29,2,6,2,11,20,-35,1,0,81,260
756,30,4,3,6,7,42,34,3,4,123,294
756,31,5,2,9,4,54,22,7,6,177,316
756,32,3,3,6,7,-67,-66,0,0,110,250
756,33,2,4,5,8,23,44,3,4,133,294
756,34,5,2,6,7,51,25,4,9,184,319
756,35,3,4,4,9,31,-55,5,4,215,264
756,36,4,3,8,5,44,32,9,6,259,296
756,37,4,2,9,4,-55,22,4,8,204,318
756,38,2,4,7,6,25,-58,9,0,229,260
756,39,2,4,7,6,-75,42,4,2,154,302
756,40,5,2,10,3,55,21,9,3,209,323
756,41,2,4,5,8,-77,44,2,7,132,367
756,42,3,3,7,6,34,-67,6,0,166,300
756,43,4,3,6,7,42,34,8,4,208,334
756,44,3,3,7,6,-66,33,2,7,142,367
756,45,2,4,3,10,21,-54,3,3,163,313
756,46,3,4,4,9,31,45,4,8,194,358
756,47,3,5,4,9,31,-46,5,2,225,312
756,48,3,3,6,7,33,34,8,6,258,346
756,49,3,3,7,6,-66,33,2,9,192,379
756,50,4,3,5,8,41,-65,3,4,233,314
756,51,4,3,7,6,43,33,6,7,276,347
756,52,4,3,9,4,-55,31,1,8,221,378
756,53,3,4,5,8,32,-56,3,2,253,322
756,54,4,3,7,6,43,33,6,5,296,355
756,55,5,2,9,4,-46,22,0,7,250,377
756,56,3,3,9,4,36,31,6,8,286,408
756,57,3,4,7,6,-66,-58,0,0,220,350
756,58,3,4,5,8,32,44,2,4,252,394
756,59,2,4,5,8,23,44,5,8,275,438
756,60,3,3,4,9,31,-64,6,4,306,374
756,61,4,3,5,8,41,35,7,9,347,409
756,62,3,4,7,6,-66,-58,1,1,281,351
756,63,3,4,7,6,34,42,5,3,315,393
756,64,3,5,3,10,30,55,5,8,345,448
756,65,4,2,10,3,-54,21,1,9,291,469
756,66,2,4,5,8,23,-56,4,3,314,413
756,67,4,3,7,6,43,33,7,6,357,446
756,68,3,3,7,6,-66,33,1,9,291,479
756,69,3,3,5,8,32,-65,3,4,323,414
756,70,3,3,6,7,33,34,6,8,356,448
756,71,2,4,4,9,22,-55,8,3,378,393
756,72,2,5,4,9,-78,54,0,7,300,447
756,73,3,4,6,7,33,-57,3,0,333,390
756,74,3,3,6,7,33,34,6,4,366,424
756,75,3,3,4,9,31,-64,7,0,397,360
756,76,5,3,9,4,-46,31,1,1,351,391
756,77,2,5,4,9,22,54,3,5,373,445
756,78,3,4,4,9,31,-55,4,0,404,390
756,79,3,4,7,6,34,42,8,2,438,432
756,80,3,3,7,6,-66,33,2,5,372,465
756,81,3,3,8,5,35,32,7,7,407,497
756,82,2,5,3,10,21,-45,8,2,428,452
756,83,2,5,3,10,21,55,9,7,449,507
757,1,3,4,5,8,32,44,2,4,32,44
757,2,5,2,8,5,53,23,5,7,85,67
757,3,3,3,6,7,33,-66,8,1,118,1
757,4,2,5,5,8,-77,53,1,4,41,54
757,5,2,5,2,11,20,-44,1,0,61,10
757,6,2,4,5,8,23,44,4,4,84,54
757,7,2,4,5,8,23,44,7,8,107,98
757,8,2,5,5,8,-77,-47,0,1,30,51
757,9,3,3,4,9,31,36,1,7,61,87
757,10,2,4,3,10,21,-54,2,3,82,33
757,11,3,4,7,6,34,42,6,5,116,75
757,12,3,4,7,6,-66,42,0,7,50,117
757,13,4,2,9,4,45,22,5,9,95,139
757,14,4,3,8,5,44,-68,9,1,139,71
757,15,5,2,8,5,-47,23,2,4,92,94
757,16,3,4,4,9,31,45,3,9,123,139
757,17,2,5,6,7,24,-48,7,1,147,91
757,18,3,3,8,5,-65,32,2,3,82,123
757,19,2,6,3,10,21,64,3,7,103,187
757,20,2,4,5,8,23,-56,6,1,126,131
757,21,5,2,6,7,51,25,7,6,177,156
757,22,2,4,7,6,-75,42,2,8,102,198
757,23,2,4,4,9,22,-55,4,3,124,143
757,24,4,3,6,7,42,34,6,7,166,177
757,25,2,4,4,9,22,-55,8,2,188,122
757,26,3,4,5,8,-68,44,0,6,120,166
757,27,3,3,8,5,35,32,5,8,155,198
757,28,4,2,7,6,43,-76,8,2,198,122
757,29,4,2,8,5,-56,23,2,5,142,145
757,30,4,3,7,6,43,33,5,8,185,178
757,31,4,3,8,5,44,-68,9,0,229,110
757,32,5,3,7,6,-48,33,1,3,181,143
757,33,4,2,7,6,43,24,4,7,224,167
757,34,2,4,7,6,25,42,9,9,249,209
757,35,3,4,8,5,-65,-59,4,0,184,150
757,36,4,2,7,6,43,24,7,4,227,174
757,37,3,4,6,7,-67,43,0,7,160,217
757,38,4,2,7,6,43,-76,3,1,203,141
757,39,2,5,4,9,22,54,5,5,225,195
757,40,4,3,8,5,44,32,9,7,269,227
757,41,3,4,7,6,-66,42,3,9,203,269
757,42,4,2,5,8,41,-74,4,5,244,195
757,43,3,3,8,5,35,32,9,7,279,227
757,44,4,2,9,4,-55,22,4,9,224,249
757,45,3,3,10,3,-63,30,1,9,161,279
757,46,4,2,7,6,43,-76,4,3,204,203
757,47,3,3,7,6,34,33,8,6,238,236
757,48,4,3,7,6,-57,33,1,9,181,269
757,49,3,3,7,6,34,-67,5,2,215,202
757,50,2,4,5,8,23,44,8,6,238,246
757,51,5,2,9,4,-46,22,2,8,192,268
757,52,4,2,8,5,44,-77,6,1,236,191
757,53,3,4,6,7,33,43,9,4,269,234
757,54,3,4,9,4,-64,40,5,4,205,274
757,55,3,3,4,9,31,-64,6,0,236,210
757,56,2,4,7,6,-75,42,1,2,161,252
757,57,5,2,9,4,54,22,5,4,215,274
757,58,2,4,5,8,23,44,8,8,238,318
757,59,3,4,4,9,31,-55,9,3,269,263
757,60,3,4,6,7,-67,43,2,6,202,306
757,61,3,3,4,9,31,-64,3,2,233,242
757,62,4,3,8,5,44,32,7,4,277,274
757,63,2,5,4,9,22,54,9,8,299,328
757,64,4,2,6,7,-58,-75,1,3,241,253
757,65,4,3,9,4,45,31,6,4,286,284
757,66,4,2,9,4,-55,22,1,6,231,306
757,67,4,3,8,5,44,32,5,8,275,338
757,68,3,3,4,9,31,-64,6,4,306,274
757,69,2,5,6,7,-76,52,0,6,230,326
757,70,3,3,5,8,32,-65,2,1,262,261
757,71,2,5,4,9,22,54,4,5,284,315
757,72,4,2,8,5,44,23,8,8,328,338
757,73,3,4,7,6,-66,-58,2,0,262,280
757,74,2,5,6,7,24,52,6,2,286,332
757,75,4,2,8,5,-56,23,0,5,230,355
757,76,4,2,9,4,45,22,5,7,275,377
757,77,3,4,4,9,31,-55,6,2,306,322
757,78,2,4,4,9,22,45,8,7,328,367
757,79,3,4,6,7,-67,-57,1,0,261,310
757,80,3,4,4,9,31,45,2,5,292,355
757,81,4,3,6,7,42,34,4,9,334,389
757,82,3,3,7,6,34,-67,8,2,368,322
757,83,3,4,5,8,-68,44,0,6,300,366
757,84,3,3,6,7,33,-66,3,0,333,300
757,85,4,3,7,6,43,33,6,3,376,333
757,86,3,3,7,6,-66,33,0,6,310,366
757,87,5,2,8,5,53,23,3,9,363,389
757,88,4,4,5,8,41,-56,4,3,404,333
757,89,3,4,5,8,32,44,6,7,436,377
757,90,4,3,7,6,43,-67,9,0,479,310
757,91,3,3,8,5,-65,32,4,2,414,342
757,92,2,4,4,9,22,45,6,7,436,387
757,93,4,2,7,6,43,-76,9,1,479,311
757,94,2,4,3,10,-79,46,0,7,400,357
757,95,2,5,4,9,22,-46,2,1,422,311
757,96,4,2,8,5,44,23,6,4,466,334
757,97,6,2,10,3,-36,21,0,5,430,355
757,98,3,3,7,6,34,33,4,8,464,388
757,99,2,4,5,8,23,-56,7,2,487,332
757,100,4,2,7,6,-57,24,0,6,430,356
757,101,3,5,4,9,31,-46,1,0,461,310
757,102,2,4,6,7,24,43,5,3,485,353
757,103,3,3,5,8,32,35,7,8,517,388
758,1,2,4,5,8,23,44,3,4,23,44
758,2,2,5,8,5,26,50,9,4,49,94
758,3,2,5,3,10,-79,55,0,9,-30,149
758,4,3,3,8,5,35,-68,5,1,5,81
758,5,3,3,7,6,34,33,9,4,39,114
758,6,3,3,6,7,-67,34,2,8,-28,148
758,7,3,3,7,6,34,-67,6,1,6,81
758,8,4,2,5,8,41,26,7,7,47,107
758,9,3,3,5,8,32,-65,9,2,79,42
758,10,2,4,5,8,-77,44,2,6,2,86
758,11,3,4,4,9,31,-55,3,1,33,31
758,12,3,3,6,7,33,34,6,5,66,65
758,13,4,3,6,7,42,34,8,9,108,99
758,14,4,2,8,5,-56,-77,2,2,52,22
758,15,3,3,8,5,35,32,7,4,87,54
758,16,2,4,6,7,-76,43,1,7,11,97
758,17,3,3,8,5,35,32,6,9,46,129
758,18,3,4,7,6,-66,-58,0,1,-20,71
758,19,4,3,6,7,42,34,2,5,22,105
758,20,3,4,8,5,35,41,7,6,57,146
758,21,2,4,5,8,-77,-56,0,0,-20,90
758,22,2,5,3,10,21,55,1,5,1,145
758,23,4,3,6,7,42,34,3,9,43,179
758,24,2,5,4,9,22,-46,5,3,65,133
758,25,3,4,7,6,34,42,9,5,99,175
758,26,4,2,7,6,-57,24,2,9,42,199
758,27,2,4,6,7,24,-57,6,2,66,142
758,28,3,3,4,9,31,36,7,8,97,178
758,29,6,2,8,5,62,-77,9,1,159,101
758,30,3,4,5,8,-68,44,1,5,91,145
758,31,4,3,9,4,45,31,6,6,136,176
758,32,4,2,10,3,-54,21,2,7,82,197
758,33,3,3,7,6,34,-67,6,0,116,130
758,34,4,2,7,6,43,24,9,4,159,154
758,35,2,4,4,9,-78,45,1,9,81,199
758,36,3,4,7,6,34,-58,5,1,115,141
758,37,4,3,4,9,40,36,5,7,155,177
758,38,4,2,9,4,-55,22,0,9,100,199
758,39,4,2,8,5,44,-77,4,2,144,122
758,40,2,5,4,9,22,54,6,6,166,176
758,41,2,5,5,8,23,53,9,9,189,229
758,42,4,3,10,3,-54,30,5,9,135,259
758,43,5,2,10,3,-45,-79,0,0,90,180
758,44,4,2,9,4,45,22,5,2,135,202
758,45,4,3,7,6,43,33,8,5,178,235
758,46,3,3,7,6,-66,33,2,8,112,268
758,47,4,2,11,2,47,20,9,8,159,288
758,48,5,2,9,4,-46,-78,3,0,113,210
758,49,3,4,7,6,34,42,7,2,147,252
758,50,3,4,9,4,-64,40,3,2,83,292
758,51,4,2,6,7,42,25,5,7,125,317
758,52,3,4,4,9,31,-55,6,2,156,262
758,53,4,3,8,5,-56,32,0,4,100,294
758,54,4,2,6,7,42,25,2,9,142,319
758,55,3,4,3,10,30,-54,2,5,172,265
758,56,3,4,7,6,34,42,6,7,206,307
758,57,2,5,4,9,22,-46,8,1,228,261
758,58,3,4,8,5,-65,41,3,2,163,302
758,59,3,3,7,6,34,33,7,5,197,335
758,60,4,3,8,5,-56,32,1,7,141,367
758,61,3,4,4,9,31,-55,2,2,172,312
758,62,3,3,7,6,34,33,6,5,206,345
758,63,3,4,7,6,-66,42,0,7,140,387
758,64,3,3,8,5,35,32,5,9,175,419
758,65,2,5,5,8,23,-47,8,2,198,372
758,66,4,2,6,7,-58,25,0,7,140,397
758,67,2,4,3,10,21,-54,1,3,161,343
758,68,4,3,9,4,45,31,6,4,206,374
758,69,5,2,10,3,-45,21,1,5,161,395
758,70,2,4,7,6,25,42,6,7,186,437
758,71,3,4,4,9,31,-55,7,2,217,382
758,72,3,4,9,4,-64,40,3,2,153,422
758,73,3,4,8,5,35,41,8,3,188,463
758,74,3,3,7,6,-66,33,2,6,122,496
758,75,2,4,6,7,24,43,6,9,146,539
759,1,2,4,2,11,20,47,0,7,20,47
759,2,4,3,6,7,42,-66,2,1,62,-19
759,3,4,3,7,6,43,33,5,4,105,14
759,4,4,2,8,5,44,23,9,7,149,37
759,5,3,4,4,9,-69,-55,0,2,80,-18
759,6,2,5,4,9,22,54,2,6,102,36
759,7,3,4,5,8,32,-56,4,0,134,-20
759,8,2,4,6,7,24,43,8,3,158,23
759,9,3,3,7,6,-66,33,2,6,92,56
759,10,4,4,8,5,44,41,6,7,136,97
759,11,2,5,4,9,22,-46,8,1,158,51
759,12,3,4,8,5,-65,41,3,2,93,92
759,13,6,2,10,3,64,21,7,3,157,113
759,14,2,4,3,10,21,46,8,9,178,159
759,15,3,4,3,10,30,-54,8,5,208,105
759,16,3,3,5,8,-68,-65,0,0,140,40
759,17,3,3,7,6,34,33,4,3,174,73
759,18,3,4,6,7,33,43,7,6,207,116
759,19,3,3,3,10,30,-63,7,3,237,53
759,20,4,4,9,4,-55,40,2,3,182,93
759,21,3,3,8,5,35,32,7,5,217,125
759,22,4,2,9,4,-55,22,2,7,162,147
759,23,5,2,9,4,54,22,6,9,216,169
759,24,4,3,8,5,-56,-68,0,1,160,101
759,25,2,4,5,8,23,44,3,5,183,145
759,26,5,2,9,4,54,22,7,7,237,167
759,27,3,4,8,5,-65,41,2,8,172,208
759,28,5,2,11,2,56,20,8,8,228,228
759,29,4,2,8,5,-56,-77,2,1,172,151
759,30,3,3,7,6,34,33,6,4,206,184
759,31,4,2,9,4,-55,22,1,6,151,206
759,32,4,3,8,5,44,32,5,8,195,238
759,33,3,3,5,8,32,-65,7,3,227,173
759,34,4,3,5,8,41,35,8,8,268,208
759,35,2,4,6,7,-76,-57,2,1,192,151
759,36,4,3,6,7,42,34,4,5,234,185
759,37,3,5,3,10,30,-45,4,0,264,140
759,38,3,4,5,8,32,44,6,4,296,184
759,39,5,2,10,3,-45,21,1,5,251,205
759,40,3,3,5,8,32,-65,3,0,283,140
759,41,4,4,5,8,41,44,4,4,324,184
759,42,4,2,8,5,44,23,8,7,368,207
759,43,2,4,6,7,-76,-57,2,0,292,150
759,44,4,2,8,5,44,23,6,3,336,173
759,45,2,4,3,10,21,46,7,9,357,219
759,46,3,3,7,6,-66,-67,1,2,291,152
759,47,4,3,7,6,43,33,4,5,334,185
759,48,4,2,10,3,-54,21,0,6,280,206
759,49,3,4,8,5,35,41,5,7,315,247
759,50,4,3,7,6,43,-67,8,0,358,180
759,51,3,4,4,9,31,45,9,5,389,225
759,52,3,3,6,7,-67,34,2,9,322,259
759,53,4,3,8,5,44,-68,6,1,366,191
759,54,3,3,7,6,-66,33,0,4,300,224
759,55,4,2,8,5,44,23,4,7,344,247
759,56,2,4,5,8,23,-56,7,1,367,191
759,57,2,5,3,10,21,55,8,6,388,246
759,58,3,3,8,5,-65,32,3,8,323,278
759,59,2,5,5,8,23,-47,6,1,346,231
759,60,3,4,5,8,32,44,8,5,378,275
759,61,4,2,10,3,-54,21,4,6,324,296
759,62,4,3,9,4,45,31,9,7,369,327
759,63,3,3,7,6,-66,-67,3,0,303,260
759,64,4,3,8,5,44,32,7,2,347,292
759,65,4,2,9,4,-55,22,2,4,292,314
759,66,2,4,5,8,23,44,5,8,315,358
759,67,4,3,7,6,43,-67,8,1,358,291
759,68,3,4,5,8,-68,44,0,5,290,335
759,69,3,4,3,10,30,-54,0,1,320,281
759,70,4,4,7,6,43,42,3,3,363,323
759,71,2,5,7,6,25,51,8,4,388,374
759,72,3,4,7,6,-66,42,2,6,322,416
759,73,3,4,5,8,32,-56,4,0,354,360
759,74,3,3,5,8,32,35,6,5,386,395
759,75,2,5,3,10,21,-45,7,0,407,350
759,76,2,4,5,8,-77,44,0,4,330,394
759,77,5,3,6,7,51,34,1,8,381,428
759,78,3,4,5,8,32,-56,3,2,413,372
759,79,2,4,5,8,23,44,6,6,436,416
759,80,3,4,4,9,31,-55,7,1,467,361
759,81,2,4,4,9,22,45,9,6,489,406
759,82,5,2,8,5,-47,23,2,9,442,429
759,83,3,4,4,9,31,-55,3,4,473,374
759,84,5,2,8,5,53,23,6,7,526,397
760,1,5,3,9,4,54,31,4,1,54,31
760,2,3,4,5,8,32,44,6,5,86,75
760,3,4,3,8,5,-56,32,0,7,30,107
760,4,4,3,8,5,44,32,4,9,74,139
760,5,3,4,4,9,31,-55,5,4,105,84
760,6,4,3,8,5,44,32,9,6,149,116
760,7,4,3,9,4,-55,31,4,7,94,147
760,8,4,4,7,6,43,42,7,9,137,189
760,9,4,3,8,5,-56,-68,1,1,81,121
760,10,3,3,6,7,33,34,4,5,114,155
760,11,2,5,4,9,22,54,6,9,136,209
760,12,4,2,8,5,-56,-77,0,2,80,132
760,13,5,2,9,4,54,22,4,4,134,154
760,14,4,3,4,9,40,-64,4,0,174,90
760,15,4,3,7,6,43,33,7,3,217,123
760,16,4,2,8,5,-56,23,1,6,161,146
760,17,4,2,7,6,43,-76,4,0,204,70
760,18,2,4,8,5,-74,41,0,1,130,111
760,19,3,4,5,8,32,44,2,5,162,155
760,20,4,3,9,4,45,31,7,6,207,186
760,21,3,4,7,6,-66,42,1,8,141,228
760,22,3,4,6,7,33,-57,4,1,174,171
760,23,4,2,9,4,45,22,9,3,219,193
760,24,3,4,7,6,-66,42,3,5,153,235
760,25,4,3,6,7,42,34,5,9,195,269
760,26,2,5,4,9,22,-46,7,3,217,223
760,27,4,2,6,7,42,25,9,8,259,248
760,28,2,5,4,9,-78,-46,1,2,181,202
760,29,3,4,5,8,32,44,3,6,213,246
760,30,4,3,9,4,45,31,8,7,258,277
760,31,3,3,5,8,-68,-65,0,2,190,212
760,32,5,2,9,4,54,22,4,4,244,234
760,33,3,4,4,9,31,45,5,9,275,279
760,34,4,3,7,6,43,-67,8,2,318,212
760,35,3,3,5,8,-68,35,0,7,250,247
760,36,3,4,5,8,32,-56,2,1,282,191
760,37,4,3,7,6,43,33,5,4,325,224
760,38,5,2,8,5,53,23,8,7,378,247
760,39,3,3,8,5,-65,32,3,9,313,279
760,40,4,2,6,7,42,-75,5,4,355,204
760,41,3,4,6,7,33,43,8,7,388,247
760,42,3,4,6,7,-67,-57,1,0,321,190
760,43,2,4,4,9,22,45,3,5,343,235
760,44,4,2,7,6,43,24,6,9,386,259
760,45,4,3,7,6,43,-67,9,2,429,192
760,46,5,2,11,2,-44,20,5,2,385,212
760,47,2,4,6,7,24,43,9,5,409,255
760,48,4,2,7,6,-57,24,2,9,352,279
760,49,3,3,6,7,33,-66,5,3,385,213
760,50,3,3,5,8,32,35,7,8,417,248
760,51,4,3,6,7,42,-66,9,2,459,182
760,52,3,3,9,4,-64,31,5,3,395,213
760,53,5,2,11,2,-44,20,1,3,351,233
760,54,2,5,2,11,20,56,1,9,371,289
760,55,5,3,7,6,52,-67,3,2,423,222
760,56,3,3,6,7,33,34,6,6,456,256
760,57,3,3,5,8,32,-65,8,1,488,191
760,58,4,2,8,5,-56,23,2,4,432,214
760,59,3,4,5,8,32,44,4,8,464,258
760,60,3,3,4,9,31,-64,5,4,495,194
760,61,4,3,8,5,44,32,9,6,539,226
761,1,5,2,11,2,56,20,6,0,56,20
761,2,5,2,6,7,51,25,7,5,107,45
761,3,4,2,8,5,-56,23,1,8,51,68
761,4,3,4,3,10,30,-54,1,4,81,14
761,5,4,2,8,5,44,23,5,7,125,37
761,6,2,4,6,7,24,-57,9,0,149,-20
761,7,4,3,7,6,-57,33,2,3,92,13
761,8,2,4,7,6,25,42,7,5,117,55
761,9,4,2,8,5,-56,23,1,8,61,78
761,10,2,5,3,10,21,-45,2,3,82,33
761,11,4,3,8,5,44,32,6,5,126,65
761,12,3,3,6,7,33,34,9,9,159,99
761,13,4,3,6,7,-58,-66,1,3,101,33
761,14,3,3,7,6,34,33,5,6,135,66
761,15,3,3,7,6,34,33,9,9,169,99
761,16,3,3,6,7,-67,-66,2,3,102,33
761,17,5,2,9,4,54,22,6,5,156,55
761,18,3,4,6,7,33,43,9,8,189,98
761,19,5,3,7,6,-48,-67,1,1,141,31
761,20,4,3,9,4,45,31,6,2,186,62
761,21,3,3,7,6,-66,33,0,5,120,95
761,22,4,2,10,3,46,21,6,6,166,116
761,23,3,3,7,6,-66,33,0,9,100,149
761,24,2,4,4,9,22,-55,2,4,122,94
761,25,4,3,8,5,44,32,6,6,166,126
761,26,4,2,7,6,43,-76,9,0,209,50
761,27,3,4,4,9,-69,45,0,5,140,95
761,28,5,2,9,4,54,22,4,7,194,117
761,29,2,5,6,7,24,52,8,9,218,169
761,30,5,2,8,5,-47,-77,1,2,171,92
761,31,3,3,7,6,34,33,5,5,205,125
761,32,2,4,6,7,24,43,9,8,229,168
761,33,5,2,8,5,-47,-77,2,1,182,91
761,34,3,3,7,6,34,33,6,4,216,124
761,35,2,6,2,11,20,65,6,9,236,189
761,36,4,2,7,6,43,-76,9,3,279,113
761,37,2,4,5,8,-77,44,2,7,202,157
761,38,6,2,8,5,62,-77,4,0,264,80
761,39,3,4,8,5,35,41,9,1,299,121
761,40,3,3,6,7,-67,34,2,5,232,155
761,41,2,5,3,10,21,-45,3,0,253,110
761,42,2,5,6,7,24,52,7,2,277,162
761,43,5,2,7,6,52,24,9,6,329,186
761,44,4,2,8,5,-56,23,3,9,273,209
761,45,4,2,9,4,45,-78,8,1,318,131
761,46,6,2,10,3,-36,21,2,2,282,152
761,47,2,5,7,6,25,51,7,3,307,203
761,48,2,4,4,9,22,45,9,8,329,248
761,49,5,2,7,6,-48,-76,1,2,281,172
761,50,3,3,8,5,35,32,6,4,316,204
761,51,3,4,7,6,-66,42,0,6,250,246
761,52,2,5,4,9,22,-46,2,0,272,200
761,53,3,3,6,7,33,34,5,4,305,234
761,54,3,3,8,5,-65,32,0,6,240,266
761,55,4,3,9,4,45,31,5,7,285,297
761,56,3,4,5,8,32,-56,7,1,317,241
761,57,2,5,3,10,21,55,8,6,338,296
761,58,3,3,9,4,-64,31,4,7,274,327
761,59,3,3,9,4,-64,31,0,8,210,358
761,60,2,5,4,9,22,-46,2,2,232,312
761,61,3,4,4,9,31,45,3,7,263,357
761,62,4,3,7,6,43,-67,6,0,306,290
761,63,2,4,4,9,22,45,8,5,328,335
761,64,3,3,5,8,-68,-65,0,0,260,270
761,65,4,2,7,6,43,24,3,4,303,294
761,66,4,3,8,5,44,32,7,6,347,326
761,67,3,3,5,8,32,-65,9,1,379,261
761,68,5,2,9,4,-46,22,3,3,333,283
761,69,3,3,10,3,-63,30,0,3,270,313
761,70,4,2,6,7,42,25,2,8,312,338
761,71,4,2,8,5,44,-77,6,1,356,261
761,72,4,2,7,6,43,24,9,5,399,285
761,73,4,3,6,7,-58,34,1,9,341,319
761,74,4,3,8,5,44,-68,5,1,385,251
761,75,3,3,7,6,34,33,9,4,419,284
761,76,4,3,8,5,-56,32,3,6,363,316
761,77,5,2,8,5,53,23,6,9,416,339
761,78,4,4,7,6,43,-58,9,1,459,281
761,79,2,6,3,10,-79,64,0,5,380,345
761,80,4,3,5,8,41,-65,1,0,421,280
761,81,3,3,6,7,33,34,4,4,454,314
761,82,3,3,5,8,32,35,6,9,486,349
761,83,3,4,7,6,-66,-58,0,1,420,291
761,84,5,2,8,5,53,23,3,4,473,314
761,85,4,3,9,4,45,31,8,5,518,345
762,1,3,3,7,6,34,33,4,3,34,33
762,2,6,2,8,5,62,23,6,6,96,56
762,3,2,4,4,9,22,-55,8,1,118,1
762,4,4,3,7,6,-57,33,1,4,61,34
762,5,2,4,5,8,23,44,4,8,84,78
762,6,4,3,10,3,-54,30,0,8,30,108
762,7,3,3,6,7,33,-66,3,2,63,42
762,8,4,4,7,6,43,42,6,4,106,84
762,9,2,5,4,9,22,54,8,8,128,138
762,10,2,5,2,11,20,-44,8,4,148,94
762,11,2,5,3,10,21,55,9,9,169,149
762,12,2,5,5,8,-77,-47,2,2,92,102
762,13,2,5,4,9,22,54,4,6,114,156
762,14,4,3,7,6,43,33,7,9,157,189
762,15,4,3,6,7,42,-66,9,3,199,123
762,16,4,2,6,7,-58,25,1,8,141,148
762,17,4,3,7,6,43,-67,4,1,184,81
762,18,5,2,9,4,54,22,8,3,238,103
762,19,4,2,6,7,-58,25,0,8,180,128
762,20,3,4,4,9,31,-55,1,3,211,73
762,21,4,2,9,4,45,22,6,5,256,95
762,22,2,4,2,11,20,-53,6,2,276,42
762,23,2,4,5,8,23,44,9,6,299,86
762,24,5,2,9,4,-46,22,3,8,253,108
762,25,3,3,7,6,34,-67,7,1,287,41
762,26,3,4,6,7,-67,43,0,4,220,84
762,27,4,4,6,7,42,43,2,7,262,127
762,28,3,3,7,6,34,-67,6,0,296,60
762,29,3,4,6,7,33,43,9,3,329,103
762,30,3,3,5,8,-68,35,1,8,261,138
762,31,4,2,7,6,43,-76,4,2,304,62
762,32,4,4,8,5,44,41,8,3,348,103
762,33,3,4,7,6,-66,42,2,5,282,145
762,34,3,4,5,8,32,44,4,9,314,189
762,35,4,3,7,6,43,-67,7,2,357,122
762,36,5,2,8,5,-47,23,0,5,310,145
762,37,3,4,6,7,33,43,3,8,343,188
762,38,2,4,4,9,22,-55,5,3,365,133
762,39,3,4,6,7,33,43,8,6,398,176
762,40,2,6,3,10,21,-36,9,0,419,140
762,41,4,3,6,7,-58,34,1,4,361,174
762,42,2,4,4,9,22,45,3,9,383,219
762,43,3,4,4,9,31,-55,4,4,414,164
762,44,3,3,10,3,-63,30,1,4,351,194
762,45,3,4,6,7,33,43,4,7,384,237
762,46,2,5,3,10,21,-45,5,2,405,192
762,47,4,2,9,4,-55,22,0,4,350,214
762,48,3,3,8,5,35,32,5,6,385,246
762,49,5,3,4,9,-50,-64,5,2,335,182
762,50,2,4,4,9,22,45,7,7,357,227
762,51,4,2,8,5,-56,-77,1,0,301,150
762,52,3,4,5,8,32,44,3,4,333,194
762,53,4,3,7,6,43,33,6,7,376,227
762,54,4,3,8,5,-56,32,0,9,320,259
762,55,4,3,6,7,42,-66,2,3,362,193
762,56,5,2,11,2,56,20,8,3,418,213
762,57,3,4,5,8,-68,44,0,7,350,257
762,58,4,2,8,5,44,-77,4,0,394,180
762,59,4,2,8,5,44,23,8,3,438,203
762,60,3,4,3,10,30,46,8,9,468,249
762,61,4,3,8,5,-56,-68,2,1,412,181
762,62,5,2,7,6,52,24,4,5,464,205
762,63,4,3,9,4,45,31,9,6,509,236
763,1,4,2,10,3,46,21,6,1,46,21
763,2,2,5,3,10,21,55,7,6,67,76
763,3,3,3,7,6,-66,33,1,9,1,109
763,4,3,4,8,5,35,-59,6,0,36,50
763,5,3,3,6,7,33,34,9,4,69,84
763,6,5,2,9,4,-46,22,3,6,23,106
763,7,3,4,5,8,32,-56,5,0,55,50
763,8,5,2,8,5,53,23,8,3,108,73
763,9,4,3,9,4,-55,31,3,4,53,104
763,10,5,2,9,4,54,22,7,6,107,126
763,11,2,5,3,10,21,-45,8,1,128,81
763,12,4,2,11,2,-53,20,5,1,75,101
763,13,3,3,6,7,33,34,8,5,108,135
763,14,3,3,4,9,31,-64,9,1,139,71
763,15,2,5,4,9,-78,54,1,5,61,125
763,16,5,3,7,6,52,33,3,8,113,158
763,17,3,3,5,8,32,-65,5,3,145,93
763,18,3,3,8,5,-65,32,0,5,80,125
763,19,5,2,9,4,54,22,4,7,134,147
763,20,5,2,7,6,52,-76,6,1,186,71
763,21,5,2,6,7,51,25,7,6,237,96
763,22,4,3,9,4,-55,31,2,7,182,127
763,23,4,2,9,4,45,22,7,9,227,149
763,24,3,3,8,5,-65,-68,2,1,162,81
763,25,5,2,9,4,54,22,6,3,216,103
763,26,3,4,6,7,33,43,9,6,249,146
763,27,3,3,7,6,-66,33,3,9,183,179
763,28,3,4,6,7,33,-57,6,2,216,122
763,29,3,4,8,5,-65,41,1,3,151,163
763,30,3,3,5,8,32,35,3,8,183,198
763,31,3,3,7,6,34,-67,7,1,217,131
763,32,2,5,1,12,-20,57,7,8,197,188
763,33,2,4,6,7,-76,-57,1,1,121,131
763,34,3,4,6,7,33,43,4,4,154,174
763,35,3,3,7,6,34,33,8,7,188,207
763,36,3,4,8,5,-65,41,3,8,123,248
763,37,2,4,5,8,23,-56,6,2,146,192
763,38,5,2,11,2,-44,20,2,2,102,212
763,39,2,4,5,8,23,44,5,6,125,256
763,40,2,5,3,10,21,-45,6,1,146,211
763,41,3,3,5,8,32,35,8,6,178,246
763,42,3,4,5,8,-68,-56,0,0,110,190
763,43,5,2,10,3,55,21,5,1,165,211
763,44,2,5,6,7,24,52,9,3,189,263
763,45,5,2,10,3,-45,21,4,4,144,284
763,46,2,4,3,10,21,-54,5,0,165,230
763,47,5,2,7,6,52,24,7,4,217,254
763,48,3,3,8,5,-65,32,2,6,152,286
763,49,4,3,7,6,43,33,5,9,195,319
763,50,2,4,5,8,23,-56,8,3,218,263
763,51,2,5,4,9,-78,54,0,7,140,317
763,52,2,5,3,10,21,-45,1,2,161,272
763,53,3,4,5,8,32,44,3,6,193,316
763,54,5,3,10,3,55,30,8,6,248,346
763,55,4,2,6,7,-58,-75,0,1,190,271
763,56,3,3,8,5,35,32,5,3,225,303
763,57,3,3,4,9,31,36,6,9,256,339
763,58,4,3,8,5,-56,-68,0,1,200,271
763,59,2,4,4,9,22,45,2,6,222,316
763,60,6,2,10,3,64,21,6,7,286,337
763,61,3,3,6,7,33,-66,9,1,319,271
763,62,3,3,7,6,-66,33,3,4,253,304
763,63,3,4,6,7,33,43,6,7,286,347
763,64,4,3,8,5,-56,32,0,9,230,379
763,65,2,4,5,8,23,-56,3,3,253,323
763,66,4,2,5,8,41,26,4,9,294,349
763,67,2,5,3,10,21,-45,5,4,315,304
763,68,2,5,2,11,20,-44,5,0,335,260
763,69,5,2,8,5,53,23,8,3,388,283
763,70,3,4,6,7,-67,43,1,6,321,326
763,71,3,4,4,9,31,-55,2,1,352,271
763,72,3,3,3,10,30,37,2,8,382,308
763,73,3,3,5,8,32,-65,4,3,414,243
763,74,2,4,3,10,21,46,5,9,435,289
763,75,5,2,8,5,53,-77,8,2,488,212
763,76,2,5,5,8,-77,53,1,5,411,265
763,77,4,3,8,5,44,32,5,7,455,297
763,78,5,2,9,4,54,22,9,9,509,319
764,1,5,2,10,3,55,21,5,1,55,21
764,2,3,3,7,6,34,33,9,4,89,54
764,3,3,3,7,6,-66,33,3,7,23,87
764,4,2,4,5,8,23,-56,6,1,46,31
764,5,3,3,8,5,-65,32,1,3,-19,63
764,6,2,5,4,9,22,54,3,7,3,117
764,7,2,4,7,6,25,42,8,9,28,159
764,8,2,5,5,8,-77,-47,1,2,-49,112
764,9,4,3,6,7,42,34,3,6,-7,146
764,10,3,4,5,8,32,-56,5,0,25,90
764,11,3,3,4,9,31,36,6,6,56,126
764,12,3,3,7,6,-66,33,0,9,-10,159
764,13,3,4,4,9,31,-55,1,4,21,104
764,14,3,4,6,7,33,43,4,7,54,147
764,15,3,3,7,6,34,-67,8,0,88,80
764,16,3,4,6,7,-67,43,1,3,21,123
764,17,3,3,7,6,34,33,5,6,55,156
764,18,2,5,3,10,21,-45,6,1,76,111
764,19,4,2,9,4,-55,22,1,3,21,133
764,20,6,2,11,2,65,20,6,3,86,153
764,21,4,2,8,5,-56,23,0,6,30,176
764,22,2,4,6,7,24,43,4,9,54,219
764,23,3,4,6,7,33,-57,7,2,87,162
764,24,4,2,8,5,-56,23,1,5,31,185
764,25,3,3,4,9,31,-64,2,1,62,121
764,26,3,5,7,6,34,51,6,2,96,172
764,27,2,5,5,8,23,53,9,5,119,225
764,28,2,4,7,6,-75,42,4,7,44,267
764,29,3,3,8,5,35,32,9,9,79,299
764,30,5,2,9,4,-46,-78,3,1,33,221
764,31,3,3,5,8,32,35,5,6,65,256
764,32,3,4,4,9,31,-55,6,1,96,201
764,33,2,4,6,7,-76,43,0,4,20,244
764,34,2,6,3,10,21,64,1,8,41,308
764,35,3,4,5,8,32,-56,3,2,73,252
764,36,2,5,4,9,22,54,5,6,95,306
764,37,4,3,10,3,-54,30,1,6,41,336
764,38,3,3,9,4,36,31,7,7,77,367
764,39,3,4,6,7,-67,-57,0,0,10,310
764,40,4,3,9,4,45,31,5,1,55,341
764,41,4,3,6,7,42,34,7,5,97,375
764,42,4,2,6,7,42,-75,9,0,139,300
764,43,2,5,4,9,-78,54,1,4,61,354
764,44,3,3,3,10,30,-63,1,1,91,291
764,45,4,3,8,5,44,32,5,3,135,323
764,46,3,3,5,8,32,35,7,8,167,358
764,47,2,5,4,9,22,-46,9,2,189,312
764,48,3,3,5,8,-68,35,1,7,121,347
764,49,3,3,6,7,33,-66,4,1,154,281
764,50,3,4,8,5,35,41,9,2,189,322
764,51,3,3,4,9,-69,36,0,8,120,358
764,52,4,3,7,6,43,-67,3,1,163,291
764,53,3,3,7,6,34,33,7,4,197,324
764,54,3,3,7,6,-66,33,1,7,131,357
764,55,3,3,6,7,33,-66,4,1,164,291
764,56,2,4,6,7,24,43,8,4,188,334
764,57,3,3,7,6,-66,33,2,7,122,367
764,58,2,5,2,11,20,-44,2,3,142,323
764,59,3,4,4,9,31,45,3,8,173,368
764,60,3,3,5,8,32,-65,5,3,205,303
764,61,4,3,7,6,43,33,8,6,248,336
764,62,2,4,7,6,-75,42,3,8,173,378
764,63,4,3,7,6,43,-67,6,1,216,311
764,64,3,4,7,6,-66,42,0,3,150,353
764,65,2,5,5,8,23,53,3,6,173,406
764,66,4,2,8,5,44,23,7,9,217,429
764,67,5,2,10,3,-45,-79,2,0,172,350
764,68,2,4,3,10,21,46,3,6,193,396
764,69,2,5,3,10,21,-45,4,1,214,351
764,70,2,4,6,7,24,43,8,4,238,394
764,71,4,3,8,5,-56,32,2,6,182,426
764,72,4,3,10,3,46,30,8,6,228,456
764,73,4,2,9,4,-55,22,3,8,173,478
764,74,2,4,4,9,22,-55,5,3,195,423
764,75,2,4,3,10,21,46,6,9,216,469
764,76,5,2,9,4,-46,-78,0,1,170,391
764,77,5,2,7,6,52,24,2,5,222,415
764,78,4,2,8,5,44,23,6,8,266,438
764,79,2,5,5,8,23,-47,9,1,289,391
764,80,3,3,8,5,-65,32,4,3,224,423
764,81,3,3,9,4,-64,31,0,4,160,454
764,82,5,2,10,3,55,21,5,5,215,475
764,83,2,4,7,6,-75,42,0,7,140,517
765,1,4,4,6,7,42,43,2,3,42,43
765,2,3,3,7,6,34,33,6,6,76,76
765,3,5,2,7,6,52,-76,8,0,128,0
765,4,2,4,4,9,-78,45,0,5,50,45
765,5,3,4,6,7,33,43,3,8,83,88
765,6,3,3,8,5,35,-68,8,0,118,20
765,7,3,3,8,5,-65,32,3,2,53,52
765,8,4,2,9,4,45,22,8,4,98,74
765,9,4,3,9,4,-55,31,3,5,43,105
765,10,5,2,10,3,55,21,8,6,98,126
765,11,2,5,5,8,-77,53,1,9,21,179
765,12,3,3,5,8,32,-65,3,4,53,114
765,13,4,2,7,6,43,24,6,8,96,138
765,14,4,3,5,8,41,-65,7,3,137,73
765,15,2,4,9,4,-73,40,4,3,64,113
765,16,3,4,6,7,33,43,7,6,97,156
765,17,4,3,8,5,-56,32,1,8,41,188
765,18,2,4,6,7,24,-57,5,1,65,131
765,19,4,3,7,6,43,33,8,4,108,164
765,20,4,3,6,7,-58,34,0,8,50,198
765,21,4,3,9,4,45,31,5,9,95,229
765,22,4,2,10,3,-54,-79,1,0,41,150
765,23,3,3,7,6,34,33,5,3,75,183
765,24,3,4,4,9,31,45,6,8,106,228
765,25,3,4,5,8,32,-56,8,2,138,172
765,26,2,4,3,10,21,46,9,8,159,218
765,27,2,4,6,7,-76,-57,3,1,83,161
765,28,4,3,12,1,-52,-30,1,1,31,131
765,29,2,5,3,10,21,55,2,6,52,186
765,30,3,3,4,9,31,-64,3,2,83,122
765,31,5,2,9,4,54,22,7,4,137,144
765,32,4,3,8,5,-56,32,1,6,81,176
765,33,2,5,3,10,21,-45,2,1,102,131
765,34,5,2,8,5,53,23,5,4,155,154
765,35,2,4,8,5,-74,41,1,5,81,195
765,36,2,5,2,11,20,-44,1,1,101,151
765,37,4,2,6,7,42,25,3,6,143,176
765,38,3,3,5,8,32,-65,5,1,175,111
765,39,2,4,3,10,21,46,6,7,196,157
765,40,2,4,4,9,22,-55,8,2,218,102
765,41,4,2,7,6,-57,24,1,6,161,126
765,42,4,3,7,6,43,33,4,9,204,159
765,43,5,2,7,6,52,-76,6,3,256,83
765,44,3,3,6,7,33,34,9,7,289,117
765,45,4,3,7,6,-57,-67,2,0,232,50
765,46,4,3,9,4,45,31,7,1,277,81
765,47,5,2,11,2,-44,20,3,1,233,101
765,48,3,3,4,9,31,36,4,7,264,137
765,49,3,4,4,9,31,-55,5,2,295,82
765,50,4,2,6,7,42,25,7,7,337,107
765,51,3,3,7,6,-66,-67,1,0,271,40
765,52,3,3,9,4,36,31,7,1,307,71
765,53,3,3,5,8,32,35,9,6,339,106
765,54,4,3,9,4,-55,31,4,7,284,137
765,55,4,3,6,7,42,-66,6,1,326,71
765,56,4,3,8,5,-56,32,0,3,270,103
765,57,4,3,5,8,41,35,1,8,311,138
765,58,3,3,5,8,32,-65,3,3,343,73
765,59,3,3,8,5,35,32,8,5,378,105
765,60,2,5,3,10,21,-45,9,0,399,60
765,61,3,4,6,7,-67,43,2,3,332,103
765,62,4,3,5,8,41,35,3,8,373,138
765,63,3,3,6,7,33,-66,6,2,406,72
765,64,3,3,5,8,32,35,8,7,438,107
765,65,3,4,5,8,-68,-56,0,1,370,51
765,66,4,3,9,4,45,31,5,2,415,82
765,67,6,2,9,4,63,22,8,4,478,104
765,68,3,3,6,7,-67,34,1,8,411,138
765,69,4,3,8,5,44,-68,5,0,455,70
765,70,3,3,8,5,-65,32,0,2,390,102
765,71,3,3,8,5,35,32,5,4,425,134
765,72,2,6,4,9,22,63,7,7,447,197
765,73,3,3,6,7,-67,-66,0,1,380,131
765,74,3,3,5,8,32,35,2,6,412,166
765,75,2,4,6,7,24,43,6,9,436,209
765,76,3,3,4,9,31,-64,7,5,467,145
765,77,3,4,5,8,32,44,9,9,499,189
765,78,3,3,7,6,-66,-67,3,2,433,122
765,79,2,5,3,10,21,55,4,7,454,177
765,80,3,4,5,8,32,-56,6,1,486,121
765,81,3,3,5,8,32,35,8,6,518,156
766,1,3,4,8,5,35,41,5,1,35,41
766,2,3,4,6,7,33,43,8,4,68,84
766,3,3,4,6,7,-67,43,1,7,1,127
766,4,3,4,6,7,33,-57,4,0,34,70
766,5,4,3,6,7,42,34,6,4,76,104
766,6,4,2,7,6,43,24,9,8,119,128
766,7,3,3,4,9,-69,-64,0,4,50,64
766,8,2,4,4,9,22,45,2,9,72,109
766,9,4,3,8,5,44,-68,6,1,116,41
766,10,3,3,7,6,-66,33,0,4,50,74
766,11,2,6,3,10,21,64,1,8,71,138
766,12,3,4,5,8,32,-56,3,2,103,82
766,13,3,3,5,8,32,35,5,7,135,117
766,14,2,4,6,7,24,-57,9,0,159,60
766,15,4,2,9,4,-55,22,4,2,104,82
766,16,2,4,9,4,-73,40,1,2,31,122
766,17,2,4,6,7,24,43,5,5,55,165
766,18,4,3,7,6,43,33,8,8,98,198
766,19,4,3,7,6,-57,-67,1,1,41,131
766,20,4,2,7,6,43,24,4,5,84,155
766,21,3,3,5,8,32,-65,6,0,116,90
766,22,2,5,4,9,22,54,8,4,138,144
766,23,2,4,5,8,-77,44,1,8,61,188
766,24,3,4,5,8,32,-56,3,2,93,132
766,25,4,2,7,6,43,24,6,6,136,156
766,26,4,4,8,5,-56,41,0,7,80,197
766,27,2,4,4,9,22,-55,2,2,102,142
766,28,2,5,7,6,25,51,7,3,127,193
766,29,2,4,6,7,-76,43,1,6,51,236
766,30,5,3,9,4,54,31,5,7,105,267
766,31,2,5,6,7,24,52,9,9,129,319
766,32,2,5,3,10,-79,-45,0,4,50,274
766,33,2,6,3,10,21,64,1,8,71,338
766,34,3,3,8,5,35,-68,6,0,106,270
766,35,3,5,6,7,33,52,9,2,139,322
766,36,3,4,7,6,-66,42,3,4,73,364
766,37,5,2,8,5,53,23,6,7,126,387
766,38,4,2,7,6,43,-76,9,1,169,311
766,39,3,4,4,9,-69,45,0,6,100,356
766,40,5,2,8,5,53,23,3,9,153,379
766,41,5,2,10,3,55,-79,8,0,208,300
766,42,3,3,5,8,-68,35,0,5,140,335
766,43,3,3,4,9,31,-64,1,1,171,271
766,44,4,3,9,4,45,31,6,2,216,302
766,45,2,5,3,10,21,55,7,7,237,357
766,46,2,4,4,9,22,-55,9,2,259,302
766,47,5,2,9,4,-46,22,3,4,213,324
766,48,5,2,10,3,55,21,8,5,268,345
766,49,4,2,9,4,-55,22,3,7,213,367
766,50,2,4,5,8,23,-56,6,1,236,311
766,51,4,2,8,5,-56,23,0,4,180,334
766,52,4,2,9,4,45,22,5,6,225,356
766,53,4,3,5,8,41,-65,6,1,266,291
766,54,6,2,11,2,-35,20,1,1,231,311
766,55,4,2,9,4,45,22,6,3,276,333
766,56,3,3,2,11,-30,-62,6,1,246,271
766,57,4,3,7,6,43,33,9,4,289,304
766,58,4,2,8,5,-56,23,3,7,233,327
766,59,3,3,4,9,31,-64,4,3,264,263
766,60,2,5,4,9,22,54,6,7,286,317
766,61,3,4,8,5,-65,41,1,8,221,358
766,62,2,5,3,10,21,-45,2,3,242,313
766,63,6,2,10,3,64,21,6,4,306,334
766,64,2,5,4,9,22,54,8,8,328,388
766,65,4,3,10,3,-54,30,4,8,274,418
766,66,2,4,5,8,23,-56,7,2,297,362
766,67,3,3,8,5,-65,32,2,4,232,394
766,68,2,4,6,7,24,43,6,7,256,437
766,69,4,2,8,5,-56,-77,0,0,200,360
766,70,3,4,7,6,34,42,4,2,234,402
766,71,3,3,7,6,34,33,8,5,268,435
766,72,5,2,9,4,-46,22,2,7,222,457
766,73,4,3,6,7,42,-66,4,1,264,391
766,74,2,5,4,9,22,54,6,5,286,445
766,75,3,3,8,5,-65,32,1,7,221,477
766,76,3,3,9,4,36,31,7,8,257,508
767,1,2,5,4,9,22,54,2,4,22,54
767,2,2,5,3,10,21,55,3,9,43,109
767,3,3,3,7,6,34,-67,7,2,77,42
767,4,3,3,7,6,-66,33,1,5,11,75
767,5,5,2,7,6,52,24,3,9,63,99
767,6,5,2,8,5,53,-77,6,2,116,22
767,7,2,4,5,8,23,44,9,6,139,66
767,8,5,3,9,4,-46,31,3,7,93,97
767,9,2,4,7,6,25,42,8,9,118,139
767,10,4,3,8,5,-56,-68,2,1,62,71
767,11,3,3,6,7,33,34,5,5,95,105
767,12,5,2,8,5,53,23,8,8,148,128
767,13,6,2,10,3,-36,21,2,9,112,149
767,14,4,3,9,4,45,-69,7,0,157,80
767,15,4,3,6,7,42,34,9,4,199,114
767,16,4,3,7,6,-57,33,2,7,142,147
767,17,4,3,9,4,45,31,7,8,187,178
767,18,5,2,7,6,52,-76,9,2,239,102
767,19,4,4,7,6,-57,42,2,4,182,144
767,20,3,3,9,4,36,31,8,5,218,175
767,21,3,3,9,4,-64,31,4,6,154,206
767,22,4,3,7,6,43,33,7,9,197,239
767,23,2,4,4,9,22,-55,9,4,219,184
767,24,4,2,7,6,-57,24,2,8,162,208
767,25,2,4,4,9,22,-55,4,3,184,153
767,26,4,3,8,5,44,32,8,5,228,185
767,27,6,2,11,2,-35,20,3,5,193,205
767,28,3,4,6,7,33,43,6,8,226,248
767,29,2,5,5,8,23,-47,9,1,249,201
767,30,3,4,5,8,-68,44,1,5,181,245
767,31,2,5,6,7,24,52,5,7,205,297
767,32,4,2,9,4,-55,22,0,9,150,319
767,33,5,2,8,5,53,-77,3,2,203,242
767,34,5,2,7,6,52,24,5,6,255,266
767,35,2,4,5,8,23,-56,8,0,278,210
767,36,5,2,10,3,-45,21,3,1,233,231
767,37,3,4,5,8,32,44,5,5,265,275
767,38,3,4,5,8,32,44,7,9,297,319
767,39,3,4,7,6,-66,-58,1,1,231,261
767,40,4,3,5,8,41,35,2,6,272,296
767,41,3,3,8,5,35,32,7,8,307,328
767,42,5,2,8,5,-47,-77,0,1,260,251
767,43,3,4,8,5,35,41,5,2,295,292
767,44,5,2,10,3,-45,21,0,3,250,313
767,45,5,2,10,3,55,21,5,4,305,334
767,46,4,2,9,4,-55,22,0,6,250,356
767,47,3,4,8,5,35,41,5,7,285,397
767,48,4,2,10,3,-54,21,1,8,231,418
767,49,2,5,5,8,23,-47,4,1,254,371
767,50,3,4,6,7,33,43,7,4,287,414
767,51,3,4,5,8,32,44,9,8,319,458
767,52,3,4,4,9,-69,-55,0,3,250,403
767,53,3,3,8,5,35,32,5,5,285,435
767,54,3,3,5,8,32,-65,7,0,317,370
767,55,4,3,7,6,-57,33,0,3,260,403
767,56,4,3,8,5,44,32,4,5,304,435
767,57,5,2,10,3,55,21,9,6,359,456
767,58,3,3,8,5,-65,32,4,8,294,488
767,59,6,2,11,2,65,20,9,8,359,508
768,1,4,3,9,4,45,31,5,1,45,31
768,2,3,3,5,8,32,35,7,6,77,66
768,3,2,5,4,9,22,-46,9,0,99,20
768,4,4,3,9,4,-55,31,4,1,44,51
768,5,3,3,8,5,35,32,9,3,79,83
768,6,3,4,7,6,-66,42,3,5,13,125
768,7,6,2,10,3,64,21,7,6,77,146
768,8,3,4,5,8,32,-56,9,0,109,90
768,9,3,4,6,7,-67,43,2,3,42,133
768,10,4,3,4,9,40,36,2,9,82,169
768,11,5,3,10,3,55,30,7,9,137,199
768,12,4,3,7,6,-57,-67,0,2,80,132
768,13,4,3,6,7,42,34,2,6,122,166
768,14,3,4,6,7,33,43,5,9,155,209
768,15,3,4,4,9,31,-55,6,4,186,154
768,16,4,3,7,6,43,33,9,7,229,187
768,17,5,2,8,5,-47,-77,2,0,182,110
768,18,4,2,5,8,41,26,3,6,223,136
768,19,4,3,8,5,44,32,7,8,267,168
768,20,2,4,6,7,-76,-57,1,1,191,111
768,21,4,3,8,5,44,32,5,3,235,143
768,22,4,3,7,6,43,33,8,6,278,176
768,23,5,2,8,5,-47,23,1,9,231,199
768,24,2,4,7,6,25,-58,6,1,256,141
768,25,4,3,6,7,42,34,8,5,298,175
768,26,5,2,7,6,-48,24,0,9,250,199
768,27,3,4,5,8,32,-56,2,3,282,143
768,28,4,3,7,6,43,33,5,6,325,176
768,29,2,5,3,10,21,-45,6,1,346,131
768,30,4,2,6,7,42,25,8,6,388,156
768,31,4,2,11,2,-53,20,5,6,335,176
768,32,4,2,4,9,40,-73,5,3,375,103
768,33,4,3,8,5,44,32,9,5,419,135
768,34,2,4,5,8,-77,44,2,9,342,179
768,35,4,2,9,4,45,-78,7,1,387,101
768,36,3,3,6,7,-67,34,0,5,320,135
768,37,3,3,5,8,32,-65,2,0,352,70
768,38,3,3,9,4,36,31,8,1,388,101
768,39,2,6,2,11,20,65,8,6,408,166
768,40,3,3,5,8,-68,-65,0,1,340,101
768,41,2,4,5,8,23,44,3,5,363,145
768,42,5,3,6,7,51,34,4,9,414,179
768,43,2,4,5,8,23,-56,7,3,437,123
768,44,6,2,9,4,-37,22,0,5,400,145
768,45,4,3,5,8,41,-65,1,0,441,80
768,46,3,3,7,6,34,33,5,3,475,113
768,47,3,4,7,6,34,42,9,5,509,155
769,1,3,4,8,5,35,41,5,1,35,41
769,2,4,3,7,6,43,33,8,4,78,74
769,3,3,4,4,9,31,45,9,9,109,119
769,4,3,4,7,6,-66,-58,3,1,43,61
769,5,2,4,7,6,25,42,8,3,68,103
769,6,2,4,4,9,-78,45,0,8,-10,148
769,7,3,3,7,6,34,-67,4,1,24,81
769,8,3,4,8,5,35,41,9,2,59,122
769,9,2,4,4,9,-78,45,1,7,-19,167
769,10,5,2,10,3,55,21,6,8,36,188
769,11,4,3,8,5,-56,-68,0,0,-20,120
769,12,2,5,4,9,22,54,2,4,2,174
769,13,5,2,9,4,54,22,6,6,56,196
769,14,3,4,8,5,-65,41,1,7,-9,237
769,15,3,3,5,8,32,-65,3,2,23,172
769,16,3,4,6,7,33,43,6,5,56,215
769,17,3,4,9,4,-64,40,2,5,-8,255
769,18,4,3,6,7,42,34,4,9,34,289
769,19,3,3,8,5,35,-68,9,1,69,221
769,20,3,4,8,5,-65,41,4,2,4,262
769,21,4,2,10,3,-54,21,0,3,-50,283
769,22,4,3,9,4,45,31,5,4,-5,314
769,23,2,4,6,7,24,43,9,7,19,357
769,24,4,3,8,5,-56,32,3,9,-37,389
769,25,3,3,5,8,32,-65,5,4,-5,324
769,26,4,2,9,4,-55,22,0,6,-60,346
769,27,4,2,8,5,44,23,4,9,-16,369
769,28,4,3,6,7,42,-66,6,3,26,303
769,29,2,4,3,10,21,46,7,9,47,349
769,30,2,4,4,9,22,-55,9,4,69,294
769,31,3,4,6,7,-67,43,2,7,2,337
769,32,4,2,10,3,46,21,8,8,48,358
769,33,6,2,11,2,-35,20,3,8,13,378
769,34,4,2,9,4,45,-78,8,0,58,300
769,35,4,4,9,4,-55,40,3,0,3,340
769,36,5,2,11,2,56,20,9,0,59,360
769,37,3,4,3,10,30,46,9,6,89,406
769,38,3,3,8,5,-65,32,4,8,24,438
769,39,5,2,9,4,54,-78,8,0,78,360
769,40,4,2,9,4,-55,22,3,2,23,382
769,41,5,2,10,3,55,21,8,3,78,403
769,42,5,3,10,3,-45,30,3,3,33,433
769,43,3,3,5,8,32,35,5,8,65,468
769,44,5,2,11,2,-44,20,1,8,21,488
769,45,3,4,6,7,33,-57,4,1,54,431
769,46,2,4,5,8,23,44,7,5,77,475
769,47,2,4,4,9,22,-55,9,0,99,420
769,48,2,5,5,8,-77,53,2,3,22,473
769,49,4,3,5,8,41,35,3,8,63,508
770,1,2,6,2,11,20,65,0,5,20,65
770,2,4,3,8,5,44,32,4,7,64,97
770,3,4,3,7,6,43,-67,7,0,107,30
770,4,4,3,5,8,41,35,8,5,148,65
770,5,4,2,6,7,-58,-75,0,0,90,-10
770,6,5,2,9,4,54,22,4,2,144,12
770,7,2,5,3,10,21,55,5,7,165,67
770,8,3,3,7,6,34,-67,9,0,199,0
770,9,2,6,3,10,-79,64,0,4,120,64
770,10,3,4,6,7,33,43,3,7,153,107
770,11,2,4,4,9,22,-55,5,2,175,52
770,12,4,2,10,3,-54,21,1,3,121,73
770,13,5,2,7,6,52,24,3,7,173,97
770,14,5,2,7,6,52,-76,5,1,225,21
770,15,2,5,3,10,21,55,6,6,246,76
770,16,4,3,10,3,-54,30,2,6,192,106
770,17,4,2,11,2,47,20,9,6,239,126
770,18,3,3,7,6,-66,33,3,9,173,159
770,19,5,2,9,4,54,-78,7,1,227,81
770,20,5,2,7,6,52,24,9,5,279,105
770,21,4,3,6,7,-58,34,1,9,221,139
770,22,2,4,5,8,23,-56,4,3,244,83
770,23,4,3,8,5,44,32,8,5,288,115
770,24,2,4,7,6,-75,42,3,7,213,157
770,25,2,4,6,7,24,-57,7,0,237,100
770,26,3,3,5,8,32,35,9,5,269,135
770,27,2,4,5,8,-77,44,2,9,192,179
770,28,3,4,6,7,33,-57,5,2,225,122
770,29,3,3,8,5,-65,32,0,4,160,154
770,30,3,3,8,5,35,32,5,6,195,186
770,31,3,3,7,6,34,33,9,9,229,219
770,32,5,2,10,3,-45,-79,4,0,184,140
770,33,3,4,5,8,32,44,6,4,216,184
770,34,2,5,4,9,22,54,8,8,238,238
770,35,3,3,9,4,-64,31,4,9,174,269
770,36,3,3,5,8,32,-65,6,4,206,204
770,37,4,2,8,5,-56,23,0,7,150,227
770,38,5,2,8,5,53,-77,3,0,203,150
770,39,3,4,7,6,34,42,7,2,237,192
770,40,4,3,8,5,-56,32,1,4,181,224
770,41,2,5,4,9,22,54,3,8,203,278
770,42,3,3,9,4,36,31,9,9,239,309
770,43,2,4,6,7,-76,-57,3,2,163,252
770,44,3,3,8,5,35,32,8,4,198,284
770,45,4,3,10,3,-54,30,4,4,144,314
770,46,3,3,5,8,32,35,6,9,176,349
770,47,3,3,9,4,-64,-69,2,0,112,280
770,48,3,4,4,9,31,45,3,5,143,325
770,49,4,2,11,2,-53,20,0,5,90,345
770,50,3,3,6,7,33,34,3,9,123,379
770,51,2,5,2,11,20,-44,3,5,143,335
770,52,3,3,8,5,35,32,8,7,178,367
770,53,5,2,9,4,-46,22,2,9,132,389
770,54,3,4,5,8,32,-56,4,3,164,333
770,55,3,3,4,9,31,36,5,9,195,369
770,56,4,2,8,5,44,-77,9,2,239,292
770,57,3,3,7,6,-66,33,3,5,173,325
770,58,4,3,10,3,46,30,9,5,219,355
770,59,5,2,11,2,-44,20,5,5,175,375
770,60,4,3,7,6,43,33,8,8,218,408
770,61,3,4,4,9,31,-55,9,3,249,353
770,62,4,2,7,6,-57,24,2,7,192,377
770,63,2,5,3,10,21,-45,3,2,213,332
770,64,6,2,9,4,63,22,6,4,276,354
770,65,6,2,11,2,-35,20,1,4,241,374
770,66,3,3,8,5,35,32,6,6,276,406
770,67,2,4,4,9,22,-55,8,1,298,351
770,68,4,3,9,4,-55,31,3,2,243,382
770,69,3,4,4,9,31,45,4,7,274,427
770,70,3,3,6,7,33,-66,7,1,307,361
770,71,5,2,9,4,-46,22,1,3,261,383
770,72,4,4,6,7,42,43,3,6,303,426
770,73,7,2,11,2,74,20,7,6,377,446
770,74,3,3,4,9,31,-64,8,2,408,382
770,75,2,5,2,11,20,56,8,8,428,438
770,76,3,3,8,5,-65,-68,3,0,363,370
770,77,3,4,4,9,31,45,4,5,394,415
770,78,3,3,7,6,34,33,8,8,428,448
770,79,5,2,9,4,-46,-78,2,0,382,370
770,80,4,3,8,5,44,32,6,2,426,402
770,81,3,3,8,5,-65,32,1,4,361,434
770,82,3,3,6,7,33,34,4,8,394,468
770,83,2,4,5,8,23,-56,7,2,417,412
770,84,5,2,10,3,-45,21,2,3,372,433
770,85,4,3,6,7,42,34,4,7,414,467
770,86,4,2,8,5,44,-77,8,0,458,390
770,87,4,2,6,7,-58,25,0,5,400,415
770,88,3,4,5,8,32,44,2,9,432,459
770,89,4,3,7,6,43,-67,5,2,475,392
770,90,3,3,7,6,34,33,9,5,509,425
771,1,3,3,10,3,37,30,7,0,37,30
771,2,3,5,6,7,-67,52,0,2,-30,82
771,3,4,3,8,5,44,32,4,4,14,114
771,4,3,3,7,6,34,33,8,7,48,147
771,5,3,3,9,4,-64,31,4,8,-16,178
771,6,3,3,8,5,35,-68,9,0,19,110
771,7,2,5,4,9,-78,54,1,4,-59,164
771,8,4,3,6,7,42,34,3,8,-17,198
771,9,2,4,6,7,24,-57,7,1,7,141
771,10,3,3,4,9,31,36,8,7,38,177
771,11,3,4,7,6,-66,42,2,9,-28,219
771,12,4,3,8,5,44,-68,6,1,16,151
771,13,2,5,4,9,22,54,8,5,38,205
771,14,3,3,6,7,-67,34,1,9,-29,239
771,15,3,3,5,8,32,-65,3,4,3,174
771,16,3,3,7,6,34,33,7,7,37,207
771,17,3,4,6,7,-67,-57,0,0,-30,150
771,18,3,4,4,9,31,45,1,5,1,195
771,19,3,4,4,9,31,-55,2,0,32,140
771,20,3,4,5,8,32,44,4,4,64,184
771,21,4,2,6,7,42,25,6,9,106,209
771,22,4,3,9,4,-55,-69,1,0,51,140
771,23,3,4,6,7,33,43,4,3,84,183
771,24,4,2,11,2,-53,20,1,3,31,203
771,25,4,3,5,8,41,35,2,8,72,238
771,26,3,3,9,4,36,31,8,9,108,269
771,27,4,2,8,5,-56,-77,2,2,52,192
771,28,2,4,5,8,23,44,5,6,75,236
771,29,2,4,6,7,24,43,9,9,99,279
771,30,4,3,6,7,-58,-66,1,3,41,213
771,31,2,4,7,6,25,42,6,5,66,255
771,32,3,3,5,8,32,-65,8,0,98,190
771,33,3,3,7,6,-66,33,2,3,32,223
771,34,3,3,6,7,33,34,5,7,65,257
771,35,4,3,8,5,44,32,9,9,109,289
771,36,4,3,8,5,-56,-68,3,1,53,221
771,37,3,3,9,4,36,31,9,2,89,252
771,38,4,3,6,7,-58,34,1,6,31,286
771,39,3,3,4,9,31,-64,2,2,62,222
771,40,2,5,4,9,22,54,4,6,84,276
771,41,3,4,5,8,32,-56,6,0,116,220
771,42,2,4,3,10,21,46,7,6,137,266
771,43,5,2,10,3,-45,21,2,7,92,287
771,44,4,2,4,9,40,-73,2,4,132,214
771,45,2,4,8,5,26,41,8,5,158,255
771,46,4,3,10,3,-54,30,4,5,104,285
771,47,5,3,8,5,53,32,7,7,157,317
771,48,2,4,5,8,-77,-56,0,1,80,261
771,49,3,3,6,7,33,34,3,5,113,295
771,50,3,4,7,6,34,42,7,7,147,337
771,51,2,4,4,9,22,-55,9,2,169,282
771,52,4,4,7,6,-57,42,2,4,112,324
771,53,4,3,10,3,46,30,8,4,158,354
771,54,3,3,3,10,30,-63,8,1,188,291
771,55,4,2,9,4,-55,22,3,3,133,313
771,56,4,3,7,6,43,33,6,6,176,346
771,57,3,3,7,6,-66,33,0,9,110,379
771,58,3,3,6,7,33,-66,3,3,143,313
771,59,2,5,6,7,24,52,7,5,167,365
771,60,3,4,4,9,31,-55,8,0,198,310
771,61,3,3,5,8,-68,35,0,5,130,345
771,62,4,2,9,4,45,22,5,7,175,367
771,63,3,4,4,9,31,-55,6,2,206,312
771,64,2,5,6,7,-76,52,0,4,130,364
771,65,4,2,11,2,47,20,7,4,177,384
771,66,4,3,8,5,-56,32,1,6,121,416
771,67,5,2,9,4,54,22,5,8,175,438
771,68,3,3,7,6,34,-67,9,1,209,371
771,69,2,4,5,8,-77,44,2,5,132,415
771,70,4,3,6,7,42,34,4,9,174,449
771,71,2,5,3,10,21,-45,5,4,195,404
771,72,2,4,4,9,22,45,7,9,217,449
771,73,5,2,10,3,-45,-79,2,0,172,370
771,74,3,3,10,3,37,30,9,0,209,400
771,75,2,5,3,10,-79,55,0,5,130,455
771,76,3,4,6,7,33,43,3,8,163,498
771,77,4,2,8,5,44,-77,7,1,207,421
771,78,2,4,6,7,-76,43,1,4,131,464
771,79,4,2,7,6,43,24,4,8,174,488
771,80,3,3,8,5,35,-68,9,0,209,420
771,81,3,3,6,7,-67,34,2,4,142,454
771,82,3,4,4,9,31,45,3,9,173,499
771,83,2,5,3,10,21,-45,4,4,194,454
771,84,5,2,10,3,55,21,9,5,249,475
771,85,5,2,10,3,-45,21,4,6,204,496
771,86,3,3,7,6,34,33,8,9,238,529
772,1,3,4,6,7,33,43,3,3,33,43
772,2,4,2,11,2,-53,20,0,3,-20,63
772,3,4,3,10,3,46,30,6,3,26,93
772,4,5,2,9,4,-46,22,0,5,-20,115
772,5,6,2,9,4,63,22,3,7,43,137
772,6,2,5,2,11,20,-44,3,3,63,93
772,7,2,5,2,11,20,56,3,9,83,149
772,8,3,3,7,6,34,-67,7,2,117,82
772,9,4,2,7,6,-57,24,0,6,60,106
772,10,3,4,6,7,33,43,3,9,93,149
772,11,2,5,5,8,23,-47,6,2,116,102
772,12,2,4,4,9,22,45,8,7,138,147
772,13,2,4,5,8,-77,-56,1,1,61,91
772,14,3,4,7,6,34,42,5,3,95,133
772,15,3,3,9,4,-64,31,1,4,31,164
772,16,3,3,5,8,32,35,3,9,63,199
772,17,2,5,4,9,22,-46,5,3,85,153
772,18,4,2,7,6,43,24,8,7,128,177
772,19,2,5,4,9,-78,-46,0,1,50,131
772,20,2,4,6,7,24,43,4,4,74,174
772,21,3,3,4,9,31,-64,5,0,105,110
772,22,3,4,9,4,-64,40,1,0,41,150
772,23,4,2,8,5,44,23,5,3,85,173
772,24,2,4,5,8,23,44,8,7,108,217
772,25,2,5,3,10,21,-45,9,2,129,172
772,26,5,3,9,4,-46,31,3,3,83,203
772,27,3,3,6,7,33,34,6,7,116,237
772,28,3,3,6,7,33,-66,9,1,149,171
772,29,2,4,6,7,-76,43,3,4,73,214
772,30,5,2,8,5,53,23,6,7,126,237
772,31,3,4,5,8,32,-56,8,1,158,181
772,32,4,3,7,6,-57,33,1,4,101,214
772,33,3,4,5,8,32,44,3,8,133,258
772,34,3,3,6,7,33,-66,6,2,166,192
772,35,2,4,6,7,-76,43,0,5,90,235
772,36,3,4,4,9,31,-55,1,0,121,180
772,37,3,3,8,5,35,32,6,2,156,212
772,38,3,3,5,8,32,35,8,7,188,247
772,39,3,3,9,4,-64,31,4,8,124,278
772,40,3,4,7,6,34,-58,8,0,158,220
772,41,2,5,2,11,20,56,8,6,178,276
772,42,3,3,4,9,31,-64,9,2,209,212
772,43,3,3,7,6,-66,33,3,5,143,245
772,44,3,3,8,5,35,32,8,7,178,277
772,45,3,4,7,6,-66,42,2,9,112,319
772,46,3,4,4,9,31,-55,3,4,143,264
772,47,3,3,9,4,36,31,9,5,179,295
772,48,5,3,6,7,-49,34,0,9,130,329
772,49,3,3,6,7,33,-66,3,3,163,263
772,50,5,2,7,6,52,24,5,7,215,287
772,51,2,4,7,6,-75,42,0,9,140,329
772,52,2,6,3,10,21,-36,1,3,161,293
772,53,3,3,5,8,32,35,3,8,193,328
772,54,2,5,5,8,23,-47,6,1,216,281
772,55,3,4,6,7,33,43,9,4,249,324
772,56,3,3,8,5,-65,32,4,6,184,356
772,57,5,2,10,3,55,21,9,7,239,377
772,58,5,2,8,5,-47,-77,2,0,192,300
772,59,5,2,8,5,53,23,5,3,245,323
772,60,4,3,7,6,43,33,8,6,288,356
772,61,5,2,9,4,-46,22,2,8,242,378
772,62,3,4,4,9,31,-55,3,3,273,323
772,63,5,2,10,3,55,21,8,4,328,344
772,64,3,3,7,6,-66,33,2,7,262,377
772,65,3,4,8,5,35,41,7,8,297,418
772,66,2,4,6,7,-76,-57,1,1,221,361
772,67,3,3,5,8,32,35,3,6,253,396
772,68,5,2,8,5,53,23,6,9,306,419
772,69,3,4,3,10,30,-54,6,5,336,365
772,70,4,2,9,4,-55,22,1,7,281,387
772,71,2,4,5,8,23,-56,4,1,304,331
772,72,3,3,7,6,34,33,8,4,338,364
772,73,6,2,8,5,-38,23,0,7,300,387
772,74,2,5,5,8,23,-47,3,0,323,340
772,75,4,3,8,5,44,32,7,2,367,372
772,76,6,2,10,3,-36,21,1,3,331,393
772,77,2,5,2,11,20,56,1,9,351,449
772,78,3,3,4,9,31,-64,2,5,382,385
772,79,2,4,5,8,23,44,5,9,405,429
772,80,3,4,7,6,34,-58,9,1,439,371
772,81,5,2,10,3,-45,21,4,2,394,392
772,82,5,2,9,4,54,22,8,4,448,414
772,83,4,3,10,3,-54,30,4,4,394,444
772,84,3,3,7,6,34,33,8,7,428,477
772,85,3,3,6,7,-67,-66,1,1,361,411
772,86,4,3,6,7,42,34,3,5,403,445
772,87,3,4,5,8,32,44,5,9,435,489
772,88,4,3,8,5,44,-68,9,1,479,421
772,89,2,4,5,8,-77,44,2,5,402,465
772,90,5,2,7,6,52,24,4,9,454,489
772,91,3,3,5,8,32,-65,6,4,486,424
772,92,5,2,11,2,-44,20,2,4,442,444
772,93,3,4,4,9,31,45,3,9,473,489
772,94,3,4,5,8,32,-56,5,3,505,433
773,1,2,5,5,8,23,53,3,3,23,53
773,2,4,2,6,7,42,25,5,8,65,78
773,3,4,2,6,7,42,-75,7,3,107,3
773,4,2,4,3,10,21,46,8,9,128,49
773,5,3,4,5,8,-68,-56,0,3,60,-7
773,6,3,4,6,7,33,43,3,6,93,36
773,7,4,3,4,9,40,-64,3,2,133,-28
773,8,5,2,10,3,55,21,8,3,188,-7
773,9,4,2,9,4,-55,22,3,5,133,15
773,10,4,4,9,4,45,40,8,5,178,55
773,11,3,4,8,5,-65,41,3,6,113,96
773,12,2,4,3,10,21,-54,4,2,134,42
773,13,4,3,8,5,44,32,8,4,178,74
773,14,3,4,6,7,-67,43,1,7,111,117
773,15,5,2,10,3,55,21,6,8,166,138
773,16,3,3,9,4,-64,31,2,9,102,169
773,17,3,4,8,5,35,-59,7,0,137,110
773,18,3,3,6,7,-67,34,0,4,70,144
773,19,3,4,3,10,30,-54,0,0,100,90
773,20,4,2,10,3,46,21,6,1,146,111
773,21,4,2,9,4,-55,22,1,3,91,133
773,22,3,3,3,10,30,-63,1,0,121,70
773,23,2,5,3,10,21,55,2,5,142,125
773,24,4,3,6,7,42,34,4,9,184,159
773,25,4,2,6,7,42,-75,6,4,226,84
773,26,2,5,3,10,21,55,7,9,247,139
773,27,3,4,6,7,-67,-57,0,2,180,82
773,28,2,6,4,9,22,63,2,5,202,145
773,29,4,4,5,8,41,44,3,9,243,189
773,30,3,4,7,6,34,-58,7,1,277,131
773,31,3,3,9,4,-64,31,3,2,213,162
773,32,2,5,4,9,22,54,5,6,235,216
773,33,3,3,6,7,33,-66,8,0,268,150
773,34,4,3,6,7,-58,34,0,4,210,184
773,35,3,3,8,5,35,32,5,6,245,216
773,36,3,3,4,9,31,-64,6,2,276,152
773,37,3,4,5,8,32,44,8,6,308,196
773,38,4,2,8,5,-56,23,2,9,252,219
773,39,4,3,6,7,42,-66,4,3,294,153
773,40,3,3,7,6,34,33,8,6,328,186
773,41,4,2,7,6,-57,-76,1,0,271,110
773,42,3,3,5,8,32,35,3,5,303,145
773,43,2,4,4,9,22,-55,5,0,325,90
773,44,5,2,9,4,54,22,9,2,379,112
773,45,2,4,3,10,-79,46,0,8,300,158
773,46,4,3,8,5,44,-68,4,0,344,90
773,47,5,3,9,4,54,31,8,1,398,121
773,48,2,4,5,8,-77,44,1,5,321,165
773,49,4,2,9,4,45,22,6,7,366,187
773,50,3,3,5,8,32,-65,8,2,398,122
773,51,3,4,5,8,-68,44,0,6,330,166
773,52,4,3,8,5,44,32,4,8,374,198
773,53,4,3,6,7,42,-66,6,2,416,132
773,54,4,3,8,5,-56,32,0,4,360,164
773,55,4,2,10,3,46,21,6,5,406,185
773,56,2,4,5,8,23,44,9,9,429,229
773,57,5,2,9,4,-46,-78,3,1,383,151
773,58,5,2,9,4,54,22,7,3,437,173
773,59,2,5,6,7,-76,52,1,5,361,225
773,60,3,5,6,7,33,52,4,7,394,277
773,61,3,4,4,9,31,-55,5,2,425,222
773,62,3,3,6,7,33,34,8,6,458,256
773,63,2,5,3,10,21,-45,9,1,479,211
773,64,2,5,3,10,-79,55,0,6,400,266
773,65,3,3,6,7,33,-66,3,0,433,200
773,66,3,3,4,9,31,36,4,6,464,236
773,67,2,5,4,9,22,-46,6,0,486,190
773,68,3,4,3,10,30,46,6,6,516,236
774,1,2,4,5,8,23,44,3,4,23,44
774,2,3,3,5,8,32,35,5,9,55,79
774,3,2,5,3,10,21,-45,6,4,76,34
774,4,4,3,6,7,42,34,8,8,118,68
774,5,3,4,7,6,-66,-58,2,0,52,10
774,6,2,5,5,8,23,53,5,3,75,63
774,7,3,4,3,10,30,46,5,9,105,109
774,8,3,3,9,4,-64,-69,1,0,41,40
774,9,4,2,8,5,44,23,5,3,85,63
774,10,2,6,3,10,21,64,6,7,106,127
774,11,4,3,9,4,-55,31,1,8,51,158
774,12,3,3,8,5,35,-68,6,0,86,90
774,13,4,3,8,5,-56,32,0,2,30,122
774,14,5,2,7,6,52,24,2,6,82,146
774,15,5,2,10,3,55,21,7,7,137,167
774,16,4,3,9,4,-55,31,2,8,82,198
774,17,2,5,4,9,22,-46,4,2,104,152
774,18,3,3,4,9,31,36,5,8,135,188
774,19,4,2,8,5,44,-77,9,1,179,111
774,20,4,3,9,4,-55,31,4,2,124,142
774,21,3,3,4,9,31,36,5,8,155,178
774,22,3,4,5,8,32,-56,7,2,187,122
774,23,4,3,7,6,-57,33,0,5,130,155
774,24,5,2,9,4,54,22,4,7,184,177
774,25,3,4,7,6,34,42,8,9,218,219
774,26,3,4,7,6,-66,-58,2,1,152,161
774,27,4,3,8,5,44,32,6,3,196,193
774,28,2,5,2,11,20,56,6,9,216,249
774,29,2,5,6,7,-76,-48,0,1,140,201
774,30,6,2,8,5,62,23,2,4,202,224
774,31,2,5,3,10,21,55,3,9,223,279
774,32,3,3,10,3,-63,30,0,9,160,309
774,33,5,2,7,6,52,-76,2,3,212,233
774,34,2,4,7,6,25,42,7,5,237,275
774,35,3,3,6,7,-67,34,0,9,170,309
774,36,2,6,2,11,20,-35,0,4,190,274
774,37,3,4,5,8,32,44,2,8,222,318
774,38,3,3,7,6,34,-67,6,1,256,251
774,39,2,5,5,8,23,53,9,4,279,304
774,40,2,4,5,8,-77,44,2,8,202,348
774,41,4,2,6,7,42,-75,4,3,244,273
774,42,3,4,4,9,31,45,5,8,275,318
774,43,3,4,4,9,31,-55,6,3,306,263
774,44,2,5,3,10,21,55,7,8,327,318
774,45,3,3,5,8,32,-65,9,3,359,253
774,46,6,2,11,2,-35,20,4,3,324,273
774,47,4,2,9,4,45,22,9,5,369,295
774,48,3,4,5,8,-68,44,1,9,301,339
774,49,3,3,7,6,34,-67,5,2,335,272
774,50,5,2,7,6,52,24,7,6,387,296
774,51,4,2,8,5,-56,23,1,9,331,319
774,52,3,3,5,8,32,-65,3,4,363,254
774,53,3,4,5,8,32,44,5,8,395,298
774,54,4,3,6,7,42,-66,7,2,437,232
774,55,2,4,5,8,-77,44,0,6,360,276
774,56,2,4,3,10,21,-54,1,2,381,222
774,57,4,3,8,5,44,32,5,4,425,254
774,58,3,4,6,7,33,43,8,7,458,297
774,59,2,4,5,8,-77,-56,1,1,381,241
774,60,3,4,6,7,33,43,4,4,414,284
774,61,4,3,8,5,44,32,8,6,458,316
774,62,3,4,8,5,-65,41,3,7,393,357
774,63,3,4,5,8,32,-56,5,1,425,301
774,64,3,3,8,5,-65,32,0,3,360,333
774,65,2,4,7,6,25,42,5,5,385,375
774,66,3,4,5,8,32,44,7,9,417,419
774,67,4,3,7,6,-57,-67,0,2,360,352
774,68,4,3,9,4,45,31,5,3,405,383
774,69,5,2,10,3,-45,21,0,4,360,404
774,70,3,3,4,9,31,-64,1,0,391,340
774,71,6,2,9,4,63,22,4,2,454,362
774,72,3,3,5,8,32,35,6,7,486,397
774,73,3,4,7,6,-66,42,0,9,420,439
774,74,3,3,10,3,37,30,7,9,457,469
774,75,4,3,8,5,-56,-68,1,1,401,401
774,76,3,3,8,5,35,32,6,3,436,433
774,77,4,3,8,5,-56,32,0,5,380,465
774,78,4,3,8,5,44,32,4,7,424,497
774,79,5,2,9,4,54,22,8,9,478,519
775,1,3,4,5,8,32,44,2,4,32,44
775,2,5,2,9,4,54,22,6,6,86,66
775,3,3,3,5,8,32,-65,8,1,118,1
775,4,3,4,4,9,31,45,9,6,149,46
775,5,4,2,7,6,-57,-76,2,0,92,-30
775,6,3,3,6,7,33,34,5,4,125,4
775,7,4,3,6,7,42,34,7,8,167,38
775,8,5,3,9,4,-46,31,1,9,121,69
775,9,2,4,5,8,23,-56,4,3,144,13
775,10,4,2,10,3,-54,21,0,4,90,34
775,11,4,2,8,5,44,23,4,7,134,57
775,12,4,3,5,8,41,-65,5,2,175,-8
775,13,3,4,5,8,32,44,7,6,207,36
775,14,3,4,5,8,32,-56,9,0,239,-20
775,15,5,2,10,3,-45,21,4,1,194,1
775,16,3,3,6,7,33,34,7,5,227,35
775,17,4,2,6,7,42,-75,9,0,269,-40
775,18,3,4,7,6,-66,42,3,2,203,2
775,19,3,4,6,7,33,43,6,5,236,45
775,20,4,3,7,6,43,33,9,8,279,78
775,21,3,3,7,6,-66,-67,3,1,213,11
775,22,6,2,11,2,65,20,8,1,278,31
775,23,2,5,5,8,-77,53,1,4,201,84
775,24,4,2,7,6,43,24,4,8,244,108
775,25,5,2,10,3,55,21,9,9,299,129
775,26,4,3,8,5,-56,-68,3,1,243,61
775,27,5,2,8,5,53,23,6,4,296,84
775,28,6,2,10,3,-36,21,0,5,260,105
775,29,2,4,5,8,23,44,3,9,283,149
775,30,5,2,9,4,54,-78,7,1,337,71
775,31,4,2,10,3,-54,21,3,2,283,92
775,32,4,3,6,7,42,34,5,6,325,126
775,33,3,3,5,8,32,-65,7,1,357,61
775,34,3,3,6,7,-67,34,0,5,290,95
775,35,3,3,6,7,33,34,3,9,323,129
775,36,4,3,5,8,41,-65,4,4,364,64
775,37,4,3,9,4,45,31,9,5,409,95
775,38,4,3,6,7,-58,34,1,9,351,129
775,39,3,4,6,7,33,-57,4,2,384,72
775,40,3,4,5,8,32,44,6,6,416,116
775,41,4,2,10,3,-54,21,2,7,362,137
775,42,3,4,3,10,30,-54,2,3,392,83
775,43,3,3,8,5,35,32,7,5,427,115
775,44,5,2,8,5,-47,23,0,8,380,138
775,45,2,4,6,7,24,-57,4,1,404,81
775,46,3,3,6,7,33,34,7,5,437,115
775,47,4,2,9,4,-55,22,2,7,382,137
775,48,4,3,10,3,46,30,8,7,428,167
775,49,3,4,6,7,-67,-57,1,0,361,110
775,50,4,4,8,5,44,41,5,1,405,151
775,51,3,4,7,6,34,42,9,3,439,193
775,52,2,6,4,9,-78,63,1,6,361,256
775,53,4,2,9,4,45,22,6,8,406,278
775,54,5,2,10,3,-45,21,1,9,361,299
775,55,4,4,8,5,44,-59,5,0,405,240
775,56,4,3,6,7,42,34,7,4,447,274
775,57,3,4,7,6,-66,42,1,6,381,316
775,58,5,2,8,5,53,23,4,9,434,339
775,59,3,3,5,8,32,-65,6,4,466,274
775,60,3,3,5,8,32,35,8,9,498,309
775,61,4,3,8,5,-56,-68,2,1,442,241
775,62,3,3,8,5,35,32,7,3,477,273
775,63,4,2,8,5,-56,23,1,6,421,296
775,64,4,3,7,6,43,33,4,9,464,329
775,65,4,3,10,3,-54,30,0,9,410,359
775,66,4,3,6,7,42,-66,2,3,452,293
775,67,3,3,8,5,35,32,7,5,487,325
775,68,4,3,7,6,-57,33,0,8,430,358
775,69,3,3,5,8,32,-65,2,3,462,293
775,70,2,4,7,6,25,42,7,5,487,335
775,71,3,3,7,6,-66,33,1,8,421,368
775,72,4,3,6,7,42,-66,3,2,463,302
775,73,4,3,8,5,44,32,7,4,507,334
776,1,4,2,7,6,43,24,3,4,43,24
776,2,4,3,7,6,43,33,6,7,86,57
776,3,4,2,10,3,-54,21,2,8,32,78
776,4,4,3,7,6,43,-67,5,1,75,11
776,5,3,4,4,9,31,45,6,6,106,56
776,6,3,3,7,6,-66,33,0,9,40,89
776,7,5,2,7,6,52,-76,2,3,92,13
776,8,2,5,6,7,24,52,6,5,116,65
776,9,5,2,11,2,-44,20,2,5,72,85
776,10,4,3,7,6,43,33,5,8,115,118
776,11,2,4,5,8,23,-56,8,2,138,62
776,12,3,3,6,7,-67,34,1,6,71,96
776,13,4,2,10,3,46,21,7,7,117,117
776,14,4,3,10,3,-54,30,3,7,63,147
776,15,2,6,3,10,21,-36,4,1,84,111
776,16,2,4,7,6,25,42,9,3,109,153
776,17,2,4,5,8,-77,44,2,7,32,197
776,18,4,3,7,6,43,-67,5,0,75,130
776,19,5,2,10,3,-45,21,0,1,30,151
776,20,2,5,4,9,22,54,2,5,52,205
776,21,3,4,6,7,33,43,5,8,85,248
776,22,3,4,6,7,33,-57,8,1,118,191
776,23,3,3,8,5,-65,32,3,3,53,223
776,24,4,2,7,6,43,24,6,7,96,247
776,25,3,3,8,5,-65,32,1,9,31,279
776,26,2,5,4,9,22,-46,3,3,53,233
776,27,4,3,9,4,45,31,8,4,98,264
776,28,3,3,6,7,-67,34,1,8,31,298
776,29,4,4,8,5,44,41,5,9,75,339
776,30,4,3,6,7,42,-66,7,3,117,273
776,31,3,3,5,8,32,35,9,8,149,308
776,32,2,4,7,6,-75,-58,4,0,74,250
776,33,3,4,7,6,34,42,8,2,108,292
776,34,3,3,5,8,-68,35,0,7,40,327
776,35,4,3,6,7,42,-66,2,1,82,261
776,36,3,3,7,6,34,33,6,4,116,294
776,37,4,2,8,5,-56,23,0,7,60,317
776,38,2,5,2,11,20,-44,0,3,80,273
776,39,3,4,5,8,32,44,2,7,112,317
776,40,4,2,9,4,45,22,7,9,157,339
776,41,2,5,4,9,22,-46,9,3,179,293
776,42,3,3,3,10,30,-63,9,0,209,230
776,43,2,4,3,10,-79,46,0,6,130,276
776,44,4,2,7,6,43,-76,3,0,173,200
776,45,5,3,6,7,51,34,4,4,224,234
776,46,3,3,4,9,31,-64,5,0,255,170
776,47,2,4,5,8,23,44,8,4,278,214
776,48,3,4,8,5,-65,41,3,5,213,255
776,49,4,4,4,9,40,-55,3,0,253,200
776,50,3,4,4,9,31,45,4,5,284,245
776,51,2,4,6,7,24,43,8,8,308,288
776,52,3,5,7,6,-66,51,2,9,242,339
776,53,4,2,6,7,42,-75,4,4,284,264
776,54,3,3,5,8,32,35,6,9,316,299
776,55,2,5,5,8,23,-47,9,2,339,252
776,56,2,4,5,8,-77,44,2,6,262,296
776,57,3,4,8,5,35,41,7,7,297,337
776,58,2,5,4,9,22,-46,9,1,319,291
776,59,5,2,8,5,-47,23,2,4,272,314
776,60,4,3,9,4,45,31,7,5,317,345
776,61,4,2,7,6,-57,24,0,9,260,369
776,62,4,4,6,7,42,-57,2,2,302,312
776,63,4,2,7,6,43,24,5,6,345,336
776,64,2,4,5,8,23,-56,8,0,368,280
776,65,5,2,7,6,-48,24,0,4,320,304
776,66,4,2,5,8,41,-74,1,0,361,230
776,67,3,4,4,9,31,45,2,5,392,275
776,68,3,3,6,7,33,34,5,9,425,309
776,69,4,2,9,4,-55,-78,0,1,370,231
776,70,4,3,7,6,43,33,3,4,413,264
776,71,3,3,8,5,35,32,8,6,448,296
776,72,2,4,3,10,21,-54,9,2,469,242
776,73,2,5,7,6,-75,51,4,3,394,293
776,74,4,2,7,6,43,24,7,7,437,317
776,75,2,4,3,10,21,-54,8,3,458,263
776,76,3,4,5,8,-68,44,0,7,390,307
776,77,2,6,2,11,20,-35,0,2,410,272
776,78,3,3,8,5,35,32,5,4,445,304
776,79,4,3,10,3,-54,30,1,4,391,334
776,80,5,2,10,3,55,21,6,5,446,355
776,81,2,5,5,8,23,53,9,8,469,408
776,82,6,2,8,5,-38,-77,1,1,431,331
776,83,3,3,4,9,31,36,2,7,462,367
776,84,4,3,6,7,42,-66,4,1,504,301
777,1,4,3,8,5,44,32,4,2,44,32
777,2,3,3,9,4,-64,31,0,3,-20,63
777,3,3,3,7,6,34,33,4,6,14,96
777,4,6,2,8,5,62,23,6,9,76,119
777,5,2,5,3,10,21,-45,7,4,97,74
777,6,3,3,4,9,31,-64,8,0,128,10
777,7,5,3,9,4,-46,31,2,1,82,41
777,8,2,5,6,7,24,52,6,3,106,93
777,9,4,3,7,6,43,33,9,6,149,126
777,10,3,4,7,6,-66,42,3,8,83,168
777,11,4,3,6,7,42,-66,5,2,125,102
777,12,4,3,9,4,-55,31,0,3,70,133
777,13,4,3,7,6,43,33,3,6,113,166
777,14,3,3,7,6,34,33,7,9,147,199
777,15,4,3,9,4,-55,-69,2,0,92,130
777,16,2,5,4,9,22,54,4,4,114,184
777,17,3,3,8,5,35,32,9,6,149,216
777,18,4,2,9,4,-55,22,4,8,94,238
777,19,2,4,6,7,24,-57,8,1,118,181
777,20,3,3,6,7,-67,34,1,5,51,215
777,21,4,3,7,6,43,33,4,8,94,248
777,22,2,5,5,8,23,-47,7,1,117,201
777,23,3,4,6,7,-67,43,0,4,50,244
777,24,3,3,8,5,35,32,5,6,85,276
777,25,4,3,9,4,-55,31,0,7,30,307
777,26,2,5,3,10,21,-45,1,2,51,262
777,27,3,3,6,7,33,34,4,6,84,296
777,28,4,3,7,6,43,33,7,9,127,329
777,29,4,2,9,4,-55,-78,2,1,72,251
777,30,3,3,4,9,31,36,3,7,103,287
777,31,3,4,9,4,36,40,9,7,139,327
777,32,5,2,10,3,-45,21,4,8,94,348
777,33,4,3,10,3,-54,30,0,8,40,378
777,34,2,5,2,11,20,-44,0,4,60,334
777,35,3,3,6,7,33,34,3,8,93,368
777,36,3,4,6,7,33,-57,6,1,126,311
777,37,4,2,9,4,-55,22,1,3,71,333
777,38,4,3,7,6,43,33,4,6,114,366
777,39,5,2,10,3,55,21,9,7,169,387
777,40,3,3,7,6,-66,-67,3,0,103,320
777,41,5,2,10,3,55,21,8,1,158,341
777,42,4,2,10,3,-54,21,4,2,104,362
777,43,4,2,10,3,-54,21,0,3,50,383
777,44,4,3,7,6,43,33,3,6,93,416
777,45,3,4,4,9,31,-55,4,1,124,361
777,46,4,3,8,5,44,32,8,3,168,393
777,47,3,3,7,6,-66,33,2,6,102,426
777,48,3,3,7,6,34,33,6,9,136,459
777,49,3,3,7,6,-66,-67,0,2,70,392
777,50,4,3,7,6,43,33,3,5,113,425
777,51,3,4,7,6,34,42,7,7,147,467
777,52,3,5,3,10,30,-45,7,2,177,422
777,53,4,4,5,8,41,44,8,6,218,466
777,54,3,3,8,5,-65,32,3,8,153,498
777,55,3,3,4,9,31,-64,4,4,184,434
777,56,3,4,7,6,34,42,8,6,218,476
777,57,4,3,10,3,-54,30,4,6,164,506
778,1,3,4,6,7,33,43,3,3,33,43
778,2,3,4,5,8,32,44,5,7,65,87
778,3,3,4,7,6,34,42,9,9,99,129
778,4,2,5,3,10,-79,-45,0,4,20,84
778,5,3,4,5,8,32,44,2,8,52,128
778,6,3,3,7,6,34,-67,6,1,86,61
778,7,4,3,9,4,-55,31,1,2,31,92
778,8,3,5,7,6,34,51,5,3,65,143
778,9,5,2,5,8,50,26,5,9,115,169
778,10,2,4,5,8,23,-56,8,3,138,113
778,11,4,2,9,4,-55,22,3,5,83,135
778,12,3,3,5,8,32,-65,5,0,115,70
778,13,3,4,5,8,32,44,7,4,147,114
778,14,5,2,10,3,-45,21,2,5,102,135
778,15,4,3,9,4,45,31,7,6,147,166
778,16,4,3,7,6,-57,33,0,9,90,199
778,17,2,4,6,7,24,-57,4,2,114,142
778,18,3,4,6,7,33,43,7,5,147,185
778,19,2,4,7,6,-75,42,2,7,72,227
778,20,4,3,7,6,43,-67,5,0,115,160
778,21,2,5,4,9,22,54,7,4,137,214
778,22,5,2,9,4,-46,22,1,6,91,236
778,23,3,3,5,8,32,-65,3,1,123,171
778,24,2,5,4,9,22,54,5,5,145,225
778,25,4,2,9,4,-55,22,0,7,90,247
778,26,4,3,5,8,41,-65,1,2,131,182
778,27,3,3,5,8,32,35,3,7,163,217
778,28,4,3,8,5,44,32,7,9,207,249
778,29,2,5,4,9,22,-46,9,3,229,203
778,30,2,5,4,9,-78,54,1,7,151,257
778,31,3,3,8,5,35,32,6,9,186,289
778,32,4,2,9,4,-55,-78,1,1,131,211
778,33,2,5,4,9,22,54,3,5,153,265
778,34,2,4,7,6,25,42,8,7,178,307
778,35,2,4,5,8,-77,-56,1,1,101,251
778,36,5,2,9,4,54,22,5,3,155,273
778,37,3,3,8,5,-65,32,0,5,90,305
778,38,2,6,5,8,23,62,3,7,113,367
778,39,2,4,7,6,25,42,8,9,138,409
778,40,2,6,4,9,-78,-37,0,2,60,372
778,41,2,4,6,7,24,43,4,5,84,415
778,42,4,2,8,5,44,23,8,8,128,438
778,43,2,4,6,7,-76,-57,2,1,52,381
778,44,2,5,4,9,22,54,4,5,74,435
778,45,3,3,4,9,31,-64,5,1,105,371
778,46,2,4,4,9,22,45,7,6,127,416
778,47,4,2,10,3,-54,21,3,7,73,437
778,48,3,3,7,6,34,-67,7,0,107,370
778,49,3,3,8,5,-65,32,2,2,42,402
778,50,2,4,4,9,22,45,4,7,64,447
778,51,3,3,6,7,33,-66,7,1,97,381
778,52,4,3,6,7,42,34,9,5,139,415
778,53,3,4,5,8,-68,44,1,9,71,459
778,54,2,5,6,7,24,-48,5,1,95,411
778,55,3,3,7,6,34,33,9,4,129,444
778,56,5,2,9,4,-46,22,3,6,83,466
778,57,2,6,3,10,21,-36,4,0,104,430
778,58,4,2,8,5,44,23,8,3,148,453
778,59,3,3,9,4,-64,31,4,4,84,484
778,60,3,3,6,7,33,34,7,8,117,518
779,1,3,4,6,7,33,43,3,3,33,43
779,2,4,2,8,5,44,23,7,6,77,66
779,3,2,5,7,6,-75,51,2,7,2,117
779,4,3,4,7,6,34,42,6,9,36,159
779,5,3,3,4,9,31,-64,7,5,67,95
779,6,5,2,8,5,-47,23,0,8,20,118
779,7,4,3,7,6,43,-67,3,1,63,51
779,8,3,4,5,8,32,44,5,5,95,95
779,9,3,3,5,8,32,-65,7,0,127,30
779,10,6,2,10,3,-36,21,1,1,91,51
779,11,4,3,9,4,45,31,6,2,136,82
779,12,5,2,6,7,51,25,7,7,187,107
779,13,2,5,6,7,-76,52,1,9,111,159
779,14,3,4,6,7,33,-57,4,2,144,102
779,15,4,2,10,3,-54,21,0,3,90,123
779,16,2,4,4,9,22,45,2,8,112,168
779,17,3,5,4,9,31,-46,3,2,143,122
779,18,4,4,7,6,43,42,6,4,186,164
779,19,3,3,7,6,-66,33,0,7,120,197
779,20,3,3,7,6,34,-67,4,0,154,130
779,21,4,3,8,5,44,32,8,2,198,162
779,22,3,3,6,7,-67,34,1,6,131,196
779,23,4,3,8,5,44,32,5,8,175,228
779,24,3,3,8,5,-65,-68,0,0,110,160
779,25,4,2,7,6,43,24,3,4,153,184
779,26,4,3,5,8,41,35,4,9,194,219
779,27,5,2,10,3,55,-79,9,0,249,140
779,28,3,3,5,8,-68,35,1,5,181,175
779,29,5,2,10,3,55,21,6,6,236,196
779,30,5,2,10,3,-45,21,1,7,191,217
779,31,5,2,7,6,52,-76,3,1,243,141
779,32,4,3,6,7,42,34,5,5,285,175
779,33,4,3,4,9,40,-64,5,1,325,111
779,34,2,4,7,6,-75,42,0,3,250,153
779,35,5,2,7,6,52,24,2,7,302,177
779,36,2,5,6,7,24,52,6,9,326,229
779,37,4,2,8,5,-56,-77,0,2,270,152
779,38,3,4,7,6,34,42,4,4,304,194
779,39,2,5,3,10,21,55,5,9,325,249
779,40,2,4,2,11,20,-53,5,6,345,196
779,41,2,4,5,8,23,-56,8,0,368,140
779,42,4,2,9,4,-55,22,3,2,313,162
779,43,2,5,4,9,22,54,5,6,335,216
779,44,3,4,5,8,32,-56,7,0,367,160
779,45,3,5,3,10,30,55,7,5,397,215
779,46,3,3,6,7,-67,34,0,9,330,249
779,47,4,3,7,6,43,-67,3,2,373,182
779,48,3,4,4,9,31,45,4,7,404,227
779,49,3,3,9,4,-64,31,0,8,340,258
779,50,3,4,5,8,32,-56,2,2,372,202
779,51,2,4,7,6,25,42,7,4,397,244
779,52,4,3,7,6,-57,33,0,7,340,277
779,53,5,2,9,4,54,22,4,9,394,299
779,54,2,5,5,8,23,-47,7,2,417,252
779,55,3,3,6,7,-67,34,0,6,350,286
779,56,2,5,5,8,23,53,3,9,373,339
779,57,4,4,8,5,44,-59,7,0,417,280
779,58,5,2,7,6,52,24,9,4,469,304
779,59,3,4,9,4,-64,40,5,4,405,344
779,60,2,4,6,7,24,43,9,7,429,387
779,61,4,3,9,4,-55,31,4,8,374,418
779,62,3,4,5,8,32,-56,6,2,406,362
779,63,3,4,7,6,-66,42,0,4,340,404
779,64,3,3,7,6,34,33,4,7,374,437
779,65,3,3,10,3,-63,30,1,7,311,467
779,66,3,3,7,6,34,-67,5,0,345,400
779,67,5,2,10,3,-45,21,0,1,300,421
779,68,4,2,8,5,44,23,4,4,344,444
779,69,3,3,6,7,33,34,7,8,377,478
779,70,3,3,8,5,-65,-68,2,0,312,410
779,71,3,3,6,7,33,34,5,4,345,444
779,72,3,4,4,9,31,45,6,9,376,489
779,73,3,4,7,6,-66,-58,0,1,310,431
779,74,2,4,6,7,24,43,4,4,334,474
779,75,3,4,8,5,35,41,9,5,369,515
780,1,5,2,8,5,53,23,3,3,53,23
780,2,4,2,11,2,-53,20,0,3,0,43
780,3,3,4,5,8,32,44,2,7,32,87
780,4,3,3,8,5,35,32,7,9,67,119
780,5,2,4,3,10,21,-54,8,5,88,65
780,6,4,2,7,6,-57,24,1,9,31,89
780,7,4,3,6,7,42,-66,3,3,73,23
780,8,3,3,9,4,36,31,9,4,109,54
780,9,4,4,4,9,40,45,9,9,149,99
780,10,4,3,6,7,-58,-66,1,3,91,33
780,11,3,4,7,6,34,42,5,5,125,75
780,12,2,4,4,9,22,-55,7,0,147,20
780,13,3,4,7,6,-66,42,1,2,81,62
780,14,3,3,7,6,34,33,5,5,115,95
780,15,3,3,7,6,34,33,9,8,149,128
780,16,2,4,7,6,-75,-58,4,0,74,70
780,17,5,3,8,5,53,32,7,2,127,102
780,18,3,4,4,9,31,45,8,7,158,147
780,19,4,2,7,6,-57,-76,1,1,101,71
780,20,2,4,3,10,21,46,2,7,122,117
780,21,3,3,6,7,33,-66,5,1,155,51
780,22,2,5,4,9,22,54,7,5,177,105
780,23,2,5,4,9,22,54,9,9,199,159
780,24,2,5,6,7,-76,-48,3,1,123,111
780,25,5,3,9,4,54,31,7,2,177,142
780,26,5,2,11,2,-44,20,3,2,133,162
780,27,2,5,3,10,21,55,4,7,154,217
780,28,5,2,9,4,54,22,8,9,208,239
780,29,3,4,4,9,31,-55,9,4,239,184
780,30,4,2,9,4,-55,22,4,6,184,206
780,31,2,5,7,6,25,51,9,7,209,257
780,32,2,4,5,8,-77,-56,2,1,132,201
780,33,4,2,9,4,45,22,7,3,177,223
780,34,3,3,9,4,-64,31,3,4,113,254
780,35,3,4,5,8,32,44,5,8,145,298
780,36,3,4,8,5,-65,41,0,9,80,339
780,37,5,2,8,5,53,-77,3,2,133,262
780,38,4,2,8,5,44,23,7,5,177,285
780,39,2,4,4,9,22,-55,9,0,199,230
780,40,5,2,9,4,-46,22,3,2,153,252
780,41,5,2,10,3,55,21,8,3,208,273
780,42,4,3,6,7,-58,34,0,7,150,307
780,43,5,2,10,3,55,21,5,8,205,328
780,44,4,2,8,5,44,-77,9,1,249,251
780,45,4,2,9,4,-55,22,4,3,194,273
780,46,4,2,9,4,45,22,9,5,239,295
780,47,3,4,5,8,-68,44,1,9,171,339
780,48,5,2,9,4,54,-78,5,1,225,261
780,49,2,5,4,9,22,54,7,5,247,315
780,50,3,3,7,6,-66,33,1,8,181,348
780,51,3,4,6,7,33,-57,4,1,214,291
780,52,2,4,3,10,21,46,5,7,235,337
780,53,3,4,4,9,31,-55,6,2,266,282
780,54,4,2,10,3,-54,21,2,3,212,303
780,55,5,2,9,4,54,22,6,5,266,325
780,56,2,4,5,8,23,44,9,9,289,369
780,57,4,3,5,8,-59,-65,0,4,230,304
780,58,2,5,3,10,21,55,1,9,251,359
780,59,4,2,6,7,42,-75,3,4,293,284
780,60,3,4,6,7,33,43,6,7,326,327
780,61,2,5,3,10,21,-45,7,2,347,282
780,62,2,5,4,9,22,54,9,6,369,336
780,63,4,3,10,3,-54,30,5,6,315,366
780,64,4,2,8,5,44,23,9,9,359,389
780,65,3,3,5,8,-68,-65,1,4,291,324
780,66,5,3,10,3,55,30,6,4,346,354
780,67,3,3,7,6,-66,33,0,7,280,387
780,68,3,3,5,8,32,-65,2,2,312,322
780,69,4,3,9,4,45,31,7,3,357,353
780,70,4,2,10,3,-54,21,3,4,303,374
780,71,4,2,6,7,42,25,5,9,345,399
780,72,4,3,9,4,-55,-69,0,0,290,330
780,73,2,5,6,7,24,52,4,2,314,382
780,74,5,2,10,3,55,21,9,3,369,403
780,75,3,3,8,5,-65,32,4,5,304,435
780,76,5,2,10,3,55,21,9,6,359,456
780,77,3,3,8,5,-65,32,4,8,294,488
780,78,3,3,9,4,-64,31,0,9,230,519
781,1,3,4,8,5,35,41,5,1,35,41
781,2,3,4,4,9,31,45,6,6,66,86
781,3,3,3,9,4,-64,31,2,7,2,117
781,4,4,3,8,5,44,32,6,9,46,149
781,5,3,3,6,7,33,-66,9,3,79,83
781,6,3,3,7,6,-66,33,3,6,13,116
781,7,4,3,5,8,41,-65,4,1,54,51
781,8,3,4,4,9,31,45,5,6,85,96
781,9,4,2,7,6,43,-76,8,0,128,20
781,10,2,5,3,10,21,55,9,5,149,75
781,11,3,4,5,8,-68,44,1,9,81,119
781,12,3,3,7,6,34,-67,5,2,115,52
781,13,3,3,9,4,-64,31,1,3,51,83
781,14,2,5,3,10,21,55,2,8,72,138
781,15,2,4,7,6,25,-58,7,0,97,80
781,16,3,4,6,7,-67,43,0,3,30,123
781,17,5,2,9,4,54,22,4,5,84,145
781,18,3,3,6,7,33,34,7,9,117,179
781,19,4,3,8,5,-56,-68,1,1,61,111
781,20,3,4,7,6,34,42,5,3,95,153
781,21,4,2,7,6,43,24,8,7,138,177
781,22,3,3,7,6,-66,-67,2,0,72,110
781,23,2,4,6,7,24,43,6,3,96,153
781,24,4,2,7,6,43,24,9,7,139,177
781,25,3,3,6,7,-67,-66,2,1,72,111
781,26,4,2,8,5,44,23,6,4,116,134
781,27,3,3,7,6,-66,33,0,7,50,167
781,28,4,2,11,2,47,20,7,7,97,187
781,29,2,6,4,9,22,-37,9,0,119,150
781,30,3,4,6,7,-67,43,2,3,52,193
781,31,2,5,3,10,21,55,3,8,73,248
781,32,4,3,8,5,44,-68,7,0,117,180
781,33,4,2,9,4,-55,22,2,2,62,202
781,34,3,4,5,8,32,44,4,6,94,246
781,35,4,3,9,4,45,31,9,7,139,277
781,36,4,3,8,5,-56,32,3,9,83,309
781,37,5,2,9,4,54,-78,7,1,137,231
781,38,5,2,10,3,-45,21,2,2,92,252
781,39,4,3,9,4,45,31,7,3,137,283
781,40,2,4,8,5,-74,41,3,4,63,324
781,41,2,4,3,10,21,-54,4,0,84,270
781,42,2,4,5,8,23,44,7,4,107,314
781,43,4,3,6,7,42,34,9,8,149,348
781,44,2,4,5,8,-77,-56,2,2,72,292
781,45,3,3,5,8,32,35,4,7,104,327
781,46,2,4,4,9,22,-55,6,2,126,272
781,47,4,2,9,4,-55,22,1,4,71,294
781,48,3,4,4,9,31,45,2,9,102,339
781,49,3,3,7,6,34,-67,6,2,136,272
781,50,2,5,4,9,22,54,8,6,158,326
781,51,5,2,8,5,-47,23,1,9,111,349
781,52,2,5,5,8,23,-47,4,2,134,302
781,53,2,4,7,6,25,42,9,4,159,344
781,54,5,2,9,4,-46,22,3,6,113,366
781,55,2,4,5,8,23,-56,6,0,136,310
781,56,3,4,7,6,-66,42,0,2,70,352
781,57,5,2,10,3,55,21,5,3,125,373
781,58,2,5,4,9,22,54,7,7,147,427
781,59,3,4,6,7,-67,-57,0,0,80,370
781,60,3,3,5,8,32,35,2,5,112,405
781,61,3,4,5,8,32,44,4,9,144,449
781,62,2,5,3,10,21,-45,5,4,165,404
781,63,4,3,9,4,-55,31,0,5,110,435
781,64,2,4,5,8,23,44,3,9,133,479
781,65,3,3,6,7,33,-66,6,3,166,413
781,66,2,4,6,7,-76,43,0,6,90,456
781,67,4,3,5,8,41,-65,1,1,131,391
781,68,4,3,9,4,45,31,6,2,176,422
781,69,5,2,11,2,-44,20,2,2,132,442
781,70,2,4,4,9,22,45,4,7,154,487
781,71,3,3,6,7,33,-66,7,1,187,421
781,72,4,4,8,5,-56,41,1,2,131,462
781,73,2,4,6,7,24,43,5,5,155,505
782,1,5,2,8,5,53,23,3,3,53,23
782,2,3,3,5,8,32,35,5,8,85,58
782,3,2,4,4,9,22,-55,7,3,107,3
782,4,3,3,7,6,-66,33,1,6,41,36
782,5,2,5,7,6,25,51,6,7,66,87
782,6,2,4,4,9,22,-55,8,2,88,32
782,7,4,2,9,4,-55,22,3,4,33,54
782,8,4,3,7,6,43,33,6,7,76,87
782,9,4,3,7,6,43,-67,9,0,119,20
782,10,2,4,6,7,-76,43,3,3,43,63
782,11,6,2,10,3,64,21,7,4,107,84
782,12,3,3,7,6,-66,33,1,7,41,117
782,13,3,3,8,5,35,32,6,9,76,149
782,14,3,3,6,7,33,-66,9,3,109,83
782,15,4,2,8,5,-56,23,3,6,53,106
782,16,3,4,8,5,35,41,8,7,88,147
782,17,3,3,6,7,-67,-66,1,1,21,81
782,18,5,2,11,2,56,20,7,1,77,101
782,19,3,3,6,7,-67,34,0,5,10,135
782,20,2,5,3,10,21,-45,1,0,31,90
782,21,5,2,9,4,54,22,5,2,85,112
782,22,4,2,9,4,-55,22,0,4,30,134
782,23,3,4,5,8,32,44,2,8,62,178
782,24,2,4,4,9,22,-55,4,3,84,123
782,25,3,4,5,8,32,44,6,7,116,167
782,26,5,2,7,6,52,-76,8,1,168,91
782,27,4,3,8,5,-56,32,2,3,112,123
782,28,4,2,6,7,42,25,4,8,154,148
782,29,3,3,5,8,32,-65,6,3,186,83
782,30,4,2,6,7,42,25,8,8,228,108
782,31,4,3,6,7,-58,-66,0,2,170,42
782,32,4,3,10,3,46,30,6,2,216,72
782,33,5,2,8,5,53,23,9,5,269,95
782,34,4,3,8,5,-56,32,3,7,213,127
782,35,4,3,8,5,44,32,7,9,257,159
782,36,3,3,5,8,32,-65,9,4,289,94
782,37,3,4,4,9,-69,45,0,9,220,139
782,38,3,4,5,8,32,-56,2,3,252,83
782,39,2,4,3,10,21,46,3,9,273,129
782,40,4,3,10,3,46,30,9,9,319,159
782,41,3,3,7,6,-66,-67,3,2,253,92
782,42,3,3,7,6,34,33,7,5,287,125
782,43,4,2,6,7,42,-75,9,0,329,50
782,44,3,3,7,6,-66,33,3,3,263,83
782,45,3,3,8,5,35,32,8,5,298,115
782,46,4,3,7,6,-57,33,1,8,241,148
782,47,4,2,8,5,44,-77,5,1,285,71
782,48,4,2,8,5,44,23,9,4,329,94
782,49,3,4,8,5,-65,41,4,5,264,135
782,50,2,5,5,8,23,53,7,8,287,188
782,51,3,3,7,6,-66,-67,1,1,221,121
782,52,3,4,6,7,33,43,4,4,254,164
782,53,3,4,5,8,32,44,6,8,286,208
782,54,2,5,3,10,21,-45,7,3,307,163
782,55,5,2,9,4,-46,22,1,5,261,185
782,56,3,3,4,9,31,-64,2,1,292,121
782,57,3,4,7,6,34,42,6,3,326,163
782,58,2,5,2,11,20,56,6,9,346,219
782,59,4,3,7,6,43,-67,9,2,389,152
782,60,4,3,8,5,-56,32,3,4,333,184
782,61,3,3,9,4,36,31,9,5,369,215
782,62,4,2,7,6,-57,24,2,9,312,239
782,63,6,2,9,4,63,-78,5,1,375,161
782,64,5,2,9,4,54,22,9,3,429,183
782,65,3,5,4,9,-69,54,0,7,360,237
782,66,3,4,5,8,32,-56,2,1,392,181
782,67,3,4,8,5,35,41,7,2,427,222
782,68,4,2,10,3,-54,21,3,3,373,243
782,69,2,4,5,8,23,44,6,7,396,287
782,70,2,5,4,9,22,-46,8,1,418,241
782,71,3,4,5,8,-68,44,0,5,350,285
782,72,3,4,8,5,35,41,5,6,385,326
782,73,5,2,10,3,-45,21,0,7,340,347
782,74,3,3,5,8,32,-65,2,2,372,282
782,75,4,3,6,7,42,34,4,6,414,316
782,76,3,4,5,8,32,-56,6,0,446,260
782,77,3,3,6,7,33,34,9,4,479,294
782,78,2,5,4,9,-78,54,1,8,401,348
782,79,2,4,5,8,23,-56,4,2,424,292
782,80,3,3,4,9,31,36,5,8,455,328
782,81,2,4,5,8,23,-56,8,2,478,272
782,82,2,4,7,6,-75,42,3,4,403,314
782,83,3,3,6,7,33,34,6,8,436,348
782,84,4,3,6,7,42,-66,8,2,478,282
782,85,5,2,9,4,-46,22,2,4,432,304
782,86,2,6,4,9,22,63,4,7,454,367
782,87,3,4,3,10,30,-54,4,3,484,313
782,88,4,3,7,6,43,33,7,6,527,346
783,1,4,3,8,5,44,32,4,2,44,32
783,2,2,5,3,10,21,55,5,7,65,87
783,3,4,2,7,6,43,-76,8,1,108,11
783,4,4,3,7,6,-57,33,1,4,51,44
783,5,4,3,8,5,44,32,5,6,95,76
783,6,2,4,6,7,24,43,9,9,119,119
783,7,4,3,7,6,-57,-67,2,2,62,52
783,8,3,4,7,6,34,42,6,4,96,94
783,9,3,4,4,9,31,45,7,9,127,139
783,10,5,2,10,3,-45,-79,2,0,82,60
783,11,4,3,8,5,44,32,6,2,126,92
783,12,3,4,6,7,33,43,9,5,159,135
783,13,4,3,5,8,-59,-65,0,0,100,70
783,14,4,2,9,4,45,22,5,2,145,92
783,15,3,3,6,7,33,34,8,6,178,126
783,16,4,3,8,5,-56,32,2,8,122,158
783,17,3,3,9,4,36,31,8,9,158,189
783,18,2,5,5,8,-77,-47,1,2,81,142
783,19,4,2,7,6,43,24,4,6,124,166
783,20,2,4,5,8,23,-56,7,0,147,110
783,21,3,3,5,8,32,35,9,5,179,145
783,22,3,3,8,5,-65,32,4,7,114,177
783,23,4,3,9,4,45,31,9,8,159,208
783,24,5,2,8,5,-47,-77,2,1,112,131
783,25,3,4,5,8,32,44,4,5,144,175
783,26,2,6,3,10,21,64,5,9,165,239
783,27,3,3,8,5,-65,-68,0,1,100,171
783,28,3,4,3,10,30,46,0,7,130,217
783,29,2,4,9,4,27,40,7,7,157,257
783,30,3,4,5,8,32,-56,9,1,189,201
783,31,2,4,3,10,-79,46,0,7,110,247
783,32,4,2,8,5,44,-77,4,0,154,170
783,33,2,4,3,10,21,46,5,6,175,216
783,34,3,3,8,5,-65,32,0,8,110,248
783,35,3,4,4,9,31,-55,1,3,141,193
783,36,2,6,4,9,22,63,3,6,163,256
783,37,3,3,7,6,34,33,7,9,197,289
783,38,2,4,3,10,21,-54,8,5,218,235
783,39,4,3,6,7,-58,34,0,9,160,269
783,40,2,5,6,7,24,-48,4,1,184,221
783,41,4,3,9,4,45,31,9,2,229,252
783,42,3,3,7,6,-66,33,3,5,163,285
783,43,2,4,4,9,22,-55,5,0,185,230
783,44,3,4,9,4,-64,40,1,0,121,270
783,45,3,4,5,8,32,44,3,4,153,314
783,46,3,3,8,5,35,32,8,6,188,346
783,47,3,4,5,8,-68,-56,0,0,120,290
783,48,2,4,6,7,24,43,4,3,144,333
783,49,3,3,4,9,31,36,5,9,175,369
783,50,3,4,7,6,34,-58,9,1,209,311
783,51,4,3,7,6,-57,33,2,4,152,344
783,52,3,4,9,4,36,40,8,4,188,384
783,53,3,3,5,8,-68,35,0,9,120,419
783,54,4,3,5,8,41,-65,1,4,161,354
783,55,3,3,6,7,33,34,4,8,194,388
783,56,4,2,10,3,-54,21,0,9,140,409
783,57,2,5,6,7,24,-48,4,1,164,361
783,58,4,4,4,9,40,45,4,6,204,406
783,59,4,3,6,7,42,-66,6,0,246,340
783,60,2,4,5,8,23,44,9,4,269,384
783,61,6,2,10,3,-36,21,3,5,233,405
783,62,3,5,4,9,31,54,4,9,264,459
783,63,4,2,9,4,45,-78,9,1,309,381
783,64,4,2,7,6,-57,24,2,5,252,405
783,65,3,3,6,7,33,34,5,9,285,439
783,66,4,3,8,5,44,-68,9,1,329,371
783,67,3,3,8,5,-65,32,4,3,264,403
783,68,3,3,8,5,35,32,9,5,299,435
783,69,3,4,6,7,-67,43,2,8,232,478
783,70,3,3,8,5,35,-68,7,0,267,410
783,71,3,4,5,8,32,44,9,4,299,454
783,72,5,2,7,6,-48,24,1,8,251,478
783,73,4,2,9,4,45,-78,6,0,296,400
783,74,6,2,10,3,-36,21,0,1,260,421
783,75,3,3,7,6,34,33,4,4,294,454
783,76,3,3,7,6,34,33,8,7,328,487
783,77,4,2,11,2,-53,20,5,7,275,507
784,1,2,5,3,10,21,55,1,5,21,55
784,2,4,3,7,6,43,33,4,8,64,88
784,3,3,4,4,9,31,-55,5,3,95,33
784,4,5,2,10,3,-45,21,0,4,50,54
784,5,3,3,4,9,31,-64,1,0,81,-10
784,6,3,3,5,8,32,35,3,5,113,25
784,7,4,2,6,7,42,-75,5,0,155,-50
784,8,4,2,7,6,43,24,8,4,198,-26
784,9,4,2,9,4,-55,22,3,6,143,-4
784,10,3,3,9,4,36,31,9,7,179,27
784,11,3,3,7,6,-66,-67,3,0,113,-40
784,12,4,4,7,6,43,42,6,2,156,2
784,13,2,6,3,10,21,64,7,6,177,66
784,14,3,4,6,7,-67,43,0,9,110,109
784,15,3,4,6,7,33,-57,3,2,143,52
784,16,2,6,3,10,21,64,4,6,164,116
784,17,3,3,5,8,32,-65,6,1,196,51
784,18,2,5,5,8,23,53,9,4,219,104
784,19,3,3,6,7,-67,34,2,8,152,138
784,20,2,4,6,7,24,-57,6,1,176,81
784,21,3,4,5,8,32,44,8,5,208,125
784,22,2,4,5,8,-77,44,1,9,131,169
784,23,5,2,9,4,54,-78,5,1,185,91
784,24,4,4,8,5,44,41,9,2,229,132
784,25,2,4,7,6,-75,42,4,4,154,174
784,26,3,5,4,9,31,54,5,8,185,228
784,27,4,3,6,7,42,-66,7,2,227,162
784,28,3,4,6,7,-67,43,0,5,160,205
784,29,3,3,6,7,33,34,3,9,193,239
784,30,3,3,7,6,34,-67,7,2,227,172
784,31,4,3,7,6,-57,33,0,5,170,205
784,32,3,3,7,6,34,33,4,8,204,238
784,33,4,3,6,7,42,-66,6,2,246,172
784,34,3,4,4,9,31,45,7,7,277,217
784,35,2,4,7,6,-75,42,2,9,202,259
784,36,4,3,9,4,45,-69,7,0,247,190
784,37,2,4,4,9,22,45,9,5,269,235
784,38,4,2,10,3,-54,21,5,6,215,256
784,39,2,5,5,8,23,53,8,9,238,309
784,40,3,4,4,9,31,-55,9,4,269,254
784,41,3,3,6,7,-67,34,2,8,202,288
784,42,2,5,6,7,24,-48,6,0,226,240
784,43,2,4,4,9,22,45,8,5,248,285
784,44,3,3,8,5,-65,32,3,7,183,317
784,45,4,2,10,3,46,21,9,8,229,338
784,46,2,5,4,9,-78,-46,1,2,151,292
784,47,3,4,6,7,33,43,4,5,184,335
784,48,4,3,9,4,45,31,9,6,229,366
784,49,2,4,3,10,-79,-54,0,2,150,312
784,50,2,6,3,10,21,64,1,6,171,376
784,51,3,3,6,7,33,-66,4,0,204,310
784,52,3,4,6,7,33,43,7,3,237,353
784,53,4,3,7,6,-57,33,0,6,180,386
784,54,3,3,7,6,34,33,4,9,214,419
784,55,2,4,4,9,22,-55,6,4,236,364
784,56,4,3,6,7,42,34,8,8,278,398
784,57,2,4,5,8,-77,-56,1,2,201,342
784,58,3,3,8,5,35,32,6,4,236,374
784,59,3,3,6,7,33,34,9,8,269,408
784,60,2,4,5,8,-77,-56,2,2,192,352
784,61,3,3,4,9,31,36,3,8,223,388
784,62,4,3,10,3,46,30,9,8,269,418
784,63,3,4,6,7,-67,-57,2,1,202,361
784,64,3,3,5,8,32,35,4,6,234,396
784,65,5,2,8,5,53,23,7,9,287,419
784,66,2,5,4,9,22,-46,9,3,309,373
784,67,5,2,7,6,-48,24,1,7,261,397
784,68,3,4,4,9,31,-55,2,2,292,342
784,69,3,3,8,5,35,32,7,4,327,374
784,70,5,2,10,3,-45,21,2,5,282,395
784,71,3,3,6,7,33,34,5,9,315,429
784,72,3,4,5,8,32,-56,7,3,347,373
784,73,3,4,7,6,-66,42,1,5,281,415
784,74,4,2,9,4,45,22,6,7,326,437
784,75,4,2,10,3,-54,21,2,8,272,458
784,76,3,3,8,5,35,-68,7,0,307,390
784,77,2,5,3,10,21,55,8,5,328,445
784,78,6,2,9,4,-37,22,1,7,291,467
784,79,4,3,8,5,44,32,5,9,335,499
784,80,2,4,4,9,22,-55,7,4,357,444
784,81,3,4,6,7,-67,43,0,7,290,487
784,82,2,5,4,9,22,-46,2,1,312,441
784,83,3,3,9,4,36,31,8,2,348,472
784,84,4,2,8,5,-56,23,2,5,292,495
784,85,5,2,8,5,53,23,5,8,345,518
785,1,3,3,6,7,33,34,3,4,33,34
785,2,4,3,5,8,41,35,4,9,74,69
785,3,4,3,7,6,43,-67,7,2,117,2
785,4,4,3,6,7,42,34,9,6,159,36
785,5,5,3,9,4,-46,31,3,7,113,67
785,6,3,3,3,10,30,-63,3,4,143,4
785,7,2,5,6,7,24,52,7,6,167,56
785,8,5,2,7,6,52,-76,9,0,219,-20
785,9,2,4,5,8,-77,44,2,4,142,24
785,10,5,2,10,3,55,21,7,5,197,45
785,11,2,4,6,7,-76,43,1,8,121,88
785,12,4,3,6,7,42,-66,3,2,163,22
785,13,4,2,8,5,44,23,7,5,207,45
785,14,5,2,9,4,-46,22,1,7,161,67
785,15,4,3,9,4,45,31,6,8,206,98
785,16,3,3,6,7,33,-66,9,2,239,32
785,17,3,4,5,8,-68,44,1,6,171,76
785,18,3,4,5,8,32,-56,3,0,203,20
785,19,3,3,7,6,34,33,7,3,237,53
785,20,3,3,6,7,-67,34,0,7,170,87
785,21,2,4,6,7,24,-57,4,0,194,30
785,22,2,4,5,8,23,44,7,4,217,74
785,23,3,3,8,5,-65,32,2,6,152,106
785,24,3,4,8,5,35,41,7,7,187,147
785,25,2,5,4,9,22,-46,9,1,209,101
785,26,3,3,5,8,-68,35,1,6,141,136
785,27,2,4,6,7,24,43,5,9,165,179
785,28,4,2,8,5,44,-77,9,2,209,102
785,29,3,4,5,8,-68,44,1,6,141,146
785,30,2,5,5,8,23,53,4,9,164,199
785,31,3,3,5,8,32,-65,6,4,196,134
785,32,4,2,11,2,-53,20,3,4,143,154
785,33,4,3,8,5,44,32,7,6,187,186
785,34,4,3,10,3,-54,30,3,6,133,216
785,35,2,5,3,10,21,-45,4,1,154,171
785,36,2,5,2,11,20,56,4,7,174,227
785,37,4,3,7,6,43,-67,7,0,217,160
785,38,4,4,6,7,42,43,9,3,259,203
785,39,2,4,6,7,-76,43,3,6,183,246
785,40,4,3,7,6,43,33,6,9,226,279
785,41,3,3,5,8,32,-65,8,4,258,214
785,42,3,3,5,8,-68,35,0,9,190,249
785,43,2,6,3,10,21,-36,1,3,211,213
785,44,4,3,6,7,42,34,3,7,253,247
785,45,4,3,7,6,43,-67,6,0,296,180
785,46,3,3,6,7,33,34,9,4,329,214
785,47,2,4,3,10,-79,-54,0,0,250,160
785,48,2,5,3,10,21,55,1,5,271,215
785,49,4,2,10,3,46,21,7,6,317,236
785,50,2,5,6,7,-76,52,1,8,241,288
785,51,2,5,4,9,22,-46,3,2,263,242
785,52,2,4,3,10,21,46,4,8,284,288
785,53,3,3,9,4,-64,31,0,9,220,319
785,54,3,3,4,9,31,-64,1,5,251,255
785,55,3,3,7,6,34,33,5,8,285,288
785,56,2,4,7,6,-75,-58,0,0,210,230
785,57,2,4,5,8,23,44,3,4,233,274
785,58,3,3,7,6,34,33,7,7,267,307
785,59,5,2,7,6,52,-76,9,1,319,231
785,60,3,3,5,8,-68,35,1,6,251,266
785,61,2,5,4,9,22,-46,3,0,273,220
785,62,3,4,4,9,31,45,4,5,304,265
785,63,2,5,5,8,23,53,7,8,327,318
785,64,3,4,5,8,32,-56,9,2,359,262
785,65,3,4,3,10,30,46,9,8,389,308
785,66,5,2,10,3,-45,21,4,9,344,329
785,67,4,3,8,5,44,-68,8,1,388,261
785,68,3,3,7,6,-66,33,2,4,322,294
785,69,4,3,8,5,44,32,6,6,366,326
785,70,3,4,5,8,32,-56,8,0,398,270
785,71,2,6,4,9,-78,63,0,3,320,333
785,72,3,3,7,6,34,33,4,6,354,366
785,73,2,5,5,8,23,53,7,9,377,419
785,74,3,4,7,6,-66,-58,1,1,311,361
785,75,5,3,8,5,53,32,4,3,364,393
785,76,4,2,9,4,45,22,9,5,409,415
785,77,2,5,5,8,-77,53,2,8,332,468
785,78,3,4,8,5,35,41,7,9,367,509
786,1,2,4,6,7,24,43,4,3,24,43
786,2,4,2,11,2,-53,20,1,3,-29,63
786,3,2,4,3,10,21,46,2,9,-8,109
786,4,5,2,10,3,55,-79,7,0,47,30
786,5,2,5,4,9,22,54,9,4,69,84
786,6,5,2,9,4,-46,22,3,6,23,106
786,7,4,3,9,4,45,31,8,7,68,137
786,8,4,2,9,4,-55,22,3,9,13,159
786,9,4,3,4,9,40,-64,3,5,53,95
786,10,3,4,3,10,30,-54,3,1,83,41
786,11,3,3,7,6,34,33,7,4,117,74
786,12,2,4,7,6,-75,42,2,6,42,116
786,13,3,3,9,4,36,31,8,7,78,147
786,14,4,2,9,4,-55,22,3,9,23,169
786,15,4,3,8,5,44,-68,7,1,67,101
786,16,2,4,6,7,-76,43,1,4,-9,144
786,17,2,4,3,10,21,-54,2,0,12,90
786,18,3,4,6,7,33,43,5,3,45,133
786,19,2,5,2,11,20,56,5,9,65,189
786,20,4,3,7,6,43,-67,8,2,108,122
786,21,3,4,6,7,-67,43,1,5,41,165
786,22,3,4,4,9,31,-55,2,0,72,110
786,23,3,4,4,9,31,45,3,5,103,155
786,24,5,2,10,3,55,21,8,6,158,176
786,25,4,3,9,4,-55,31,3,7,103,207
786,26,3,4,5,8,32,-56,5,1,135,151
786,27,3,3,6,7,33,34,8,5,168,185
786,28,3,3,3,10,30,-63,8,2,198,122
786,29,3,3,5,8,-68,35,0,7,130,157
786,30,4,3,5,8,41,-65,1,2,171,92
786,31,3,4,6,7,33,43,4,5,204,135
786,32,4,2,6,7,42,-75,6,0,246,60
786,33,3,4,4,9,31,45,7,5,277,105
786,34,2,4,6,7,-76,43,1,8,201,148
786,35,4,3,8,5,44,-68,5,0,245,80
786,36,4,4,6,7,42,43,7,3,287,123
786,37,3,3,5,8,32,35,9,8,319,158
786,38,3,5,3,10,30,-45,9,3,349,113
786,39,4,3,9,4,-55,31,4,4,294,144
786,40,3,3,7,6,34,33,8,7,328,177
786,41,4,2,7,6,-57,-76,1,1,271,101
786,42,5,2,6,7,51,25,2,6,322,126
786,43,5,2,8,5,53,23,5,9,375,149
786,44,4,2,8,5,44,-77,9,2,419,72
786,45,4,2,8,5,-56,23,3,5,363,95
786,46,5,2,9,4,54,22,7,7,417,117
786,47,3,3,8,5,-65,32,2,9,352,149
786,48,4,2,6,7,42,-75,4,4,394,74
786,49,5,2,8,5,53,23,7,7,447,97
786,50,4,2,9,4,-55,22,2,9,392,119
786,51,4,4,5,8,41,-56,3,3,433,63
786,52,5,2,11,2,56,20,9,3,489,83
786,53,4,2,10,3,-54,21,5,4,435,104
786,54,3,3,5,8,32,35,7,9,467,139
786,55,2,5,3,10,21,-45,8,4,488,94
786,56,3,3,8,5,-65,32,3,6,423,126
786,57,3,4,5,8,32,-56,5,0,455,70
786,58,2,5,5,8,23,53,8,3,478,123
786,59,3,3,7,6,-66,33,2,6,412,156
786,60,3,4,5,8,32,-56,4,0,444,100
786,61,2,5,3,10,21,55,5,5,465,155
786,62,4,3,9,4,-55,31,0,6,410,186
786,63,2,5,7,6,25,51,5,7,435,237
786,64,3,3,6,7,33,-66,8,1,468,171
786,65,3,4,6,7,-67,43,1,4,401,214
786,66,5,2,9,4,54,22,5,6,455,236
786,67,3,4,6,7,33,43,8,9,488,279
786,68,2,6,4,9,-78,-37,0,2,410,242
786,69,3,3,7,6,34,33,4,5,444,275
786,70,3,3,7,6,34,33,8,8,478,308
786,71,3,3,4,9,31,-64,9,4,509,244
787,1,3,4,6,7,33,43,3,3,33,43
787,2,4,2,7,6,43,24,6,7,76,67
787,3,3,4,7,6,-66,42,0,9,10,109
787,4,2,4,7,6,25,-58,5,1,35,51
787,5,3,4,7,6,34,42,9,3,69,93
787,6,4,3,8,5,-56,32,3,5,13,125
787,7,4,3,10,3,46,30,9,5,59,155
787,8,5,2,8,5,-47,23,2,8,12,178
787,9,4,2,10,3,46,21,8,9,58,199
787,10,4,2,8,5,-56,-77,2,2,2,122
787,11,3,3,6,7,33,34,5,6,35,156
787,12,3,4,7,6,34,42,9,8,69,198
787,13,4,2,9,4,-55,-78,4,0,14,120
787,14,3,4,7,6,34,42,8,2,48,162
787,15,2,5,7,6,-75,51,3,3,-27,213
787,16,4,3,6,7,42,34,5,7,15,247
787,17,3,3,7,6,34,-67,9,0,49,180
787,18,3,4,6,7,-67,43,2,3,-18,223
787,19,4,2,7,6,43,24,5,7,25,247
787,20,2,4,3,10,21,-54,6,3,46,193
787,21,5,2,10,3,-45,21,1,4,1,214
787,22,3,4,5,8,32,44,3,8,33,258
787,23,4,2,11,2,-53,20,0,8,-20,278
787,24,3,3,4,9,31,-64,1,4,11,214
787,25,2,4,9,4,27,40,8,4,38,254
787,26,2,5,3,10,21,55,9,9,59,309
787,27,4,3,4,9,40,-64,9,5,99,245
787,28,3,4,6,7,-67,43,2,8,32,288
787,29,6,2,11,2,65,20,7,8,97,308
787,30,5,2,8,5,-47,-77,0,1,50,231
787,31,3,4,5,8,32,44,2,5,82,275
787,32,2,4,3,10,21,-54,3,1,103,221
787,33,2,4,8,5,26,41,9,2,129,262
787,34,4,2,8,5,-56,23,3,5,73,285
787,35,3,3,6,7,33,34,6,9,106,319
787,36,3,3,4,9,31,-64,7,5,137,255
787,37,3,3,5,8,32,-65,9,0,169,190
787,38,3,3,6,7,-67,34,2,4,102,224
787,39,2,4,6,7,24,43,6,7,126,267
787,40,2,4,5,8,23,-56,9,1,149,211
787,41,4,2,10,3,-54,21,5,2,95,232
787,42,3,3,9,4,-64,31,1,3,31,263
787,43,2,6,2,11,20,65,1,8,51,328
787,44,5,2,9,4,54,-78,5,0,105,250
787,45,4,3,8,5,44,32,9,2,149,282
787,46,2,4,7,6,-75,42,4,4,74,324
787,47,4,2,6,7,42,25,6,9,116,349
787,48,2,5,4,9,22,-46,8,3,138,303
787,49,3,4,4,9,31,45,9,8,169,348
787,50,3,3,4,9,-69,-64,0,4,100,284
787,51,3,3,5,8,32,35,2,9,132,319
787,52,3,4,6,7,33,-57,5,2,165,262
787,53,4,3,5,8,41,35,6,7,206,297
787,54,3,4,5,8,32,-56,8,1,238,241
787,55,3,3,8,5,-65,32,3,3,173,273
787,56,2,4,6,7,24,43,7,6,197,316
787,57,4,3,5,8,41,-65,8,1,238,251
787,58,6,2,10,3,-36,21,2,2,202,272
787,59,2,6,4,9,22,63,4,5,224,335
787,60,3,3,5,8,32,-65,6,0,256,270
787,61,3,3,8,5,-65,32,1,2,191,302
787,62,4,4,8,5,44,41,5,3,235,343
787,63,4,3,9,4,-55,31,0,4,180,374
787,64,3,3,6,7,33,34,3,8,213,408
787,65,4,3,8,5,44,-68,7,0,257,340
787,66,3,4,5,8,32,44,9,4,289,384
787,67,2,4,3,10,-79,-54,0,0,210,330
787,68,2,4,4,9,22,45,2,5,232,375
787,69,3,4,8,5,35,41,7,6,267,416
787,70,4,2,5,8,41,-74,8,2,308,342
787,71,4,3,4,9,40,36,8,8,348,378
787,72,4,2,8,5,-56,-77,2,1,292,301
787,73,2,4,6,7,24,43,6,4,316,344
787,74,3,3,8,5,-65,32,1,6,251,376
787,75,3,3,5,8,32,-65,3,1,283,311
787,76,2,4,4,9,22,45,5,6,305,356
787,77,4,3,4,9,40,-64,5,2,345,292
787,78,3,4,4,9,31,45,6,7,376,337
787,79,5,2,8,5,53,-77,9,0,429,260
787,80,3,3,6,7,-67,34,2,4,362,294
787,81,2,5,4,9,22,54,4,8,384,348
787,82,2,6,3,10,21,-36,5,2,405,312
787,83,5,2,9,4,54,22,9,4,459,334
787,84,3,3,7,6,-66,33,3,7,393,367
787,85,3,3,8,5,35,32,8,9,428,399
787,86,3,3,6,7,-67,-66,1,3,361,333
787,87,5,3,10,3,55,30,6,3,416,363
787,88,2,4,2,11,20,-53,6,0,436,310
787,89,4,3,7,6,43,33,9,3,479,343
787,90,4,2,7,6,-57,24,2,7,422,367
787,91,2,5,4,9,22,-46,4,1,444,321
787,92,3,3,7,6,34,33,8,4,478,354
787,93,2,4,5,8,-77,44,1,8,401,398
787,94,4,2,8,5,44,-77,5,1,445,321
787,95,4,4,7,6,43,42,8,3,488,363
787,96,3,3,7,6,-66,33,2,6,422,396
787,97,2,5,3,10,21,-45,3,1,443,351
787,98,5,2,10,3,55,21,8,2,498,372
787,99,3,4,5,8,-68,44,0,6,430,416
787,100,3,3,10,3,37,30,7,6,467,446
787,101,2,4,6,7,-76,43,1,9,391,489
787,102,2,4,6,7,24,-57,5,2,415,432
787,103,3,3,7,6,34,33,9,5,449,465
787,104,3,3,5,8,-68,-65,1,0,381,400
787,105,2,4,5,8,23,44,4,4,404,444
787,106,4,3,9,4,45,31,9,5,449,475
787,107,2,4,3,10,-79,-54,0,1,370,421
787,108,3,3,6,7,33,34,3,5,403,455
787,109,4,3,7,6,43,33,6,8,446,488
787,110,3,3,8,5,-65,-68,1,0,381,420
787,111,5,2,10,3,55,21,6,1,436,441
787,112,4,4,6,7,42,43,8,4,478,484
787,113,4,2,9,4,-55,22,3,6,423,506
788,1,2,5,2,11,20,56,0,6,20,56
788,2,2,4,7,6,25,42,5,8,45,98
788,3,5,2,8,5,53,-77,8,1,98,21
788,4,4,3,7,6,-57,33,1,4,41,54
788,5,2,4,7,6,25,42,6,6,66,96
788,6,2,4,6,7,-76,43,0,9,-10,139
788,7,3,3,5,8,32,-65,2,4,22,74
788,8,5,2,10,3,55,21,7,5,77,95
788,9,4,3,6,7,42,34,9,9,119,129
788,10,2,6,2,11,20,-35,9,4,139,94
788,11,5,2,9,4,-46,22,3,6,93,116
788,12,4,3,6,7,42,-66,5,0,135,50
788,13,4,2,8,5,44,23,9,3,179,73
788,14,2,5,4,9,-78,54,1,7,101,127
788,15,3,4,8,5,35,41,6,8,136,168
788,16,2,4,4,9,22,-55,8,3,158,113
788,17,4,2,7,6,-57,24,1,7,101,137
788,18,2,5,6,7,24,52,5,9,125,189
788,19,3,4,6,7,33,-57,8,2,158,132
788,20,3,4,5,8,-68,44,0,6,90,176
788,21,3,4,5,8,32,-56,2,0,122,120
788,22,4,3,8,5,44,32,6,2,166,152
788,23,5,2,11,2,-44,20,2,2,122,172
788,24,3,3,8,5,35,32,7,4,157,204
788,25,4,3,5,8,41,35,8,9,198,239
788,26,2,6,4,9,-78,-37,0,2,120,202
788,27,3,3,8,5,35,32,5,4,155,234
788,28,3,4,5,8,32,44,7,8,187,278
788,29,3,3,8,5,-65,-68,2,0,122,210
788,30,3,4,8,5,35,41,7,1,157,251
788,31,2,5,3,10,21,55,8,6,178,306
788,32,4,3,4,9,40,-64,8,2,218,242
788,33,2,4,5,8,-77,44,1,6,141,286
788,34,4,4,7,6,43,42,4,8,184,328
788,35,3,4,6,7,33,-57,7,1,217,271
788,36,2,5,4,9,22,54,9,5,239,325
788,37,3,3,6,7,-67,34,2,9,172,359
788,38,3,3,6,7,33,-66,5,3,205,293
788,39,3,4,4,9,31,45,6,8,236,338
788,40,2,4,5,8,23,-56,9,2,259,282
788,41,2,4,3,10,-79,46,0,8,180,328
788,42,3,4,5,8,32,-56,2,2,212,272
788,43,4,3,7,6,43,33,5,5,255,305
788,44,4,3,9,4,-55,31,0,6,200,336
788,45,3,4,7,6,34,42,4,8,234,378
788,46,3,4,9,4,-64,40,0,8,170,418
788,47,3,4,5,8,32,-56,2,2,202,362
788,48,4,3,8,5,44,32,6,4,246,394
788,49,3,4,5,8,32,44,8,8,278,438
788,50,3,3,8,5,-65,-68,3,0,213,370
788,51,2,5,5,8,23,53,6,3,236,423
788,52,5,2,9,4,-46,22,0,5,190,445
788,53,6,2,11,2,65,20,5,5,255,465
788,54,3,4,7,6,34,42,9,7,289,507
789,1,5,2,7,6,52,24,2,4,52,24
789,2,2,4,6,7,24,43,6,7,76,67
789,3,3,4,5,8,32,-56,8,1,108,11
789,4,3,5,6,7,-67,52,1,3,41,63
789,5,5,2,7,6,52,24,3,7,93,87
789,6,2,4,4,9,22,-55,5,2,115,32
789,7,4,3,10,3,-54,30,1,2,61,62
789,8,3,4,4,9,31,45,2,7,92,107
789,9,4,3,8,5,44,32,6,9,136,139
789,10,2,4,6,7,-76,-57,0,2,60,82
789,11,2,5,4,9,22,54,2,6,82,136
789,12,3,3,7,6,34,33,6,9,116,169
789,13,3,4,5,8,32,-56,8,3,148,113
789,14,3,3,7,6,-66,33,2,6,82,146
789,15,3,3,6,7,33,-66,5,0,115,80
789,16,3,3,7,6,34,33,9,3,149,113
789,17,4,4,8,5,-56,41,3,4,93,154
789,18,2,5,5,8,23,53,6,7,116,207
789,19,3,3,4,9,31,-64,7,3,147,143
789,20,3,5,5,8,32,53,9,6,179,196
789,21,5,2,5,8,50,-74,9,2,229,122
789,22,2,5,6,7,-76,52,3,4,153,174
789,23,3,3,4,9,31,-64,4,0,184,110
789,24,3,4,5,8,32,44,6,4,216,154
789,25,3,4,7,6,-66,42,0,6,150,196
789,26,4,3,7,6,43,33,3,9,193,229
789,27,4,3,9,4,45,-69,8,0,238,160
789,28,3,3,7,6,-66,33,2,3,172,193
789,29,3,3,9,4,36,31,8,4,208,224
789,30,4,2,6,7,-58,25,0,9,150,249
789,31,4,3,9,4,45,-69,5,0,195,180
789,32,5,3,9,4,54,31,9,1,249,211
789,33,5,3,9,4,-46,31,3,2,203,242
789,34,3,4,6,7,33,43,6,5,236,285
789,35,4,2,7,6,43,24,9,9,279,309
789,36,3,3,5,8,-68,-65,1,4,211,244
789,37,3,4,8,5,35,41,6,5,246,285
789,38,4,3,7,6,43,33,9,8,289,318
789,39,5,2,11,2,-44,20,5,8,245,338
789,40,4,2,8,5,44,-77,9,1,289,261
789,41,4,4,9,4,-55,40,4,1,234,301
789,42,3,3,6,7,33,34,7,5,267,335
789,43,6,2,11,2,-35,20,2,5,232,355
789,44,3,4,8,5,35,41,7,6,267,396
789,45,5,3,8,5,-47,32,0,8,220,428
789,46,4,3,9,4,45,31,5,9,265,459
789,47,2,5,7,6,-75,-49,0,0,190,410
789,48,4,2,9,4,45,22,5,2,235,432
789,49,4,3,9,4,-55,31,0,3,180,463
789,50,4,2,11,2,47,20,7,3,227,483
789,51,4,3,8,5,-56,32,1,5,171,515
790,1,2,4,5,8,23,44,3,4,23,44
790,2,3,3,9,4,36,31,9,5,59,75
790,3,3,3,7,6,-66,33,3,8,-7,108
790,4,3,3,3,10,30,-63,3,5,23,45
790,5,5,2,10,3,55,21,8,6,78,66
790,6,4,2,6,7,-58,-75,0,1,20,-9
790,7,3,4,7,6,34,42,4,3,54,33
790,8,4,3,6,7,42,34,6,7,96,67
790,9,4,3,8,5,-56,32,0,9,40,99
790,10,4,2,10,3,46,-79,6,0,86,20
790,11,4,3,9,4,-55,31,1,1,31,51
790,12,3,4,4,9,31,45,2,6,62,96
790,13,5,2,10,3,55,21,7,7,117,117
790,14,3,3,6,7,-67,-66,0,1,50,51
790,15,4,4,5,8,41,44,1,5,91,95
790,16,2,5,5,8,23,53,4,8,114,148
790,17,3,3,6,7,33,-66,7,2,147,82
790,18,2,5,3,10,21,55,8,7,168,137
790,19,2,6,2,11,20,-35,8,2,188,102
790,20,2,5,5,8,-77,53,1,5,111,155
790,21,5,2,10,3,55,21,6,6,166,176
790,22,2,5,3,10,21,-45,7,1,187,131
790,23,5,2,8,5,-47,23,0,4,140,154
790,24,3,4,4,9,31,45,1,9,171,199
790,25,2,4,4,9,22,-55,3,4,193,144
790,26,3,4,6,7,33,43,6,7,226,187
790,27,5,2,7,6,52,-76,8,1,278,111
790,28,5,2,7,6,-48,24,0,5,230,135
790,29,3,3,6,7,33,34,3,9,263,169
790,30,4,3,8,5,44,-68,7,1,307,101
790,31,2,5,4,9,22,54,9,5,329,155
790,32,4,3,7,6,-57,33,2,8,272,188
790,33,3,4,4,9,31,-55,3,3,303,133
790,34,3,4,7,6,34,42,7,5,337,175
790,35,3,4,8,5,-65,41,2,6,272,216
790,36,3,4,4,9,31,-55,3,1,303,161
790,37,4,2,6,7,42,25,5,6,345,186
790,38,2,4,7,6,-75,42,0,8,270,228
790,39,4,2,8,5,44,-77,4,1,314,151
790,40,3,3,8,5,35,32,9,3,349,183
790,41,3,5,5,8,-68,53,1,6,281,236
790,42,3,3,7,6,34,33,5,9,315,269
790,43,3,4,5,8,32,-56,7,3,347,213
790,44,4,2,9,4,-55,22,2,5,292,235
790,45,4,2,4,9,40,-73,2,2,332,162
790,46,3,5,4,9,31,54,3,6,363,216
790,47,3,3,5,8,32,-65,5,1,395,151
790,48,3,5,3,10,30,55,5,6,425,206
790,49,5,2,8,5,53,23,8,9,478,229
790,50,2,5,3,10,21,-45,9,4,499,184
790,51,3,5,5,8,-68,53,1,7,431,237
790,52,2,5,3,10,21,-45,2,2,452,192
790,53,2,4,4,9,22,45,4,7,474,237
790,54,2,4,4,9,22,-55,6,2,496,182
790,55,5,2,9,4,-46,22,0,4,450,204
790,56,3,4,5,8,32,44,2,8,482,248
790,57,3,3,5,8,32,-65,4,3,514,183
791,1,2,5,3,10,21,55,1,5,21,55
791,2,4,3,7,6,43,33,4,8,64,88
791,3,4,3,9,4,45,31,9,9,109,119
791,4,2,5,2,11,20,-44,9,5,129,75
791,5,5,3,10,3,-45,30,4,5,84,105
791,6,2,5,2,11,20,-44,4,1,104,61
791,7,4,3,8,5,44,32,8,3,148,93
791,8,3,3,8,5,-65,32,3,5,83,125
791,9,3,4,7,6,34,42,7,7,117,167
791,10,4,2,8,5,-56,-77,1,0,61,90
791,11,3,3,8,5,35,32,6,2,96,122
791,12,2,5,5,8,23,53,9,5,119,175
791,13,3,3,5,8,-68,-65,1,0,51,110
791,14,4,3,7,6,43,33,4,3,94,143
791,15,5,2,11,2,-44,20,0,3,50,163
791,16,3,4,4,9,31,45,1,8,81,208
791,17,3,3,8,5,35,-68,6,0,116,140
791,18,3,4,7,6,-66,42,0,2,50,182
791,19,5,2,8,5,53,23,3,5,103,205
791,20,4,3,6,7,42,34,5,9,145,239
791,21,2,5,2,11,20,-44,5,5,165,195
791,22,5,2,11,2,-44,20,1,5,121,215
791,23,3,4,5,8,32,44,3,9,153,259
791,24,2,5,5,8,23,-47,6,2,176,212
791,25,4,2,9,4,-55,22,1,4,121,234
791,26,3,3,8,5,35,32,6,6,156,266
791,27,3,4,7,6,-66,42,0,8,90,308
791,28,5,2,9,4,54,-78,4,0,144,230
791,29,3,3,10,3,-63,30,1,0,81,260
791,30,4,3,7,6,43,33,4,3,124,293
791,31,4,3,6,7,42,34,6,7,166,327
791,32,3,3,7,6,-66,-67,0,0,100,260
791,33,5,2,7,6,52,24,2,4,152,284
791,34,5,2,8,5,53,23,5,7,205,307
791,35,4,2,8,5,44,-77,9,0,249,230
791,36,4,3,9,4,-55,31,4,1,194,261
791,37,4,3,8,5,44,32,8,3,238,293
791,38,5,2,7,6,-48,24,0,7,190,317
791,39,5,2,10,3,55,21,5,8,245,338
791,40,3,3,9,4,-64,31,1,9,181,369
791,41,2,5,3,10,21,-45,2,4,202,324
791,42,4,2,7,6,43,24,5,8,245,348
791,43,2,4,5,8,23,-56,8,2,268,292
791,44,4,3,6,7,-58,34,0,6,210,326
791,45,2,4,5,8,23,-56,3,0,233,270
791,46,5,2,9,4,54,22,7,2,287,292
791,47,4,3,7,6,-57,33,0,5,230,325
791,48,3,4,7,6,34,42,4,7,264,367
791,49,2,4,5,8,23,-56,7,1,287,311
791,50,5,2,8,5,-47,23,0,4,240,334
791,51,4,2,9,4,45,22,5,6,285,356
791,52,4,2,7,6,43,-76,8,0,328,280
791,53,3,3,4,9,31,36,9,6,359,316
791,54,4,2,7,6,-57,-76,2,0,302,240
791,55,2,4,5,8,23,44,5,4,325,284
791,56,2,5,4,9,22,54,7,8,347,338
791,57,4,3,6,7,42,-66,9,2,389,272
791,58,3,3,4,9,-69,36,0,8,320,308
791,59,2,5,5,8,23,-47,3,1,343,261
791,60,5,2,10,3,55,21,8,2,398,282
791,61,2,5,2,11,20,56,8,8,418,338
791,62,2,4,6,7,-76,-57,2,1,342,281
791,63,4,2,6,7,42,25,4,6,384,306
791,64,4,2,5,8,41,-74,5,2,425,232
791,65,3,4,8,5,-65,41,0,3,360,273
791,66,4,2,6,7,42,25,2,8,402,298
791,67,3,3,5,8,32,-65,4,3,434,233
791,68,4,3,8,5,44,32,8,5,478,265
791,69,3,4,5,8,-68,44,0,9,410,309
791,70,3,4,7,6,34,-58,4,1,444,251
791,71,4,2,8,5,44,23,8,4,488,274
791,72,4,3,7,6,-57,33,1,7,431,307
791,73,4,3,7,6,43,-67,4,0,474,240
791,74,3,3,9,4,-64,31,0,1,410,271
791,75,5,2,11,2,56,20,6,1,466,291
791,76,2,5,4,9,22,54,8,5,488,345
791,77,4,3,9,4,-55,31,3,6,433,376
791,78,5,2,9,4,54,22,7,8,487,398
791,79,4,2,8,5,-56,-77,1,1,431,321
791,80,4,2,10,3,46,21,7,2,477,342
791,81,3,3,8,5,-65,32,2,4,412,374
791,82,3,3,5,8,32,35,4,9,444,409
791,83,4,3,8,5,44,-68,8,1,488,341
791,84,6,2,11,2,-35,20,3,1,453,361
791,85,6,2,10,3,64,21,7,2,517,382
792,1,2,5,4,9,22,54,2,4,22,54
792,2,3,4,5,8,32,44,4,8,54,98
792,3,3,4,5,8,32,-56,6,2,86,42
792,4,4,2,6,7,42,25,8,7,128,67
792,5,2,5,7,6,-75,51,3,8,53,118
792,6,2,5,2,11,20,-44,3,4,73,74
792,7,4,2,9,4,45,22,8,6,118,96
792,8,2,4,6,7,-76,43,2,9,42,139
792,9,3,4,6,7,33,-57,5,2,75,82
792,10,4,2,6,7,42,25,7,7,117,107
792,11,3,4,8,5,-65,41,2,8,52,148
792,12,3,3,5,8,32,-65,4,3,84,83
792,13,4,3,8,5,44,32,8,5,128,115
792,14,3,4,6,7,-67,43,1,8,61,158
792,15,2,5,5,8,23,-47,4,1,84,111
792,16,3,3,7,6,34,33,8,4,118,144
792,17,4,3,9,4,-55,31,3,5,63,175
792,18,2,4,7,6,25,42,8,7,88,217
792,19,4,2,8,5,-56,-77,2,0,32,140
792,20,5,3,10,3,55,30,7,0,87,170
792,21,5,2,9,4,-46,22,1,2,41,192
792,22,3,3,6,7,33,34,4,6,74,226
792,23,4,2,6,7,42,-75,6,1,116,151
792,24,4,3,8,5,-56,32,0,3,60,183
792,25,5,3,6,7,51,34,1,7,111,217
792,26,4,3,10,3,46,30,7,7,157,247
792,27,3,3,7,6,-66,-67,1,0,91,180
792,28,5,2,8,5,53,23,4,3,144,203
792,29,3,4,5,8,32,44,6,7,176,247
792,30,3,4,4,9,31,-55,7,2,207,192
792,31,5,3,9,4,-46,31,1,3,161,223
792,32,3,3,8,5,35,32,6,5,196,255
792,33,3,3,8,5,-65,32,1,7,131,287
792,34,3,5,7,6,34,51,5,8,165,338
792,35,2,5,6,7,24,-48,9,0,189,290
792,36,4,4,8,5,-56,41,3,1,133,331
792,37,3,3,7,6,34,33,7,4,167,364
792,38,2,5,4,9,22,54,9,8,189,418
792,39,3,3,7,6,-66,-67,3,1,123,351
792,40,4,2,11,2,-53,20,0,1,70,371
792,41,2,5,3,10,21,55,1,6,91,426
792,42,4,2,7,6,43,-76,4,0,134,350
792,43,2,5,3,10,21,55,5,5,155,405
792,44,3,3,8,5,-65,32,0,7,90,437
792,45,3,4,6,7,33,-57,3,0,123,380
792,46,4,4,7,6,43,42,6,2,166,422
792,47,5,2,9,4,-46,22,0,4,120,444
792,48,4,2,8,5,44,23,4,7,164,467
792,49,4,3,5,8,41,-65,5,2,205,402
792,50,6,2,10,3,64,21,9,3,269,423
792,51,3,4,5,8,-68,44,1,7,201,467
792,52,2,5,3,10,21,-45,2,2,222,422
792,53,3,4,6,7,33,43,5,5,255,465
792,54,3,3,5,8,32,-65,7,0,287,400
792,55,4,3,5,8,41,35,8,5,328,435
792,56,3,4,6,7,-67,43,1,8,261,478
792,57,5,2,9,4,54,-78,5,0,315,400
792,58,2,5,2,11,20,56,5,6,335,456
792,59,4,2,10,3,-54,21,1,7,281,477
792,60,3,3,5,8,32,-65,3,2,313,412
792,61,5,2,10,3,55,21,8,3,368,433
792,62,5,2,8,5,-47,23,1,6,321,456
792,63,4,3,8,5,44,32,5,8,365,488
792,64,3,3,9,4,-64,31,1,9,301,519
793,1,3,4,5,8,32,44,2,4,32,44
793,2,5,2,7,6,52,24,4,8,84,68
793,3,4,3,7,6,43,-67,7,1,127,1
793,4,5,2,8,5,-47,23,0,4,80,24
793,5,5,2,9,4,54,22,4,6,134,46
793,6,3,3,4,9,31,-64,5,2,165,-18
793,7,4,3,9,4,-55,31,0,3,110,13
793,8,4,3,6,7,42,34,2,7,152,47
793,9,4,2,6,7,42,-75,4,2,194,-28
793,10,5,2,10,3,55,21,9,3,249,-7
793,11,4,2,9,4,-55,22,4,5,194,15
793,12,4,2,6,7,42,-75,6,0,236,-60
793,13,2,5,5,8,23,53,9,3,259,-7
793,14,3,3,7,6,-66,33,3,6,193,26
793,15,4,3,6,7,42,-66,5,0,235,-40
793,16,4,4,7,6,43,42,8,2,278,2
793,17,2,4,5,8,-77,44,1,6,201,46
793,18,4,3,7,6,43,33,4,9,244,79
793,19,3,4,7,6,34,-58,8,1,278,21
793,20,2,5,4,9,-78,54,0,5,200,75
793,21,3,4,4,9,31,-55,1,0,231,20
793,22,4,3,9,4,45,31,6,1,276,51
793,23,5,2,9,4,-46,22,0,3,230,73
793,24,3,3,8,5,35,32,5,5,265,105
793,25,2,5,3,10,21,-45,6,0,286,60
793,26,3,4,5,8,32,44,8,4,318,104
793,27,2,4,3,10,21,-54,9,0,339,50
793,28,4,3,5,8,-59,35,0,5,280,85
793,29,4,2,9,4,45,22,5,7,325,107
793,30,3,3,7,6,34,-67,9,0,359,40
793,31,4,2,9,4,-55,22,4,2,304,62
793,32,2,5,4,9,22,54,6,6,326,116
793,33,4,3,7,6,43,33,9,9,369,149
793,34,4,3,8,5,-56,-68,3,1,313,81
793,35,3,4,6,7,33,43,6,4,346,124
793,36,2,4,7,6,-75,42,1,6,271,166
793,37,3,4,6,7,33,43,4,9,304,209
793,38,6,2,11,2,65,20,9,9,369,229
793,39,2,4,5,8,-77,-56,2,3,292,173
793,40,5,2,9,4,54,22,6,5,346,195
793,41,2,4,4,9,22,-55,8,0,368,140
793,42,4,3,7,6,-57,33,1,3,311,173
793,43,2,4,5,8,23,44,4,7,334,217
793,44,2,4,5,8,23,-56,7,1,357,161
793,45,2,5,3,10,21,55,8,6,378,216
793,46,5,2,8,5,-47,23,1,9,331,239
793,47,4,2,9,4,45,-78,6,1,376,161
793,48,4,3,6,7,42,34,8,5,418,195
793,49,4,3,6,7,-58,34,0,9,360,229
793,50,5,2,10,3,55,-79,5,0,415,150
793,51,3,3,7,6,34,33,9,3,449,183
793,52,3,3,6,7,-67,34,2,7,382,217
793,53,3,4,7,6,34,42,6,9,416,259
793,54,4,2,5,8,41,-74,7,5,457,185
793,55,3,4,4,9,31,-55,8,0,488,130
793,56,2,4,3,10,21,46,9,6,509,176
794,1,3,4,7,6,34,42,4,2,34,42
794,2,3,3,7,6,34,33,8,5,68,75
794,3,5,3,8,5,-47,32,1,7,21,107
794,4,2,4,6,7,24,-57,5,0,45,50
794,5,3,3,7,6,34,33,9,3,79,83
794,6,3,4,8,5,-65,41,4,4,14,124
794,7,4,3,10,3,-54,30,0,4,-40,154
794,8,3,3,4,9,31,-64,1,0,-9,90
794,9,3,3,7,6,34,33,5,3,25,123
794,10,2,4,5,8,23,44,8,7,48,167
794,11,4,2,8,5,-56,-77,2,0,-8,90
794,12,3,4,7,6,34,42,6,2,26,132
794,13,4,2,9,4,-55,22,1,4,-29,154
794,14,4,2,9,4,45,22,6,6,16,176
794,15,5,2,9,4,-46,22,0,8,-30,198
794,16,2,5,4,9,22,-46,2,2,-8,152
794,17,4,3,7,6,43,33,5,5,35,185
794,18,4,3,5,8,41,-65,6,0,76,120
794,19,4,2,8,5,-56,23,0,3,20,143
794,20,2,5,4,9,22,54,2,7,42,197
794,21,3,3,8,5,35,32,7,9,77,229
794,22,2,5,7,6,-75,-49,2,0,2,180
794,23,2,5,3,10,21,55,3,5,23,235
794,24,2,5,3,10,21,-45,4,0,44,190
794,25,3,3,4,9,31,36,5,6,75,226
794,26,3,4,4,9,31,-55,6,1,106,171
794,27,2,4,4,9,22,45,8,6,128,216
794,28,3,3,6,7,-67,-66,1,0,61,150
794,29,4,2,7,6,43,24,4,4,104,174
794,30,4,2,8,5,44,23,8,7,148,197
794,31,3,3,8,5,-65,32,3,9,83,229
794,32,4,2,8,5,44,-77,7,2,127,152
794,33,2,4,8,5,-74,41,3,3,53,193
794,34,2,4,6,7,24,43,7,6,77,236
794,35,6,2,10,3,-36,21,1,7,41,257
794,36,2,4,4,9,22,-55,3,2,63,202
794,37,2,5,4,9,22,54,5,6,85,256
794,38,2,4,7,6,-75,42,0,8,10,298
794,39,3,4,4,9,31,-55,1,3,41,243
794,40,2,4,4,9,22,45,3,8,63,288
794,41,2,5,2,11,20,-44,3,4,83,244
794,42,4,4,7,6,43,42,6,6,126,286
794,43,2,4,4,9,22,-55,8,1,148,231
794,44,3,3,4,9,31,36,9,7,179,267
794,45,3,3,8,5,-65,32,4,9,114,299
794,46,3,3,5,8,32,-65,6,4,146,234
794,47,4,3,6,7,42,34,8,8,188,268
794,48,2,4,5,8,-77,-56,1,2,111,212
794,49,6,2,11,2,65,20,6,2,176,232
794,50,3,3,8,5,-65,32,1,4,111,264
794,51,3,3,8,5,35,32,6,6,146,296
794,52,3,4,5,8,32,-56,8,0,178,240
794,53,4,3,6,7,-58,34,0,4,120,274
794,54,3,3,6,7,33,34,3,8,153,308
794,55,2,4,6,7,24,-57,7,1,177,251
794,56,2,6,4,9,22,63,9,4,199,314
794,57,4,3,8,5,-56,32,3,6,143,346
794,58,3,3,5,8,32,-65,5,1,175,281
794,59,3,3,6,7,33,34,8,5,208,315
794,60,4,2,8,5,-56,23,2,8,152,338
794,61,4,3,7,6,43,-67,5,1,195,271
794,62,4,3,9,4,-55,31,0,2,140,302
794,63,3,3,8,5,35,32,5,4,175,334
794,64,2,5,6,7,24,52,9,6,199,386
794,65,3,3,7,6,-66,33,3,9,133,419
794,66,3,3,6,7,33,-66,6,3,166,353
794,67,2,4,3,10,21,46,7,9,187,399
794,68,3,3,5,8,32,-65,9,4,219,334
794,69,2,4,4,9,-78,45,1,9,141,379
794,70,3,4,6,7,33,-57,4,2,174,322
794,71,5,2,11,2,-44,20,0,2,130,342
794,72,4,2,9,4,45,22,5,4,175,364
794,73,3,3,6,7,33,34,8,8,208,398
794,74,3,3,7,6,-66,-67,2,1,142,331
794,75,2,4,4,9,22,45,4,6,164,376
794,76,4,3,7,6,43,33,7,9,207,409
794,77,5,2,9,4,-46,-78,1,1,161,331
794,78,4,2,8,5,44,23,5,4,205,354
794,79,5,2,7,6,52,24,7,8,257,378
794,80,4,2,7,6,-57,-76,0,2,200,302
794,81,4,2,7,6,43,24,3,6,243,326
794,82,4,2,6,7,42,-75,5,1,285,251
794,83,3,4,6,7,33,43,8,4,318,294
794,84,3,3,5,8,-68,35,0,9,250,329
794,85,4,3,6,7,42,-66,2,3,292,263
794,86,2,4,7,6,25,42,7,5,317,305
794,87,2,5,6,7,-76,52,1,7,241,357
794,88,5,3,9,4,54,31,5,8,295,388
794,89,4,3,9,4,-55,31,0,9,240,419
794,90,3,3,6,7,33,-66,3,3,273,353
794,91,2,4,5,8,23,44,6,7,296,397
794,92,4,2,7,6,43,-76,9,1,339,321
794,93,4,3,9,4,-55,31,4,2,284,352
794,94,4,3,9,4,45,31,9,3,329,383
794,95,2,5,2,11,20,56,9,9,349,439
794,96,3,3,10,3,-63,30,6,9,286,469
794,97,3,5,3,10,30,-45,6,4,316,424
794,98,2,4,3,10,21,-54,7,0,337,370
794,99,2,5,4,9,22,54,9,4,359,424
794,100,4,3,7,6,-57,33,2,7,302,457
794,101,5,2,9,4,54,22,6,9,356,479
794,102,4,2,9,4,-55,-78,1,1,301,401
794,103,4,4,5,8,41,44,2,5,342,445
794,104,4,3,6,7,42,34,4,9,384,479
794,105,3,4,6,7,33,-57,7,2,417,422
794,106,2,4,6,7,-76,43,1,5,341,465
794,107,2,4,4,9,22,-55,3,0,363,410
794,108,3,3,7,6,34,33,7,3,397,443
794,109,2,5,5,8,-77,53,0,6,320,496
794,110,3,4,5,8,32,-56,2,0,352,440
794,111,3,3,8,5,35,32,7,2,387,472
794,112,2,4,7,6,-75,42,2,4,312,514
795,1,3,3,8,5,35,32,5,2,35,32
795,2,2,6,4,9,22,63,7,5,57,95
795,3,4,3,8,5,-56,32,1,7,1,127
795,4,4,3,6,7,42,-66,3,1,43,61
795,5,4,2,10,3,46,21,9,2,89,82
795,6,5,2,8,5,-47,23,2,5,42,105
795,7,4,3,6,7,42,34,4,9,84,139
795,8,4,3,7,6,43,-67,7,2,127,72
795,9,3,4,5,8,32,44,9,6,159,116
795,10,5,2,11,2,-44,20,5,6,115,136
795,11,3,4,5,8,32,-56,7,0,147,80
795,12,2,5,3,10,21,55,8,5,168,135
795,13,5,2,7,6,-48,24,0,9,120,159
795,14,3,5,6,7,33,-48,3,1,153,111
795,15,3,3,9,4,36,31,9,2,189,142
795,16,3,3,7,6,-66,33,3,5,123,175
795,17,4,2,7,6,43,24,6,9,166,199
795,18,3,3,5,8,32,-65,8,4,198,134
795,19,2,4,4,9,-78,45,0,9,120,179
795,20,5,2,10,3,55,-79,5,0,175,100
795,21,4,2,10,3,-54,21,1,1,121,121
795,22,4,2,10,3,46,21,7,2,167,142
795,23,2,4,5,8,-77,44,0,6,90,186
795,24,4,2,9,4,45,22,5,8,135,208
795,25,3,3,4,9,31,-64,6,4,166,144
795,26,4,3,6,7,42,34,8,8,208,178
795,27,3,3,9,4,-64,31,4,9,144,209
795,28,2,5,5,8,23,-47,7,2,167,162
795,29,3,4,6,7,-67,43,0,5,100,205
795,30,3,4,6,7,33,43,3,8,133,248
795,31,4,3,8,5,44,-68,7,0,177,180
795,32,3,4,5,8,32,44,9,4,209,224
795,33,4,2,10,3,-54,21,5,5,155,245
795,34,2,4,3,10,21,-54,6,1,176,191
795,35,4,3,8,5,-56,32,0,3,120,223
795,36,3,3,4,9,31,36,1,9,151,259
795,37,3,3,7,6,34,-67,5,2,185,192
795,38,2,5,3,10,21,55,6,7,206,247
795,39,3,3,9,4,-64,31,2,8,142,278
795,40,4,3,6,7,42,-66,4,2,184,212
795,41,3,3,5,8,32,35,6,7,216,247
795,42,3,3,7,6,-66,-67,0,0,150,180
795,43,4,2,6,7,42,25,2,5,192,205
795,44,3,3,8,5,35,32,7,7,227,237
795,45,3,5,8,5,-65,50,2,7,162,287
795,46,3,3,3,10,30,-63,2,4,192,224
795,47,5,2,10,3,55,21,7,5,247,245
795,48,2,4,6,7,-76,43,1,8,171,288
795,49,4,2,11,2,47,20,8,8,218,308
795,50,3,4,5,8,-68,-56,0,2,150,252
795,51,3,3,6,7,33,34,3,6,183,286
795,52,3,4,4,9,31,-55,4,1,214,231
795,53,3,4,5,8,32,44,6,5,246,275
795,54,5,2,8,5,53,23,9,8,299,298
795,55,4,2,6,7,-58,-75,1,3,241,223
795,56,3,3,7,6,34,33,5,6,275,256
795,57,5,2,10,3,-45,21,0,7,230,277
795,58,3,3,8,5,35,32,5,9,265,309
795,59,4,3,6,7,42,-66,7,3,307,243
795,60,5,2,8,5,-47,23,0,6,260,266
795,61,3,3,9,4,36,31,6,7,296,297
795,62,4,3,6,7,42,-66,8,1,338,231
795,63,3,4,6,7,-67,43,1,4,271,274
795,64,4,2,5,8,41,-74,2,0,312,200
795,65,3,4,3,10,30,46,2,6,342,246
795,66,4,2,6,7,42,-75,4,1,384,171
795,67,3,3,5,8,32,35,6,6,416,206
795,68,3,3,5,8,32,-65,8,1,448,141
795,69,2,4,2,11,20,47,8,8,468,188
795,70,4,3,7,6,-57,-67,1,1,411,121
795,71,2,5,5,8,23,53,4,4,434,174
795,72,2,4,4,9,22,45,6,9,456,219
795,73,3,4,5,8,32,-56,8,3,488,163
795,74,2,5,5,8,-77,53,1,6,411,216
795,75,3,3,4,9,31,-64,2,2,442,152
795,76,4,2,7,6,43,24,5,6,485,176
795,77,3,3,6,7,33,-66,8,0,518,110
796,1,2,5,2,11,20,56,0,6,20,56
796,2,3,3,7,6,34,33,4,9,54,89
796,3,3,3,8,5,35,-68,9,1,89,21
796,4,3,3,8,5,-65,32,4,3,24,53
796,5,3,4,7,6,34,42,8,5,58,95
796,6,3,4,5,8,-68,44,0,9,-10,139
796,7,2,4,4,9,22,-55,2,4,12,84
796,8,2,4,7,6,25,42,7,6,37,126
796,9,3,3,8,5,-65,32,2,8,-28,158
796,10,5,2,11,2,56,20,8,8,28,178
796,11,5,2,11,2,-44,20,4,8,-16,198
796,12,3,3,6,7,33,-66,7,2,17,132
796,13,3,3,8,5,-65,32,2,4,-48,164
796,14,3,4,6,7,33,43,5,7,-15,207
796,15,4,2,9,4,-55,22,0,9,-70,229
796,16,3,3,8,5,35,-68,5,1,-35,161
796,17,3,3,5,8,32,35,7,6,-3,196
796,18,4,3,5,8,41,-65,8,1,38,131
796,19,2,5,6,7,-76,52,2,3,-38,183
796,20,4,2,8,5,44,23,6,6,6,206
796,21,3,3,7,6,-66,33,0,9,-60,239
796,22,2,4,7,6,25,-58,5,1,-35,181
796,23,2,5,5,8,23,53,8,4,-12,234
796,24,2,4,7,6,-75,42,3,6,-87,276
796,25,2,4,5,8,23,-56,6,0,-64,220
796,26,4,2,9,4,-55,22,1,2,-119,242
796,27,2,4,5,8,23,44,4,6,-96,286
796,28,4,3,7,6,43,33,7,9,-53,319
796,29,2,5,5,8,-77,-47,0,2,-130,272
796,30,3,3,5,8,32,35,2,7,-98,307
796,31,4,2,4,9,40,-73,2,4,-58,234
796,32,5,3,9,4,54,31,6,5,-4,265
796,33,4,3,8,5,-56,32,0,7,-60,297
796,34,3,3,7,6,34,-67,4,0,-26,230
796,35,2,4,3,10,21,46,5,6,-5,276
796,36,5,2,9,4,54,22,9,8,49,298
796,37,4,4,8,5,-56,41,3,9,-7,339
796,38,3,3,6,7,33,-66,6,3,26,273
796,39,2,4,5,8,23,44,9,7,49,317
796,40,3,3,6,7,-67,-66,2,1,-18,251
796,41,3,4,7,6,34,42,6,3,16,293
796,42,2,4,6,7,-76,43,0,6,-60,336
796,43,4,4,6,7,42,43,2,9,-18,379
796,44,3,3,6,7,33,-66,5,3,15,313
796,45,3,3,6,7,33,34,8,7,48,347
796,46,4,2,8,5,-56,-77,2,0,-8,270
796,47,2,5,6,7,24,52,6,2,16,322
796,48,3,4,7,6,-66,42,0,4,-50,364
796,49,4,3,6,7,42,34,2,8,-8,398
796,50,4,3,7,6,43,-67,5,1,35,331
796,51,3,4,7,6,34,42,9,3,69,373
796,52,3,4,6,7,-67,43,2,6,2,416
796,53,2,4,3,10,21,-54,3,2,23,362
796,54,4,3,6,7,42,34,5,6,65,396
796,55,2,6,3,10,21,-36,6,0,86,360
796,56,3,3,6,7,33,34,9,4,119,394
796,57,2,5,4,9,-78,54,1,8,41,448
796,58,4,2,9,4,45,-78,6,0,86,370
796,59,3,4,7,6,-66,42,0,2,20,412
796,60,2,5,5,8,23,53,3,5,43,465
796,61,5,2,7,6,52,24,5,9,95,489
796,62,4,3,10,3,-54,30,1,9,41,519
797,1,2,4,4,9,22,45,2,5,22,45
797,2,4,2,9,4,45,22,7,7,67,67
797,3,2,4,5,8,-77,-56,0,1,-10,11
797,4,3,3,4,9,31,36,1,7,21,47
797,5,2,5,6,7,24,52,5,9,45,99
797,6,3,4,6,7,33,-57,8,2,78,42
797,7,3,4,5,8,-68,44,0,6,10,86
797,8,4,3,7,6,43,33,3,9,53,119
797,9,2,4,4,9,22,-55,5,4,75,64
797,10,3,3,5,8,32,35,7,9,107,99
797,11,4,3,9,4,-55,-69,2,0,52,30
797,12,3,3,7,6,34,33,6,3,86,63
797,13,5,3,8,5,53,32,9,5,139,95
797,14,3,3,8,5,-65,32,4,7,74,127
797,15,3,3,6,7,33,-66,7,1,107,61
797,16,4,2,7,6,-57,24,0,5,50,85
797,17,2,5,4,9,22,54,2,9,72,139
797,18,3,3,8,5,35,-68,7,1,107,71
797,19,4,3,7,6,-57,33,0,4,50,104
797,20,3,3,6,7,33,34,3,8,83,138
797,21,3,3,8,5,35,-68,8,0,118,70
797,22,3,4,4,9,31,45,9,5,149,115
797,23,4,3,8,5,-56,32,3,7,93,147
797,24,3,4,5,8,32,-56,5,1,125,91
797,25,3,3,6,7,33,34,8,5,158,125
797,26,2,5,3,10,21,-45,9,0,179,80
797,27,4,3,7,6,-57,33,2,3,122,113
797,28,3,3,6,7,33,34,5,7,155,147
797,29,2,4,3,10,21,-54,6,3,176,93
797,30,3,3,5,8,32,35,8,8,208,128
797,31,4,2,9,4,-55,-78,3,0,153,50
797,32,3,4,8,5,35,41,8,1,188,91
797,33,2,4,4,9,-78,45,0,6,110,136
797,34,5,2,8,5,53,23,3,9,163,159
797,35,3,3,7,6,34,-67,7,2,197,92
797,36,3,4,5,8,32,44,9,6,229,136
797,37,3,4,6,7,-67,43,2,9,162,179
797,38,3,4,7,6,34,-58,6,1,196,121
797,39,3,4,5,8,32,44,8,5,228,165
797,40,3,4,7,6,-66,42,2,7,162,207
797,41,3,4,5,8,32,-56,4,1,194,151
797,42,4,3,9,4,45,31,9,2,239,182
797,43,5,2,9,4,-46,22,3,4,193,204
797,44,3,3,7,6,34,33,7,7,227,237
797,45,4,2,9,4,-55,22,2,9,172,259
797,46,4,2,6,7,42,-75,4,4,214,184
797,47,4,3,8,5,44,32,8,6,258,216
797,48,2,5,5,8,-77,53,1,9,181,269
797,49,4,3,6,7,42,-66,3,3,223,203
797,50,2,5,6,7,24,52,7,5,247,255
797,51,4,4,7,6,-57,42,0,7,190,297
797,52,3,4,4,9,31,-55,1,2,221,242
797,53,2,4,3,10,21,46,2,8,242,288
797,54,5,3,7,6,52,-67,4,1,294,221
797,55,2,4,7,6,25,42,9,3,319,263
797,56,3,4,6,7,-67,43,2,6,252,306
797,57,5,2,6,7,51,-75,3,1,303,231
797,58,2,4,4,9,22,45,5,6,325,276
797,59,2,4,3,10,21,-54,6,2,346,222
797,60,4,2,8,5,-56,23,0,5,290,245
797,61,2,5,5,8,23,53,3,8,313,298
797,62,2,5,5,8,23,-47,6,1,336,251
797,63,3,3,8,5,-65,32,1,3,271,283
797,64,4,2,7,6,43,24,4,7,314,307
797,65,2,5,3,10,21,-45,5,2,335,262
797,66,5,2,10,3,-45,21,0,3,290,283
797,67,2,4,7,6,25,42,5,5,315,325
797,68,3,3,10,3,-63,30,2,5,252,355
797,69,3,3,8,5,35,32,7,7,287,387
797,70,3,3,5,8,32,-65,9,2,319,322
797,71,3,3,8,5,-65,32,4,4,254,354
797,72,3,3,6,7,33,34,7,8,287,388
797,73,4,2,8,5,-56,-77,1,1,231,311
797,74,4,3,7,6,43,33,4,4,274,344
797,75,3,3,9,4,-64,31,0,5,210,375
797,76,3,3,3,10,30,-63,0,2,240,312
797,77,4,3,7,6,43,33,3,5,283,345
797,78,3,4,6,7,33,43,6,8,316,388
797,79,4,4,8,5,-56,41,0,9,260,429
797,80,3,3,4,9,31,-64,1,5,291,365
797,81,2,5,4,9,22,54,3,9,313,419
797,82,3,3,7,6,34,-67,7,2,347,352
797,83,3,3,6,7,-67,34,0,6,280,386
797,84,3,3,7,6,34,33,4,9,314,419
797,85,4,2,11,2,-53,20,1,9,261,439
797,86,2,4,5,8,23,-56,4,3,284,383
797,87,3,4,6,7,33,43,7,6,317,426
797,88,3,3,5,8,32,-65,9,1,349,361
797,89,4,3,9,4,-55,31,4,2,294,392
797,90,4,3,7,6,43,33,7,5,337,425
797,91,2,5,4,9,22,54,9,9,359,479
797,92,4,3,5,8,-59,-65,0,4,300,414
797,93,3,3,4,9,31,-64,1,0,331,350
797,94,4,2,6,7,42,25,3,5,373,375
797,95,3,4,5,8,32,44,5,9,405,419
797,96,4,2,8,5,44,-77,9,2,449,342
797,97,3,4,7,6,-66,42,3,4,383,384
797,98,5,2,9,4,54,22,7,6,437,406
797,99,4,2,10,3,-54,21,3,7,383,427
797,100,3,4,5,8,32,-56,5,1,415,371
797,101,3,4,7,6,34,42,9,3,449,413
797,102,4,2,6,7,-58,25,1,8,391,438
797,103,4,3,9,4,45,31,6,9,436,469
797,104,3,3,6,7,33,-66,9,3,469,403
797,105,4,3,6,7,-58,34,1,7,411,437
797,106,2,5,7,6,25,51,6,8,436,488
797,107,4,3,6,7,42,-66,8,2,478,422
797,108,5,2,10,3,-45,21,3,3,433,443
797,109,4,3,8,5,44,32,7,5,477,475
797,110,4,3,6,7,42,34,9,9,519,509
798,1,5,3,6,7,51,34,1,4,51,34
798,2,3,3,6,7,33,34,4,8,84,68
798,3,4,3,9,4,45,31,9,9,129,99
798,4,4,2,11,2,-53,20,6,9,76,119
798,5,3,4,8,5,-65,-59,1,0,11,60
798,6,4,3,9,4,45,31,6,1,56,91
798,7,2,4,5,8,23,44,9,5,79,135
798,8,5,2,10,3,-45,21,4,6,34,156
798,9,3,3,5,8,32,-65,6,1,66,91
798,10,4,3,10,3,-54,30,2,1,12,121
798,11,4,2,10,3,46,21,8,2,58,142
798,12,3,3,6,7,-67,34,1,6,-9,176
798,13,4,3,10,3,46,30,7,6,37,206
798,14,3,4,7,6,-66,42,1,8,-29,248
798,15,3,4,7,6,34,-58,5,0,5,190
798,16,3,4,7,6,34,42,9,2,39,232
798,17,4,3,8,5,-56,32,3,4,-17,264
798,18,3,4,5,8,32,44,5,8,15,308
798,19,5,2,9,4,54,-78,9,0,69,230
798,20,4,2,9,4,-55,22,4,2,14,252
798,21,3,3,5,8,32,35,6,7,46,287
798,22,3,4,8,5,-65,41,1,8,-19,328
798,23,3,3,8,5,35,-68,6,0,16,260
798,24,3,3,10,3,-63,30,3,0,-47,290
798,25,2,4,6,7,24,43,7,3,-23,333
798,26,2,5,4,9,22,54,9,7,-1,387
798,27,4,3,8,5,-56,32,3,9,-57,419
798,28,4,3,8,5,44,-68,7,1,-13,351
798,29,3,3,6,7,-67,34,0,5,-80,385
798,30,4,3,8,5,44,32,4,7,-36,417
798,31,3,3,5,8,32,-65,6,2,-4,352
798,32,5,2,10,3,-45,21,1,3,-49,373
798,33,3,4,6,7,33,43,4,6,-16,416
798,34,2,5,3,10,21,-45,5,1,5,371
798,35,4,3,7,6,43,33,8,4,48,404
798,36,4,3,6,7,-58,34,0,8,-10,438
798,37,3,4,4,9,31,-55,1,3,21,383
798,38,4,2,9,4,45,22,6,5,66,405
798,39,4,3,7,6,43,33,9,8,109,438
798,40,3,4,3,10,30,-54,9,4,139,384
798,41,3,4,6,7,-67,43,2,7,72,427
798,42,4,3,6,7,42,-66,4,1,114,361
798,43,2,5,6,7,24,52,8,3,138,413
798,44,2,4,5,8,-77,44,1,7,61,457
798,45,5,2,9,4,54,22,5,9,115,479
798,46,3,4,7,6,34,-58,9,1,149,421
798,47,3,3,6,7,-67,34,2,5,82,455
798,48,4,3,5,8,41,-65,3,0,123,390
798,49,5,2,9,4,54,22,7,2,177,412
798,50,4,3,9,4,-55,31,2,3,122,443
798,51,4,3,8,5,44,32,6,5,166,475
798,52,2,5,7,6,-75,51,1,6,91,526
799,1,2,4,4,9,22,45,2,5,22,45
799,2,3,3,7,6,34,33,6,8,56,78
799,3,3,3,6,7,33,-66,9,2,89,12
799,4,4,2,5,8,-59,26,0,8,30,38
799,5,3,3,6,7,33,-66,3,2,63,-28
799,6,3,4,3,10,30,46,3,8,93,18
799,7,3,3,7,6,34,-67,7,1,127,-49
799,8,3,4,4,9,31,45,8,6,158,-4
799,9,3,4,3,10,30,-54,8,2,188,-58
799,10,3,3,5,8,-68,35,0,7,120,-23
799,11,3,4,4,9,31,-55,1,2,151,-78
799,12,2,5,4,9,22,54,3,6,173,-24
799,13,4,2,9,4,45,22,8,8,218,-2
799,14,4,3,6,7,-58,-66,0,2,160,-68
799,15,3,4,6,7,33,43,3,5,193,-25
799,16,5,2,7,6,52,24,5,9,245,-1
799,17,5,2,8,5,53,-77,8,2,298,-78
799,18,4,2,5,8,41,26,9,8,339,-52
799,19,4,2,9,4,-55,-78,4,0,284,-130
799,20,2,4,5,8,23,44,7,4,307,-86
799,21,3,3,5,8,32,35,9,9,339,-51
799,22,4,3,6,7,-58,-66,1,3,281,-117
799,23,5,2,7,6,52,24,3,7,333,-93
799,24,4,3,10,3,46,30,9,7,379,-63
799,25,3,4,5,8,-68,-56,1,1,311,-119
799,26,5,2,8,5,53,23,4,4,364,-96
799,27,4,3,6,7,42,34,6,8,406,-62
799,28,4,2,8,5,-56,-77,0,1,350,-139
799,29,2,4,2,11,20,47,0,8,370,-92
799,30,3,3,6,7,33,-66,3,2,403,-158
799,31,3,4,4,9,31,45,4,7,434,-113
799,32,4,2,10,3,-54,21,0,8,380,-92
799,33,2,4,5,8,23,-56,3,2,403,-148
799,34,2,5,6,7,24,52,7,4,427,-96
799,35,4,3,6,7,42,34,9,8,469,-62
799,36,3,4,4,9,-69,-55,0,3,400,-117
799,37,4,3,5,8,41,35,1,8,441,-82
799,38,4,2,6,7,42,-75,3,3,483,-157
799,39,3,4,6,7,33,43,6,6,516,-114
800,1,4,3,6,7,42,34,2,4,42,34
800,2,3,4,5,8,32,44,4,8,74,78
800,3,4,2,7,6,43,-76,7,2,117,2
800,4,2,5,5,8,-77,53,0,5,40,55
800,5,2,4,4,9,22,-55,2,0,62,0
800,6,5,3,8,5,53,32,5,2,115,32
800,7,4,2,8,5,44,23,9,5,159,55
800,8,3,4,6,7,-67,43,2,8,92,98
800,9,4,3,8,5,44,-68,6,0,136,30
800,10,5,2,6,7,51,25,7,5,187,55
800,11,4,2,7,6,-57,24,0,9,130,79
800,12,5,2,6,7,51,-75,1,4,181,4
800,13,3,4,7,6,34,42,5,6,215,46
800,14,3,3,4,9,31,-64,6,2,246,-18
800,15,2,4,8,5,-74,41,2,3,172,23
800,16,2,4,4,9,22,45,4,8,194,68
800,17,3,4,4,9,31,-55,5,3,225,13
800,18,4,3,5,8,41,35,6,8,266,48
800,19,3,4,6,7,33,-57,9,1,299,-9
800,20,3,3,8,5,-65,32,4,3,234,23
800,21,5,2,7,6,52,24,6,7,286,47
800,22,4,3,6,7,42,-66,8,1,328,-19
800,23,4,2,6,7,-58,25,0,6,270,6
800,24,4,3,6,7,42,-66,2,0,312,-60
800,25,2,4,4,9,22,45,4,5,334,-15
800,26,3,4,7,6,34,42,8,7,368,27
800,27,5,2,10,3,-45,21,3,8,323,48
800,28,3,4,6,7,33,-57,6,1,356,-9
800,29,6,2,10,3,-36,21,0,2,320,12
800,30,4,2,5,8,41,26,1,8,361,38
800,31,4,4,6,7,42,-57,3,1,403,-19
800,32,3,4,4,9,31,45,4,6,434,26
800,33,3,4,5,8,32,-56,6,0,466,-30
800,34,5,2,10,3,-45,21,1,1,421,-9
800,35,3,3,4,9,31,36,2,7,452,27
800,36,4,3,7,6,43,-67,5,0,495,-40
800,37,3,3,5,8,32,35,7,5,527,-5
801,1,5,2,9,4,54,22,4,2,54,22
801,2,3,4,7,6,34,42,8,4,88,64
801,3,3,3,5,8,-68,35,0,9,20,99
801,4,3,4,4,9,31,-55,1,4,51,44
801,5,4,2,7,6,43,24,4,8,94,68
801,6,2,4,7,6,25,-58,9,0,119,10
801,7,3,3,7,6,-66,33,3,3,53,43
801,8,2,5,4,9,22,54,5,7,75,97
801,9,2,4,6,7,24,-57,9,0,99,40
801,10,2,5,4,9,-78,54,1,4,21,94
801,11,5,2,11,2,56,20,7,4,77,114
801,12,5,3,8,5,-47,32,0,6,30,146
801,13,4,3,7,6,43,33,3,9,73,179
801,14,2,5,4,9,22,-46,5,3,95,133
801,15,3,3,5,8,32,35,7,8,127,168
801,16,3,3,6,7,-67,-66,0,2,60,102
801,17,2,4,8,5,26,41,6,3,86,143
801,18,2,4,4,9,22,45,8,8,108,188
801,19,3,4,7,6,-66,-58,2,0,42,130
801,20,3,4,4,9,31,45,3,5,73,175
801,21,3,3,7,6,34,33,7,8,107,208
801,22,4,2,11,2,-53,20,4,8,54,228
801,23,2,5,3,10,21,-45,5,3,75,183
801,24,5,2,9,4,54,22,9,5,129,205
801,25,3,4,5,8,-68,44,1,9,61,249
801,26,3,3,6,7,33,-66,4,3,94,183
801,27,5,2,11,2,-44,20,0,3,50,203
801,28,3,3,8,5,35,32,5,5,85,235
801,29,3,3,5,8,32,-65,7,0,117,170
801,30,2,5,3,10,21,55,8,5,138,225
801,31,5,2,8,5,-47,23,1,8,91,248
801,32,3,4,4,9,31,-55,2,3,122,193
801,33,3,3,6,7,33,34,5,7,155,227
801,34,2,4,5,8,23,-56,8,1,178,171
801,35,2,4,5,8,-77,44,1,5,101,215
801,36,5,2,8,5,53,23,4,8,154,238
801,37,4,3,7,6,43,-67,7,1,197,171
801,38,4,3,8,5,-56,32,1,3,141,203
801,39,3,3,9,4,36,31,7,4,177,234
801,40,2,4,5,8,-77,44,0,8,100,278
801,41,3,4,3,10,30,-54,0,4,130,224
801,42,2,5,2,11,20,-44,0,0,150,180
801,43,3,4,6,7,33,43,3,3,183,223
801,44,2,4,3,10,21,46,4,9,204,269
801,45,2,4,7,6,25,-58,9,1,229,211
801,46,5,2,8,5,-47,23,2,4,182,234
801,47,4,3,7,6,43,33,5,7,225,267
801,48,4,2,8,5,44,-77,9,0,269,190
801,49,2,5,4,9,-78,54,1,4,191,244
801,50,2,5,4,9,22,54,3,8,213,298
801,51,2,4,7,6,25,-58,8,0,238,240
801,52,4,2,8,5,-56,23,2,3,182,263
801,53,3,3,6,7,33,34,5,7,215,297
801,54,3,3,7,6,34,-67,9,0,249,230
801,55,4,3,7,6,-57,33,2,3,192,263
801,56,3,3,8,5,35,32,7,5,227,295
801,57,4,3,6,7,42,34,9,9,269,329
801,58,5,2,10,3,-45,-79,4,0,224,250
801,59,6,2,10,3,64,21,8,1,288,271
801,60,4,2,6,7,-58,25,0,6,230,296
801,61,3,4,5,8,32,-56,2,0,262,240
801,62,5,3,7,6,52,33,4,3,314,273
801,63,7,2,11,2,74,20,8,3,388,293
801,64,2,4,4,9,-78,45,0,8,310,338
801,65,4,2,6,7,42,-75,2,3,352,263
801,66,3,4,8,5,35,41,7,4,387,304
801,67,3,3,7,6,-66,33,1,7,321,337
801,68,2,4,6,7,24,-57,5,0,345,280
801,69,4,3,7,6,43,33,8,3,388,313
801,70,4,3,9,4,-55,31,3,4,333,344
801,71,3,4,4,9,31,45,4,9,364,389
801,72,4,2,10,3,-54,-79,0,0,310,310
801,73,6,2,8,5,62,23,2,3,372,333
801,74,4,3,8,5,44,32,6,5,416,365
801,75,4,3,7,6,43,33,9,8,459,398
801,76,4,2,7,6,-57,-76,2,2,402,322
801,77,3,4,6,7,33,43,5,5,435,365
801,78,4,3,5,8,41,-65,6,0,476,300
801,79,2,4,4,9,22,45,8,5,498,345
801,80,4,3,8,5,-56,32,2,7,442,377
801,81,4,3,4,9,40,-64,2,3,482,313
801,82,5,2,10,3,55,21,7,4,537,334
802,1,4,2,8,5,44,23,4,3,44,23
802,2,4,3,7,6,43,33,7,6,87,56
802,3,4,2,6,7,42,-75,9,1,129,-19
802,4,3,3,6,7,-67,34,2,5,62,15
802,5,3,4,6,7,33,43,5,8,95,58
802,6,4,3,7,6,43,-67,8,1,138,-9
802,7,2,4,5,8,-77,44,1,5,61,35
802,8,6,2,11,2,65,20,6,5,126,55
802,9,4,2,7,6,43,24,9,9,169,79
802,10,3,3,5,8,-68,-65,1,4,101,14
802,11,2,5,6,7,24,52,5,6,125,66
802,12,4,2,7,6,43,-76,8,0,168,-10
802,13,2,4,3,10,21,46,9,6,189,36
802,14,6,2,10,3,-36,21,3,7,153,57
802,15,4,2,8,5,44,-77,7,0,197,-20
802,16,2,4,5,8,-77,44,0,4,120,24
802,17,2,4,6,7,24,43,4,7,144,67
802,18,5,2,7,6,52,-76,6,1,196,-9
802,19,2,6,2,11,20,65,6,6,216,56
802,20,3,4,5,8,32,-56,8,0,248,0
802,21,4,2,10,3,-54,21,4,1,194,21
802,22,3,3,10,3,-63,30,1,1,131,51
802,23,4,3,10,3,46,30,7,1,177,81
802,24,2,6,4,9,22,63,9,4,199,144
802,25,3,4,5,8,-68,44,1,8,131,188
802,26,4,3,6,7,42,-66,3,2,173,122
802,27,4,2,8,5,44,23,7,5,217,145
802,28,3,4,4,9,31,-55,8,0,248,90
802,29,3,4,5,8,-68,44,0,4,180,134
802,30,5,2,9,4,54,22,4,6,234,156
802,31,2,5,3,10,21,-45,5,1,255,111
802,32,5,2,8,5,53,23,8,4,308,134
802,33,4,3,7,6,-57,33,1,7,251,167
802,34,4,3,10,3,46,30,7,7,297,197
802,35,2,5,5,8,-77,-47,0,0,220,150
802,36,2,4,4,9,22,45,2,5,242,195
802,37,2,5,4,9,22,54,4,9,264,249
802,38,2,4,4,9,22,-55,6,4,286,194
802,39,3,3,7,6,-66,33,0,7,220,227
802,40,3,4,5,8,32,-56,2,1,252,171
802,41,3,3,7,6,34,33,6,4,286,204
802,42,3,4,7,6,-66,42,0,6,220,246
802,43,4,2,8,5,44,23,4,9,264,269
802,44,2,5,7,6,25,-49,9,0,289,220
802,45,3,3,9,4,-64,31,5,1,225,251
802,46,4,2,11,2,-53,20,2,1,172,271
802,47,3,3,5,8,32,35,4,6,204,306
802,48,4,3,6,7,42,-66,6,0,246,240
802,49,4,2,11,2,-53,20,3,0,193,260
802,50,3,3,8,5,35,32,8,2,228,292
802,51,6,2,9,4,-37,22,1,4,191,314
802,52,3,3,5,8,32,35,3,9,223,349
802,53,3,3,7,6,34,-67,7,2,257,282
802,54,3,3,7,6,-66,33,1,5,191,315
802,55,5,2,8,5,53,23,4,8,244,338
802,56,3,3,8,5,35,-68,9,0,279,270
802,57,2,5,5,8,-77,53,2,3,202,323
802,58,3,3,9,4,36,31,8,4,238,354
802,59,3,4,6,7,-67,43,1,7,171,397
802,60,2,5,3,10,21,-45,2,2,192,352
802,61,2,4,5,8,23,44,5,6,215,396
802,62,3,4,7,6,34,42,9,8,249,438
802,63,5,2,9,4,-46,-78,3,0,203,360
802,64,3,4,6,7,33,43,6,3,236,403
802,65,4,2,11,2,-53,20,3,3,183,423
802,66,6,2,10,3,64,21,7,4,247,444
802,67,4,3,7,6,-57,33,0,7,190,477
802,68,4,3,8,5,44,32,4,9,234,509
803,1,2,5,5,8,23,53,3,3,23,53
803,2,4,3,7,6,43,33,6,6,66,86
803,3,2,4,8,5,-74,41,2,7,-8,127
803,4,3,3,5,8,32,-65,4,2,24,62
803,5,2,5,3,10,21,55,5,7,45,117
803,6,3,3,7,6,34,-67,9,0,79,50
803,7,3,3,5,8,-68,35,1,5,11,85
803,8,2,4,7,6,25,42,6,7,36,127
803,9,2,4,5,8,23,-56,9,1,59,71
803,10,3,4,8,5,-65,41,4,2,-6,112
803,11,4,2,9,4,45,22,9,4,39,134
803,12,2,4,7,6,-75,42,4,6,-36,176
803,13,4,4,5,8,41,-56,5,0,5,120
803,14,3,3,7,6,34,33,9,3,39,153
803,15,3,3,8,5,-65,32,4,5,-26,185
803,16,5,2,10,3,55,21,9,6,29,206
803,17,3,3,8,5,-65,32,4,8,-36,238
803,18,2,4,4,9,22,-55,6,3,-14,183
803,19,2,5,4,9,22,54,8,7,8,237
803,20,4,2,7,6,-57,-76,1,1,-49,161
803,21,3,3,5,8,32,35,3,6,-17,196
803,22,4,3,8,5,44,32,7,8,27,228
803,23,2,5,4,9,22,-46,9,2,49,182
803,24,6,2,8,5,-38,23,1,5,11,205
803,25,2,4,4,9,22,-55,3,0,33,150
803,26,5,2,10,3,55,21,8,1,88,171
803,27,5,2,9,4,-46,22,2,3,42,193
803,28,4,3,8,5,44,32,6,5,86,225
803,29,2,6,3,10,21,64,7,9,107,289
803,30,3,3,3,10,30,-63,7,6,137,226
803,31,2,5,4,9,22,-46,9,0,159,180
803,32,5,2,10,3,-45,21,4,1,114,201
803,33,3,5,4,9,31,54,5,5,145,255
803,34,2,5,5,8,23,53,8,8,168,308
803,35,2,5,4,9,-78,-46,0,2,90,262
803,36,2,5,4,9,22,54,2,6,112,316
803,37,3,3,5,8,32,-65,4,1,144,251
803,38,3,3,6,7,33,34,7,5,177,285
803,39,2,4,3,10,21,-54,8,1,198,231
803,40,2,4,7,6,-75,42,3,3,123,273
803,41,4,2,8,5,44,23,7,6,167,296
803,42,3,3,8,5,-65,32,2,8,102,328
803,43,5,2,10,3,55,21,7,9,157,349
803,44,3,4,6,7,-67,-57,0,2,90,292
803,45,3,4,7,6,34,42,4,4,124,334
803,46,4,4,7,6,43,42,7,6,167,376
803,47,2,5,5,8,-77,53,0,9,90,429
803,48,3,3,8,5,35,-68,5,1,125,361
803,49,3,3,8,5,-65,32,0,3,60,393
803,50,3,3,8,5,35,32,5,5,95,425
803,51,3,4,6,7,33,43,8,8,128,468
803,52,3,3,9,4,-64,31,4,9,64,499
803,53,4,3,9,4,45,-69,9,0,109,430
803,54,5,2,10,3,-45,21,4,1,64,451
803,55,3,4,8,5,35,41,9,2,99,492
803,56,4,3,8,5,-56,32,3,4,43,524
804,1,3,4,5,8,32,44,2,4,32,44
804,2,3,3,7,6,34,33,6,7,66,77
804,3,3,3,6,7,33,-66,9,1,99,11
804,4,4,3,7,6,-57,33,2,4,42,44
804,5,2,4,7,6,25,42,7,6,67,86
804,6,4,2,11,2,-53,20,4,6,14,106
804,7,4,2,6,7,42,-75,6,1,56,31
804,8,4,2,8,5,-56,23,0,4,0,54
804,9,3,4,6,7,33,43,3,7,33,97
804,10,4,2,9,4,45,22,8,9,78,119
804,11,2,4,4,9,-78,-55,0,4,0,64
804,12,3,3,6,7,33,34,3,8,33,98
804,13,3,3,9,4,36,31,9,9,69,129
804,14,3,4,4,9,-69,-55,0,4,0,74
804,15,2,5,5,8,23,53,3,7,23,127
804,16,2,4,2,11,20,-53,3,4,43,74
804,17,4,2,9,4,45,22,8,6,88,96
804,18,3,3,7,6,-66,33,2,9,22,129
804,19,3,3,9,4,36,-69,8,0,58,60
804,20,3,4,5,8,-68,44,0,4,-10,104
804,21,3,3,8,5,35,32,5,6,25,136
804,22,3,3,5,8,32,-65,7,1,57,71
804,23,3,3,6,7,-67,34,0,5,-10,105
804,24,3,4,6,7,33,43,3,8,23,148
804,25,2,5,4,9,22,-46,5,2,45,102
804,26,3,3,6,7,33,34,8,6,78,136
804,27,3,4,4,9,31,-55,9,1,109,81
804,28,4,2,9,4,-55,22,4,3,54,103
804,29,3,3,9,4,-64,31,0,4,-10,134
804,30,4,2,7,6,43,24,3,8,33,158
804,31,4,4,8,5,44,41,7,9,77,199
804,32,3,3,5,8,32,-65,9,4,109,134
804,33,4,3,9,4,-55,31,4,5,54,165
804,34,4,3,9,4,45,31,9,6,99,196
804,35,3,5,5,8,-68,53,1,9,31,249
804,36,4,2,9,4,45,-78,6,1,76,171
804,37,4,3,6,7,42,34,8,5,118,205
804,38,2,4,7,6,-75,42,3,7,43,247
804,39,4,4,4,9,40,-55,3,2,83,192
804,40,4,2,7,6,43,24,6,6,126,216
804,41,3,5,3,10,30,-45,6,1,156,171
804,42,5,2,6,7,51,25,7,6,207,196
804,43,3,3,6,7,-67,-66,0,0,140,130
804,44,3,3,6,7,33,34,3,4,173,164
804,45,4,3,7,6,43,33,6,7,216,197
804,46,3,3,6,7,33,-66,9,1,249,131
804,47,3,3,7,6,-66,33,3,4,183,164
804,48,4,3,6,7,42,34,5,8,225,198
804,49,2,5,4,9,22,-46,7,2,247,152
804,50,4,2,9,4,-55,22,2,4,192,174
804,51,2,5,4,9,22,54,4,8,214,228
804,52,5,2,8,5,53,-77,7,1,267,151
804,53,4,2,10,3,-54,21,3,2,213,172
804,54,4,3,7,6,43,33,6,5,256,205
804,55,4,3,10,3,-54,30,2,5,202,235
804,56,3,4,8,5,35,41,7,6,237,276
804,57,2,5,3,10,21,-45,8,1,258,231
804,58,2,5,5,8,-77,53,1,4,181,284
804,59,3,3,5,8,32,35,3,9,213,319
804,60,3,4,5,8,32,-56,5,3,245,263
804,61,3,3,7,6,34,33,9,6,279,296
804,62,4,2,8,5,-56,23,3,9,223,319
804,63,2,5,3,10,21,-45,4,4,244,274
804,64,3,4,6,7,33,43,7,7,277,317
804,65,4,3,6,7,42,-66,9,1,319,251
804,66,4,3,6,7,-58,34,1,5,261,285
804,67,2,5,5,8,23,53,4,8,284,338
804,68,3,3,6,7,33,-66,7,2,317,272
804,69,3,3,4,9,31,36,8,8,348,308
804,70,2,5,6,7,-76,-48,2,0,272,260
804,71,2,5,4,9,22,54,4,4,294,314
804,72,3,4,6,7,33,43,7,7,327,357
804,73,2,4,5,8,-77,-56,0,1,250,301
804,74,4,2,8,5,44,23,4,4,294,324
804,75,2,5,6,7,24,52,8,6,318,376
804,76,3,3,7,6,-66,33,2,9,252,409
804,77,3,3,8,5,35,-68,7,1,287,341
804,78,3,4,5,8,32,44,9,5,319,385
804,79,2,4,4,9,-78,-55,1,0,241,330
804,80,5,2,11,2,56,20,7,0,297,350
804,81,2,4,6,7,-76,43,1,3,221,393
804,82,4,3,5,8,41,35,2,8,262,428
804,83,3,3,6,7,33,-66,5,2,295,362
804,84,3,4,6,7,33,43,8,5,328,405
804,85,3,3,9,4,-64,31,4,6,264,436
804,86,3,3,5,8,32,-65,6,1,296,371
804,87,3,3,5,8,32,35,8,6,328,406
804,88,3,3,6,7,-67,-66,1,0,261,340
804,89,3,3,7,6,34,33,5,3,295,373
804,90,2,5,5,8,23,53,8,6,318,426
804,91,4,3,9,4,-55,31,3,7,263,457
804,92,2,4,5,8,23,-56,6,1,286,401
804,93,4,4,4,9,40,45,6,6,326,446
804,94,4,3,6,7,42,-66,8,0,368,380
804,95,2,4,3,10,21,46,9,6,389,426
804,96,2,5,5,8,-77,53,2,9,312,479
804,97,2,5,4,9,22,-46,4,3,334,433
804,98,3,3,9,4,-64,31,0,4,270,464
804,99,4,3,8,5,44,32,4,6,314,496
804,100,5,2,7,6,52,-76,6,0,366,420
804,101,2,5,3,10,21,55,7,5,387,475
804,102,4,2,10,3,-54,21,3,6,333,496
804,103,4,3,8,5,44,32,7,8,377,528
805,1,4,3,7,6,43,33,3,3,43,33
805,2,2,4,7,6,25,42,8,5,68,75
805,3,2,4,6,7,-76,43,2,8,-8,118
805,4,3,4,8,5,35,41,7,9,27,159
805,5,5,3,6,7,51,-66,8,3,78,93
805,6,4,3,8,5,-56,32,2,5,22,125
805,7,3,3,8,5,35,32,7,7,57,157
805,8,5,2,8,5,-47,-77,0,0,10,80
805,9,5,2,11,2,56,20,6,0,66,100
805,10,3,4,7,6,-66,42,0,2,0,142
805,11,4,3,7,6,43,33,3,5,43,175
805,12,4,3,9,4,45,31,8,6,88,206
805,13,3,3,7,6,-66,33,2,9,22,239
805,14,3,5,8,5,35,50,7,9,57,289
805,15,5,3,9,4,-46,-69,1,0,11,220
805,16,2,4,7,6,25,42,6,2,36,262
805,17,2,5,4,9,22,54,8,6,58,316
805,18,4,2,6,7,-58,-75,0,1,0,241
805,19,4,2,7,6,43,24,3,5,43,265
805,20,4,3,8,5,44,32,7,7,87,297
805,21,4,3,6,7,42,-66,9,1,129,231
805,22,5,2,8,5,-47,23,2,4,82,254
805,23,4,2,9,4,45,22,7,6,127,276
805,24,2,5,4,9,22,-46,9,0,149,230
805,25,3,3,7,6,-66,33,3,3,83,263
805,26,2,5,5,8,23,53,6,6,106,316
805,27,4,2,8,5,-56,23,0,9,50,339
805,28,3,4,4,9,31,-55,1,4,81,284
805,29,4,2,6,7,42,25,3,9,123,309
805,30,2,4,4,9,22,-55,5,4,145,254
805,31,4,3,7,6,43,33,8,7,188,287
805,32,3,3,7,6,-66,-67,2,0,122,220
805,33,3,4,6,7,33,43,5,3,155,263
805,34,4,3,9,4,-55,31,0,4,100,294
805,35,2,4,3,10,21,-54,1,0,121,240
805,36,4,2,9,4,45,22,6,2,166,262
805,37,2,5,4,9,22,54,8,6,188,316
805,38,3,3,5,8,-68,-65,0,1,120,251
805,39,3,4,6,7,33,43,3,4,153,294
805,40,2,5,3,10,21,55,4,9,174,349
805,41,3,3,8,5,35,-68,9,1,209,281
805,42,2,4,4,9,-78,45,1,6,131,326
805,43,2,5,5,8,23,53,4,9,154,379
805,44,4,3,6,7,42,-66,6,3,196,313
805,45,4,3,6,7,42,34,8,7,238,347
805,46,3,3,5,8,-68,-65,0,2,170,282
805,47,2,4,3,10,21,46,1,8,191,328
805,48,4,3,7,6,43,-67,4,1,234,261
805,49,2,6,4,9,22,63,6,4,256,324
805,50,4,2,10,3,-54,21,2,5,202,345
805,51,3,4,5,8,32,44,4,9,234,389
805,52,3,3,5,8,32,-65,6,4,266,324
805,53,5,2,11,2,-44,20,2,4,222,344
805,54,2,4,2,11,20,-53,2,1,242,291
805,55,3,4,4,9,31,45,3,6,273,336
805,56,3,3,4,9,31,-64,4,2,304,272
805,57,3,4,5,8,32,44,6,6,336,316
805,58,2,4,3,10,21,-54,7,2,357,262
805,59,4,2,9,4,-55,22,2,4,302,284
805,60,3,3,6,7,33,34,5,8,335,318
805,61,2,4,7,6,-75,-58,0,0,260,260
805,62,5,2,10,3,55,21,5,1,315,281
805,63,6,2,11,2,-35,20,0,1,280,301
805,64,2,5,7,6,25,51,5,2,305,352
805,65,4,4,6,7,42,43,7,5,347,395
805,66,4,3,7,6,-57,33,0,8,290,428
805,67,3,3,8,5,35,-68,5,0,325,360
805,68,4,3,9,4,-55,31,0,1,270,391
805,69,3,3,7,6,34,33,4,4,304,424
805,70,4,2,5,8,41,-74,5,0,345,350
805,71,3,3,5,8,32,35,7,5,377,385
805,72,3,4,4,9,31,-55,8,0,408,330
805,73,4,2,8,5,-56,23,2,3,352,353
805,74,2,5,2,11,20,56,2,9,372,409
805,75,2,4,4,9,22,-55,4,4,394,354
805,76,5,2,9,4,54,22,8,6,448,376
805,77,4,4,7,6,-57,42,1,8,391,418
805,78,3,4,6,7,33,-57,4,1,424,361
805,79,4,2,7,6,43,24,7,5,467,385
805,80,3,3,9,4,-64,31,3,6,403,416
805,81,5,2,10,3,55,21,8,7,458,437
805,82,4,3,8,5,-56,32,2,9,402,469
805,83,5,2,10,3,55,-79,7,0,457,390
805,84,3,3,6,7,-67,34,0,4,390,424
805,85,3,4,4,9,31,45,1,9,421,469
805,86,3,3,6,7,33,-66,4,3,454,403
805,87,4,3,8,5,44,32,8,5,498,435
805,88,3,3,5,8,-68,-65,0,0,430,370
805,89,2,4,3,10,21,46,1,6,451,416
805,90,3,3,6,7,33,-66,4,0,484,350
805,91,3,5,3,10,30,55,4,5,514,405
806,1,4,3,8,5,44,32,4,2,44,32
806,2,4,2,9,4,45,22,9,4,89,54
806,3,2,5,3,10,-79,55,0,9,10,109
806,4,4,3,6,7,42,-66,2,3,52,43
806,5,4,3,7,6,43,33,5,6,95,76
806,6,3,3,8,5,-65,32,0,8,30,108
806,7,6,2,11,2,65,20,5,8,95,128
806,8,4,3,6,7,42,-66,7,2,137,62
806,9,2,4,7,6,-75,42,2,4,62,104
806,10,2,6,4,9,22,63,4,7,84,167
806,11,3,3,6,7,33,-66,7,1,117,101
806,12,2,5,3,10,21,55,8,6,138,156
806,13,2,4,4,9,-78,-55,0,1,60,101
806,14,4,3,10,3,46,30,6,1,106,131
806,15,4,2,10,3,-54,21,2,2,52,152
806,16,4,3,6,7,42,34,4,6,94,186
806,17,2,4,7,6,25,42,9,8,119,228
806,18,3,4,8,5,-65,41,4,9,54,269
806,19,3,3,6,7,33,-66,7,3,87,203
806,20,2,4,4,9,22,45,9,8,109,248
806,21,2,5,3,10,-79,-45,0,3,30,203
806,22,6,2,8,5,62,23,2,6,92,226
806,23,6,2,11,2,65,20,7,6,157,246
806,24,2,5,5,8,-77,53,0,9,80,299
806,25,2,4,5,8,23,-56,3,3,103,243
806,26,3,4,6,7,33,43,6,6,136,286
806,27,3,4,5,8,32,-56,8,0,168,230
806,28,3,3,7,6,-66,33,2,3,102,263
806,29,2,4,4,9,22,45,4,8,124,308
806,30,3,5,4,9,31,-46,5,2,155,262
806,31,3,3,4,9,31,36,6,8,186,298
806,32,4,3,8,5,-56,-68,0,0,130,230
806,33,2,5,6,7,24,52,4,2,154,282
806,34,4,3,8,5,44,32,8,4,198,314
806,35,2,6,2,11,20,65,8,9,218,379
806,36,4,3,7,6,-57,-67,1,2,161,312
806,37,3,4,7,6,34,42,5,4,195,354
806,38,2,4,5,8,23,44,8,8,218,398
806,39,3,4,7,6,-66,-58,2,0,152,340
806,40,2,4,3,10,21,46,3,6,173,386
806,41,5,2,7,6,52,-76,5,0,225,310
806,42,2,5,4,9,22,54,7,4,247,364
806,43,3,3,8,5,-65,32,2,6,182,396
806,44,3,4,8,5,35,41,7,7,217,437
806,45,2,4,8,5,-74,41,3,8,143,478
806,46,5,2,10,3,55,21,8,9,198,499
806,47,3,3,7,6,-66,-67,2,2,132,432
806,48,5,2,11,2,56,20,8,2,188,452
806,49,3,4,8,5,-65,41,3,3,123,493
806,50,3,3,5,8,32,35,5,8,155,528
807,1,4,2,4,9,40,27,0,7,40,27
807,2,2,5,4,9,22,-46,2,1,62,-19
807,3,4,3,9,4,45,31,7,2,107,12
807,4,2,4,4,9,22,45,9,7,129,57
807,5,3,3,5,8,-68,-65,1,2,61,-8
807,6,3,4,4,9,31,45,2,7,92,37
807,7,5,2,8,5,53,-77,5,0,145,-40
807,8,3,3,8,5,-65,32,0,2,80,-8
807,9,4,2,9,4,45,22,5,4,125,14
807,10,3,3,7,6,34,33,9,7,159,47
807,11,2,4,8,5,-74,41,5,8,85,88
807,12,3,3,8,5,-65,-68,0,0,20,20
807,13,3,4,5,8,32,44,2,4,52,64
807,14,5,2,9,4,54,22,6,6,106,86
807,15,3,4,3,10,30,-54,6,2,136,32
807,16,2,4,4,9,22,45,8,7,158,77
807,17,5,2,10,3,-45,21,3,8,113,98
807,18,4,2,8,5,44,-77,7,1,157,21
807,19,3,3,3,10,30,37,7,8,187,58
807,20,5,2,9,4,-46,-78,1,0,141,-20
807,21,2,4,5,8,23,44,4,4,164,24
807,22,3,4,4,9,31,45,5,9,195,69
807,23,5,2,7,6,52,-76,7,3,247,-7
807,24,4,2,9,4,-55,22,2,5,192,15
807,25,4,3,9,4,45,31,7,6,237,46
807,26,2,4,6,7,-76,43,1,9,161,89
807,27,4,3,8,5,44,-68,5,1,205,21
807,28,3,3,9,4,-64,31,1,2,141,52
807,29,2,4,5,8,23,44,4,6,164,96
807,30,3,3,6,7,33,-66,7,0,197,30
807,31,3,4,7,6,-66,42,1,2,131,72
807,32,4,2,10,3,46,21,7,3,177,93
807,33,4,2,8,5,-56,23,1,6,121,116
807,34,3,3,8,5,35,32,6,8,156,148
807,35,4,3,6,7,42,-66,8,2,198,82
807,36,4,3,10,3,-54,30,4,2,144,112
807,37,5,2,10,3,55,21,9,3,199,133
807,38,2,5,5,8,-77,53,2,6,122,186
807,39,2,5,4,9,22,-46,4,0,144,140
807,40,2,4,3,10,21,46,5,6,165,186
807,41,3,3,7,6,34,33,9,9,199,219
807,42,4,3,7,6,-57,-67,2,2,142,152
807,43,4,3,10,3,46,30,8,2,188,182
807,44,3,3,10,3,-63,30,5,2,125,212
807,45,6,2,10,3,64,21,9,3,189,233
807,46,3,3,5,8,-68,35,1,8,121,268
807,47,3,3,3,10,30,-63,1,5,151,205
807,48,5,2,8,5,53,23,4,8,204,228
807,49,3,3,6,7,33,-66,7,2,237,162
807,50,5,2,7,6,52,24,9,6,289,186
807,51,3,3,9,4,-64,31,5,7,225,217
807,52,4,2,7,6,43,-76,8,1,268,141
807,53,3,3,7,6,-66,33,2,4,202,174
807,54,4,3,8,5,44,32,6,6,246,206
807,55,3,4,6,7,33,43,9,9,279,249
807,56,3,4,5,8,-68,-56,1,3,211,193
807,57,3,4,5,8,32,44,3,7,243,237
807,58,4,3,7,6,43,-67,6,0,286,170
807,59,2,5,7,6,-75,51,1,1,211,221
807,60,2,4,5,8,23,44,4,5,234,265
807,61,4,3,8,5,44,32,8,7,278,297
807,62,3,3,4,9,31,-64,9,3,309,233
807,63,3,4,8,5,-65,41,4,4,244,274
807,64,3,5,4,9,31,54,5,8,275,328
807,65,3,3,5,8,32,-65,7,3,307,263
807,66,3,4,6,7,-67,43,0,6,240,306
807,67,3,4,5,8,32,-56,2,0,272,250
807,68,4,2,7,6,43,24,5,4,315,274
807,69,3,3,9,4,-64,31,1,5,251,305
807,70,2,5,4,9,22,54,3,9,273,359
807,71,2,4,8,5,26,-59,9,0,299,300
807,72,3,3,7,6,-66,33,3,3,233,333
807,73,4,2,8,5,44,23,7,6,277,356
807,74,3,4,8,5,-65,41,2,7,212,397
807,75,2,4,7,6,25,42,7,9,237,439
807,76,3,3,7,6,-66,-67,1,2,171,372
807,77,4,2,6,7,42,25,3,7,213,397
807,78,2,4,7,6,25,42,8,9,238,439
807,79,4,2,6,7,-58,-75,0,4,180,364
807,80,6,2,10,3,64,21,4,5,244,385
807,81,2,5,4,9,22,54,6,9,266,439
807,82,4,3,8,5,-56,-68,0,1,210,371
807,83,3,5,7,6,34,51,4,2,244,422
807,84,3,4,4,9,31,45,5,7,275,467
807,85,4,2,6,7,42,-75,7,2,317,392
807,86,3,4,4,9,31,45,8,7,348,437
807,87,3,3,6,7,-67,-66,1,1,281,371
807,88,4,2,8,5,44,23,5,4,325,394
807,89,3,3,5,8,32,35,7,9,357,429
807,90,2,5,3,10,21,-45,8,4,378,384
807,91,2,5,8,5,-74,50,4,4,304,434
807,92,3,3,6,7,33,34,7,8,337,468
807,93,2,4,6,7,-76,-57,1,1,261,411
807,94,5,2,7,6,52,24,3,5,313,435
807,95,3,4,8,5,35,41,8,6,348,476
807,96,3,3,6,7,-67,-66,1,0,281,410
807,97,3,3,6,7,33,34,4,4,314,444
807,98,3,4,6,7,33,43,7,7,347,487
807,99,3,3,7,6,-66,-67,1,0,281,420
807,100,3,4,6,7,33,43,4,3,314,463
807,101,3,3,9,4,-64,31,0,4,250,494
807,102,3,3,8,5,35,32,5,6,285,526
808,1,3,3,4,9,31,36,1,6,31,36
808,2,2,4,6,7,24,43,5,9,55,79
808,3,4,3,5,8,41,-65,6,4,96,14
808,4,5,2,10,3,-45,21,1,5,51,35
808,5,2,4,6,7,24,43,5,8,75,78
808,6,3,4,7,6,34,-58,9,0,109,20
808,7,3,3,6,7,-67,34,2,4,42,54
808,8,3,3,6,7,33,34,5,8,75,88
808,9,2,5,5,8,23,-47,8,1,98,41
808,10,3,4,5,8,-68,44,0,5,30,85
808,11,3,3,8,5,35,32,5,7,65,117
808,12,3,4,6,7,33,-57,8,0,98,60
808,13,4,3,9,4,-55,31,3,1,43,91
808,14,4,2,10,3,46,21,9,2,89,112
808,15,2,5,3,10,-79,55,0,7,10,167
808,16,4,3,9,4,45,31,5,8,55,198
808,17,2,5,5,8,23,-47,8,1,78,151
808,18,2,4,5,8,-77,44,1,5,1,195
808,19,4,2,10,3,46,21,7,6,47,216
808,20,5,2,10,3,-45,21,2,7,2,237
808,21,3,4,6,7,33,-57,5,0,35,180
808,22,3,3,6,7,33,34,8,4,68,214
808,23,3,3,5,8,-68,35,0,9,0,249
808,24,3,4,8,5,35,-59,5,0,35,190
808,25,4,2,7,6,43,24,8,4,78,214
808,26,4,3,9,4,-55,31,3,5,23,245
808,27,3,3,7,6,34,33,7,8,57,278
808,28,3,4,6,7,-67,-57,0,1,-10,221
808,29,3,3,7,6,34,33,4,4,24,254
808,30,2,4,6,7,24,43,8,7,48,297
808,31,4,2,8,5,-56,-77,2,0,-8,220
808,32,4,2,8,5,44,23,6,3,36,243
808,33,5,2,9,4,-46,22,0,5,-10,265
808,34,4,3,7,6,43,33,3,8,33,298
808,35,4,2,7,6,43,-76,6,2,76,222
808,36,4,3,10,3,-54,30,2,2,22,252
808,37,4,3,8,5,44,32,6,4,66,284
808,38,4,3,5,8,41,35,7,9,107,319
808,39,2,6,2,11,20,-35,7,4,127,284
808,40,3,3,10,3,-63,30,4,4,64,314
808,41,4,3,8,5,44,32,8,6,108,346
808,42,2,4,8,5,-74,41,4,7,34,387
808,43,2,5,2,11,20,-44,4,3,54,343
808,44,2,5,3,10,21,55,5,8,75,398
808,45,5,2,10,3,-45,21,0,9,30,419
808,46,2,4,7,6,25,-58,5,1,55,361
808,47,3,4,9,4,-64,40,1,1,-9,401
808,48,2,5,6,7,24,52,5,3,15,453
808,49,3,3,5,8,32,35,7,8,47,488
808,50,6,2,10,3,-36,21,1,9,11,509
809,1,4,3,9,4,45,31,5,1,45,31
809,2,3,3,3,10,30,37,5,8,75,68
809,3,4,3,4,9,40,-64,5,4,115,4
809,4,5,3,8,5,53,32,8,6,168,36
809,5,5,2,9,4,-46,22,2,8,122,58
809,6,2,4,5,8,23,-56,5,2,145,2
809,7,2,5,6,7,24,52,9,4,169,54
809,8,3,3,10,3,-63,30,6,4,106,84
809,9,3,4,8,5,-65,41,1,5,41,125
809,10,3,4,7,6,34,42,5,7,75,167
809,11,2,4,6,7,24,-57,9,0,99,110
809,12,2,5,3,10,-79,55,0,5,20,165
809,13,3,3,4,9,31,-64,1,1,51,101
809,14,5,2,11,2,56,20,7,1,107,121
809,15,3,4,6,7,-67,43,0,4,40,164
809,16,3,4,6,7,33,43,3,7,73,207
809,17,4,4,6,7,42,-57,5,0,115,150
809,18,2,5,5,8,23,53,8,3,138,203
809,19,2,4,6,7,-76,43,2,6,62,246
809,20,2,4,5,8,23,-56,5,0,85,190
809,21,3,4,7,6,34,42,9,2,119,232
809,22,4,2,7,6,-57,24,2,6,62,256
809,23,2,5,7,6,25,51,7,7,87,307
809,24,3,4,6,7,-67,-57,0,0,20,250
809,25,4,3,7,6,43,33,3,3,63,283
809,26,2,4,4,9,22,45,5,8,85,328
809,27,3,4,7,6,34,-58,9,0,119,270
809,28,4,3,5,8,-59,35,0,5,60,305
809,29,3,3,4,9,31,-64,1,1,91,241
809,30,2,5,6,7,24,52,5,3,115,293
809,31,3,4,7,6,34,42,9,5,149,335
809,32,4,3,7,6,-57,33,2,8,92,368
809,33,3,4,5,8,32,-56,4,2,124,312
809,34,3,3,7,6,34,33,8,5,158,345
809,35,3,4,7,6,-66,42,2,7,92,387
809,36,5,2,7,6,52,-76,4,1,144,311
809,37,4,3,5,8,41,35,5,6,185,346
809,38,5,2,10,3,-45,21,0,7,140,367
809,39,4,3,7,6,43,-67,3,0,183,300
809,40,2,4,3,10,21,46,4,6,204,346
809,41,5,2,8,5,53,23,7,9,257,369
809,42,3,3,3,10,30,-63,7,6,287,306
809,43,4,3,9,4,-55,31,2,7,232,337
809,44,3,4,3,10,30,-54,2,3,262,283
809,45,2,6,3,10,21,64,3,7,283,347
809,46,2,4,6,7,24,-57,7,0,307,290
809,47,4,3,7,6,-57,33,0,3,250,323
809,48,3,3,8,5,35,32,5,5,285,355
809,49,3,3,9,4,-64,31,1,6,221,386
809,50,4,3,7,6,43,33,4,9,264,419
809,51,4,4,7,6,43,-58,7,1,307,361
809,52,2,4,6,7,-76,43,1,4,231,404
809,53,3,4,4,9,31,45,2,9,262,449
809,54,4,3,8,5,44,-68,6,1,306,381
809,55,3,4,6,7,33,43,9,4,339,424
809,56,4,2,8,5,-56,23,3,7,283,447
809,57,3,3,7,6,34,-67,7,0,317,380
809,58,3,3,8,5,-65,32,2,2,252,412
809,59,2,5,5,8,23,53,5,5,275,465
809,60,2,5,3,10,21,-45,6,0,296,420
809,61,2,4,4,9,22,45,8,5,318,465
809,62,6,2,9,4,-37,22,1,7,281,487
809,63,2,5,3,10,21,-45,2,2,302,442
809,64,4,2,6,7,42,25,4,7,344,467
809,65,2,4,7,6,25,42,9,9,369,509
810,1,3,3,6,7,33,34,3,4,33,34
810,2,2,5,6,7,24,52,7,6,57,86
810,3,4,3,9,4,-55,31,2,7,2,117
810,4,3,4,5,8,32,-56,4,1,34,61
810,5,2,4,5,8,23,44,7,5,57,105
810,6,5,2,8,5,-47,23,0,8,10,128
810,7,2,5,3,10,21,-45,1,3,31,83
810,8,4,3,7,6,43,33,4,6,74,116
810,9,2,6,2,11,20,-35,4,1,94,81
810,10,5,2,8,5,53,23,7,4,147,104
810,11,3,4,6,7,-67,43,0,7,80,147
810,12,5,2,10,3,55,21,5,8,135,168
810,13,6,2,8,5,62,-77,7,1,197,91
810,14,5,3,9,4,-46,31,1,2,151,122
810,15,3,3,7,6,34,33,5,5,185,155
810,16,4,4,5,8,41,44,6,9,226,199
810,17,2,4,4,9,22,-55,8,4,248,144
810,18,3,3,9,4,-64,31,4,5,184,175
810,19,3,3,6,7,33,34,7,9,217,209
810,20,4,3,6,7,42,-66,9,3,259,143
810,21,2,5,6,7,-76,52,3,5,183,195
810,22,5,2,6,7,51,-75,4,0,234,120
810,23,2,5,4,9,22,54,6,4,256,174
810,24,4,3,8,5,-56,32,0,6,200,206
810,25,3,4,5,8,32,-56,2,0,232,150
810,26,4,3,7,6,43,33,5,3,275,183
810,27,4,3,8,5,44,32,9,5,319,215
810,28,2,4,6,7,-76,43,3,8,243,258
810,29,4,2,9,4,45,-78,8,0,288,180
810,30,2,5,5,8,-77,53,1,3,211,233
810,31,4,3,6,7,42,34,3,7,253,267
810,32,4,3,8,5,44,32,7,9,297,299
810,33,4,3,8,5,-56,-68,1,1,241,231
810,34,3,4,4,9,31,45,2,6,272,276
810,35,3,3,6,7,33,-66,5,0,305,210
810,36,3,3,7,6,34,33,9,3,339,243
810,37,4,2,6,7,-58,25,1,8,281,268
810,38,4,3,5,8,41,-65,2,3,322,203
810,39,2,5,7,6,25,51,7,4,347,254
810,40,3,4,7,6,-66,42,1,6,281,296
810,41,4,2,10,3,46,21,7,7,327,317
810,42,3,4,4,9,31,-55,8,2,358,262
810,43,6,2,9,4,-37,22,1,4,321,284
810,44,4,2,6,7,42,25,3,9,363,309
810,45,5,2,8,5,53,-77,6,2,416,232
810,46,4,2,9,4,-55,22,1,4,361,254
810,47,3,3,6,7,33,34,4,8,394,288
810,48,5,2,10,3,55,21,9,9,449,309
810,49,3,4,4,9,-69,-55,0,4,380,254
810,50,6,2,9,4,63,22,3,6,443,276
810,51,5,2,10,3,55,21,8,7,498,297
810,52,3,4,7,6,-66,42,2,9,432,339
810,53,2,5,6,7,24,-48,6,1,456,291
810,54,4,3,6,7,42,34,8,5,498,325
810,55,3,3,5,8,-68,-65,0,0,430,260
810,56,2,5,5,8,23,53,3,3,453,313
810,57,2,5,3,10,21,55,4,8,474,368
810,58,3,3,6,7,33,-66,7,2,507,302
811,1,3,3,6,7,33,34,3,4,33,34
811,2,2,5,2,11,20,-44,3,0,53,-10
811,3,3,3,7,6,34,33,7,3,87,23
811,4,5,3,9,4,-46,31,1,4,41,54
811,5,4,2,9,4,45,22,6,6,86,76
811,6,2,4,4,9,22,-55,8,1,108,21
811,7,4,2,7,6,-57,24,1,5,51,45
811,8,3,4,5,8,32,44,3,9,83,89
811,9,3,3,8,5,35,-68,8,1,118,21
811,10,2,4,6,7,-76,43,2,4,42,64
811,11,4,2,8,5,44,23,6,7,86,87
811,12,3,3,7,6,-66,-67,0,0,20,20
811,13,4,3,10,3,46,30,6,0,66,50
811,14,3,4,5,8,32,44,8,4,98,94
811,15,5,2,10,3,-45,21,3,5,53,115
811,16,4,2,10,3,46,21,9,6,99,136
811,17,3,3,9,4,-64,31,5,7,35,167
811,18,3,4,5,8,32,-56,7,1,67,111
811,19,4,3,6,7,42,34,9,5,109,145
811,20,2,4,5,8,-77,44,2,9,32,189
811,21,3,4,5,8,32,-56,4,3,64,133
811,22,4,3,6,7,42,34,6,7,106,167
811,23,2,5,4,9,22,-46,8,1,128,121
811,24,3,3,7,6,-66,33,2,4,62,154
811,25,3,4,5,8,32,44,4,8,94,198
811,26,2,4,5,8,23,-56,7,2,117,142
811,27,4,2,7,6,-57,24,0,6,60,166
811,28,3,4,5,8,32,-56,2,0,92,110
811,29,6,2,11,2,65,20,7,0,157,130
811,30,5,2,11,2,-44,20,3,0,113,150
811,31,6,2,11,2,65,20,8,0,178,170
811,32,5,2,9,4,-46,22,2,2,132,192
811,33,3,3,5,8,32,35,4,7,164,227
811,34,4,2,7,6,43,-76,7,1,207,151
811,35,5,2,8,5,-47,23,0,4,160,174
811,36,2,5,4,9,22,54,2,8,182,228
811,37,2,4,4,9,22,-55,4,3,204,173
811,38,3,3,6,7,33,34,7,7,237,207
811,39,4,3,9,4,-55,31,2,8,182,238
811,40,2,5,5,8,23,-47,5,1,205,191
811,41,3,3,9,4,-64,31,1,2,141,222
811,42,3,3,6,7,33,34,4,6,174,256
811,43,3,4,6,7,33,43,7,9,207,299
811,44,3,3,8,5,-65,-68,2,1,142,231
811,45,3,4,5,8,32,44,4,5,174,275
811,46,5,2,9,4,54,22,8,7,228,297
811,47,3,3,6,7,-67,-66,1,1,161,231
811,48,2,4,9,4,27,40,8,1,188,271
811,49,2,4,7,6,-75,42,3,3,113,313
811,50,5,2,10,3,55,21,8,4,168,334
811,51,4,2,10,3,-54,21,4,5,114,355
811,52,3,3,5,8,32,-65,6,0,146,290
811,53,3,3,4,9,31,36,7,6,177,326
811,54,4,3,6,7,42,-66,9,0,219,260
811,55,4,3,10,3,-54,30,5,0,165,290
811,56,4,3,5,8,41,35,6,5,206,325
811,57,4,3,8,5,-56,32,0,7,150,357
811,58,4,2,7,6,43,-76,3,1,193,281
811,59,3,3,9,4,36,31,9,2,229,312
811,60,4,2,10,3,-54,21,5,3,175,333
811,61,2,4,3,10,21,46,6,9,196,379
811,62,3,3,6,7,33,-66,9,3,229,313
811,63,2,5,3,10,-79,55,0,8,150,368
811,64,3,3,5,8,32,-65,2,3,182,303
811,65,3,4,5,8,32,44,4,7,214,347
811,66,3,3,8,5,35,32,9,9,249,379
811,67,2,4,6,7,-76,-57,3,2,173,322
811,68,3,4,4,9,31,45,4,7,204,367
811,69,2,5,3,10,21,-45,5,2,225,322
811,70,5,2,6,7,51,25,6,7,276,347
811,71,4,2,9,4,-55,22,1,9,221,369
811,72,3,4,5,8,32,-56,3,3,253,313
811,73,2,4,4,9,22,45,5,8,275,358
811,74,5,2,11,2,-44,20,1,8,231,378
811,75,4,3,9,4,45,31,6,9,276,409
811,76,2,4,5,8,23,-56,9,3,299,353
811,77,3,3,5,8,-68,35,1,8,231,388
811,78,3,4,4,9,31,-55,2,3,262,333
811,79,3,3,6,7,33,34,5,7,295,367
811,80,4,2,9,4,-55,22,0,9,240,389
811,81,4,3,8,5,44,-68,4,1,284,321
811,82,4,3,7,6,43,33,7,4,327,354
811,83,2,5,7,6,-75,51,2,5,252,405
811,84,4,2,7,6,43,24,5,9,295,429
811,85,2,4,6,7,24,-57,9,2,319,372
811,86,5,2,8,5,-47,23,2,5,272,395
811,87,3,4,6,7,33,43,5,8,305,438
811,88,4,3,9,4,-55,31,0,9,250,469
811,89,3,4,5,8,32,-56,2,3,282,413
811,90,3,3,5,8,32,35,4,8,314,448
811,91,5,2,9,4,54,-78,8,0,368,370
811,92,4,3,5,8,41,35,9,5,409,405
811,93,4,3,8,5,-56,32,3,7,353,437
811,94,2,5,5,8,23,-47,6,0,376,390
811,95,4,3,8,5,-56,32,0,2,320,422
811,96,2,4,6,7,24,43,4,5,344,465
811,97,3,3,7,6,34,33,8,8,378,498
811,98,2,5,5,8,-77,-47,1,1,301,451
811,99,5,2,10,3,55,21,6,2,356,472
811,100,2,4,7,6,-75,42,1,4,281,514
812,1,3,3,9,4,36,31,6,1,36,31
812,2,3,4,7,6,-66,42,0,3,-30,73
812,3,3,5,2,11,-30,56,0,9,-60,129
812,4,4,3,5,8,41,-65,1,4,-19,64
812,5,3,4,4,9,31,45,2,9,12,109
812,6,4,2,6,7,42,-75,4,4,54,34
812,7,4,3,8,5,44,32,8,6,98,66
812,8,3,3,6,7,-67,-66,1,0,31,0
812,9,3,3,7,6,34,33,5,3,65,33
812,10,4,2,7,6,43,24,8,7,108,57
812,11,4,3,10,3,-54,30,4,7,54,87
812,12,3,5,8,5,35,50,9,7,89,137
812,13,4,3,8,5,-56,32,3,9,33,169
812,14,4,3,5,8,41,-65,4,4,74,104
812,15,2,4,7,6,25,42,9,6,99,146
812,16,4,2,9,4,-55,22,4,8,44,168
812,17,2,4,5,8,23,-56,7,2,67,112
812,18,2,5,4,9,22,54,9,6,89,166
812,19,4,2,10,3,-54,21,5,7,35,187
812,20,5,2,11,2,-44,20,1,7,-9,207
812,21,2,5,4,9,22,-46,3,1,13,161
812,22,3,5,3,10,30,55,3,6,43,216
812,23,2,5,5,8,23,53,6,9,66,269
812,24,2,4,6,7,-76,-57,0,2,-10,212
812,25,4,3,9,4,45,31,5,3,35,243
812,26,4,2,6,7,42,25,7,8,77,268
812,27,2,4,2,11,20,-53,7,5,97,215
812,28,3,3,6,7,-67,34,0,9,30,249
812,29,2,4,7,6,25,-58,5,1,55,191
812,30,2,5,6,7,24,52,9,3,79,243
812,31,2,4,6,7,-76,43,3,6,3,286
812,32,5,2,6,7,51,-75,4,1,54,211
812,33,5,2,10,3,55,21,9,2,109,232
812,34,4,3,8,5,-56,32,3,4,53,264
812,35,5,2,9,4,54,22,7,6,107,286
812,36,4,4,6,7,42,43,9,9,149,329
812,37,2,4,4,9,-78,-55,1,4,71,274
812,38,4,3,9,4,45,31,6,5,116,305
812,39,2,4,2,11,20,-53,6,2,136,252
812,40,3,3,8,5,-65,32,1,4,71,284
812,41,4,2,8,5,44,23,5,7,115,307
812,42,4,2,5,8,41,-74,6,3,156,233
812,43,3,3,5,8,32,35,8,8,188,268
812,44,5,2,10,3,-45,21,3,9,143,289
812,45,2,4,8,5,26,-59,9,0,169,230
812,46,3,4,5,8,-68,44,1,4,101,274
812,47,3,3,3,10,30,-63,1,1,131,211
812,48,2,4,4,9,22,45,3,6,153,256
812,49,3,3,4,9,31,-64,4,2,184,192
812,50,2,5,3,10,21,55,5,7,205,247
812,51,3,3,7,6,34,-67,9,0,239,180
812,52,4,3,8,5,-56,32,3,2,183,212
812,53,4,2,8,5,44,23,7,5,227,235
812,54,4,2,10,3,-54,21,3,6,173,256
812,55,2,4,5,8,23,-56,6,0,196,200
812,56,4,2,8,5,-56,23,0,3,140,223
812,57,5,2,11,2,56,20,6,3,196,243
812,58,4,3,7,6,43,33,9,6,239,276
812,59,3,3,6,7,-67,-66,2,0,172,210
812,60,5,3,7,6,52,33,4,3,224,243
812,61,5,2,8,5,53,23,7,6,277,266
812,62,3,4,5,8,32,-56,9,0,309,210
812,63,3,3,6,7,-67,34,2,4,242,244
812,64,3,4,4,9,31,45,3,9,273,289
812,65,4,2,5,8,41,-74,4,5,314,215
812,66,2,4,5,8,23,44,7,9,337,259
812,67,2,4,5,8,-77,-56,0,3,260,203
812,68,2,5,5,8,23,53,3,6,283,256
812,69,4,3,7,6,43,33,6,9,326,289
812,70,2,5,3,10,21,-45,7,4,347,244
812,71,3,3,7,6,-66,33,1,7,281,277
812,72,3,4,6,7,33,-57,4,0,314,220
812,73,4,3,7,6,43,33,7,3,357,253
812,74,2,5,5,8,-77,53,0,6,280,306
812,75,2,4,6,7,24,43,4,9,304,349
812,76,3,3,4,9,31,-64,5,5,335,285
812,77,3,4,5,8,32,44,7,9,367,329
812,78,4,2,9,4,-55,-78,2,1,312,251
812,79,2,5,2,11,20,56,2,7,332,307
812,80,2,4,4,9,22,-55,4,2,354,252
812,81,3,3,5,8,32,35,6,7,386,287
812,82,2,5,3,10,21,-45,7,2,407,242
812,83,2,4,5,8,-77,44,0,6,330,286
812,84,3,3,6,7,33,-66,3,0,363,220
812,85,3,3,8,5,35,32,8,2,398,252
812,86,2,4,4,9,-78,45,0,7,320,297
812,87,2,6,2,11,20,-35,0,2,340,262
812,88,4,2,8,5,44,23,4,5,384,285
812,89,4,3,8,5,44,32,8,7,428,317
812,90,2,4,7,6,-75,42,3,9,353,359
812,91,3,3,8,5,35,-68,8,1,388,291
812,92,4,3,8,5,-56,32,2,3,332,323
812,93,3,3,7,6,34,33,6,6,366,356
812,94,5,2,11,2,-44,20,2,6,322,376
812,95,5,2,9,4,54,22,6,8,376,398
812,96,4,2,8,5,-56,-77,0,1,320,321
812,97,4,3,8,5,44,32,4,3,364,353
812,98,2,5,7,6,25,51,9,4,389,404
812,99,2,4,4,9,-78,45,1,9,311,449
812,100,3,3,6,7,33,-66,4,3,344,383
812,101,4,2,8,5,44,23,8,6,388,406
812,102,3,4,8,5,-65,41,3,7,323,447
812,103,3,4,7,6,34,42,7,9,357,489
812,104,4,2,7,6,-57,-76,0,3,300,413
812,105,3,4,8,5,35,41,5,4,335,454
812,106,2,4,3,10,21,-54,6,0,356,400
812,107,4,3,5,8,41,35,7,5,397,435
812,108,2,5,5,8,-77,53,0,8,320,488
812,109,2,5,3,10,21,-45,1,3,341,443
812,110,6,2,10,3,64,21,5,4,405,464
812,111,2,4,6,7,24,43,9,7,429,507
813,1,5,2,11,2,56,20,6,0,56,20
813,2,3,3,7,6,-66,33,0,3,-10,53
813,3,4,2,7,6,43,24,3,7,33,77
813,4,3,3,5,8,32,-65,5,2,65,12
813,5,4,2,7,6,43,24,8,6,108,36
813,6,3,4,5,8,-68,-56,0,0,40,-20
813,7,5,2,10,3,55,21,5,1,95,1
813,8,4,3,9,4,-55,31,0,2,40,32
813,9,3,3,7,6,34,33,4,5,74,65
813,10,3,3,7,6,34,33,8,8,108,98
813,11,5,2,9,4,-46,-78,2,0,62,20
813,12,3,3,4,9,31,36,3,6,93,56
813,13,4,3,5,8,41,-65,4,1,134,-9
813,14,3,4,4,9,31,45,5,6,165,36
813,15,4,3,8,5,44,32,9,8,209,68
813,16,3,4,5,8,-68,-56,1,2,141,12
813,17,2,4,4,9,22,45,3,7,163,57
813,18,3,4,6,7,33,-57,6,0,196,0
813,19,2,5,4,9,22,54,8,4,218,54
813,20,4,3,7,6,-57,33,1,7,161,87
813,21,3,3,7,6,34,-67,5,0,195,20
813,22,3,4,5,8,32,44,7,4,227,64
813,23,5,2,10,3,-45,21,2,5,182,85
813,24,3,4,6,7,33,43,5,8,215,128
813,25,3,3,9,4,-64,31,1,9,151,159
813,26,2,5,7,6,25,-49,6,0,176,110
813,27,3,3,6,7,33,34,9,4,209,144
813,28,3,3,8,5,-65,32,4,6,144,176
813,29,2,5,3,10,21,-45,5,1,165,131
813,30,3,5,6,7,33,52,8,3,198,183
813,31,3,4,5,8,-68,44,0,7,130,227
813,32,3,3,7,6,34,-67,4,0,164,160
813,33,2,5,4,9,22,54,6,4,186,214
813,34,4,3,5,8,41,35,7,9,227,249
813,35,3,3,8,5,-65,-68,2,1,162,181
813,36,3,3,6,7,33,34,5,5,195,215
813,37,2,4,4,9,22,-55,7,0,217,160
813,38,3,3,6,7,-67,34,0,4,150,194
813,39,3,4,3,10,30,-54,0,0,180,140
813,40,5,2,9,4,54,22,4,2,234,162
813,41,2,4,3,10,21,46,5,8,255,208
813,42,4,3,6,7,42,-66,7,2,297,142
813,43,3,4,7,6,-66,42,1,4,231,184
813,44,3,5,5,8,32,53,3,7,263,237
813,45,2,4,6,7,24,-57,7,0,287,180
813,46,4,3,5,8,41,35,8,5,328,215
813,47,5,2,10,3,-45,21,3,6,283,236
813,48,2,4,7,6,25,42,8,8,308,278
813,49,2,4,7,6,-75,-58,3,0,233,220
813,50,3,4,7,6,34,42,7,2,267,262
813,51,2,4,5,8,-77,44,0,6,190,306
813,52,4,3,6,7,42,-66,2,0,232,240
813,53,2,4,4,9,22,45,4,5,254,285
813,54,3,4,5,8,32,44,6,9,286,329
813,55,3,4,6,7,33,-57,9,2,319,272
813,56,4,3,6,7,-58,34,1,6,261,306
813,57,4,2,9,4,45,22,6,8,306,328
813,58,3,3,9,4,-64,31,2,9,242,359
813,59,3,3,7,6,34,-67,6,2,276,292
813,60,2,4,3,10,21,46,7,8,297,338
813,61,5,2,9,4,-46,-78,1,0,251,260
813,62,4,3,6,7,42,34,3,4,293,294
813,63,5,2,9,4,54,22,7,6,347,316
813,64,3,4,6,7,-67,43,0,9,280,359
813,65,4,3,8,5,44,-68,4,1,324,291
813,66,5,2,8,5,53,23,7,4,377,314
813,67,4,2,8,5,-56,23,1,7,321,337
813,68,4,3,4,9,40,-64,1,3,361,273
813,69,3,3,5,8,32,35,3,8,393,308
813,70,4,2,8,5,44,-77,7,1,437,231
813,71,3,3,9,4,-64,31,3,2,373,262
813,72,2,4,6,7,24,43,7,5,397,305
813,73,4,3,10,3,-54,30,3,5,343,335
813,74,2,4,5,8,23,44,6,9,366,379
813,75,3,4,7,6,-66,-58,0,1,300,321
813,76,3,4,4,9,31,45,1,6,331,366
813,77,3,4,5,8,32,-56,3,0,363,310
813,78,3,3,6,7,33,34,6,4,396,344
813,79,3,3,8,5,-65,32,1,6,331,376
813,80,4,3,7,6,43,33,4,9,374,409
813,81,5,2,9,4,54,-78,8,1,428,331
813,82,3,4,4,9,31,45,9,6,459,376
813,83,3,3,6,7,-67,-66,2,0,392,310
813,84,4,3,5,8,41,35,3,5,433,345
813,85,5,2,10,3,55,21,8,6,488,366
813,86,4,3,8,5,-56,32,2,8,432,398
813,87,3,5,5,8,32,-47,4,1,464,351
813,88,3,4,5,8,32,44,6,5,496,395
813,89,4,3,9,4,-55,31,1,6,441,426
813,90,3,4,6,7,33,43,4,9,474,469
813,91,3,3,6,7,33,-66,7,3,507,403
814,1,4,3,8,5,44,32,4,2,44,32
814,2,5,2,8,5,53,23,7,5,97,55
814,3,4,3,6,7,42,34,9,9,139,89
814,4,3,4,4,9,-69,-55,0,4,70,34
814,5,3,3,4,9,31,-64,1,0,101,-30
814,6,4,3,10,3,46,30,7,0,147,0
814,7,2,4,2,11,20,47,7,7,167,47
814,8,3,4,6,7,-67,-57,0,0,100,-10
814,9,3,5,5,8,32,53,2,3,132,43
814,10,3,3,6,7,33,34,5,7,165,77
814,11,3,4,5,8,32,-56,7,1,197,21
814,12,4,4,7,6,-57,42,0,3,140,63
814,13,3,4,4,9,31,45,1,8,171,108
814,14,3,4,5,8,32,-56,3,2,203,52
814,15,3,3,8,5,35,32,8,4,238,84
814,16,2,4,7,6,-75,42,3,6,163,126
814,17,4,2,8,5,44,23,7,9,207,149
814,18,3,4,8,5,-65,-59,2,0,142,90
814,19,4,3,9,4,45,31,7,1,187,121
814,20,3,4,5,8,32,44,9,5,219,165
814,21,3,4,4,9,-69,-55,0,0,150,110
814,22,3,3,5,8,32,35,2,5,182,145
814,23,3,3,6,7,33,34,5,9,215,179
814,24,3,5,4,9,31,-46,6,3,246,133
814,25,2,5,6,7,-76,52,0,5,170,185
814,26,3,3,7,6,34,33,4,8,204,218
814,27,4,3,9,4,45,31,9,9,249,249
814,28,3,4,7,6,-66,-58,3,1,183,191
814,29,4,2,9,4,45,22,8,3,228,213
814,30,3,3,8,5,-65,32,3,5,163,245
814,31,2,6,5,8,23,62,6,7,186,307
814,32,4,2,8,5,-56,-77,0,0,130,230
814,33,5,2,9,4,54,22,4,2,184,252
814,34,3,4,8,5,35,41,9,3,219,293
814,35,4,2,9,4,-55,22,4,5,164,315
814,36,4,3,6,7,42,34,6,9,206,349
814,37,3,3,8,5,-65,-68,1,1,141,281
814,38,4,2,8,5,44,23,5,4,185,304
814,39,5,2,11,2,-44,20,1,4,141,324
814,40,6,2,8,5,62,23,3,7,203,347
814,41,2,5,4,9,22,-46,5,1,225,301
814,42,2,5,4,9,22,54,7,5,247,355
814,43,3,3,4,9,31,-64,8,1,278,291
814,44,3,3,6,7,-67,34,1,5,211,325
814,45,2,4,7,6,25,42,6,7,236,367
814,46,4,2,7,6,43,-76,9,1,279,291
814,47,3,3,7,6,-66,33,3,4,213,324
814,48,4,2,9,4,45,22,8,6,258,346
814,49,4,2,7,6,-57,-76,1,0,201,270
814,50,2,5,2,11,20,56,1,6,221,326
814,51,3,3,5,8,32,-65,3,1,253,261
814,52,3,3,5,8,32,35,5,6,285,296
814,53,4,3,9,4,-55,31,0,7,230,327
814,54,5,3,9,4,54,31,4,8,284,358
814,55,4,3,8,5,44,-68,8,0,328,290
814,56,5,2,9,4,-46,22,2,2,282,312
814,57,3,3,4,9,31,36,3,8,313,348
814,58,3,4,6,7,33,-57,6,1,346,291
814,59,3,3,8,5,-65,32,1,3,281,323
814,60,2,4,4,9,22,45,3,8,303,368
814,61,3,4,5,8,32,-56,5,2,335,312
814,62,4,2,7,6,43,24,8,6,378,336
814,63,3,3,8,5,-65,32,3,8,313,368
814,64,2,4,4,9,22,-55,5,3,335,313
814,65,5,2,8,5,53,23,8,6,388,336
814,66,3,4,4,9,31,-55,9,1,419,281
814,67,4,2,5,8,-59,26,0,7,360,307
814,68,3,4,4,9,31,-55,1,2,391,252
814,69,3,4,5,8,32,44,3,6,423,296
814,70,2,5,3,10,21,-45,4,1,444,251
814,71,3,4,5,8,32,44,6,5,476,295
814,72,2,4,7,6,-75,42,1,7,401,337
814,73,3,5,8,5,35,50,6,7,436,387
814,74,4,2,6,7,42,-75,8,2,478,312
814,75,4,3,10,3,-54,30,4,2,424,342
814,76,2,4,5,8,23,44,7,6,447,386
814,77,3,4,7,6,-66,42,1,8,381,428
814,78,6,2,9,4,63,-78,4,0,444,350
814,79,3,4,5,8,32,44,6,4,476,394
814,80,2,5,7,6,-75,51,1,5,401,445
814,81,3,4,5,8,32,44,3,9,433,489
814,82,2,4,6,7,24,-57,7,2,457,432
814,83,4,2,10,3,-54,21,3,3,403,453
814,84,2,4,7,6,25,42,8,5,428,495
814,85,5,2,9,4,-46,22,2,7,382,517
815,1,3,4,7,6,34,42,4,2,34,42
815,2,4,3,5,8,41,35,5,7,75,77
815,3,2,4,5,8,23,-56,8,1,98,21
815,4,4,4,6,7,-58,43,0,4,40,64
815,5,4,3,10,3,46,30,6,4,86,94
815,6,2,5,3,10,21,55,7,9,107,149
815,7,3,4,5,8,32,-56,9,3,139,93
815,8,4,3,7,6,-57,33,2,6,82,126
815,9,3,3,8,5,35,32,7,8,117,158
815,10,4,3,5,8,41,-65,8,3,158,93
815,11,5,2,8,5,-47,23,1,6,111,116
815,12,4,3,10,3,46,30,7,6,157,146
815,13,4,2,10,3,-54,21,3,7,103,167
815,14,3,4,7,6,34,42,7,9,137,209
815,15,3,3,9,4,-64,-69,3,0,73,140
815,16,3,4,6,7,33,43,6,3,106,183
815,17,4,2,8,5,-56,23,0,6,50,206
815,18,2,4,6,7,24,43,4,9,74,249
815,19,4,3,8,5,44,-68,8,1,118,181
815,20,5,2,10,3,-45,21,3,2,73,202
815,21,2,4,7,6,25,42,8,4,98,244
815,22,3,4,5,8,-68,44,0,8,30,288
815,23,4,2,8,5,44,-77,4,1,74,211
815,24,3,4,5,8,32,44,6,5,106,255
815,25,2,4,2,11,20,-53,6,2,126,202
815,26,3,3,9,4,-64,31,2,3,62,233
815,27,4,3,6,7,42,34,4,7,104,267
815,28,6,2,9,4,63,22,7,9,167,289
815,29,5,2,10,3,-45,-79,2,0,122,210
815,30,3,4,3,10,30,46,2,6,152,256
815,31,4,3,5,8,41,-65,3,1,193,191
815,32,3,4,4,9,31,45,4,6,224,236
815,33,3,4,4,9,31,-55,5,1,255,181
815,34,4,3,6,7,42,34,7,5,297,215
815,35,5,2,11,2,-44,20,3,5,253,235
815,36,5,2,11,2,56,20,9,5,309,255
815,37,3,3,6,7,-67,34,2,9,242,289
815,38,3,5,5,8,32,-47,4,2,274,242
815,39,2,4,6,7,24,43,8,5,298,285
815,40,3,3,5,8,-68,-65,0,0,230,220
815,41,4,3,8,5,44,32,4,2,274,252
815,42,4,2,11,2,-53,20,1,2,221,272
815,43,3,4,5,8,32,44,3,6,253,316
815,44,2,6,3,10,21,-36,4,0,274,280
815,45,4,3,10,3,-54,30,0,0,220,310
815,46,2,6,4,9,22,63,2,3,242,373
815,47,2,5,5,8,23,53,5,6,265,426
815,48,3,3,5,8,32,-65,7,1,297,361
815,49,2,5,3,10,21,55,8,6,318,416
815,50,3,4,5,8,-68,-56,0,0,250,360
815,51,4,3,8,5,44,32,4,2,294,392
815,52,4,3,5,8,41,35,5,7,335,427
815,53,3,3,9,4,-64,31,1,8,271,458
815,54,4,2,11,2,47,20,8,8,318,478
815,55,3,4,4,9,31,-55,9,3,349,423
815,56,4,3,8,5,-56,32,3,5,293,455
815,57,3,3,7,6,34,33,7,8,327,488
815,58,2,4,5,8,-77,-56,0,2,250,432
815,59,4,2,7,6,43,24,3,6,293,456
815,60,4,3,6,7,42,-66,5,0,335,390
815,61,3,4,5,8,32,44,7,4,367,434
815,62,3,3,9,4,-64,31,3,5,303,465
815,63,2,4,5,8,23,44,6,9,326,509
816,1,5,2,9,4,54,22,4,2,54,22
816,2,3,4,7,6,34,42,8,4,88,64
816,3,2,5,3,10,21,55,9,9,109,119
816,4,4,2,8,5,-56,-77,3,2,53,42
816,5,3,4,7,6,34,42,7,4,87,84
816,6,3,4,4,9,31,45,8,9,118,129
816,7,4,3,7,6,-57,-67,1,2,61,62
816,8,4,4,4,9,40,45,1,7,101,107
816,9,4,3,6,7,42,-66,3,1,143,41
816,10,2,4,5,8,23,44,6,5,166,85
816,11,4,2,9,4,-55,22,1,7,111,107
816,12,4,2,8,5,44,-77,5,0,155,30
816,13,3,3,7,6,34,33,9,3,189,63
816,14,2,4,7,6,-75,42,4,5,114,105
816,15,4,3,9,4,45,31,9,6,159,136
816,16,4,2,10,3,-54,21,5,7,105,157
816,17,4,3,6,7,42,-66,7,1,147,91
816,18,2,5,4,9,22,54,9,5,169,145
816,19,3,3,6,7,-67,34,2,9,102,179
816,20,3,3,6,7,33,-66,5,3,135,113
816,21,2,4,3,10,21,46,6,9,156,159
816,22,2,4,8,5,-74,-59,2,0,82,100
816,23,3,3,6,7,33,34,5,4,115,134
816,24,4,3,8,5,44,32,9,6,159,166
816,25,4,2,9,4,-55,22,4,8,104,188
816,26,5,2,11,2,-44,20,0,8,60,208
816,27,2,5,2,11,20,-44,0,4,80,164
816,28,4,3,5,8,41,35,1,9,121,199
816,29,3,3,5,8,32,-65,3,4,153,134
816,30,4,3,6,7,42,34,5,8,195,168
816,31,2,4,6,7,24,-57,9,1,219,111
816,32,3,4,6,7,-67,43,2,4,152,154
816,33,3,4,8,5,35,41,7,5,187,195
816,34,3,3,8,5,-65,32,2,7,122,227
816,35,4,2,8,5,44,-77,6,0,166,150
816,36,2,4,2,11,20,47,6,7,186,197
816,37,4,2,6,7,42,-75,8,2,228,122
816,38,4,2,6,7,-58,25,0,7,170,147
816,39,4,3,9,4,45,31,5,8,215,178
816,40,4,2,9,4,-55,-78,0,0,160,100
816,41,5,2,9,4,54,22,4,2,214,122
816,42,3,4,5,8,32,44,6,6,246,166
816,43,3,3,7,6,-66,33,0,9,180,199
816,44,2,4,5,8,23,-56,3,3,203,143
816,45,4,3,9,4,45,31,8,4,248,174
816,46,3,3,8,5,-65,32,3,6,183,206
816,47,3,3,6,7,33,-66,6,0,216,140
816,48,3,3,8,5,-65,32,1,2,151,172
816,49,3,3,8,5,35,32,6,4,186,204
816,50,3,4,4,9,31,45,7,9,217,249
816,51,3,4,4,9,31,-55,8,4,248,194
816,52,3,3,6,7,-67,34,1,8,181,228
816,53,3,3,8,5,35,-68,6,0,216,160
816,54,4,2,7,6,43,24,9,4,259,184
816,55,4,2,7,6,-57,24,2,8,202,208
816,56,4,3,6,7,42,-66,4,2,244,142
816,57,3,3,9,4,-64,31,0,3,180,173
816,58,3,3,3,10,30,-63,0,0,210,110
816,59,2,6,3,10,21,64,1,4,231,174
816,60,4,2,11,2,47,20,8,4,278,194
816,61,4,2,10,3,-54,21,4,5,224,215
816,62,3,3,8,5,35,32,9,7,259,247
816,63,4,2,4,9,40,-73,9,4,299,174
816,64,5,2,10,3,-45,21,4,5,254,195
816,65,3,3,8,5,35,32,9,7,289,227
816,66,4,3,7,6,-57,-67,2,0,232,160
816,67,6,2,10,3,64,21,6,1,296,181
816,68,4,3,5,8,41,35,7,6,337,216
816,69,4,3,9,4,-55,31,2,7,282,247
816,70,2,4,6,7,24,-57,6,0,306,190
816,71,4,3,5,8,41,35,7,5,347,225
816,72,4,2,5,8,41,-74,8,1,388,151
816,73,3,4,5,8,-68,44,0,5,320,195
816,74,2,5,4,9,22,54,2,9,342,249
816,75,4,3,5,8,41,-65,3,4,383,184
816,76,3,3,7,6,34,33,7,7,417,217
816,77,3,3,5,8,32,-65,9,2,449,152
816,78,3,4,6,7,-67,43,2,5,382,195
816,79,5,2,8,5,53,23,5,8,435,218
816,80,4,4,6,7,42,-57,7,1,477,161
816,81,2,5,4,9,22,54,9,5,499,215
816,82,2,4,3,10,-79,-54,0,1,420,161
816,83,3,3,9,4,36,31,6,2,456,192
816,84,4,2,10,3,-54,21,2,3,402,213
816,85,4,2,8,5,44,23,6,6,446,236
816,86,2,5,5,8,23,53,9,9,469,289
816,87,2,4,6,7,-76,-57,3,2,393,232
816,88,4,3,5,8,41,35,4,7,434,267
816,89,3,3,6,7,33,-66,7,1,467,201
816,90,3,4,8,5,-65,41,2,2,402,242
816,91,2,5,8,5,26,50,8,2,428,292
816,92,2,5,6,7,-76,52,2,4,352,344
816,93,4,3,8,5,44,32,6,6,396,376
816,94,3,3,3,10,30,-63,6,3,426,313
816,95,5,2,11,2,-44,20,2,3,382,333
816,96,3,3,7,6,34,33,6,6,416,366
816,97,2,4,6,7,-76,43,0,9,340,409
816,98,4,2,7,6,43,-76,3,3,383,333
816,99,5,2,7,6,52,24,5,7,435,357
816,100,4,3,8,5,44,32,9,9,479,389
816,101,3,4,3,10,30,-54,9,5,509,335
817,1,3,4,8,5,35,41,5,1,35,41
817,2,2,5,3,10,21,55,6,6,56,96
817,3,3,4,3,10,30,-54,6,2,86,42
817,4,5,2,10,3,-45,21,1,3,41,63
817,5,3,4,5,8,32,44,3,7,73,107
817,6,5,2,11,2,56,20,9,7,129,127
817,7,3,3,8,5,-65,32,4,9,64,159
817,8,2,5,4,9,22,-46,6,3,86,113
817,9,4,3,6,7,42,34,8,7,128,147
817,10,4,2,5,8,41,-74,9,3,169,73
817,11,4,3,7,6,-57,33,2,6,112,106
817,12,5,2,8,5,53,23,5,9,165,129
817,13,3,4,7,6,34,-58,9,1,199,71
817,14,4,3,9,4,-55,31,4,2,144,102
817,15,4,2,9,4,45,22,9,4,189,124
817,16,4,2,6,7,-58,25,1,9,131,149
817,17,4,3,7,6,43,-67,4,2,174,82
817,18,4,2,9,4,45,22,9,4,219,104
817,19,4,3,8,5,-56,32,3,6,163,136
817,20,4,2,8,5,44,23,7,9,207,159
817,21,3,4,7,6,-66,-58,1,1,141,101
817,22,4,2,7,6,43,24,4,5,184,125
817,23,3,3,6,7,33,34,7,9,217,159
817,24,4,3,8,5,-56,-68,1,1,161,91
817,25,3,4,6,7,33,43,4,4,194,134
817,26,3,3,6,7,33,34,7,8,227,168
817,27,3,3,6,7,-67,-66,0,2,160,102
817,28,2,4,5,8,23,44,3,6,183,146
817,29,3,4,7,6,34,42,7,8,217,188
817,30,4,3,10,3,-54,30,3,8,163,218
817,31,5,2,9,4,54,-78,7,0,217,140
817,32,2,5,5,8,-77,53,0,3,140,193
817,33,3,3,8,5,35,32,5,5,175,225
817,34,3,3,8,5,-65,32,0,7,110,257
817,35,4,2,7,6,43,-76,3,1,153,181
817,36,3,3,5,8,32,35,5,6,185,216
817,37,3,4,8,5,-65,41,0,7,120,257
817,38,4,3,5,8,41,-65,1,2,161,192
817,39,3,3,7,6,34,33,5,5,195,225
817,40,3,4,6,7,33,43,8,8,228,268
817,41,3,3,8,5,-65,-68,3,0,163,200
817,42,4,2,6,7,42,25,5,5,205,225
817,43,2,4,6,7,24,43,9,8,229,268
817,44,4,3,6,7,-58,-66,1,2,171,202
817,45,5,2,10,3,55,21,6,3,226,223
817,46,4,2,8,5,-56,23,0,6,170,246
817,47,3,4,6,7,33,43,3,9,203,289
817,48,4,3,9,4,45,-69,8,0,248,220
817,49,4,3,8,5,-56,32,2,2,192,252
817,50,4,3,6,7,42,34,4,6,234,286
817,51,3,4,5,8,32,-56,6,0,266,230
817,52,4,4,8,5,-56,41,0,1,210,271
817,53,2,4,3,10,21,46,1,7,231,317
817,54,4,3,8,5,44,32,5,9,275,349
817,55,4,4,7,6,43,-58,8,1,318,291
817,56,3,3,9,4,-64,31,4,2,254,322
817,57,3,3,7,6,34,33,8,5,288,355
817,58,4,4,4,9,40,-55,8,0,328,300
817,59,2,4,5,8,-77,44,1,4,251,344
817,60,3,4,4,9,31,45,2,9,282,389
817,61,4,2,8,5,44,-77,6,2,326,312
817,62,4,3,7,6,43,33,9,5,369,345
817,63,3,4,7,6,-66,42,3,7,303,387
817,64,4,3,6,7,42,-66,5,1,345,321
817,65,3,4,5,8,32,44,7,5,377,365
817,66,2,5,2,11,20,-44,7,1,397,321
817,67,3,3,8,5,-65,32,2,3,332,353
817,68,2,5,4,9,22,54,4,7,354,407
817,69,4,3,9,4,45,31,9,8,399,438
817,70,5,2,9,4,-46,-78,3,0,353,360
817,71,4,3,7,6,43,33,6,3,396,393
817,72,4,3,7,6,43,33,9,6,439,426
817,73,3,3,9,4,-64,31,5,7,375,457
817,74,4,3,5,8,41,-65,6,2,416,392
817,75,4,2,8,5,-56,23,0,5,360,415
817,76,4,2,10,3,46,21,6,6,406,436
817,77,2,4,4,9,22,-55,8,1,428,381
817,78,4,3,8,5,-56,32,2,3,372,413
817,79,3,3,8,5,35,32,7,5,407,445
817,80,4,3,6,7,42,34,9,9,449,479
817,81,4,2,6,7,-58,-75,1,4,391,404
817,82,2,5,2,11,20,-44,1,0,411,360
817,83,4,3,8,5,44,32,5,2,455,392
817,84,4,3,9,4,-55,31,0,3,400,423
817,85,3,4,7,6,34,42,4,5,434,465
817,86,3,5,6,7,33,52,7,7,467,517
818,1,5,2,5,8,50,26,0,6,50,26
818,2,5,2,10,3,55,21,5,7,105,47
818,3,3,4,7,6,34,42,9,9,139,89
818,4,3,3,9,4,-64,-69,5,0,75,20
818,5,3,4,5,8,32,44,7,4,107,64
818,6,4,2,11,2,-53,20,4,4,54,84
818,7,5,2,11,2,-44,20,0,4,10,104
818,8,3,4,5,8,32,44,2,8,42,148
818,9,2,5,5,8,23,-47,5,1,65,101
818,10,3,5,6,7,33,52,8,3,98,153
818,11,2,4,7,6,-75,42,3,5,23,195
818,12,4,3,6,7,42,34,5,9,65,229
818,13,5,2,11,2,-44,20,1,9,21,249
818,14,4,3,8,5,44,-68,5,1,65,181
818,15,2,5,4,9,22,54,7,5,87,235
818,16,5,2,7,6,52,24,9,9,139,259
818,17,6,2,11,2,-35,20,4,9,104,279
818,18,3,3,6,7,33,-66,7,3,137,213
818,19,4,3,6,7,42,34,9,7,179,247
818,20,2,4,4,9,-78,-55,1,2,101,192
818,21,3,3,4,9,31,36,2,8,132,228
818,22,4,3,7,6,43,-67,5,1,175,161
818,23,4,3,5,8,41,35,6,6,216,196
818,24,5,2,11,2,-44,20,2,6,172,216
818,25,3,3,4,9,31,-64,3,2,203,152
818,26,4,3,6,7,42,34,5,6,245,186
818,27,4,3,8,5,44,32,9,8,289,218
818,28,6,2,10,3,-36,21,3,9,253,239
818,29,5,2,6,7,51,-75,4,4,304,164
818,30,3,4,5,8,32,44,6,8,336,208
818,31,3,4,7,6,-66,-58,0,0,270,150
818,32,5,2,6,7,51,25,1,5,321,175
818,33,2,5,4,9,22,54,3,9,343,229
818,34,5,2,11,2,56,20,9,9,399,249
818,35,6,2,8,5,-38,-77,1,2,361,172
818,36,2,4,5,8,23,44,4,6,384,216
818,37,3,3,8,5,35,32,9,8,419,248
818,38,5,2,10,3,-45,21,4,9,374,269
818,39,3,4,4,9,31,-55,5,4,405,214
818,40,3,4,5,8,32,44,7,8,437,258
818,41,5,2,10,3,-45,21,2,9,392,279
818,42,2,4,3,10,21,-54,3,5,413,225
818,43,2,6,4,9,22,63,5,8,435,288
818,44,4,2,7,6,43,-76,8,2,478,212
818,45,2,4,5,8,-77,44,1,6,401,256
818,46,2,4,4,9,22,-55,3,1,423,201
818,47,3,4,4,9,31,45,4,6,454,246
818,48,5,2,6,7,51,-75,5,1,505,171
819,1,3,3,5,8,32,35,2,5,32,35
819,2,3,4,5,8,32,44,4,9,64,79
819,3,3,4,5,8,32,-56,6,3,96,23
819,4,5,2,8,5,53,23,9,6,149,46
819,5,3,4,6,7,-67,43,2,9,82,89
819,6,3,4,6,7,33,-57,5,2,115,32
819,7,4,4,6,7,42,43,7,5,157,75
819,8,4,2,5,8,41,-74,8,1,198,1
819,9,4,2,6,7,-58,25,0,6,140,26
819,10,5,2,10,3,55,21,5,7,195,47
819,11,6,2,9,4,63,22,8,9,258,69
819,12,3,3,5,8,-68,-65,0,4,190,4
819,13,3,3,9,4,36,31,6,5,226,35
819,14,3,4,7,6,-66,42,0,7,160,77
819,15,2,5,5,8,23,-47,3,0,183,30
819,16,4,3,8,5,44,32,7,2,227,62
819,17,3,4,7,6,-66,42,1,4,161,104
819,18,4,2,8,5,44,23,5,7,205,127
819,19,5,2,9,4,54,22,9,9,259,149
819,20,4,3,8,5,-56,-68,3,1,203,81
819,21,4,3,7,6,43,33,6,4,246,114
819,22,4,3,5,8,41,35,7,9,287,149
819,23,3,3,8,5,-65,-68,2,1,222,81
819,24,3,4,7,6,34,42,6,3,256,123
819,25,3,3,5,8,32,35,8,8,288,158
819,26,5,2,9,4,-46,-78,2,0,242,80
819,27,3,4,6,7,33,43,5,3,275,123
819,28,3,4,6,7,33,43,8,6,308,166
819,29,5,2,9,4,-46,22,2,8,262,188
819,30,5,2,8,5,53,-77,5,1,315,111
819,31,3,4,4,9,31,45,6,6,346,156
819,32,3,3,5,8,32,-65,8,1,378,91
819,33,3,3,5,8,-68,35,0,6,310,126
819,34,2,4,4,9,22,-55,2,1,332,71
819,35,3,3,6,7,33,34,5,5,365,105
819,36,4,2,10,3,-54,21,1,6,311,126
819,37,3,4,6,7,33,43,4,9,344,169
819,38,4,3,8,5,44,-68,8,1,388,101
819,39,2,4,5,8,-77,44,1,5,311,145
819,40,3,4,6,7,33,43,4,8,344,188
819,41,3,3,6,7,33,-66,7,2,377,122
819,42,5,3,9,4,-46,31,1,3,331,153
819,43,2,4,6,7,24,43,5,6,355,196
819,44,3,4,5,8,32,-56,7,0,387,140
819,45,2,6,2,11,20,65,7,5,407,205
819,46,3,3,5,8,32,-65,9,0,439,140
819,47,4,3,5,8,-59,35,0,5,380,175
819,48,3,4,5,8,32,44,2,9,412,219
819,49,3,5,5,8,32,-47,4,2,444,172
819,50,4,3,5,8,41,35,5,7,485,207
819,51,2,5,2,11,20,-44,5,3,505,163
820,1,4,2,10,3,46,21,6,1,46,21
820,2,4,3,5,8,41,35,7,6,87,56
820,3,3,3,8,5,-65,32,2,8,22,88
820,4,4,2,7,6,43,-76,5,2,65,12
820,5,4,2,9,4,-55,22,0,4,10,34
820,6,4,2,6,7,42,25,2,9,52,59
820,7,5,2,7,6,52,-76,4,3,104,-17
820,8,4,2,5,8,41,26,5,9,145,9
820,9,3,3,8,5,-65,-68,0,1,80,-59
820,10,2,4,7,6,25,42,5,3,105,-17
820,11,2,5,6,7,24,52,9,5,129,35
820,12,2,4,8,5,-74,41,5,6,55,76
820,13,4,2,8,5,44,23,9,9,99,99
820,14,3,4,3,10,30,-54,9,5,129,45
820,15,2,5,4,9,-78,54,1,9,51,99
820,16,4,3,9,4,45,-69,6,0,96,30
820,17,2,4,5,8,23,44,9,4,119,74
820,18,4,2,8,5,-56,23,3,7,63,97
820,19,3,4,7,6,34,42,7,9,97,139
820,20,3,3,5,8,32,-65,9,4,129,74
820,21,5,2,11,2,-44,20,5,4,85,94
820,22,3,4,5,8,32,44,7,8,117,138
820,23,3,3,7,6,-66,-67,1,1,51,71
820,24,4,2,7,6,43,24,4,5,94,95
820,25,4,3,8,5,44,32,8,7,138,127
820,26,2,5,5,8,-77,-47,1,0,61,80
820,27,2,5,3,10,21,55,2,5,82,135
820,28,2,5,3,10,21,-45,3,0,103,90
820,29,5,2,10,3,55,21,8,1,158,111
820,30,4,2,7,6,-57,24,1,5,101,135
820,31,3,3,7,6,34,33,5,8,135,168
820,32,2,5,2,11,20,-44,5,4,155,124
820,33,3,3,9,4,-64,31,1,5,91,155
820,34,4,3,6,7,42,34,3,9,133,189
820,35,4,3,7,6,43,-67,6,2,176,122
820,36,4,3,4,9,40,36,6,8,216,158
820,37,5,2,9,4,-46,-78,0,0,170,80
820,38,3,4,7,6,34,42,4,2,204,122
820,39,2,4,4,9,22,45,6,7,226,167
820,40,4,2,10,3,-54,21,2,8,172,188
820,41,3,4,7,6,34,-58,6,0,206,130
820,42,3,3,6,7,33,34,9,4,239,164
820,43,2,5,4,9,-78,54,1,8,161,218
820,44,3,3,4,9,31,-64,2,4,192,154
820,45,4,2,6,7,42,25,4,9,234,179
820,46,3,3,5,8,32,-65,6,4,266,114
820,47,3,3,7,6,-66,33,0,7,200,147
820,48,3,4,7,6,34,42,4,9,234,189
820,49,4,2,7,6,43,-76,7,3,277,113
820,50,2,5,2,11,20,56,7,9,297,169
820,51,3,4,6,7,-67,-57,0,2,230,112
820,52,3,3,9,4,36,31,6,3,266,143
820,53,5,2,10,3,-45,21,1,4,221,164
820,54,4,3,5,8,41,35,2,9,262,199
820,55,4,2,8,5,44,-77,6,2,306,122
820,56,4,2,10,3,-54,21,2,3,252,143
820,57,3,4,5,8,32,44,4,7,284,187
820,58,2,4,3,10,21,-54,5,3,305,133
820,59,3,4,5,8,32,44,7,7,337,177
820,60,3,4,6,7,-67,-57,0,0,270,120
820,61,4,2,5,8,41,26,1,6,311,146
820,62,4,3,7,6,43,33,4,9,354,179
820,63,2,5,2,11,20,-44,4,5,374,135
820,64,5,2,10,3,55,21,9,6,429,156
820,65,2,5,4,9,-78,-46,1,0,351,110
820,66,4,2,8,5,44,23,5,3,395,133
820,67,3,3,9,4,-64,31,1,4,331,164
820,68,5,2,8,5,53,23,4,7,384,187
820,69,3,4,5,8,32,-56,6,1,416,131
820,70,4,3,8,5,-56,32,0,3,360,163
820,71,4,2,7,6,43,24,3,7,403,187
820,72,2,5,4,9,22,-46,5,1,425,141
820,73,5,2,7,6,52,24,7,5,477,165
820,74,3,3,8,5,-65,32,2,7,412,197
820,75,2,4,1,12,-20,-52,2,5,392,145
820,76,4,2,11,2,47,20,9,5,439,165
820,77,3,3,9,4,-64,31,5,6,375,196
820,78,4,2,10,3,-54,21,1,7,321,217
820,79,2,4,5,8,23,-56,4,1,344,161
820,80,3,4,4,9,31,45,5,6,375,206
820,81,4,2,8,5,44,23,9,9,419,229
820,82,2,4,6,7,-76,-57,3,2,343,172
820,83,5,3,5,8,50,35,3,7,393,207
820,84,4,3,5,8,41,-65,4,2,434,142
820,85,2,4,6,7,24,43,8,5,458,185
820,86,3,4,3,10,30,-54,8,1,488,131
820,87,5,2,9,4,-46,22,2,3,442,153
820,88,2,4,5,8,23,44,5,7,465,197
820,89,2,4,5,8,23,-56,8,1,488,141
820,90,3,3,5,8,-68,35,0,6,420,176
820,91,2,4,6,7,24,43,4,9,444,219
820,92,4,3,5,8,41,-65,5,4,485,154
820,93,3,4,8,5,-65,41,0,5,420,195
820,94,5,3,8,5,53,32,3,7,473,227
820,95,3,3,5,8,32,-65,5,2,505,162
821,1,4,3,9,4,45,31,5,1,45,31
821,2,2,4,4,9,22,45,7,6,67,76
821,3,3,3,8,5,-65,32,2,8,2,108
821,4,3,3,8,5,35,-68,7,0,37,40
821,5,4,3,6,7,42,34,9,4,79,74
821,6,3,4,4,9,-69,45,0,9,10,119
821,7,4,3,5,8,41,-65,1,4,51,54
821,8,3,3,7,6,34,33,5,7,85,87
821,9,5,2,10,3,-45,21,0,8,40,108
821,10,2,4,3,10,21,-54,1,4,61,54
821,11,4,3,7,6,43,33,4,7,104,87
821,12,5,2,8,5,53,-77,7,0,157,10
821,13,4,3,7,6,-57,33,0,3,100,43
821,14,3,3,6,7,33,34,3,7,133,77
821,15,4,2,6,7,42,-75,5,2,175,2
821,16,2,4,4,9,22,45,7,7,197,47
821,17,4,3,10,3,-54,30,3,7,143,77
821,18,2,4,6,7,24,-57,7,0,167,20
821,19,3,4,3,10,30,46,7,6,197,66
821,20,3,4,8,5,-65,41,2,7,132,107
821,21,4,2,7,6,43,-76,5,1,175,31
821,22,4,4,9,4,-55,40,0,1,120,71
821,23,2,4,6,7,24,43,4,4,144,114
821,24,4,2,7,6,43,24,7,8,187,138
821,25,5,2,9,4,-46,-78,1,0,141,60
821,26,2,5,5,8,23,53,4,3,164,113
821,27,2,5,7,6,25,51,9,4,189,164
821,28,3,4,7,6,-66,42,3,6,123,206
821,29,3,5,5,8,32,53,5,9,155,259
821,30,2,5,6,7,24,-48,9,1,179,211
821,31,3,4,6,7,-67,43,2,4,112,254
821,32,4,2,10,3,46,21,8,5,158,275
821,33,2,4,3,10,21,-54,9,1,179,221
821,34,3,4,4,9,-69,45,0,6,110,266
821,35,2,5,5,8,23,53,3,9,133,319
821,36,3,4,6,7,33,-57,6,2,166,262
821,37,4,3,8,5,-56,32,0,4,110,294
821,38,4,3,7,6,43,33,3,7,153,327
821,39,2,4,6,7,24,-57,7,0,177,270
821,40,3,4,7,6,-66,42,1,2,111,312
821,41,2,5,6,7,24,52,5,4,135,364
821,42,4,2,6,7,42,25,7,9,177,389
821,43,3,3,7,6,-66,-67,1,2,111,322
821,44,3,3,8,5,35,32,6,4,146,354
821,45,3,3,5,8,32,35,8,9,178,389
821,46,4,2,9,4,-55,-78,3,1,123,311
821,47,3,3,6,7,33,34,6,5,156,345
821,48,2,5,6,7,-76,52,0,7,80,397
821,49,3,3,8,5,35,32,5,9,115,429
821,50,4,3,6,7,42,-66,7,3,157,363
821,51,3,3,4,9,31,36,8,9,188,399
821,52,4,3,6,7,-58,-66,0,3,130,333
821,53,2,5,3,10,21,55,1,8,151,388
821,54,4,3,9,4,45,31,6,9,196,419
821,55,5,2,11,2,-44,20,2,9,152,439
821,56,4,3,9,4,45,-69,7,0,197,370
821,57,4,2,8,5,-56,23,1,3,141,393
821,58,4,3,6,7,42,34,3,7,183,427
821,59,3,3,7,6,34,-67,7,0,217,360
821,60,4,2,6,7,42,25,9,5,259,385
821,61,4,4,6,7,-58,43,1,8,201,428
821,62,3,3,5,8,32,-65,3,3,233,363
821,63,2,5,4,9,22,54,5,7,255,417
821,64,4,3,7,6,43,-67,8,0,298,350
821,65,4,3,6,7,-58,34,0,4,240,384
821,66,2,5,5,8,23,53,3,7,263,437
821,67,3,3,6,7,33,-66,6,1,296,371
821,68,4,2,9,4,-55,22,1,3,241,393
821,69,4,2,7,6,43,24,4,7,284,417
821,70,4,2,11,2,-53,20,1,7,231,437
821,71,4,2,10,3,46,21,7,8,277,458
821,72,3,3,7,6,-66,-67,1,1,211,391
821,73,4,2,7,6,43,24,4,5,254,415
821,74,3,3,3,10,30,-63,4,2,284,352
821,75,2,4,2,11,20,47,4,9,304,399
821,76,2,5,4,9,22,-46,6,3,326,353
821,77,3,4,8,5,-65,41,1,4,261,394
821,78,3,3,6,7,33,34,4,8,294,428
821,79,4,2,9,4,45,-78,9,0,339,350
821,80,3,3,3,10,30,37,9,7,369,387
821,81,4,2,9,4,-55,22,4,9,314,409
821,82,5,2,8,5,53,-77,7,2,367,332
821,83,3,4,5,8,32,44,9,6,399,376
821,84,3,3,8,5,-65,32,4,8,334,408
821,85,3,4,6,7,33,-57,7,1,367,351
821,86,5,2,9,4,-46,22,1,3,321,373
821,87,6,2,9,4,63,22,4,5,384,395
821,88,3,4,7,6,34,42,8,7,418,437
821,89,4,2,9,4,-55,22,3,9,363,459
821,90,3,3,8,5,35,-68,8,1,398,391
821,91,4,3,6,7,-58,34,0,5,340,425
821,92,2,4,6,7,24,43,4,8,364,468
821,93,3,3,6,7,33,-66,7,2,397,402
821,94,5,2,9,4,-46,22,1,4,351,424
821,95,4,3,7,6,43,33,4,7,394,457
821,96,2,4,5,8,23,-56,7,1,417,401
821,97,4,2,7,6,-57,24,0,5,360,425
821,98,2,5,4,9,22,54,2,9,382,479
821,99,4,2,8,5,44,-77,6,2,426,402
821,100,4,2,8,5,-56,23,0,5,370,425
821,101,2,5,3,10,21,-45,1,0,391,380
821,102,4,2,9,4,45,22,6,2,436,402
821,103,2,5,4,9,22,54,8,6,458,456
821,104,4,3,5,8,41,-65,9,1,499,391
821,105,2,5,4,9,-78,54,1,5,421,445
821,106,4,3,9,4,45,31,6,6,466,476
821,107,5,2,10,3,-45,21,1,7,421,497
821,108,4,4,6,7,42,-57,3,0,463,440
821,109,5,2,11,2,56,20,9,0,519,460
822,1,5,2,9,4,54,22,4,2,54,22
822,2,4,3,8,5,44,32,8,4,98,54
822,3,4,2,8,5,-56,23,2,7,42,77
822,4,4,2,9,4,45,22,7,9,87,99
822,5,2,5,6,7,-76,-48,1,1,11,51
822,6,3,4,6,7,33,43,4,4,44,94
822,7,4,3,6,7,42,34,6,8,86,128
822,8,3,4,4,9,31,-55,7,3,117,73
822,9,3,4,3,10,30,46,7,9,147,119
822,10,5,2,9,4,-46,-78,1,1,101,41
822,11,4,4,9,4,45,40,6,1,146,81
822,12,2,5,4,9,22,54,8,5,168,135
822,13,3,3,6,7,-67,34,1,9,101,169
822,14,2,5,3,10,21,-45,2,4,122,124
822,15,4,3,9,4,45,31,7,5,167,155
822,16,4,3,5,8,41,-65,8,0,208,90
822,17,3,3,6,7,-67,34,1,4,141,124
822,18,2,4,4,9,22,45,3,9,163,169
822,19,5,2,10,3,55,-79,8,0,218,90
822,20,4,2,11,2,-53,20,5,0,165,110
822,21,3,3,4,9,31,36,6,6,196,146
822,22,3,4,6,7,33,43,9,9,229,189
822,23,5,2,8,5,-47,-77,2,2,182,112
822,24,2,5,6,7,24,52,6,4,206,164
822,25,3,4,6,7,33,43,9,7,239,207
822,26,3,4,6,7,-67,-57,2,0,172,150
822,27,4,3,8,5,44,32,6,2,216,182
822,28,4,3,9,4,-55,31,1,3,161,213
822,29,3,4,8,5,35,41,6,4,196,254
822,30,2,5,3,10,21,55,7,9,217,309
822,31,5,2,8,5,-47,-77,0,2,170,232
822,32,4,3,6,7,42,34,2,6,212,266
822,33,3,4,7,6,34,42,6,8,246,308
822,34,4,4,6,7,42,-57,8,1,288,251
822,35,3,3,9,4,-64,31,4,2,224,282
822,36,4,3,8,5,44,32,8,4,268,314
822,37,2,4,4,9,-78,45,0,9,190,359
822,38,6,2,9,4,63,-78,3,1,253,281
822,39,3,3,6,7,33,34,6,5,286,315
822,40,4,2,8,5,-56,23,0,8,230,338
822,41,4,3,8,5,44,-68,4,0,274,270
822,42,2,5,5,8,23,53,7,3,297,323
822,43,4,3,8,5,-56,32,1,5,241,355
822,44,5,2,10,3,55,21,6,6,296,376
822,45,2,5,4,9,22,-46,8,0,318,330
822,46,4,3,10,3,-54,30,4,0,264,360
822,47,4,3,7,6,43,33,7,3,307,393
822,48,2,4,5,8,-77,44,0,7,230,437
822,49,4,3,8,5,44,32,4,9,274,469
822,50,4,2,8,5,44,-77,8,2,318,392
822,51,3,3,6,7,-67,34,1,6,251,426
822,52,4,3,9,4,45,31,6,7,296,457
822,53,2,4,5,8,23,-56,9,1,319,401
822,54,2,4,5,8,-77,44,2,5,242,445
822,55,2,4,6,7,24,43,6,8,266,488
822,56,4,2,9,4,-55,-78,1,0,211,410
822,57,3,3,7,6,34,33,5,3,245,443
822,58,3,3,7,6,34,33,9,6,279,476
822,59,4,3,8,5,-56,32,3,8,223,508
823,1,2,4,5,8,23,44,3,4,23,44
823,2,3,4,5,8,32,44,5,8,55,88
823,3,3,3,9,4,-64,31,1,9,-9,119
823,4,6,2,10,3,64,-79,5,0,55,40
823,5,5,3,8,5,53,32,8,2,108,72
823,6,3,4,6,7,-67,43,1,5,41,115
823,7,5,2,9,4,54,22,5,7,95,137
823,8,2,5,3,10,21,-45,6,2,116,92
823,9,4,2,8,5,-56,23,0,5,60,115
823,10,2,5,3,10,21,-45,1,0,81,70
823,11,4,3,7,6,43,33,4,3,124,103
823,12,4,3,6,7,42,34,6,7,166,137
823,13,4,3,9,4,-55,31,1,8,111,168
823,14,2,6,4,9,22,-37,3,1,133,131
823,15,4,3,8,5,44,32,7,3,177,163
823,16,3,3,7,6,-66,33,1,6,111,196
823,17,4,3,8,5,44,32,5,8,155,228
823,18,5,3,8,5,53,-68,8,0,208,160
823,19,3,3,5,8,-68,35,0,5,140,195
823,20,5,3,7,6,52,33,2,8,192,228
823,21,3,4,4,9,31,-55,3,3,223,173
823,22,3,4,6,7,33,43,6,6,256,216
823,23,3,3,6,7,33,-66,9,0,289,150
823,24,5,2,8,5,-47,23,2,3,242,173
823,25,3,4,7,6,34,42,6,5,276,215
823,26,4,3,7,6,43,33,9,8,319,248
823,27,3,4,6,7,-67,-57,2,1,252,191
823,28,3,4,7,6,34,42,6,3,286,233
823,29,3,3,8,5,-65,32,1,5,221,265
823,30,4,2,8,5,44,23,5,8,265,288
823,31,4,3,8,5,44,-68,9,0,309,220
823,32,3,4,6,7,-67,43,2,3,242,263
823,33,3,4,4,9,31,45,3,8,273,308
823,34,3,4,5,8,32,-56,5,2,305,252
823,35,4,3,7,6,43,33,8,5,348,285
823,36,5,2,9,4,-46,22,2,7,302,307
823,37,6,2,10,3,64,21,6,8,366,328
823,38,4,2,7,6,43,-76,9,2,409,252
823,39,2,5,3,10,-79,55,0,7,330,307
823,40,2,4,5,8,23,-56,3,1,353,251
823,41,3,3,7,6,34,33,7,4,387,284
823,42,4,2,6,7,42,25,9,9,429,309
823,43,4,2,7,6,-57,-76,2,3,372,233
823,44,2,4,5,8,23,44,5,7,395,277
823,45,4,2,8,5,44,-77,9,0,439,200
823,46,4,3,6,7,-58,34,1,4,381,234
823,47,2,4,5,8,23,44,4,8,404,278
823,48,2,4,4,9,22,-55,6,3,426,223
823,49,3,3,8,5,-65,32,1,5,361,255
823,50,3,4,4,9,31,-55,2,0,392,200
823,51,4,3,6,7,42,34,4,4,434,234
823,52,2,5,3,10,21,55,5,9,455,289
823,53,5,2,10,3,-45,-79,0,0,410,210
823,54,5,2,11,2,56,20,6,0,466,230
823,55,4,3,6,7,42,34,8,4,508,264
824,1,4,3,9,4,45,31,5,1,45,31
824,2,2,4,5,8,23,44,8,5,68,75
824,3,3,3,5,8,-68,-65,0,0,0,10
824,4,4,4,7,6,43,42,3,2,43,52
824,5,3,4,5,8,32,44,5,6,75,96
824,6,3,4,5,8,32,-56,7,0,107,40
824,7,2,6,4,9,22,63,9,3,129,103
824,8,4,2,8,5,-56,23,3,6,73,126
824,9,4,2,8,5,44,23,7,9,117,149
824,10,4,3,8,5,-56,-68,1,1,61,81
824,11,4,3,8,5,44,32,5,3,105,113
824,12,3,3,7,6,34,33,9,6,139,146
824,13,2,4,6,7,-76,43,3,9,63,189
824,14,4,3,8,5,44,-68,7,1,107,121
824,15,4,3,8,5,-56,32,1,3,51,153
824,16,2,4,3,10,21,46,2,9,72,199
824,17,2,5,5,8,23,-47,5,2,95,152
824,18,3,4,7,6,34,42,9,4,129,194
824,19,2,5,4,9,-78,54,1,8,51,248
824,20,5,2,8,5,53,-77,4,1,104,171
824,21,3,4,5,8,32,44,6,5,136,215
824,22,3,4,4,9,31,-55,7,0,167,160
824,23,5,2,10,3,-45,21,2,1,122,181
824,24,5,2,9,4,54,22,6,3,176,203
824,25,5,2,9,4,-46,22,0,5,130,225
824,26,3,3,6,7,33,34,3,9,163,259
824,27,2,4,4,9,22,-55,5,4,185,204
824,28,4,2,10,3,-54,21,1,5,131,225
824,29,4,3,8,5,44,32,5,7,175,257
824,30,3,3,5,8,32,-65,7,2,207,192
824,31,3,3,7,6,-66,33,1,5,141,225
824,32,5,2,9,4,54,22,5,7,195,247
824,33,3,3,6,7,33,-66,8,1,228,181
824,34,6,2,9,4,-37,22,1,3,191,203
824,35,4,2,9,4,45,22,6,5,236,225
824,36,3,3,10,3,-63,30,3,5,173,255
824,37,2,5,4,9,22,54,5,9,195,309
824,38,5,3,8,5,53,-68,8,1,248,241
824,39,2,5,4,9,-78,54,0,5,170,295
824,40,3,4,5,8,32,44,2,9,202,339
824,41,3,4,5,8,32,-56,4,3,234,283
824,42,4,3,9,4,45,31,9,4,279,314
824,43,2,4,7,6,-75,42,4,6,204,356
824,44,5,2,8,5,53,23,7,9,257,379
824,45,5,2,8,5,-47,-77,0,2,210,302
824,46,2,4,4,9,22,45,2,7,232,347
824,47,3,3,5,8,32,-65,4,2,264,282
824,48,3,3,6,7,33,34,7,6,297,316
824,49,4,2,5,8,41,-74,8,2,338,242
824,50,5,2,10,3,-45,21,3,3,293,263
824,51,4,4,8,5,44,41,7,4,337,304
824,52,2,4,4,9,22,45,9,9,359,349
824,53,6,2,9,4,-37,-78,2,1,322,271
824,54,3,4,8,5,35,41,7,2,357,312
824,55,2,5,5,8,-77,53,0,5,280,365
824,56,4,3,7,6,43,33,3,8,323,398
824,57,4,2,7,6,43,-76,6,2,366,322
824,58,4,3,5,8,41,35,7,7,407,357
824,59,2,4,5,8,-77,-56,0,1,330,301
824,60,3,3,5,8,32,35,2,6,362,336
824,61,4,2,7,6,43,-76,5,0,405,260
824,62,6,2,9,4,63,22,8,2,468,282
824,63,4,3,10,3,-54,30,4,2,414,312
824,64,3,3,8,5,35,32,9,4,449,344
824,65,5,2,10,3,-45,21,4,5,404,365
824,66,4,2,10,3,-54,21,0,6,350,386
824,67,4,3,9,4,45,31,5,7,395,417
824,68,5,2,7,6,52,-76,7,1,447,341
824,69,4,4,8,5,-56,41,1,2,391,382
824,70,3,3,8,5,35,32,6,4,426,414
824,71,2,4,5,8,23,44,9,8,449,458
824,72,4,2,8,5,-56,-77,3,1,393,381
824,73,3,3,6,7,33,34,6,5,426,415
824,74,2,4,7,6,-75,42,1,7,351,457
824,75,3,3,6,7,33,-66,4,1,384,391
824,76,3,4,3,10,30,46,4,7,414,437
824,77,4,2,9,4,45,22,9,9,459,459
824,78,4,2,5,8,-59,-74,0,5,400,385
824,79,3,3,4,9,31,-64,1,1,431,321
824,80,2,5,6,7,24,52,5,3,455,373
824,81,3,3,5,8,32,35,7,8,487,408
824,82,4,2,9,4,-55,-78,2,0,432,330
824,83,2,4,5,8,23,44,5,4,455,374
824,84,4,3,7,6,43,33,8,7,498,407
824,85,3,4,6,7,-67,-57,1,0,431,350
824,86,4,3,9,4,45,31,6,1,476,381
824,87,4,3,8,5,-56,32,0,3,420,413
824,88,5,2,10,3,55,21,5,4,475,434
824,89,2,4,8,5,-74,41,1,5,401,475
824,90,3,3,7,6,34,33,5,8,435,508
825,1,4,2,9,4,45,22,5,2,45,22
825,2,3,4,5,8,32,44,7,6,77,66
825,3,2,4,6,7,-76,43,1,9,1,109
825,4,4,2,10,3,46,-79,7,0,47,30
825,5,4,3,9,4,-55,31,2,1,-8,61
825,6,3,4,7,6,34,42,6,3,26,103
825,7,5,2,10,3,-45,21,1,4,-19,124
825,8,4,2,8,5,44,23,5,7,25,147
825,9,4,3,8,5,44,32,9,9,69,179
825,10,4,3,6,7,-58,-66,1,3,11,113
825,11,3,3,7,6,34,33,5,6,45,146
825,12,6,2,10,3,64,21,9,7,109,167
825,13,2,4,8,5,-74,41,5,8,35,208
825,14,3,3,4,9,31,-64,6,4,66,144
825,15,3,3,6,7,33,34,9,8,99,178
825,16,2,4,7,6,-75,-58,4,0,24,120
825,17,2,5,2,11,20,56,4,6,44,176
825,18,4,2,8,5,44,23,8,9,88,199
825,19,3,3,7,6,-66,-67,2,2,22,132
825,20,4,2,10,3,46,21,8,3,68,153
825,21,4,3,6,7,-58,34,0,7,10,187
825,22,2,5,3,10,21,-45,1,2,31,142
825,23,2,4,6,7,24,43,5,5,55,185
825,24,2,5,4,9,22,54,7,9,77,239
825,25,4,2,7,6,-57,-76,0,3,20,163
825,26,3,3,9,4,36,31,6,4,56,194
825,27,3,3,9,4,-64,31,2,5,-8,225
825,28,5,2,7,6,52,24,4,9,44,249
825,29,4,2,8,5,44,-77,8,2,88,172
825,30,5,2,6,7,51,25,9,7,139,197
825,31,4,2,7,6,-57,-76,2,1,82,121
825,32,2,4,3,10,21,46,3,7,103,167
825,33,3,3,5,8,32,-65,5,2,135,102
825,34,2,5,4,9,22,54,7,6,157,156
825,35,3,3,7,6,-66,33,1,9,91,189
825,36,2,5,4,9,22,-46,3,3,113,143
825,37,2,5,6,7,24,52,7,5,137,195
825,38,2,4,7,6,-75,42,2,7,62,237
825,39,4,3,8,5,44,32,6,9,106,269
825,40,3,3,7,6,-66,-67,0,2,40,202
825,41,2,5,6,7,24,52,4,4,64,254
825,42,2,4,4,9,22,45,6,9,86,299
825,43,5,2,10,3,-45,-79,1,0,41,220
825,44,4,3,5,8,41,35,2,5,82,255
825,45,4,3,7,6,43,33,5,8,125,288
825,46,2,5,5,8,23,-47,8,1,148,241
825,47,3,4,4,9,31,45,9,6,179,286
825,48,3,4,7,6,-66,42,3,8,113,328
825,49,3,3,8,5,35,-68,8,0,148,260
825,50,2,4,2,11,20,47,8,7,168,307
825,51,5,2,9,4,-46,22,2,9,122,329
825,52,4,3,8,5,44,-68,6,1,166,261
825,53,3,4,6,7,33,43,9,4,199,304
825,54,2,4,6,7,-76,43,3,7,123,347
825,55,5,2,10,3,55,21,8,8,178,368
825,56,4,3,7,6,-57,-67,1,1,121,301
825,57,4,2,10,3,46,21,7,2,167,322
825,58,3,4,5,8,32,44,9,6,199,366
825,59,4,3,7,6,-57,33,2,9,142,399
825,60,5,2,11,2,56,20,8,9,198,419
825,61,3,4,4,9,31,-55,9,4,229,364
825,62,2,5,5,8,-77,53,2,7,152,417
825,63,2,4,5,8,23,-56,5,1,175,361
825,64,3,3,8,5,-65,32,0,3,110,393
825,65,3,3,7,6,34,33,4,6,144,426
825,66,2,4,8,5,-74,41,0,7,70,467
825,67,4,3,8,5,44,32,4,9,114,499
825,68,4,4,9,4,45,40,9,9,159,539
826,1,3,3,6,7,33,34,3,4,33,34
826,2,3,3,9,4,36,31,9,5,69,65
826,3,5,2,10,3,-45,21,4,6,24,86
826,4,4,3,8,5,44,32,8,8,68,118
826,5,3,3,8,5,-65,-68,3,0,3,50
826,6,2,5,4,9,22,54,5,4,25,104
826,7,5,2,7,6,52,24,7,8,77,128
826,8,3,5,7,6,-66,51,1,9,11,179
826,9,2,6,5,8,23,-38,4,1,34,141
826,10,2,5,5,8,23,53,7,4,57,194
826,11,4,2,6,7,42,25,9,9,99,219
826,12,4,2,9,4,-55,-78,4,1,44,141
826,13,3,3,5,8,32,35,6,6,76,176
826,14,5,2,9,4,-46,22,0,8,30,198
826,15,2,4,6,7,24,-57,4,1,54,141
826,16,3,4,5,8,32,44,6,5,86,185
826,17,5,2,9,4,-46,22,0,7,40,207
826,18,3,4,5,8,32,-56,2,1,72,151
826,19,3,3,7,6,34,33,6,4,106,184
826,20,3,4,6,7,33,43,9,7,139,227
826,21,2,5,5,8,-77,-47,2,0,62,180
826,22,2,4,2,11,20,47,2,7,82,227
826,23,2,4,6,7,24,-57,6,0,106,170
826,24,5,2,10,3,-45,21,1,1,61,191
826,25,3,4,3,10,30,46,1,7,91,237
826,26,3,3,10,3,37,30,8,7,128,267
826,27,5,2,8,5,-47,-77,1,0,81,190
826,28,4,3,5,8,41,35,2,5,122,225
826,29,4,3,8,5,44,32,6,7,166,257
826,30,2,5,4,9,22,-46,8,1,188,211
826,31,2,4,3,10,21,46,9,7,209,257
826,32,2,4,6,7,-76,-57,3,0,133,200
826,33,3,3,7,6,34,33,7,3,167,233
826,34,4,2,7,6,-57,24,0,7,110,257
826,35,4,2,7,6,43,-76,3,1,153,181
826,36,3,3,6,7,33,34,6,5,186,215
826,37,4,2,6,7,42,-75,8,0,228,140
826,38,5,2,10,3,-45,21,3,1,183,161
826,39,2,5,5,8,23,53,6,4,206,214
826,40,2,4,5,8,23,44,9,8,229,258
826,41,4,3,8,5,-56,-68,3,0,173,190
826,42,5,2,9,4,54,22,7,2,227,212
826,43,2,4,6,7,-76,43,1,5,151,255
826,44,4,2,10,3,46,21,7,6,197,276
826,45,4,4,5,8,41,-56,8,0,238,220
826,46,2,4,4,9,-78,45,0,5,160,265
826,47,4,3,6,7,42,34,2,9,202,299
826,48,3,3,7,6,34,-67,6,2,236,232
826,49,3,3,4,9,31,36,7,8,267,268
826,50,3,4,5,8,32,-56,9,2,299,212
826,51,2,4,8,5,-74,41,5,3,225,253
826,52,2,5,4,9,22,54,7,7,247,307
826,53,4,3,6,7,42,-66,9,1,289,241
826,54,4,2,7,6,-57,24,2,5,232,265
826,55,3,3,4,9,31,-64,3,1,263,201
826,56,3,3,5,8,32,35,5,6,295,236
826,57,4,2,9,4,-55,22,0,8,240,258
826,58,4,3,8,5,44,-68,4,0,284,190
826,59,5,3,9,4,54,31,8,1,338,221
826,60,3,4,5,8,-68,44,0,5,270,265
826,61,4,3,5,8,41,-65,1,0,311,200
826,62,4,2,8,5,44,23,5,3,355,223
826,63,4,2,8,5,44,23,9,6,399,246
826,64,4,3,6,7,-58,-66,1,0,341,180
826,65,3,3,7,6,34,33,5,3,375,213
826,66,3,3,4,9,31,36,6,9,406,249
826,67,3,3,5,8,32,-65,8,4,438,184
826,68,4,3,8,5,-56,32,2,6,382,216
826,69,2,5,5,8,23,53,5,9,405,269
826,70,4,2,10,3,-54,-79,1,0,351,190
826,71,4,2,8,5,44,23,5,3,395,213
826,72,4,3,4,9,40,36,5,9,435,249
826,73,5,3,8,5,53,-68,8,1,488,181
826,74,3,4,5,8,-68,44,0,5,420,225
826,75,4,2,10,3,46,21,6,6,466,246
826,76,3,3,6,7,33,-66,9,0,499,180
826,77,3,3,6,7,-67,34,2,4,432,214
826,78,4,2,8,5,44,23,6,7,476,237
826,79,4,2,7,6,43,-76,9,1,519,161
827,1,3,3,7,6,34,33,4,3,34,33
827,2,4,3,6,7,42,34,6,7,76,67
827,3,3,4,5,8,32,-56,8,1,108,11
827,4,3,3,4,9,31,36,9,7,139,47
827,5,4,3,9,4,-55,31,4,8,84,78
827,6,4,3,6,7,42,-66,6,2,126,12
827,7,5,2,9,4,-46,22,0,4,80,34
827,8,6,2,10,3,64,21,4,5,144,55
827,9,3,4,5,8,32,44,6,9,176,99
827,10,5,2,8,5,53,-77,9,2,229,22
827,11,3,3,9,4,-64,31,5,3,165,53
827,12,4,3,8,5,44,32,9,5,209,85
827,13,2,4,6,7,-76,43,3,8,133,128
827,14,3,4,3,10,30,-54,3,4,163,74
827,15,3,3,7,6,34,33,7,7,197,107
827,16,5,2,9,4,-46,22,1,9,151,129
827,17,3,3,4,9,31,-64,2,5,182,65
827,18,4,2,9,4,45,22,7,7,227,87
827,19,3,3,5,8,32,-65,9,2,259,22
827,20,3,4,6,7,-67,43,2,5,192,65
827,21,4,2,6,7,42,-75,4,0,234,-10
827,22,2,5,3,10,21,55,5,5,255,45
827,23,3,3,4,9,31,-64,6,1,286,-19
827,24,4,3,6,7,42,34,8,5,328,15
827,25,3,4,4,9,31,-55,9,0,359,-40
827,26,3,4,6,7,-67,43,2,3,292,3
827,27,3,4,6,7,33,43,5,6,325,46
827,28,5,2,7,6,52,-76,7,0,377,-30
827,29,3,3,5,8,32,35,9,5,409,5
827,30,5,2,10,3,-45,21,4,6,364,26
827,31,4,2,9,4,45,22,9,8,409,48
827,32,4,3,9,4,-55,31,4,9,354,79
827,33,5,2,7,6,52,-76,6,3,406,3
827,34,2,5,5,8,23,53,9,6,429,56
827,35,3,3,8,5,-65,32,4,8,364,88
827,36,2,4,8,5,-74,41,0,9,290,129
827,37,4,3,7,6,43,-67,3,2,333,62
827,38,3,4,7,6,34,42,7,4,367,104
827,39,3,3,7,6,-66,33,1,7,301,137
827,40,3,3,7,6,34,-67,5,0,335,70
827,41,3,4,5,8,32,44,7,4,367,114
827,42,5,2,11,2,-44,20,3,4,323,134
827,43,4,3,7,6,43,33,6,7,366,167
827,44,3,3,6,7,33,-66,9,1,399,101
827,45,2,4,6,7,-76,43,3,4,323,144
827,46,4,3,8,5,44,32,7,6,367,176
827,47,5,2,7,6,52,-76,9,0,419,100
827,48,3,3,4,9,-69,36,0,6,350,136
827,49,3,3,9,4,36,31,6,7,386,167
827,50,4,2,8,5,-56,-77,0,0,330,90
827,51,5,2,6,7,51,25,1,5,381,115
827,52,2,5,3,10,21,-45,2,0,402,70
827,53,4,2,7,6,43,24,5,4,445,94
827,54,4,3,8,5,44,32,9,6,489,126
827,55,5,3,9,4,-46,31,3,7,443,157
827,56,5,2,9,4,54,22,7,9,497,179
827,57,3,3,7,6,-66,-67,1,2,431,112
827,58,3,3,7,6,34,33,5,5,465,145
827,59,4,3,7,6,43,33,8,8,508,178
828,1,3,4,5,8,32,44,2,4,32,44
828,2,2,4,5,8,23,44,5,8,55,88
828,3,3,3,4,9,31,-64,6,4,86,24
828,4,3,3,5,8,32,35,8,9,118,59
828,5,3,4,6,7,-67,-57,1,2,51,2
828,6,3,3,8,5,35,32,6,4,86,34
828,7,3,4,4,9,31,45,7,9,117,79
828,8,5,2,8,5,-47,-77,0,2,70,2
828,9,2,5,5,8,23,53,3,5,93,55
828,10,4,2,7,6,43,24,6,9,136,79
828,11,4,2,5,8,41,-74,7,5,177,5
828,12,3,3,8,5,-65,32,2,7,112,37
828,13,2,5,6,7,24,52,6,9,136,89
828,14,3,4,5,8,32,-56,8,3,168,33
828,15,3,3,3,10,30,-63,8,0,198,-30
828,16,5,2,9,4,-46,22,2,2,152,-8
828,17,3,4,5,8,32,44,4,6,184,36
828,18,3,3,10,3,-63,30,1,6,121,66
828,19,5,2,10,3,55,21,6,7,176,87
828,20,2,4,6,7,-76,-57,0,0,100,30
828,21,3,4,7,6,34,42,4,2,134,72
828,22,3,3,4,9,31,36,5,8,165,108
828,23,5,2,10,3,-45,21,0,9,120,129
828,24,2,5,3,10,21,-45,1,4,141,84
828,25,2,4,6,7,24,43,5,7,165,127
828,26,3,4,4,9,31,-55,6,2,196,72
828,27,4,2,8,5,-56,23,0,5,140,95
828,28,5,2,11,2,56,20,6,5,196,115
828,29,6,2,9,4,63,22,9,7,259,137
828,30,3,4,7,6,-66,42,3,9,193,179
828,31,4,2,6,7,42,-75,5,4,235,104
828,32,4,4,6,7,42,43,7,7,277,147
828,33,3,3,8,5,-65,32,2,9,212,179
828,34,4,2,7,6,43,-76,5,3,255,103
828,35,4,2,10,3,-54,21,1,4,201,124
828,36,4,3,5,8,41,35,2,9,242,159
828,37,4,4,8,5,44,-59,6,0,286,100
828,38,4,3,6,7,42,34,8,4,328,134
828,39,5,2,9,4,-46,22,2,6,282,156
828,40,4,2,6,7,42,-75,4,1,324,81
828,41,3,3,4,9,31,36,5,7,355,117
828,42,2,6,5,8,23,62,8,9,378,179
828,43,3,4,6,7,-67,-57,1,2,311,122
828,44,3,4,4,9,31,45,2,7,342,167
828,45,3,3,6,7,33,-66,5,1,375,101
828,46,3,5,7,6,34,51,9,2,409,152
828,47,3,3,5,8,-68,35,1,7,341,187
828,48,4,3,7,6,43,-67,4,0,384,120
828,49,3,3,5,8,32,35,6,5,416,155
828,50,3,4,5,8,32,44,8,9,448,199
828,51,4,3,7,6,-57,-67,1,2,391,132
828,52,5,2,9,4,54,22,5,4,445,154
828,53,3,3,8,5,-65,32,0,6,380,186
828,54,3,4,5,8,32,-56,2,0,412,130
828,55,4,2,8,5,44,23,6,3,456,153
828,56,4,2,7,6,43,24,9,7,499,177
828,57,3,3,6,7,-67,-66,2,1,432,111
828,58,3,3,10,3,37,30,9,1,469,141
828,59,3,4,4,9,-69,45,0,6,400,186
828,60,3,3,6,7,33,-66,3,0,433,120
828,61,5,2,9,4,54,22,7,2,487,142
828,62,4,3,7,6,-57,33,0,5,430,175
828,63,6,2,10,3,64,21,4,6,494,196
828,64,3,3,6,7,33,-66,7,0,527,130
829,1,2,5,3,10,21,55,1,5,21,55
829,2,4,3,7,6,43,33,4,8,64,88
829,3,3,4,6,7,33,-57,7,1,97,31
829,4,4,3,7,6,-57,33,0,4,40,64
829,5,3,4,5,8,32,44,2,8,72,108
829,6,3,4,5,8,32,-56,4,2,104,52
829,7,4,2,7,6,43,24,7,6,147,76
829,8,5,2,10,3,-45,21,2,7,102,97
829,9,3,3,8,5,35,32,7,9,137,129
829,10,2,5,3,10,21,-45,8,4,158,84
829,11,3,3,7,6,-66,33,2,7,92,117
829,12,4,2,8,5,44,-77,6,0,136,40
829,13,2,4,7,6,-75,42,1,2,61,82
829,14,5,3,9,4,54,31,5,3,115,113
829,15,3,4,4,9,31,45,6,8,146,158
829,16,3,5,6,7,33,-48,9,0,179,110
829,17,4,2,8,5,-56,23,3,3,123,133
829,18,3,3,6,7,33,34,6,7,156,167
829,19,3,4,5,8,32,-56,8,1,188,111
829,20,5,2,8,5,-47,23,1,4,141,134
829,21,4,2,10,3,46,21,7,5,187,155
829,22,4,2,7,6,-57,24,0,9,130,179
829,23,5,2,9,4,54,-78,4,1,184,101
829,24,4,3,5,8,41,35,5,6,225,136
829,25,2,4,4,9,22,-55,7,1,247,81
829,26,3,3,9,4,-64,31,3,2,183,112
829,27,4,2,8,5,44,23,7,5,227,135
829,28,3,3,8,5,-65,32,2,7,162,167
829,29,3,3,6,7,33,-66,5,1,195,101
829,30,2,4,4,9,22,45,7,6,217,146
829,31,4,4,7,6,-57,42,0,8,160,188
829,32,4,3,9,4,45,31,5,9,205,219
829,33,3,4,7,6,34,-58,9,1,239,161
829,34,2,4,5,8,-77,44,2,5,162,205
829,35,2,5,6,7,24,52,6,7,186,257
829,36,3,3,8,5,-65,32,1,9,121,289
829,37,4,2,9,4,45,-78,6,1,166,211
829,38,2,6,2,11,20,65,6,6,186,276
829,39,4,2,6,7,42,-75,8,1,228,201
829,40,3,4,7,6,-66,42,2,3,162,243
829,41,3,3,6,7,33,34,5,7,195,277
829,42,4,3,6,7,42,-66,7,1,237,211
829,43,5,2,10,3,-45,21,2,2,192,232
829,44,4,3,7,6,43,33,5,5,235,265
829,45,2,4,7,6,-75,42,0,7,160,307
829,46,5,2,10,3,55,21,5,8,215,328
829,47,5,2,7,6,52,-76,7,2,267,252
829,48,5,2,8,5,-47,23,0,5,220,275
829,49,3,3,5,8,32,-65,2,0,252,210
829,50,3,3,7,6,34,33,6,3,286,243
829,51,4,2,8,5,-56,23,0,6,230,266
829,52,2,4,5,8,23,-56,3,0,253,210
829,53,3,4,3,10,30,46,3,6,283,256
829,54,2,4,7,6,25,42,8,8,308,298
829,55,4,3,8,5,-56,-68,2,0,252,230
829,56,4,2,8,5,44,23,6,3,296,253
829,57,3,3,5,8,32,35,8,8,328,288
829,58,5,2,5,8,50,-74,8,4,378,214
829,59,4,3,6,7,-58,34,0,8,320,248
829,60,4,2,8,5,44,-77,4,1,364,171
829,61,3,4,7,6,34,42,8,3,398,213
829,62,3,3,8,5,-65,32,3,5,333,245
829,63,3,3,5,8,32,-65,5,0,365,180
829,64,4,2,10,3,-54,21,1,1,311,201
829,65,4,2,9,4,45,22,6,3,356,223
829,66,2,5,3,10,21,55,7,8,377,278
829,67,6,2,9,4,-37,-78,0,0,340,200
829,68,5,2,7,6,52,24,2,4,392,224
829,69,3,3,5,8,32,35,4,9,424,259
829,70,5,2,9,4,54,-78,8,1,478,181
829,71,2,4,5,8,-77,44,1,5,401,225
829,72,4,3,5,8,41,-65,2,0,442,160
829,73,4,3,7,6,43,33,5,3,485,193
829,74,2,5,4,9,22,54,7,7,507,247
830,1,3,4,8,5,35,41,5,1,35,41
830,2,3,3,8,5,-65,32,0,3,-30,73
830,3,4,3,6,7,42,34,2,7,12,107
830,4,2,4,3,10,21,-54,3,3,33,53
830,5,4,3,6,7,42,34,5,7,75,87
830,6,4,3,5,8,41,-65,6,2,116,22
830,7,3,3,7,6,-66,33,0,5,50,55
830,8,3,4,5,8,32,44,2,9,82,99
830,9,4,3,9,4,45,-69,7,0,127,30
830,10,3,3,8,5,-65,32,2,2,62,62
830,11,4,4,5,8,41,44,3,6,103,106
830,12,3,3,6,7,33,-66,6,0,136,40
830,13,2,4,4,9,22,45,8,5,158,85
830,14,3,3,4,9,31,-64,9,1,189,21
830,15,4,3,8,5,-56,32,3,3,133,53
830,16,3,4,5,8,32,44,5,7,165,97
830,17,3,3,4,9,31,-64,6,3,196,33
830,18,5,2,10,3,-45,21,1,4,151,54
830,19,3,4,7,6,34,42,5,6,185,96
830,20,4,3,8,5,44,32,9,8,229,128
830,21,4,3,5,8,-59,-65,0,3,170,63
830,22,3,4,7,6,34,42,4,5,204,105
830,23,2,5,4,9,22,54,6,9,226,159
830,24,2,5,6,7,-76,-48,0,1,150,111
830,25,3,3,6,7,33,34,3,5,183,145
830,26,3,3,7,6,34,33,7,8,217,178
830,27,6,2,9,4,-37,-78,0,0,180,100
830,28,5,3,5,8,50,35,0,5,230,135
830,29,2,4,3,10,21,-54,1,1,251,81
830,30,4,4,7,6,43,42,4,3,294,123
830,31,5,2,9,4,54,22,8,5,348,145
830,32,3,3,10,3,-63,30,5,5,285,175
830,33,5,2,10,3,-45,21,0,6,240,196
830,34,3,3,6,7,33,-66,3,0,273,130
830,35,2,4,2,11,20,47,3,7,293,177
830,36,3,4,6,7,33,-57,6,0,326,120
830,37,3,3,7,6,-66,33,0,3,260,153
830,38,2,5,5,8,23,53,3,6,283,206
830,39,4,2,7,6,43,-76,6,0,326,130
830,40,2,4,4,9,22,45,8,5,348,175
830,41,2,6,2,11,20,-35,8,0,368,140
830,42,3,4,6,7,-67,43,1,3,301,183
830,43,3,3,6,7,33,34,4,7,334,217
830,44,3,4,4,9,31,-55,5,2,365,162
830,45,4,2,6,7,42,25,7,7,407,187
830,46,3,4,8,5,-65,41,2,8,342,228
830,47,4,2,6,7,42,-75,4,3,384,153
830,48,3,3,9,4,-64,31,0,4,320,184
830,49,2,4,4,9,22,45,2,9,342,229
830,50,2,5,5,8,23,-47,5,2,365,182
830,51,3,3,4,9,31,36,6,8,396,218
830,52,4,4,7,6,43,-58,9,0,439,160
830,53,4,2,8,5,-56,23,3,3,383,183
830,54,4,3,5,8,41,35,4,8,424,218
830,55,3,4,4,9,31,-55,5,3,455,163
830,56,4,2,9,4,-55,22,0,5,400,185
830,57,4,2,9,4,45,22,5,7,445,207
830,58,3,4,7,6,34,42,9,9,479,249
830,59,3,4,5,8,-68,-56,1,3,411,193
830,60,3,3,5,8,32,35,3,8,443,228
830,61,2,4,6,7,24,-57,7,1,467,171
830,62,2,5,4,9,22,54,9,5,489,225
830,63,5,2,6,7,-49,-75,0,0,440,150
830,64,2,4,5,8,23,44,3,4,463,194
830,65,4,3,9,4,45,31,8,5,508,225
831,1,3,4,5,8,32,44,2,4,32,44
831,2,2,5,4,9,22,54,4,8,54,98
831,3,4,3,8,5,44,-68,8,0,98,30
831,4,3,3,9,4,-64,31,4,1,34,61
831,5,3,3,9,4,-64,31,0,2,-30,92
831,6,3,4,5,8,32,44,2,6,2,136
831,7,2,5,6,7,24,52,6,8,26,188
831,8,5,3,10,3,-45,30,1,8,-19,218
831,9,4,2,9,4,45,-78,6,0,26,140
831,10,5,2,9,4,-46,22,0,2,-20,162
831,11,3,4,6,7,33,43,3,5,13,205
831,12,3,4,3,10,30,-54,3,1,43,151
831,13,2,5,5,8,23,53,6,4,66,204
831,14,2,5,5,8,23,53,9,7,89,257
831,15,6,2,10,3,-36,21,3,8,53,278
831,16,4,2,9,4,45,-78,8,0,98,200
831,17,4,2,8,5,-56,23,2,3,42,223
831,18,5,2,11,2,56,20,8,3,98,243
831,19,4,2,8,5,-56,23,2,6,42,266
831,20,3,3,5,8,32,-65,4,1,74,201
831,21,3,3,7,6,34,33,8,4,108,234
831,22,5,2,7,6,-48,24,0,8,60,258
831,23,4,2,9,4,45,-78,5,0,105,180
831,24,2,5,5,8,23,53,8,3,128,233
831,25,2,5,5,8,-77,53,1,6,51,286
831,26,2,5,3,10,21,-45,2,1,72,241
831,27,3,3,6,7,33,34,5,5,105,275
831,28,5,2,4,9,-50,-73,5,2,55,202
831,29,4,3,8,5,44,32,9,4,99,234
831,30,4,3,8,5,-56,32,3,6,43,266
831,31,3,3,5,8,32,-65,5,1,75,201
831,32,4,4,8,5,44,41,9,2,119,242
831,33,3,4,4,9,-69,45,0,7,50,287
831,34,4,3,9,4,45,31,5,8,95,318
831,35,2,4,3,10,21,-54,6,4,116,264
831,36,5,2,10,3,-45,21,1,5,71,285
831,37,3,4,6,7,33,43,4,8,104,328
831,38,3,3,7,6,34,-67,8,1,138,261
831,39,3,3,6,7,-67,34,1,5,71,295
831,40,2,4,3,10,21,-54,2,1,92,241
831,41,2,4,7,6,25,42,7,3,117,283
831,42,3,3,8,5,-65,32,2,5,52,315
831,43,3,3,7,6,34,33,6,8,86,348
831,44,3,3,7,6,-66,-67,0,1,20,281
831,45,4,3,8,5,44,32,4,3,64,313
831,46,4,4,7,6,43,42,7,5,107,355
831,47,5,2,10,3,-45,21,2,6,62,376
831,48,4,2,9,4,45,22,7,8,107,398
831,49,4,3,6,7,42,-66,9,2,149,332
831,50,3,4,8,5,-65,41,4,3,84,373
831,51,2,4,5,8,23,44,7,7,107,417
831,52,4,3,5,8,41,-65,8,2,148,352
831,53,4,3,9,4,-55,31,3,3,93,383
831,54,3,3,8,5,35,32,8,5,128,415
831,55,4,2,8,5,-56,23,2,8,72,438
831,56,3,3,6,7,33,-66,5,2,105,372
831,57,3,3,8,5,-65,32,0,4,40,404
831,58,3,4,7,6,34,42,4,6,74,446
831,59,4,2,6,7,42,-75,6,1,116,371
831,60,4,3,6,7,42,34,8,5,158,405
831,61,4,3,8,5,-56,32,2,7,102,437
831,62,3,3,6,7,33,-66,5,1,135,371
831,63,4,3,6,7,42,34,7,5,177,405
831,64,3,3,9,4,-64,31,3,6,113,436
831,65,5,2,7,6,52,-76,5,0,165,360
831,66,4,2,7,6,43,24,8,4,208,384
831,67,4,2,7,6,-57,24,1,8,151,408
831,68,3,3,5,8,32,-65,3,3,183,343
831,69,3,3,7,6,34,33,7,6,217,376
831,70,3,4,5,8,32,-56,9,0,249,320
831,71,4,3,6,7,-58,34,1,4,191,354
831,72,5,2,11,2,56,20,7,4,247,374
831,73,4,3,8,5,-56,32,1,6,191,406
831,74,3,4,6,7,33,43,4,9,224,449
831,75,3,3,6,7,33,-66,7,3,257,383
831,76,3,3,8,5,-65,32,2,5,192,415
831,77,3,3,6,7,33,34,5,9,225,449
831,78,3,4,5,8,32,-56,7,3,257,393
831,79,2,5,4,9,22,54,9,7,279,447
831,80,2,4,8,5,-74,41,5,8,205,488
831,81,4,3,7,6,43,-67,8,1,248,421
831,82,2,4,3,10,21,46,9,7,269,467
831,83,3,3,6,7,-67,-66,2,1,202,401
831,84,3,4,6,7,33,43,5,4,235,444
831,85,3,4,5,8,32,44,7,8,267,488
831,86,3,3,7,6,-66,-67,1,1,201,421
831,87,5,2,9,4,54,22,5,3,255,443
831,88,4,3,8,5,44,32,9,5,299,475
831,89,3,4,6,7,-67,43,2,8,232,518
832,1,2,4,3,10,21,46,1,6,21,46
832,2,3,4,4,9,31,-55,2,1,52,-9
832,3,3,4,6,7,33,43,5,4,85,34
832,4,4,3,9,4,-55,31,0,5,30,65
832,5,4,3,6,7,42,34,2,9,72,99
832,6,5,2,11,2,56,20,8,9,128,119
832,7,2,5,4,9,-78,-46,0,3,50,73
832,8,3,3,9,4,36,31,6,4,86,104
832,9,2,4,4,9,22,45,8,9,108,149
832,10,4,4,6,7,-58,-57,0,2,50,92
832,11,3,3,8,5,35,32,5,4,85,124
832,12,3,3,8,5,-65,32,0,6,20,156
832,13,3,4,7,6,34,42,4,8,54,198
832,14,4,2,7,6,43,-76,7,2,97,122
832,15,2,5,4,9,22,54,9,6,119,176
832,16,3,3,8,5,-65,32,4,8,54,208
832,17,3,4,4,9,31,-55,5,3,85,153
832,18,4,3,5,8,41,35,6,8,126,188
832,19,5,3,10,3,-45,30,1,8,81,218
832,20,4,2,8,5,44,-77,5,1,125,141
832,21,4,3,8,5,44,32,9,3,169,173
832,22,4,3,6,7,-58,34,1,7,111,207
832,23,3,4,3,10,30,-54,1,3,141,153
832,24,4,2,9,4,45,22,6,5,186,175
832,25,6,2,9,4,63,22,9,7,249,197
832,26,4,3,7,6,-57,-67,2,0,192,130
832,27,2,4,3,10,21,46,3,6,213,176
832,28,4,2,8,5,44,23,7,9,257,199
832,29,3,4,4,9,31,-55,8,4,288,144
832,30,3,3,4,9,31,-64,9,0,319,80
832,31,2,4,6,7,-76,43,3,3,243,123
832,32,4,3,7,6,43,33,6,6,286,156
832,33,3,3,6,7,33,-66,9,0,319,90
832,34,3,3,9,4,-64,31,5,1,255,121
832,35,3,3,7,6,34,33,9,4,289,154
832,36,4,3,8,5,-56,32,3,6,233,186
832,37,6,2,11,2,65,20,8,6,298,206
832,38,5,2,10,3,-45,21,3,7,253,227
832,39,3,3,6,7,33,-66,6,1,286,161
832,40,2,5,3,10,21,55,7,6,307,216
832,41,5,3,8,5,-47,32,0,8,260,248
832,42,3,3,4,9,31,-64,1,4,291,184
832,43,4,2,7,6,43,24,4,8,334,208
832,44,2,4,4,9,22,-55,6,3,356,153
832,45,4,3,9,4,-55,31,1,4,301,184
832,46,2,4,7,6,25,42,6,6,326,226
832,47,3,4,5,8,32,-56,8,0,358,170
832,48,3,3,7,6,-66,33,2,3,292,203
832,49,2,5,3,10,21,55,3,8,313,258
832,50,3,3,4,9,31,-64,4,4,344,194
832,51,3,4,3,10,30,-54,4,0,374,140
832,52,3,4,5,8,32,44,6,4,406,184
832,53,2,4,5,8,23,44,9,8,429,228
832,54,3,4,6,7,-67,-57,2,1,362,171
832,55,2,5,3,10,21,55,3,6,383,226
832,56,3,4,7,6,34,42,7,8,417,268
832,57,5,2,7,6,52,-76,9,2,469,192
832,58,2,5,5,8,-77,53,2,5,392,245
832,59,2,5,3,10,21,-45,3,0,413,200
832,60,2,4,8,5,26,41,9,1,439,241
832,61,3,3,5,8,-68,35,1,6,371,276
832,62,3,3,4,9,31,-64,2,2,402,212
832,63,2,4,6,7,24,43,6,5,426,255
832,64,3,4,5,8,32,44,8,9,458,299
832,65,4,3,7,6,-57,-67,1,2,401,232
832,66,4,3,5,8,41,35,2,7,442,267
832,67,3,3,7,6,34,-67,6,0,476,200
832,68,2,4,5,8,23,44,9,4,499,244
832,69,3,3,7,6,-66,33,3,7,433,277
832,70,3,4,5,8,32,-56,5,1,465,221
832,71,3,3,5,8,32,35,7,6,497,256
832,72,2,5,4,9,22,-46,9,0,519,210
833,1,2,4,4,9,22,45,2,5,22,45
833,2,5,2,7,6,52,24,4,9,74,69
833,3,4,4,8,5,44,-59,8,0,118,10
833,4,4,3,8,5,-56,32,2,2,62,42
833,5,3,4,7,6,34,42,6,4,96,84
833,6,4,2,10,3,-54,21,2,5,42,105
833,7,4,3,6,7,42,34,4,9,84,139
833,8,3,4,6,7,33,-57,7,2,117,82
833,9,2,5,2,11,20,56,7,8,137,138
833,10,4,3,7,6,-57,-67,0,1,80,71
833,11,3,4,7,6,34,42,4,3,114,113
833,12,5,2,9,4,54,22,8,5,168,135
833,13,2,5,5,8,-77,53,1,8,91,188
833,14,2,4,5,8,23,-56,4,2,114,132
833,15,2,5,6,7,24,52,8,4,138,184
833,16,3,3,8,5,-65,32,3,6,73,216
833,17,3,3,9,4,36,31,9,7,109,247
833,18,5,2,9,4,-46,22,3,9,63,269
833,19,3,3,7,6,34,-67,7,2,97,202
833,20,4,2,11,2,-53,20,4,2,44,222
833,21,3,3,8,5,35,32,9,4,79,254
833,22,4,3,9,4,-55,31,4,5,24,285
833,23,4,3,9,4,45,31,9,6,69,316
833,24,3,3,8,5,-65,32,4,8,4,348
833,25,4,2,10,3,-54,21,0,9,-50,369
833,26,2,5,6,7,24,-48,4,1,-26,321
833,27,3,4,8,5,35,41,9,2,9,362
833,28,2,5,5,8,-77,53,2,5,-68,415
833,29,4,2,9,4,45,22,7,7,-23,437
833,30,3,3,4,9,31,-64,8,3,8,373
833,31,2,6,3,10,21,64,9,7,29,437
833,32,3,3,6,7,-67,-66,2,1,-38,371
833,33,3,4,6,7,33,43,5,4,-5,414
833,34,3,3,8,5,-65,32,0,6,-70,446
833,35,2,5,2,11,20,-44,0,2,-50,402
833,36,4,3,5,8,41,35,1,7,-9,437
833,37,4,3,7,6,43,-67,4,0,34,370
833,38,5,2,9,4,54,22,8,2,88,392
833,39,4,2,10,3,-54,21,4,3,34,413
833,40,3,3,7,6,34,33,8,6,68,446
833,41,3,3,6,7,-67,-66,1,0,1,380
833,42,4,3,5,8,41,35,2,5,42,415
833,43,4,2,9,4,45,22,7,7,87,437
833,44,3,3,7,6,-66,-67,1,0,21,370
833,45,2,5,6,7,24,52,5,2,45,422
833,46,4,2,10,3,-54,21,1,3,-9,443
833,47,3,3,7,6,34,33,5,6,25,476
833,48,4,3,10,3,-54,30,1,6,-29,506
834,1,4,3,7,6,43,33,3,3,43,33
834,2,3,5,5,8,32,53,5,6,75,86
834,3,3,3,8,5,-65,32,0,8,10,118
834,4,2,4,6,7,24,-57,4,1,34,61
834,5,4,3,7,6,43,33,7,4,77,94
834,6,2,4,4,9,22,45,9,9,99,139
834,7,4,3,8,5,-56,-68,3,1,43,71
834,8,3,4,4,9,31,45,4,6,74,116
834,9,4,2,8,5,44,23,8,9,118,139
834,10,2,5,5,8,-77,-47,1,2,41,92
834,11,3,3,8,5,35,32,6,4,76,124
834,12,2,4,4,9,22,45,8,9,98,169
834,13,4,3,9,4,-55,-69,3,0,43,100
834,14,4,3,9,4,45,31,8,1,88,131
834,15,4,3,6,7,-58,34,0,5,30,165
834,16,2,5,2,11,20,-44,0,1,50,121
834,17,3,3,7,6,34,33,4,4,84,154
834,18,5,2,10,3,55,21,9,5,139,175
834,19,5,2,9,4,-46,22,3,7,93,197
834,20,2,4,6,7,24,-57,7,0,117,140
834,21,5,2,8,5,-47,23,0,3,70,163
834,22,3,3,8,5,35,32,5,5,105,195
834,23,3,4,6,7,33,43,8,8,138,238
834,24,2,5,4,9,-78,-46,0,2,60,192
834,25,2,4,8,5,26,41,6,3,86,233
834,26,3,4,4,9,31,45,7,8,117,278
834,27,2,4,7,6,-75,-58,2,0,42,220
834,28,4,2,7,6,43,24,5,4,85,244
834,29,3,4,3,10,30,-54,5,0,115,190
834,30,4,4,5,8,41,44,6,4,156,234
834,31,4,2,8,5,-56,23,0,7,100,257
834,32,4,2,5,8,41,-74,1,3,141,183
834,33,3,3,4,9,31,36,2,9,172,219
834,34,2,5,3,10,21,-45,3,4,193,174
834,35,3,3,6,7,33,34,6,8,226,208
834,36,2,5,3,10,21,-45,7,3,247,163
834,37,4,3,7,6,-57,33,0,6,190,196
834,38,5,3,8,5,53,32,3,8,243,228
834,39,5,2,6,7,51,-75,4,3,294,153
834,40,3,3,6,7,33,34,7,7,327,187
834,41,3,3,5,8,32,-65,9,2,359,122
834,42,2,4,9,4,-73,40,6,2,286,162
834,43,3,4,6,7,33,43,9,5,319,205
834,44,5,2,6,7,-49,-75,0,0,270,130
834,45,4,3,7,6,43,33,3,3,313,163
834,46,4,2,6,7,42,25,5,8,355,188
834,47,2,5,3,10,21,-45,6,3,376,143
834,48,4,3,5,8,41,35,7,8,417,178
834,49,3,4,3,10,30,-54,7,4,447,124
834,50,4,2,6,7,42,25,9,9,489,149
834,51,2,5,6,7,-76,-48,3,1,413,101
834,52,2,4,7,6,25,42,8,3,438,143
834,53,2,4,8,5,-74,41,4,4,364,184
834,54,3,3,8,5,35,32,9,6,399,216
834,55,3,3,6,7,-67,-66,2,0,332,150
834,56,4,3,6,7,42,34,4,4,374,184
834,57,3,4,8,5,35,41,9,5,409,225
834,58,4,3,8,5,-56,32,3,7,353,257
834,59,4,3,8,5,44,32,7,9,397,289
834,60,2,5,6,7,-76,-48,1,1,321,241
834,61,4,2,8,5,44,23,5,4,365,264
834,62,3,3,9,4,-64,31,1,5,301,295
834,63,5,2,10,3,55,21,6,6,356,316
834,64,3,3,6,7,33,-66,9,0,389,250
834,65,4,2,8,5,-56,23,3,3,333,273
834,66,3,4,7,6,34,42,7,5,367,315
834,67,5,2,10,3,-45,21,2,6,322,336
834,68,2,5,3,10,21,-45,3,1,343,291
834,69,4,2,10,3,46,21,9,2,389,312
834,70,3,3,6,7,-67,34,2,6,322,346
834,71,2,4,6,7,24,43,6,9,346,389
834,72,2,5,4,9,22,-46,8,3,368,343
834,73,4,2,5,8,41,26,9,9,409,369
834,74,2,5,4,9,-78,-46,1,3,331,323
834,75,3,3,8,5,35,32,6,5,366,355
834,76,2,5,3,10,21,-45,7,0,387,310
834,77,3,3,6,7,-67,34,0,4,320,344
834,78,3,4,5,8,32,44,2,8,352,388
834,79,5,2,9,4,54,-78,6,0,406,310
834,80,2,4,5,8,23,44,9,4,429,354
834,81,2,5,2,11,20,-44,9,0,449,310
834,82,3,4,5,8,-68,44,1,4,381,354
834,83,3,3,8,5,35,32,6,6,416,386
834,84,3,4,8,5,-65,41,1,7,351,427
834,85,2,4,5,8,23,-56,4,1,374,371
834,86,3,3,7,6,34,33,8,4,408,404
834,87,4,3,8,5,-56,32,2,6,352,436
834,88,5,2,8,5,53,23,5,9,405,459
834,89,2,4,5,8,23,-56,8,3,428,403
834,90,5,2,10,3,-45,21,3,4,383,424
834,91,4,2,8,5,44,23,7,7,427,447
834,92,6,2,9,4,-37,22,0,9,390,469
834,93,3,3,7,6,34,-67,4,2,424,402
834,94,3,3,9,4,-64,31,0,3,360,433
834,95,4,3,6,7,42,34,2,7,402,467
834,96,3,4,5,8,32,-56,4,1,434,411
834,97,3,3,4,9,31,36,5,7,465,447
834,98,4,4,8,5,44,41,9,8,509,488
835,1,4,3,10,3,46,30,6,0,46,30
835,2,2,6,2,11,20,65,6,5,66,95
835,3,2,4,6,7,-76,43,0,8,-10,138
835,4,4,3,7,6,43,-67,3,1,33,71
835,5,3,4,5,8,32,44,5,5,65,115
835,6,2,5,3,10,21,-45,6,0,86,70
835,7,3,3,7,6,-66,33,0,3,20,103
835,8,4,2,8,5,44,23,4,6,64,126
835,9,2,5,5,8,23,53,7,9,87,179
835,10,5,2,12,1,-43,-20,4,9,44,159
835,11,3,4,5,8,32,-56,6,3,76,103
835,12,3,4,7,6,-66,42,0,5,10,145
835,13,5,3,7,6,52,33,2,8,62,178
835,14,3,3,3,10,30,-63,2,5,92,115
835,15,2,4,4,9,22,-55,4,0,114,60
835,16,2,5,3,10,21,55,5,5,135,115
835,17,6,2,11,2,-35,20,0,5,100,135
835,18,3,3,7,6,34,33,4,8,134,168
835,19,4,3,6,7,42,-66,6,2,176,102
835,20,3,3,9,4,-64,31,2,3,112,133
835,21,3,4,4,9,31,45,3,8,143,178
835,22,5,2,8,5,53,-77,6,1,196,101
835,23,4,3,6,7,42,34,8,5,238,135
835,24,3,3,6,7,-67,34,1,9,171,169
835,25,2,4,7,6,25,-58,6,1,196,111
835,26,3,4,5,8,32,44,8,5,228,155
835,27,2,4,3,10,21,-54,9,1,249,101
835,28,3,4,7,6,-66,42,3,3,183,143
835,29,3,4,5,8,32,44,5,7,215,187
835,30,3,3,5,8,32,-65,7,2,247,122
835,31,3,4,7,6,-66,42,1,4,181,164
835,32,2,4,3,10,21,-54,2,0,202,110
835,33,3,4,6,7,33,43,5,3,235,153
835,34,2,4,2,11,20,-53,5,0,255,100
835,35,2,4,5,8,23,44,8,4,278,144
835,36,3,3,6,7,-67,34,1,8,211,178
835,37,2,4,5,8,23,-56,4,2,234,122
835,38,3,4,9,4,-64,40,0,2,170,162
835,39,5,2,10,3,55,21,5,3,225,183
835,40,2,5,6,7,24,52,9,5,249,235
835,41,5,2,8,5,-47,23,2,8,202,258
835,42,2,4,5,8,23,-56,5,2,225,202
835,43,3,3,7,6,34,33,9,5,259,235
835,44,4,3,7,6,-57,33,2,8,202,268
835,45,6,2,10,3,64,21,6,9,266,289
835,46,3,3,7,6,-66,-67,0,2,200,222
835,47,2,4,7,6,25,42,5,4,225,264
835,48,3,4,9,4,-64,40,1,4,161,304
835,49,3,3,6,7,33,34,4,8,194,338
835,50,3,4,7,6,34,-58,8,0,228,280
835,51,3,3,6,7,-67,34,1,4,161,314
835,52,3,3,10,3,37,30,8,4,198,344
835,53,2,5,4,9,-78,54,0,8,120,398
835,54,2,5,3,10,21,-45,1,3,141,353
835,55,3,4,3,10,30,46,1,9,171,399
835,56,4,3,7,6,43,-67,4,2,214,332
835,57,2,5,3,10,21,55,5,7,235,387
835,58,5,2,9,4,54,22,9,9,289,409
835,59,3,4,8,5,-65,-59,4,0,224,350
835,60,6,2,7,6,61,24,5,4,285,374
835,61,2,4,5,8,23,44,8,8,308,418
835,62,2,5,2,11,20,-44,8,4,328,374
835,63,3,4,8,5,-65,41,3,5,263,415
835,64,4,4,7,6,43,42,6,7,306,457
835,65,3,4,7,6,-66,42,0,9,240,499
835,66,3,3,7,6,34,-67,4,2,274,432
835,67,3,3,6,7,33,34,7,6,307,466
835,68,3,3,9,4,-64,31,3,7,243,497
835,69,3,4,4,9,31,-55,4,2,274,442
835,70,2,5,4,9,22,54,6,6,296,496
835,71,4,3,7,6,43,33,9,9,339,529
836,1,4,2,6,7,42,25,2,5,42,25
836,2,2,4,5,8,23,44,5,9,65,69
836,3,5,2,10,3,-45,-79,0,0,20,-10
836,4,3,3,6,7,33,34,3,4,53,24
836,5,3,3,5,8,32,35,5,9,85,59
836,6,4,2,9,4,-55,-78,0,1,30,-19
836,7,3,4,8,5,35,41,5,2,65,22
836,8,4,2,10,3,-54,21,1,3,11,43
836,9,4,2,10,3,46,21,7,4,57,64
836,10,4,2,6,7,42,25,9,9,99,89
836,11,3,3,4,9,-69,-64,0,5,30,25
836,12,3,3,6,7,33,34,3,9,63,59
836,13,4,3,5,8,41,-65,4,4,104,-6
836,14,2,4,3,10,21,-54,5,0,125,-60
836,15,2,5,3,10,21,55,6,5,146,-5
836,16,2,4,7,6,-75,42,1,7,71,37
836,17,2,4,3,10,21,-54,2,3,92,-17
836,18,2,4,6,7,24,43,6,6,116,26
836,19,4,3,5,8,41,-65,7,1,157,-39
836,20,2,4,8,5,-74,41,3,2,83,2
836,21,2,7,1,12,-20,75,3,7,63,77
836,22,3,3,9,4,36,31,9,8,99,108
836,23,2,4,5,8,-77,-56,2,2,22,52
836,24,3,4,6,7,33,43,5,5,55,95
836,25,3,4,4,9,31,-55,6,0,86,40
836,26,4,2,7,6,43,24,9,4,129,64
836,27,4,3,8,5,-56,32,3,6,73,96
836,28,2,4,4,9,22,-55,5,1,95,41
836,29,3,3,8,5,-65,32,0,3,30,73
836,30,3,4,5,8,32,44,2,7,62,117
836,31,2,4,4,9,22,-55,4,2,84,62
836,32,3,4,4,9,31,45,5,7,115,107
836,33,5,2,9,4,54,22,9,9,169,129
836,34,5,2,8,5,-47,-77,2,2,122,52
836,35,3,3,7,6,34,33,6,5,156,85
836,36,3,4,8,5,-65,41,1,6,91,126
836,37,2,4,6,7,24,43,5,9,115,169
836,38,4,2,8,5,44,-77,9,2,159,92
836,39,3,4,7,6,-66,42,3,4,93,134
836,40,2,5,2,11,20,-44,3,0,113,90
836,41,3,4,5,8,32,44,5,4,145,134
836,42,3,3,7,6,34,33,9,7,179,167
836,43,3,3,7,6,-66,-67,3,0,113,100
836,44,3,3,8,5,35,32,8,2,148,132
836,45,4,3,9,4,-55,31,3,3,93,163
836,46,4,2,10,3,46,21,9,4,139,184
836,47,5,2,9,4,-46,22,3,6,93,206
836,48,5,2,10,3,55,21,8,7,148,227
836,49,2,5,3,10,21,-45,9,2,169,182
836,50,5,2,9,4,-46,22,3,4,123,204
836,51,2,5,3,10,21,55,4,9,144,259
836,52,3,4,7,6,34,-58,8,1,178,201
836,53,4,3,5,8,41,35,9,6,219,236
836,54,4,2,8,5,-56,23,3,9,163,259
836,55,3,5,6,7,33,-48,6,1,196,211
836,56,2,5,5,8,23,53,9,4,219,264
836,57,5,3,11,2,-44,-30,5,4,175,234
836,58,2,5,2,11,20,-44,5,0,195,190
836,59,3,3,8,5,-65,32,0,2,130,222
836,60,3,4,5,8,32,44,2,6,162,266
836,61,4,3,9,4,45,31,7,7,207,297
836,62,3,4,6,7,-67,-57,0,0,140,240
836,63,3,3,6,7,33,34,3,4,173,274
836,64,3,3,4,9,31,-64,4,0,204,210
836,65,3,4,7,6,34,42,8,2,238,252
836,66,2,5,3,10,21,55,9,7,259,307
836,67,3,3,7,6,-66,-67,3,0,193,240
836,68,4,3,8,5,44,32,7,2,237,272
836,69,2,5,5,8,-77,53,0,5,160,325
836,70,3,3,8,5,35,32,5,7,195,357
836,71,4,3,8,5,44,32,9,9,239,389
836,72,3,3,7,6,-66,-67,3,2,173,322
836,73,3,4,5,8,32,44,5,6,205,366
836,74,3,3,7,6,34,33,9,9,239,399
836,75,4,2,8,5,-56,-77,3,2,183,322
836,76,3,3,7,6,34,33,7,5,217,355
836,77,3,3,6,7,-67,34,0,9,150,389
836,78,2,5,3,10,21,-45,1,4,171,344
836,79,5,2,9,4,54,22,5,6,225,366
836,80,5,2,9,4,54,22,9,8,279,388
836,81,2,5,5,8,-77,-47,2,1,202,341
836,82,2,4,2,11,20,47,2,8,222,388
836,83,2,5,6,7,24,-48,6,0,246,340
836,84,2,6,3,10,21,64,7,4,267,404
836,85,4,3,6,7,42,34,9,8,309,438
836,86,6,2,8,5,-38,-77,1,1,271,361
836,87,3,3,4,9,31,36,2,7,302,397
836,88,5,2,10,3,55,21,7,8,357,418
836,89,2,4,5,8,-77,-56,0,2,280,362
836,90,4,3,6,7,42,34,2,6,322,396
836,91,4,3,7,6,43,33,5,9,365,429
836,92,3,4,6,7,33,-57,8,2,398,372
836,93,2,5,3,10,21,55,9,7,419,427
836,94,2,6,3,10,-79,-36,0,1,340,391
836,95,4,3,8,5,44,32,4,3,384,423
836,96,4,2,8,5,44,23,8,6,428,446
836,97,3,4,5,8,-68,-56,0,0,360,390
836,98,2,5,4,9,22,54,2,4,382,444
836,99,3,4,4,9,31,45,3,9,413,489
836,100,2,5,4,9,22,-46,5,3,435,443
836,101,5,2,10,3,-45,21,0,4,390,464
836,102,2,5,5,8,23,53,3,7,413,517
837,1,4,3,9,4,45,31,5,1,45,31
837,2,3,4,6,7,33,43,8,4,78,74
837,3,4,3,6,7,-58,34,0,8,20,108
837,4,3,3,5,8,32,-65,2,3,52,43
837,5,2,5,4,9,22,54,4,7,74,97
837,6,4,3,7,6,43,-67,7,0,117,30
837,7,4,3,8,5,-56,32,1,2,61,62
837,8,6,2,8,5,62,23,3,5,123,85
837,9,5,2,9,4,54,22,7,7,177,107
837,10,3,3,6,7,-67,-66,0,1,110,41
837,11,3,3,6,7,33,34,3,5,143,75
837,12,4,3,8,5,44,32,7,7,187,107
837,13,6,2,11,2,-35,20,2,7,152,127
837,14,4,3,7,6,43,-67,5,0,195,60
837,15,4,3,10,3,-54,30,1,0,141,90
837,16,2,5,3,10,21,55,2,5,162,145
837,17,2,5,2,11,20,-44,2,1,182,101
837,18,3,4,9,4,36,40,8,1,218,141
837,19,5,3,9,4,-46,31,2,2,172,172
837,20,3,4,5,8,32,44,4,6,204,216
837,21,3,4,9,4,-64,40,0,6,140,256
837,22,3,3,6,7,33,-66,3,0,173,190
837,23,3,3,9,4,36,31,9,1,209,221
837,24,3,3,9,4,-64,31,5,2,145,252
837,25,3,3,7,6,34,33,9,5,179,285
837,26,2,4,7,6,-75,42,4,7,104,327
837,27,3,4,7,6,34,42,8,9,138,369
837,28,3,3,6,7,-67,-66,1,3,71,303
837,29,4,3,9,4,45,31,6,4,116,334
837,30,3,3,6,7,33,34,9,8,149,368
837,31,5,2,7,6,-48,-76,1,2,101,292
837,32,3,3,8,5,35,32,6,4,136,324
837,33,3,3,10,3,-63,30,3,4,73,354
837,34,2,5,5,8,23,53,6,7,96,407
837,35,2,5,2,11,20,-44,6,3,116,363
837,36,4,3,7,6,43,33,9,6,159,396
837,37,2,6,4,9,-78,63,1,9,81,459
837,38,3,3,6,7,33,-66,4,3,114,393
837,39,4,2,7,6,43,24,7,7,157,417
837,40,5,2,8,5,-47,-77,0,0,110,340
837,41,4,3,5,8,41,35,1,5,151,375
837,42,3,3,7,6,34,33,5,8,185,408
837,43,2,5,4,9,22,-46,7,2,207,362
837,44,3,3,7,6,-66,33,1,5,141,395
837,45,2,4,6,7,24,43,5,8,165,438
837,46,2,4,5,8,23,-56,8,2,188,382
837,47,5,3,7,6,-48,33,0,5,140,415
837,48,5,2,11,2,56,20,6,5,196,435
837,49,3,3,7,6,-66,33,0,8,130,468
837,50,3,4,3,10,30,-54,0,4,160,414
837,51,3,4,5,8,32,44,2,8,192,458
837,52,4,3,8,5,44,-68,6,0,236,390
837,53,2,4,4,9,22,45,8,5,258,435
837,54,5,3,8,5,-47,32,1,7,211,467
837,55,2,4,8,5,26,41,7,8,237,508
838,1,2,5,3,10,21,55,1,5,21,55
838,2,2,5,4,9,22,54,3,9,43,109
838,3,3,3,4,9,31,-64,4,5,74,45
838,4,4,3,9,4,45,31,9,6,119,76
838,5,4,3,8,5,-56,32,3,8,63,108
838,6,4,2,8,5,44,-77,7,1,107,31
838,7,4,3,10,3,-54,30,3,1,53,61
838,8,4,2,8,5,44,23,7,4,97,84
838,9,5,2,8,5,-47,23,0,7,50,107
838,10,5,2,10,3,55,21,5,8,105,128
838,11,4,2,5,8,41,-74,6,4,146,54
838,12,3,4,6,7,33,43,9,7,179,97
838,13,2,5,4,9,-78,-46,1,1,101,51
838,14,4,3,6,7,42,34,3,5,143,85
838,15,3,3,7,6,34,33,7,8,177,118
838,16,3,3,6,7,-67,-66,0,2,110,52
838,17,2,4,4,9,22,45,2,7,132,97
838,18,3,4,7,6,34,42,6,9,166,139
838,19,4,3,10,3,-54,30,2,9,112,169
838,20,3,3,7,6,34,-67,6,2,146,102
838,21,2,4,6,7,-76,43,0,5,70,145
838,22,4,2,8,5,44,23,4,8,114,168
838,23,2,4,5,8,23,-56,7,2,137,112
838,24,2,5,3,10,21,55,8,7,158,167
838,25,3,4,4,9,31,-55,9,2,189,112
838,26,3,4,6,7,-67,43,2,5,122,155
838,27,3,4,6,7,33,43,5,8,155,198
838,28,3,3,8,5,-65,-68,0,0,90,130
838,29,4,3,5,8,41,35,1,5,131,165
838,30,4,4,5,8,41,44,2,9,172,209
838,31,2,5,4,9,22,-46,4,3,194,163
838,32,3,4,5,8,32,44,6,7,226,207
838,33,3,3,8,5,-65,32,1,9,161,239
838,34,4,2,6,7,42,-75,3,4,203,164
838,35,5,2,11,2,56,20,9,4,259,184
838,36,4,3,7,6,-57,33,2,7,202,217
838,37,4,3,8,5,44,32,6,9,246,249
838,38,3,3,8,5,-65,-68,1,1,181,181
838,39,2,5,3,10,21,55,2,6,202,236
838,40,2,4,2,11,20,-53,2,3,222,183
838,41,3,3,6,7,33,34,5,7,255,217
838,42,3,3,5,8,32,-65,7,2,287,152
838,43,4,2,9,4,-55,22,2,4,232,174
838,44,4,3,8,5,44,32,6,6,276,206
838,45,3,4,4,9,31,-55,7,1,307,151
838,46,3,4,4,9,31,45,8,6,338,196
838,47,4,2,8,5,-56,23,2,9,282,219
838,48,3,4,3,10,30,-54,2,5,312,165
838,49,3,3,6,7,33,34,5,9,345,199
838,50,5,2,10,3,-45,-79,0,0,300,120
838,51,2,5,5,8,23,53,3,3,323,173
838,52,2,4,6,7,24,43,7,6,347,216
838,53,2,5,7,6,-75,51,2,7,272,267
838,54,4,4,6,7,42,-57,4,0,314,210
838,55,4,3,6,7,42,34,6,4,356,244
838,56,5,2,9,4,-46,22,0,6,310,266
838,57,4,2,9,4,45,22,5,8,355,288
838,58,3,4,4,9,31,-55,6,3,386,233
838,59,2,4,8,5,-74,41,2,4,312,274
838,60,3,3,7,6,34,33,6,7,346,307
838,61,3,5,4,9,31,-46,7,1,377,261
838,62,2,4,3,10,21,46,8,7,398,307
838,63,3,3,8,5,-65,32,3,9,333,339
838,64,3,4,3,10,30,-54,3,5,363,285
838,65,2,4,5,8,23,44,6,9,386,329
838,66,3,4,4,9,31,-55,7,4,417,274
838,67,3,4,7,6,-66,42,1,6,351,316
838,68,3,3,5,8,32,-65,3,1,383,251
838,69,4,3,7,6,43,33,6,4,426,284
838,70,3,4,8,5,-65,41,1,5,361,325
838,71,2,4,4,9,22,-55,3,0,383,270
838,72,4,3,10,3,46,30,9,0,429,300
838,73,2,5,3,10,-79,55,0,5,350,355
838,74,3,4,3,10,30,-54,0,1,380,301
838,75,3,3,6,7,33,34,3,5,413,335
838,76,5,2,10,3,55,21,8,6,468,356
838,77,2,4,2,11,20,-53,8,3,488,303
838,78,3,3,8,5,-65,32,3,5,423,335
838,79,3,3,9,4,36,31,9,6,459,366
838,80,4,3,7,6,-57,33,2,9,402,399
838,81,4,4,6,7,42,-57,4,2,444,342
838,82,5,3,6,7,51,34,5,6,495,376
838,83,3,3,4,9,31,-64,6,2,526,312
839,1,4,3,5,8,41,35,1,5,41,35
839,2,3,4,7,6,34,42,5,7,75,77
839,3,4,3,8,5,44,32,9,9,119,109
839,4,2,4,3,10,-79,-54,0,5,40,55
839,5,4,2,11,2,47,20,7,5,87,75
839,6,3,4,4,9,31,-55,8,0,118,20
839,7,2,4,6,7,-76,43,2,3,42,63
839,8,3,4,7,6,34,42,6,5,76,105
839,9,3,3,3,10,30,-63,6,2,106,42
839,10,3,3,6,7,33,34,9,6,139,76
839,11,3,3,6,7,-67,-66,2,0,72,10
839,12,3,4,4,9,31,45,3,5,103,55
839,13,3,3,10,3,-63,30,0,5,40,85
839,14,3,3,6,7,33,34,3,9,73,119
839,15,3,3,9,4,36,-69,9,0,109,50
839,16,4,3,8,5,-56,32,3,2,53,82
839,17,4,2,8,5,44,23,7,5,97,105
839,18,3,3,4,9,31,-64,8,1,128,41
839,19,3,3,8,5,-65,32,3,3,63,73
839,20,3,4,8,5,35,41,8,4,98,114
839,21,5,3,8,5,-47,32,1,6,51,146
839,22,4,2,9,4,45,22,6,8,96,168
839,23,4,3,9,4,-55,31,1,9,41,199
839,24,5,2,9,4,54,-78,5,1,95,121
839,25,4,3,8,5,44,32,9,3,139,153
839,26,4,3,6,7,-58,34,1,7,81,187
839,27,3,3,4,9,31,-64,2,3,112,123
839,28,3,5,4,9,31,54,3,7,143,177
839,29,4,3,6,7,42,-66,5,1,185,111
839,30,5,2,8,5,53,23,8,4,238,134
839,31,4,3,7,6,-57,33,1,7,181,167
839,32,4,4,8,5,44,41,5,8,225,208
839,33,2,6,3,10,21,-36,6,2,246,172
839,34,2,5,4,9,22,54,8,6,268,226
839,35,4,2,8,5,-56,23,2,9,212,249
839,36,6,2,9,4,63,-78,5,1,275,171
839,37,4,3,7,6,43,33,8,4,318,204
839,38,4,2,9,4,-55,22,3,6,263,226
839,39,4,2,7,6,43,-76,6,0,306,150
839,40,2,4,7,6,-75,42,1,2,231,192
839,41,4,2,6,7,42,25,3,7,273,217
839,42,2,4,4,9,22,-55,5,2,295,162
839,43,4,2,8,5,44,23,9,5,339,185
839,44,3,3,5,8,-68,-65,1,0,271,120
839,45,3,3,5,8,32,35,3,5,303,155
839,46,3,4,8,5,35,41,8,6,338,196
839,47,4,3,5,8,41,-65,9,1,379,131
839,48,5,2,10,3,-45,21,4,2,334,152
839,49,2,5,6,7,24,52,8,4,358,204
839,50,3,4,5,8,-68,44,0,8,290,248
839,51,3,5,6,7,33,-48,3,0,323,200
839,52,5,2,6,7,51,25,4,5,374,225
839,53,4,2,8,5,44,23,8,8,418,248
839,54,3,4,3,10,30,-54,8,4,448,194
839,55,2,4,4,9,-78,45,0,9,370,239
839,56,3,3,6,7,33,-66,3,3,403,173
839,57,4,3,9,4,45,31,8,4,448,204
839,58,4,3,5,8,41,35,9,9,489,239
839,59,2,5,4,9,-78,-46,1,3,411,193
839,60,4,2,10,3,46,21,7,4,457,214
839,61,6,2,10,3,-36,21,1,5,421,235
839,62,4,3,4,9,40,-64,1,1,461,171
839,63,5,2,10,3,55,21,6,2,516,192
840,1,5,2,10,3,55,21,5,1,55,21
840,2,5,2,9,4,54,22,9,3,109,43
840,3,4,3,5,8,-59,35,0,8,50,78
840,4,3,4,7,6,34,-58,4,0,84,20
840,5,3,3,5,8,32,35,6,5,116,55
840,6,4,3,8,5,-56,32,0,7,60,87
840,7,3,4,4,9,31,-55,1,2,91,32
840,8,3,4,4,9,31,45,2,7,122,77
840,9,5,2,9,4,54,22,6,9,176,99
840,10,3,3,7,6,-66,-67,0,2,110,32
840,11,2,4,4,9,22,45,2,7,132,77
840,12,2,4,5,8,23,-56,5,1,155,21
840,13,4,3,8,5,44,32,9,3,199,53
840,14,4,3,9,4,-55,31,4,4,144,84
840,15,2,4,5,8,23,44,7,8,167,128
840,16,2,5,5,8,-77,-47,0,1,90,81
840,17,3,4,6,7,33,43,3,4,123,124
840,18,3,3,7,6,34,33,7,7,157,157
840,19,3,3,5,8,32,-65,9,2,189,92
840,20,5,3,8,5,-47,32,2,4,142,124
840,21,4,4,5,8,41,44,3,8,183,168
840,22,2,4,4,9,22,-55,5,3,205,113
840,23,3,4,6,7,33,43,8,6,238,156
840,24,4,4,7,6,-57,42,1,8,181,198
840,25,4,2,9,4,45,-78,6,0,226,120
840,26,3,3,5,8,32,35,8,5,258,155
840,27,5,2,10,3,-45,21,3,6,213,176
840,28,2,4,6,7,24,43,7,9,237,219
840,29,2,4,6,7,-76,-57,1,2,161,162
840,30,3,4,8,5,35,41,6,3,196,203
840,31,5,2,10,3,-45,21,1,4,151,224
840,32,4,3,9,4,45,31,6,5,196,255
840,33,3,4,7,6,-66,42,0,7,130,297
840,34,3,4,4,9,31,-55,1,2,161,242
840,35,2,4,4,9,22,45,3,7,183,287
840,36,3,3,6,7,33,-66,6,1,216,221
840,37,2,4,5,8,23,44,9,5,239,265
840,38,3,3,8,5,-65,32,4,7,174,297
840,39,3,4,7,6,34,42,8,9,208,339
840,40,5,2,10,3,-45,-79,3,0,163,260
840,41,2,5,5,8,23,53,6,3,186,313
840,42,4,2,8,5,-56,23,0,6,130,336
840,43,2,4,6,7,24,43,4,9,154,379
840,44,3,3,6,7,33,-66,7,3,187,313
840,45,2,5,6,7,-76,52,1,5,111,365
840,46,2,5,5,8,23,53,4,8,134,418
840,47,5,2,9,4,54,-78,8,0,188,340
840,48,3,4,6,7,-67,43,1,3,121,383
840,49,4,2,7,6,43,24,4,7,164,407
840,50,4,3,7,6,43,-67,7,0,207,340
840,51,5,2,10,3,-45,21,2,1,162,361
840,52,2,5,6,7,24,52,6,3,186,413
840,53,4,3,7,6,43,33,9,6,229,446
840,54,6,2,11,2,-35,20,4,6,194,466
840,55,5,2,10,3,55,21,9,7,249,487
840,56,3,3,7,6,-66,-67,3,0,183,420
840,57,3,3,5,8,32,35,5,5,215,455
840,58,2,5,5,8,23,53,8,8,238,508
841,1,4,3,8,5,44,32,4,2,44,32
841,2,2,6,2,11,20,65,4,7,64,97
841,3,5,2,7,6,52,-76,6,1,116,21
841,4,4,2,10,3,-54,21,2,2,62,42
841,5,3,3,10,3,37,30,9,2,99,72
841,6,4,2,8,5,-56,23,3,5,43,95
841,7,3,4,6,7,33,43,6,8,76,138
841,8,4,2,9,4,-55,-78,1,0,21,60
841,9,3,4,7,6,34,42,5,2,55,102
841,10,4,3,7,6,43,33,8,5,98,135
841,11,5,2,10,3,-45,21,3,6,53,156
841,12,3,3,4,9,31,-64,4,2,84,92
841,13,6,2,9,4,63,22,7,4,147,114
841,14,4,3,6,7,42,34,9,8,189,148
841,15,3,4,7,6,-66,-58,3,0,123,90
841,16,3,3,8,5,35,32,8,2,158,122
841,17,4,4,6,7,-58,43,0,5,100,165
841,18,2,4,4,9,22,-55,2,0,122,110
841,19,4,2,8,5,44,23,6,3,166,133
841,20,4,2,7,6,43,24,9,7,209,157
841,21,4,3,9,4,-55,31,4,8,154,188
841,22,4,3,5,8,41,-65,5,3,195,123
841,23,4,3,7,6,43,33,8,6,238,156
841,24,2,5,6,7,-76,52,2,8,162,208
841,25,4,2,6,7,42,-75,4,3,204,133
841,26,4,2,7,6,43,24,7,7,247,157
841,27,3,4,6,7,-67,-57,0,0,180,100
841,28,3,4,6,7,33,43,3,3,213,143
841,29,4,3,5,8,41,35,4,8,254,178
841,30,4,2,8,5,44,-77,8,1,298,101
841,31,2,5,3,10,21,55,9,6,319,156
841,32,4,3,8,5,-56,32,3,8,263,188
841,33,2,5,5,8,23,-47,6,1,286,141
841,34,2,5,5,8,23,53,9,4,309,194
841,35,3,3,4,9,-69,-64,0,0,240,130
841,36,5,2,8,5,53,23,3,3,293,153
841,37,3,3,7,6,34,33,7,6,327,186
841,38,3,4,8,5,-65,41,2,7,262,227
841,39,3,4,5,8,32,-56,4,1,294,171
841,40,4,4,6,7,42,43,6,4,336,214
841,41,3,4,7,6,-66,42,0,6,270,256
841,42,4,3,5,8,41,-65,1,1,311,191
841,43,5,2,8,5,53,23,4,4,364,214
841,44,2,5,7,6,25,51,9,5,389,265
841,45,3,3,7,6,-66,33,3,8,323,298
841,46,4,3,5,8,41,-65,4,3,364,233
841,47,3,3,4,9,31,36,5,9,395,269
841,48,3,3,7,6,34,-67,9,2,429,202
841,49,3,4,7,6,-66,42,3,4,363,244
841,50,2,5,4,9,22,54,5,8,385,298
841,51,4,3,8,5,44,-68,9,0,429,230
841,52,3,4,8,5,-65,41,4,1,364,271
841,53,2,5,4,9,22,54,6,5,386,325
841,54,5,2,10,3,-45,21,1,6,341,346
841,55,2,4,6,7,24,43,5,9,365,389
841,56,3,4,7,6,34,-58,9,1,399,331
841,57,2,4,5,8,-77,44,2,5,322,375
841,58,5,2,9,4,54,22,6,7,376,397
841,59,3,4,4,9,31,-55,7,2,407,342
841,60,6,2,9,4,-37,22,0,4,370,364
841,61,2,4,5,8,23,44,3,8,393,408
841,62,2,5,5,8,23,-47,6,1,416,361
841,63,2,4,3,10,21,46,7,7,437,407
841,64,3,4,8,5,-65,41,2,8,372,448
841,65,5,3,7,6,52,-67,4,1,424,381
841,66,5,2,8,5,53,23,7,4,477,404
841,67,3,3,5,8,32,35,9,9,509,439
842,1,3,3,6,7,33,34,3,4,33,34
842,2,2,4,6,7,24,43,7,7,57,77
842,3,4,2,6,7,42,-75,9,2,99,2
842,4,3,3,7,6,-66,33,3,5,33,35
842,5,4,2,7,6,43,24,6,9,76,59
842,6,3,4,7,6,-66,-58,0,1,10,1
842,7,2,4,3,10,21,46,1,7,31,47
842,8,4,2,9,4,45,22,6,9,76,69
842,9,3,4,6,7,33,-57,9,2,109,12
842,10,3,3,9,4,-64,31,5,3,45,43
842,11,2,4,3,10,21,46,6,9,66,89
842,12,3,4,4,9,31,-55,7,4,97,34
842,13,4,2,9,4,-55,22,2,6,42,56
842,14,4,2,8,5,44,23,6,9,86,79
842,15,4,3,9,4,-55,-69,1,0,31,10
842,16,4,3,9,4,45,31,6,1,76,41
842,17,4,3,6,7,42,34,8,5,118,75
842,18,4,4,5,8,41,44,9,9,159,119
842,19,3,3,8,5,-65,-68,4,1,94,51
842,20,3,4,4,9,31,45,5,6,125,96
842,21,4,3,10,3,-54,30,1,6,71,126
842,22,4,2,10,3,46,21,7,7,117,147
842,23,3,3,9,4,-64,31,3,8,53,178
842,24,2,4,3,10,21,-54,4,4,74,124
842,25,5,2,9,4,54,22,8,6,128,146
842,26,4,2,9,4,-55,22,3,8,73,168
842,27,2,5,4,9,22,-46,5,2,95,122
842,28,3,3,6,7,33,34,8,6,128,156
842,29,3,3,4,9,31,-64,9,2,159,92
842,30,5,2,7,6,-48,24,1,6,111,116
842,31,4,2,7,6,43,-76,4,0,154,40
842,32,5,2,7,6,52,24,6,4,206,64
842,33,4,3,8,5,-56,32,0,6,150,96
842,34,4,2,9,4,45,22,5,8,195,118
842,35,2,4,6,7,24,-57,9,1,219,61
842,36,4,2,8,5,-56,23,3,4,163,84
842,37,2,5,5,8,23,53,6,7,186,137
842,38,5,2,11,2,-44,20,2,7,142,157
842,39,3,4,4,9,31,-55,3,2,173,102
842,40,3,3,6,7,33,34,6,6,206,136
842,41,3,4,7,6,-66,42,0,8,140,178
842,42,3,3,4,9,31,-64,1,4,171,114
842,43,5,2,10,3,55,21,6,5,226,135
842,44,3,3,10,3,-63,30,3,5,163,165
842,45,3,3,8,5,35,32,8,7,198,197
842,46,4,3,9,4,-55,31,3,8,143,228
842,47,3,3,4,9,31,-64,4,4,174,164
842,48,4,2,5,8,41,-74,5,0,215,90
842,49,2,5,3,10,21,55,6,5,236,145
842,50,4,2,8,5,-56,23,0,8,180,168
842,51,3,4,3,10,30,-54,0,4,210,114
842,52,4,3,7,6,43,33,3,7,253,147
842,53,3,3,8,5,35,32,8,9,288,179
842,54,3,3,9,4,-64,-69,4,0,224,110
842,55,3,4,5,8,32,44,6,4,256,154
842,56,2,5,4,9,22,54,8,8,278,208
842,57,4,2,9,4,-55,-78,3,0,223,130
842,58,4,2,7,6,43,24,6,4,266,154
842,59,2,4,3,10,21,-54,7,0,287,100
842,60,2,5,3,10,21,55,8,5,308,155
842,61,2,5,5,8,-77,53,1,8,231,208
842,62,2,5,6,7,24,-48,5,0,255,160
842,63,4,3,9,4,-55,31,0,1,200,191
842,64,4,3,5,8,41,35,1,6,241,226
842,65,4,3,10,3,46,30,7,6,287,256
842,66,4,2,10,3,-54,21,3,7,233,277
842,67,2,4,6,7,24,-57,7,0,257,220
842,68,2,5,3,10,21,55,8,5,278,275
842,69,2,5,3,10,21,-45,9,0,299,230
842,70,4,2,9,4,-55,22,4,2,244,252
842,71,3,4,3,10,30,46,4,8,274,298
842,72,3,4,7,6,34,-58,8,0,308,240
842,73,3,4,5,8,-68,44,0,4,240,284
842,74,4,4,5,8,41,44,1,8,281,328
842,75,3,4,6,7,33,-57,4,1,314,271
842,76,3,4,8,5,35,41,9,2,349,312
842,77,2,5,5,8,-77,53,2,5,272,365
842,78,2,5,4,9,22,54,4,9,294,419
842,79,3,3,5,8,32,-65,6,4,326,354
842,80,3,3,7,6,-66,33,0,7,260,387
842,81,4,2,8,5,44,-77,4,0,304,310
842,82,4,2,8,5,44,23,8,3,348,333
842,83,5,2,9,4,-46,22,2,5,302,355
842,84,4,2,11,2,47,20,9,5,349,375
842,85,2,5,5,8,-77,53,2,8,272,428
842,86,2,4,5,8,23,-56,5,2,295,372
842,87,5,2,11,2,-44,20,1,2,251,392
842,88,3,4,7,6,34,42,5,4,285,434
842,89,3,4,7,6,34,42,9,6,319,476
842,90,3,4,5,8,-68,-56,1,0,251,420
842,91,3,3,8,5,35,32,6,2,286,452
842,92,4,3,8,5,-56,32,0,4,230,484
842,93,2,6,2,11,20,65,0,9,250,549
843,1,3,3,9,4,36,31,6,1,36,31
843,2,2,4,3,10,21,46,7,7,57,77
843,3,5,2,6,7,51,-75,8,2,108,2
843,4,3,4,7,6,-66,42,2,4,42,44
843,5,3,4,5,8,32,44,4,8,74,88
843,6,4,2,8,5,44,-77,8,1,118,11
843,7,3,3,8,5,-65,32,3,3,53,43
843,8,3,3,4,9,31,36,4,9,84,79
843,9,2,4,6,7,24,-57,8,2,108,22
843,10,3,4,4,9,31,45,9,7,139,67
843,11,4,3,8,5,-56,32,3,9,83,99
843,12,5,2,8,5,53,-77,6,2,136,22
843,13,3,3,5,8,32,35,8,7,168,57
843,14,5,2,8,5,-47,-77,1,0,121,-20
843,15,4,3,9,4,45,31,6,1,166,11
843,16,5,2,9,4,-46,22,0,3,120,33
843,17,4,2,9,4,45,22,5,5,165,55
843,18,3,4,6,7,33,43,8,8,198,98
843,19,5,2,10,3,-45,21,3,9,153,119
843,20,6,2,10,3,64,-79,7,0,217,40
843,21,5,2,9,4,-46,22,1,2,171,62
843,22,4,3,7,6,43,33,4,5,214,95
843,23,4,3,8,5,44,32,8,7,258,127
843,24,3,3,7,6,-66,-67,2,0,192,60
843,25,2,4,5,8,23,44,5,4,215,104
843,26,2,4,8,5,-74,41,1,5,141,145
843,27,3,4,6,7,33,43,4,8,174,188
843,28,3,3,7,6,34,-67,8,1,208,121
843,29,3,3,8,5,-65,32,3,3,143,153
843,30,5,2,9,4,54,22,7,5,197,175
843,31,3,3,5,8,32,-65,9,0,229,110
843,32,4,3,7,6,-57,33,2,3,172,143
843,33,3,4,4,9,31,45,3,8,203,188
843,34,3,3,9,4,36,31,9,9,239,219
843,35,4,3,9,4,-55,-69,4,0,184,150
843,36,5,2,6,7,51,25,5,5,235,175
843,37,3,5,5,8,32,53,7,8,267,228
843,38,3,4,3,10,30,-54,7,4,297,174
843,39,4,2,7,6,-57,24,0,8,240,198
843,40,3,4,6,7,33,-57,3,1,273,141
843,41,3,4,8,5,35,41,8,2,308,182
843,42,3,3,6,7,-67,34,1,6,241,216
843,43,3,4,8,5,35,41,6,7,276,257
843,44,2,4,4,9,22,-55,8,2,298,202
843,45,5,2,9,4,-46,22,2,4,252,224
843,46,3,5,3,10,30,55,2,9,282,279
843,47,2,5,2,11,20,-44,2,5,302,235
843,48,4,3,8,5,44,32,6,7,346,267
843,49,3,4,6,7,33,-57,9,0,379,210
843,50,4,4,6,7,-58,43,1,3,321,253
843,51,4,3,6,7,42,34,3,7,363,287
843,52,3,3,9,4,36,31,9,8,399,318
843,53,4,3,8,5,-56,-68,3,0,343,250
843,54,4,3,7,6,43,33,6,3,386,283
843,55,3,3,8,5,-65,32,1,5,321,315
843,56,2,6,3,10,21,64,2,9,342,379
843,57,4,3,6,7,42,-66,4,3,384,313
843,58,4,3,5,8,41,35,5,8,425,348
843,59,2,4,6,7,24,-57,9,1,449,291
843,60,2,4,6,7,-76,43,3,4,373,334
843,61,3,3,8,5,35,32,8,6,408,366
843,62,2,4,5,8,-77,-56,1,0,331,310
843,63,4,3,8,5,44,32,5,2,375,342
843,64,4,2,9,4,-55,22,0,4,320,364
843,65,3,3,8,5,35,32,5,6,355,396
843,66,3,3,7,6,34,33,9,9,389,429
843,67,4,3,7,6,-57,-67,2,2,332,362
843,68,4,2,9,4,45,22,7,4,377,384
843,69,5,2,9,4,-46,22,1,6,331,406
843,70,4,2,4,9,40,-73,1,3,371,333
843,71,3,3,8,5,35,32,6,5,406,365
843,72,4,2,7,6,43,24,9,9,449,389
843,73,3,4,8,5,-65,-59,4,0,384,330
843,74,4,3,6,7,42,34,6,4,426,364
843,75,3,5,7,6,-66,51,0,5,360,415
843,76,3,3,9,4,36,31,6,6,396,446
843,77,3,4,8,5,-65,41,1,7,331,487
843,78,4,3,9,4,45,31,6,8,376,518
844,1,5,2,8,5,53,23,3,3,53,23
844,2,4,3,8,5,44,32,7,5,97,55
844,3,2,5,4,9,22,54,9,9,119,109
844,4,4,3,7,6,-57,-67,2,2,62,42
844,5,4,3,9,4,45,31,7,3,107,73
844,6,3,3,8,5,-65,32,2,5,42,105
844,7,4,3,6,7,42,34,4,9,84,139
844,8,3,3,7,6,34,-67,8,2,118,72
844,9,4,3,5,8,41,35,9,7,159,107
844,10,4,2,10,3,-54,21,5,8,105,128
844,11,3,3,10,3,-63,30,2,8,42,158
844,12,2,6,3,10,21,-36,3,2,63,122
844,13,5,2,10,3,55,21,8,3,118,143
844,14,3,4,5,8,-68,44,0,7,50,187
844,15,3,4,4,9,31,-55,1,2,81,132
844,16,4,3,8,5,44,32,5,4,125,164
844,17,2,4,5,8,23,44,8,8,148,208
844,18,3,4,5,8,-68,-56,0,2,80,152
844,19,4,2,7,6,43,24,3,6,123,176
844,20,2,5,8,5,26,50,9,6,149,226
844,21,2,4,8,5,-74,41,5,7,75,267
844,22,3,3,5,8,32,-65,7,2,107,202
844,23,4,3,6,7,42,34,9,6,149,236
844,24,3,3,4,9,-69,-64,0,2,80,172
844,25,5,2,8,5,53,23,3,5,133,195
844,26,2,6,4,9,22,63,5,8,155,258
844,27,4,3,8,5,44,-68,9,0,199,190
844,28,5,2,10,3,-45,21,4,1,154,211
844,29,3,3,6,7,33,34,7,5,187,245
844,30,3,3,7,6,-66,33,1,8,121,278
844,31,4,3,6,7,42,-66,3,2,163,212
844,32,4,3,6,7,42,34,5,6,205,246
844,33,4,3,6,7,42,-66,7,0,247,180
844,34,3,4,4,9,31,45,8,5,278,225
844,35,4,2,8,5,-56,23,2,8,222,248
844,36,3,4,4,9,31,-55,3,3,253,193
844,37,4,3,7,6,43,33,6,6,296,226
844,38,3,4,7,6,-66,42,0,8,230,268
844,39,4,3,8,5,44,-68,4,0,274,200
844,40,3,3,6,7,33,34,7,4,307,234
844,41,2,5,3,10,21,55,8,9,328,289
844,42,3,3,6,7,-67,-66,1,3,261,223
844,43,3,4,8,5,35,41,6,4,296,264
844,44,2,5,3,10,21,55,7,9,317,319
844,45,4,2,6,7,42,-75,9,4,359,244
844,46,3,4,5,8,-68,44,1,8,291,288
844,47,3,3,6,7,33,-66,4,2,324,222
844,48,3,3,9,4,-64,31,0,3,260,253
844,49,3,3,6,7,33,34,3,7,293,287
844,50,3,4,7,6,34,42,7,9,327,329
844,51,5,3,10,3,-45,30,2,9,282,359
844,52,5,2,8,5,53,-77,5,2,335,282
844,53,4,2,8,5,44,23,9,5,379,305
844,54,3,3,6,7,-67,34,2,9,312,339
844,55,4,3,8,5,44,-68,6,1,356,271
844,56,4,3,5,8,41,35,7,6,397,306
844,57,4,2,7,6,-57,-76,0,0,340,230
844,58,3,4,6,7,33,43,3,3,373,273
844,59,4,2,6,7,42,25,5,8,415,298
844,60,2,6,5,8,23,-38,8,0,438,260
844,61,4,3,6,7,-58,34,0,4,380,294
844,62,4,2,11,2,47,20,7,4,427,314
844,63,4,3,9,4,-55,31,2,5,372,345
844,64,5,2,6,7,51,-75,3,0,423,270
844,65,3,3,6,7,33,34,6,4,456,304
844,66,2,4,4,9,22,45,8,9,478,349
844,67,3,4,6,7,-67,-57,1,2,411,292
844,68,4,3,7,6,43,33,4,5,454,325
844,69,3,4,6,7,33,43,7,8,487,368
844,70,2,6,4,9,22,-37,9,1,509,331
845,1,2,5,3,10,21,55,1,5,21,55
845,2,3,3,7,6,34,33,5,8,55,88
845,3,3,3,8,5,-65,-68,0,0,-10,20
845,4,4,3,6,7,42,34,2,4,32,54
845,5,5,2,7,6,52,24,4,8,84,78
845,6,2,5,6,7,24,-48,8,0,108,30
845,7,2,5,2,11,20,56,8,6,128,86
845,8,4,3,5,8,41,-65,9,1,169,21
845,9,4,3,9,4,-55,31,4,2,114,52
845,10,3,4,5,8,32,44,6,6,146,96
845,11,4,3,5,8,41,-65,7,1,187,31
845,12,3,4,7,6,-66,42,1,3,121,73
845,13,4,3,6,7,42,34,3,7,163,107
845,14,4,2,8,5,44,-77,7,0,207,30
845,15,3,3,8,5,-65,32,2,2,142,62
845,16,3,4,5,8,32,44,4,6,174,106
845,17,4,3,8,5,44,32,8,8,218,138
845,18,4,3,9,4,-55,31,3,9,163,169
845,19,3,3,4,9,31,-64,4,5,194,105
845,20,6,2,10,3,64,21,8,6,258,126
845,21,2,4,4,9,-78,-55,0,1,180,71
845,22,4,3,10,3,46,30,6,1,226,101
845,23,3,4,3,10,30,46,6,7,256,147
845,24,2,5,5,8,23,-47,9,0,279,100
845,25,2,5,4,9,-78,54,1,4,201,154
845,26,4,2,10,3,46,21,7,5,247,175
845,27,3,3,4,9,31,-64,8,1,278,111
845,28,3,3,6,7,-67,34,1,5,211,145
845,29,3,4,7,6,34,42,5,7,245,187
845,30,3,3,8,5,-65,32,0,9,180,219
845,31,4,2,5,8,41,-74,1,5,221,145
845,32,3,3,5,8,32,-65,3,0,253,80
845,33,6,2,11,2,65,20,8,0,318,100
845,34,4,3,7,6,-57,33,1,3,261,133
845,35,3,3,5,8,32,35,3,8,293,168
845,36,3,4,7,6,34,-58,7,0,327,110
845,37,2,5,3,10,21,55,8,5,348,165
845,38,5,3,7,6,-48,33,0,8,300,198
845,39,5,2,9,4,54,-78,4,0,354,120
845,40,2,4,7,6,25,42,9,2,379,162
845,41,4,3,8,5,-56,32,3,4,323,194
845,42,2,5,3,10,21,55,4,9,344,249
845,43,4,2,7,6,43,-76,7,3,387,173
845,44,3,4,6,7,-67,43,0,6,320,216
845,45,5,2,9,4,54,22,4,8,374,238
845,46,4,3,9,4,45,31,9,9,419,269
845,47,4,3,6,7,-58,-66,1,3,361,203
845,48,2,4,5,8,23,44,4,7,384,247
845,49,5,2,10,3,55,21,9,8,439,268
845,50,3,3,8,5,-65,-68,4,0,374,200
845,51,2,4,6,7,24,43,8,3,398,243
845,52,3,3,4,9,31,36,9,9,429,279
845,53,2,4,5,8,-77,-56,2,3,352,223
845,54,5,2,10,3,55,21,7,4,407,244
845,55,4,2,9,4,-55,22,2,6,352,266
845,56,3,3,5,8,32,-65,4,1,384,201
845,57,3,4,5,8,32,44,6,5,416,245
845,58,2,6,4,9,22,63,8,8,438,308
845,59,3,4,4,9,31,-55,9,3,469,253
845,60,3,4,6,7,-67,43,2,6,402,296
845,61,4,2,6,7,42,-75,4,1,444,221
845,62,2,5,3,10,21,55,5,6,465,276
845,63,4,2,11,2,-53,20,2,6,412,296
845,64,5,2,8,5,53,23,5,9,465,319
845,65,4,3,8,5,44,-68,9,1,509,251
846,1,4,3,9,4,45,31,5,1,45,31
846,2,5,2,9,4,54,22,9,3,99,53
846,3,4,4,6,7,-58,43,1,6,41,96
846,4,3,4,5,8,32,-56,3,0,73,40
846,5,3,3,7,6,34,33,7,3,107,73
846,6,3,4,6,7,-67,43,0,6,40,116
846,7,4,2,7,6,43,-76,3,0,83,40
846,8,4,2,7,6,43,24,6,4,126,64
846,9,3,3,5,8,32,35,8,9,158,99
846,10,3,5,5,8,-68,-47,0,2,90,52
846,11,2,4,5,8,23,44,3,6,113,96
846,12,3,3,10,3,-63,30,0,6,50,126
846,13,2,4,7,6,25,42,5,8,75,168
846,14,2,5,5,8,23,-47,8,1,98,121
846,15,4,2,9,4,-55,22,3,3,43,143
846,16,4,3,6,7,42,34,5,7,85,177
846,17,3,4,8,5,-65,41,0,8,20,218
846,18,3,4,6,7,33,-57,3,1,53,161
846,19,3,4,4,9,31,45,4,6,84,206
846,20,3,3,7,6,34,33,8,9,118,239
846,21,5,2,10,3,-45,-79,3,0,73,160
846,22,3,3,5,8,32,35,5,5,105,195
846,23,3,4,7,6,34,42,9,7,139,237
846,24,4,3,6,7,-58,-66,1,1,81,171
846,25,3,3,9,4,36,31,7,2,117,202
846,26,5,2,11,2,-44,20,3,2,73,222
846,27,3,4,3,10,30,46,3,8,103,268
846,28,4,3,9,4,45,31,8,9,148,299
846,29,3,4,6,7,-67,-57,1,2,81,242
846,30,4,3,6,7,42,34,3,6,123,276
846,31,6,2,9,4,63,22,6,8,186,298
846,32,4,2,7,6,43,-76,9,2,229,222
846,33,3,3,4,9,-69,36,0,8,160,258
846,34,4,2,9,4,45,-78,5,0,205,180
846,35,2,4,6,7,24,43,9,3,229,223
846,36,4,3,9,4,-55,31,4,4,174,254
846,37,4,3,7,6,43,33,7,7,217,287
846,38,4,2,7,6,-57,-76,0,1,160,211
846,39,3,3,5,8,32,35,2,6,192,246
846,40,2,4,7,6,25,42,7,8,217,288
846,41,5,2,8,5,-47,-77,0,1,170,211
846,42,4,3,7,6,43,33,3,4,213,244
846,43,3,3,7,6,34,33,7,7,247,277
846,44,2,5,5,8,-77,-47,0,0,170,230
846,45,5,2,8,5,53,23,3,3,223,253
846,46,3,3,6,7,33,34,6,7,256,287
846,47,4,3,7,6,43,-67,9,0,299,220
846,48,3,4,8,5,-65,41,4,1,234,261
846,49,3,3,7,6,34,33,8,4,268,294
846,50,4,2,10,3,-54,21,4,5,214,315
846,51,2,4,3,10,21,-54,5,1,235,261
846,52,3,3,7,6,34,33,9,4,269,294
846,53,4,4,6,7,-58,43,1,7,211,337
846,54,2,4,5,8,23,-56,4,1,234,281
846,55,3,4,5,8,32,44,6,5,266,325
846,56,2,4,5,8,23,44,9,9,289,369
846,57,4,2,6,7,-58,-75,1,4,231,294
846,58,2,6,6,7,24,61,5,5,255,355
846,59,2,5,6,7,24,52,9,7,279,407
846,60,2,4,6,7,-76,-57,3,0,203,350
846,61,4,2,10,3,46,21,9,1,249,371
846,62,4,2,6,7,-58,25,1,6,191,396
846,63,5,2,10,3,55,21,6,7,246,417
846,64,3,4,6,7,33,-57,9,0,279,360
846,65,3,5,5,8,-68,53,1,3,211,413
846,66,5,2,9,4,54,22,5,5,265,435
846,67,3,4,7,6,34,42,9,7,299,477
846,68,4,2,8,5,-56,-77,3,0,243,400
846,69,5,2,10,3,55,21,8,1,298,421
846,70,5,2,8,5,-47,23,1,4,251,444
846,71,4,4,8,5,44,41,5,5,295,485
846,72,3,4,7,6,34,42,9,7,329,527
847,1,2,4,5,8,23,44,3,4,23,44
847,2,3,5,4,9,31,54,4,8,54,98
847,3,4,2,7,6,43,-76,7,2,97,22
847,4,3,3,7,6,-66,33,1,5,31,55
847,5,5,2,8,5,53,23,4,8,84,78
847,6,3,3,6,7,33,-66,7,2,117,12
847,7,6,2,9,4,-37,22,0,4,80,34
847,8,3,3,3,10,30,-63,0,1,110,-29
847,9,5,2,9,4,54,22,4,3,164,-7
847,10,3,3,6,7,33,34,7,7,197,27
847,11,3,3,6,7,-67,-66,0,1,130,-39
847,12,4,3,6,7,42,34,2,5,172,-5
847,13,2,4,6,7,24,43,6,8,196,38
847,14,4,2,8,5,-56,-77,0,1,140,-39
847,15,4,3,8,5,44,32,4,3,184,-7
847,16,6,2,11,2,65,20,9,3,249,13
847,17,2,6,3,10,-79,64,0,7,170,77
847,18,6,2,8,5,62,-77,2,0,232,0
847,19,2,4,3,10,21,46,3,6,253,46
847,20,4,3,8,5,44,32,7,8,297,78
847,21,3,4,5,8,32,-56,9,2,329,22
847,22,2,4,2,11,20,47,9,9,349,69
847,23,3,4,6,7,-67,-57,2,2,282,12
847,24,3,4,4,9,31,45,3,7,313,57
847,25,3,4,4,9,31,-55,4,2,344,2
847,26,4,3,9,4,45,31,9,3,389,33
847,27,4,3,10,3,-54,30,5,3,335,63
847,28,3,3,5,8,32,35,7,8,367,98
847,29,2,5,3,10,21,-45,8,3,388,53
847,30,3,3,6,7,-67,34,1,7,321,87
847,31,4,3,6,7,42,-66,3,1,363,21
847,32,5,2,10,3,55,21,8,2,418,42
847,33,2,4,3,10,21,46,9,8,439,88
847,34,4,3,8,5,-56,-68,3,0,383,20
847,35,3,4,4,9,31,45,4,5,414,65
847,36,2,4,4,9,22,-55,6,0,436,10
847,37,4,3,7,6,43,33,9,3,479,43
847,38,4,3,9,4,-55,31,4,4,424,74
847,39,4,3,7,6,43,33,7,7,467,107
847,40,3,3,8,5,-65,32,2,9,402,139
847,41,2,4,4,9,22,-55,4,4,424,84
847,42,4,3,7,6,43,33,7,7,467,117
847,43,4,2,8,5,-56,-77,1,0,411,40
847,44,3,4,5,8,32,44,3,4,443,84
847,45,3,3,6,7,33,34,6,8,476,118
847,46,2,5,5,8,23,-47,9,1,499,71
847,47,5,2,8,5,-47,23,2,4,452,94
847,48,4,2,11,2,47,20,9,4,499,114
847,49,4,3,8,5,-56,32,3,6,443,146
847,50,2,4,6,7,24,43,7,9,467,189
847,51,3,3,8,5,-65,-68,2,1,402,121
847,52,2,5,3,10,21,55,3,6,423,176
847,53,3,4,6,7,33,43,6,9,456,219
847,54,4,3,5,8,41,-65,7,4,497,154
847,55,4,2,8,5,-56,23,1,7,441,177
847,56,3,4,8,5,35,41,6,8,476,218
847,57,5,2,7,6,52,-76,8,2,528,142
848,1,4,3,5,8,41,35,1,5,41,35
848,2,2,4,4,9,22,-55,3,0,63,-20
848,3,3,3,6,7,33,34,6,4,96,14
848,4,4,3,8,5,-56,32,0,6,40,46
848,5,4,3,7,6,43,33,3,9,83,79
848,6,5,2,9,4,54,-78,7,1,137,1
848,7,3,3,6,7,-67,34,0,5,70,35
848,8,3,4,3,10,30,-54,0,1,100,-19
848,9,3,3,5,8,32,35,2,6,132,16
848,10,3,3,7,6,34,33,6,9,166,49
848,11,3,3,4,9,31,-64,7,5,197,-15
848,12,3,3,8,5,-65,32,2,7,132,17
848,13,3,3,4,9,31,-64,3,3,163,-47
848,14,3,4,7,6,34,42,7,5,197,-5
848,15,3,4,5,8,32,44,9,9,229,39
848,16,3,4,8,5,-65,-59,4,0,164,-20
848,17,2,5,3,10,21,55,5,5,185,35
848,18,4,2,6,7,42,-75,7,0,227,-40
848,19,3,4,6,7,-67,43,0,3,160,3
848,20,2,4,5,8,23,44,3,7,183,47
848,21,3,4,7,6,34,42,7,9,217,89
848,22,2,4,5,8,-77,-56,0,3,140,33
848,23,2,5,3,10,21,55,1,8,161,88
848,24,5,3,8,5,53,-68,4,0,214,20
848,25,4,2,8,5,44,23,8,3,258,43
848,26,3,3,5,8,-68,35,0,8,190,78
848,27,5,2,9,4,54,-78,4,0,244,0
848,28,2,4,4,9,22,45,6,5,266,45
848,29,3,3,8,5,-65,32,1,7,201,77
848,30,4,2,11,2,47,20,8,7,248,97
848,31,3,3,6,7,-67,-66,1,1,181,31
848,32,3,4,5,8,32,44,3,5,213,75
848,33,2,4,4,9,22,-55,5,0,235,20
848,34,4,2,7,6,43,24,8,4,278,44
848,35,5,2,8,5,-47,23,1,7,231,67
848,36,4,3,8,5,44,32,5,9,275,99
848,37,4,3,8,5,44,-68,9,1,319,31
848,38,3,3,7,6,-66,33,3,4,253,64
848,39,3,3,5,8,32,35,5,9,285,99
848,40,4,3,9,4,-55,-69,0,0,230,30
848,41,6,2,8,5,62,23,2,3,292,53
848,42,4,2,6,7,42,25,4,8,334,78
848,43,3,3,4,9,31,-64,5,4,365,14
848,44,3,3,7,6,34,33,9,7,399,47
848,45,5,2,10,3,-45,21,4,8,354,68
848,46,4,3,7,6,43,-67,7,1,397,1
848,47,3,3,6,7,-67,34,0,5,330,35
848,48,4,2,9,4,45,22,5,7,375,57
848,49,4,2,6,7,42,-75,7,2,417,-18
848,50,2,4,6,7,-76,43,1,5,341,25
848,51,3,3,6,7,33,34,4,9,374,59
848,52,4,2,7,6,43,-76,7,3,417,-17
848,53,4,3,9,4,-55,31,2,4,362,14
848,54,4,2,9,4,45,22,7,6,407,36
848,55,2,5,2,11,20,-44,7,2,427,-8
848,56,2,4,9,4,-73,40,4,2,354,32
848,57,3,4,5,8,32,44,6,6,386,76
848,58,3,3,6,7,33,-66,9,0,419,10
848,59,4,2,6,7,-58,25,1,5,361,35
848,60,2,4,5,8,23,44,4,9,384,79
848,61,3,3,9,4,-64,-69,0,0,320,10
848,62,3,4,4,9,31,45,1,5,351,55
848,63,5,2,9,4,54,22,5,7,405,77
848,64,3,3,8,5,-65,32,0,9,340,109
848,65,4,2,10,3,46,-79,6,0,386,30
848,66,3,4,7,6,-66,42,0,2,320,72
848,67,3,3,6,7,33,34,3,6,353,106
848,68,2,4,5,8,23,-56,6,0,376,50
848,69,3,3,6,7,33,34,9,4,409,84
848,70,2,6,4,9,-78,63,1,7,331,147
848,71,4,2,9,4,45,22,6,9,376,169
848,72,4,4,7,6,43,-58,9,1,419,111
848,73,2,5,4,9,-78,54,1,5,341,165
848,74,4,2,10,3,46,21,7,6,387,186
848,75,4,3,8,5,-56,32,1,8,331,218
848,76,2,6,3,10,21,-36,2,2,352,182
848,77,3,4,7,6,34,42,6,4,386,224
848,78,3,5,4,9,31,54,7,8,417,278
848,79,6,2,11,2,-35,20,2,8,382,298
848,80,4,2,7,6,43,-76,5,2,425,222
848,81,5,2,9,4,54,22,9,4,479,244
848,82,4,4,5,8,-59,44,0,8,420,288
848,83,4,3,5,8,41,-65,1,3,461,223
848,84,4,2,8,5,44,23,5,6,505,246
849,1,4,3,7,6,43,33,3,3,43,33
849,2,2,4,8,5,26,41,9,4,69,74
849,3,4,3,7,6,-57,33,2,7,12,107
849,4,3,4,5,8,32,-56,4,1,44,51
849,5,2,4,4,9,22,45,6,6,66,96
849,6,3,4,6,7,33,43,9,9,99,139
849,7,4,2,9,4,-55,-78,4,1,44,61
849,8,3,4,5,8,32,44,6,5,76,105
849,9,4,2,8,5,-56,23,0,8,20,128
849,10,2,5,3,10,21,-45,1,3,41,83
849,11,4,3,6,7,42,34,3,7,83,117
849,12,4,3,9,4,45,31,8,8,128,148
849,13,2,4,3,10,21,-54,9,4,149,94
849,14,2,4,4,9,-78,45,1,9,71,139
849,15,3,5,6,7,33,-48,4,1,104,91
849,16,5,2,11,2,-44,20,0,1,60,111
849,17,4,3,9,4,45,31,5,2,105,142
849,18,3,4,4,9,31,45,6,7,136,187
849,19,3,4,4,9,31,-55,7,2,167,132
849,20,4,3,5,8,41,35,8,7,208,167
849,21,3,3,7,6,-66,-67,2,0,142,100
849,22,3,3,7,6,34,33,6,3,176,133
849,23,3,3,6,7,33,34,9,7,209,167
849,24,5,2,6,7,-49,-75,0,2,160,92
849,25,3,3,5,8,32,35,2,7,192,127
849,26,5,2,9,4,54,22,6,9,246,149
849,27,3,3,7,6,-66,-67,0,2,180,82
849,28,4,2,8,5,44,23,4,5,224,105
849,29,4,3,6,7,42,34,6,9,266,139
849,30,4,2,7,6,43,-76,9,3,309,63
849,31,3,4,6,7,-67,43,2,6,242,106
849,32,5,2,9,4,54,22,6,8,296,128
849,33,2,5,5,8,23,-47,9,1,319,81
849,34,5,2,9,4,-46,22,3,3,273,103
849,35,4,2,8,5,44,23,7,6,317,126
849,36,2,5,3,10,21,-45,8,1,338,81
849,37,3,3,4,9,31,36,9,7,369,117
849,38,2,5,2,11,20,-44,9,3,389,73
849,39,4,3,6,7,-58,34,1,7,331,107
849,40,4,2,8,5,44,-77,5,0,375,30
849,41,4,4,7,6,43,42,8,2,418,72
849,42,3,4,9,4,-64,40,4,2,354,112
849,43,5,2,11,2,-44,20,0,2,310,132
849,44,2,4,3,10,21,46,1,8,331,178
849,45,6,2,10,3,64,21,5,9,395,199
849,46,3,3,5,8,32,-65,7,4,427,134
849,47,3,4,4,9,31,45,8,9,458,179
849,48,3,4,5,8,-68,-56,0,3,390,123
849,49,2,5,6,7,24,52,4,5,414,175
849,50,4,3,4,9,40,-64,4,1,454,111
849,51,3,3,3,10,30,37,4,8,484,148
849,52,4,3,8,5,44,-68,8,0,528,80
850,1,3,4,5,8,32,44,2,4,32,44
850,2,3,4,5,8,32,44,4,8,64,88
850,3,4,3,5,8,41,-65,5,3,105,23
850,4,3,4,3,10,30,46,5,9,135,69
850,5,2,4,5,8,23,-56,8,3,158,13
850,6,3,4,4,9,31,45,9,8,189,58
850,7,4,3,8,5,-56,-68,3,0,133,-10
850,8,2,5,2,11,20,56,3,6,153,46
850,9,6,2,10,3,64,21,7,7,217,67
850,10,4,3,6,7,42,-66,9,1,259,1
850,11,4,3,6,7,-58,34,1,5,201,35
850,12,2,4,5,8,23,44,4,9,224,79
850,13,3,3,6,7,33,-66,7,3,257,13
850,14,4,3,9,4,-55,31,2,4,202,44
850,15,4,3,7,6,43,33,5,7,245,77
850,16,3,3,6,7,33,-66,8,1,278,11
850,17,4,3,9,4,-55,31,3,2,223,42
850,18,2,5,4,9,22,54,5,6,245,96
850,19,3,4,3,10,30,-54,5,2,275,42
850,20,4,3,7,6,43,33,8,5,318,75
850,21,4,2,7,6,-57,24,1,9,261,99
850,22,3,3,7,6,34,-67,5,2,295,32
850,23,4,3,6,7,42,34,7,6,337,66
850,24,3,4,8,5,-65,41,2,7,272,107
850,25,5,2,9,4,54,22,6,9,326,129
850,26,2,4,7,6,-75,-58,1,1,251,71
850,27,4,4,6,7,42,43,3,4,293,114
850,28,3,3,8,5,35,32,8,6,328,146
850,29,3,4,6,7,-67,43,1,9,261,189
850,30,2,5,5,8,23,-47,4,2,284,142
850,31,3,4,8,5,35,41,9,3,319,183
850,32,2,5,5,8,-77,53,2,6,242,236
850,33,4,3,8,5,44,32,6,8,286,268
850,34,3,4,8,5,-65,41,1,9,221,309
850,35,4,2,8,5,44,-77,5,2,265,232
850,36,4,3,7,6,43,33,8,5,308,265
850,37,2,5,5,8,-77,53,1,8,231,318
850,38,3,3,7,6,34,-67,5,1,265,251
850,39,2,4,5,8,23,44,8,5,288,295
850,40,4,2,10,3,-54,21,4,6,234,316
850,41,3,4,7,6,34,42,8,8,268,358
850,42,4,2,7,6,-57,-76,1,2,211,282
850,43,3,3,7,6,34,33,5,5,245,315
850,44,2,4,5,8,23,44,8,9,268,359
850,45,2,6,3,10,21,-36,9,3,289,323
850,46,5,2,9,4,-46,22,3,5,243,345
850,47,3,4,4,9,31,-55,4,0,274,290
850,48,3,3,7,6,34,33,8,3,308,323
850,49,4,2,9,4,-55,22,3,5,253,345
850,50,2,5,5,8,23,53,6,8,276,398
850,51,4,2,8,5,-56,-77,0,1,220,321
850,52,2,5,3,10,21,55,1,6,241,376
850,53,4,3,7,6,43,33,4,9,284,409
850,54,5,2,9,4,54,-78,8,1,338,331
850,55,3,3,6,7,-67,34,1,5,271,365
850,56,3,4,4,9,31,-55,2,0,302,310
850,57,2,4,4,9,22,45,4,5,324,355
850,58,2,5,2,11,20,-44,4,1,344,311
850,59,4,2,9,4,45,22,9,3,389,333
850,60,5,2,10,3,-45,21,4,4,344,354
850,61,2,5,6,7,24,52,8,6,368,406
850,62,3,3,6,7,-67,-66,1,0,301,340
850,63,5,2,8,5,53,23,4,3,354,363
850,64,4,3,8,5,44,32,8,5,398,395
850,65,3,4,7,6,-66,42,2,7,332,437
850,66,2,4,6,7,24,-57,6,0,356,380
850,67,3,3,8,5,-65,32,1,2,291,412
850,68,2,5,4,9,22,54,3,6,313,466
850,69,3,4,6,7,33,43,6,9,346,509
851,1,4,3,9,4,45,31,5,1,45,31
851,2,4,3,6,7,42,34,7,5,87,65
851,3,4,3,8,5,-56,32,1,7,31,97
851,4,3,3,6,7,33,-66,4,1,64,31
851,5,4,2,9,4,45,22,9,3,109,53
851,6,3,3,7,6,-66,33,3,6,43,86
851,7,2,4,4,9,22,-55,5,1,65,31
851,8,3,3,7,6,34,33,9,4,99,64
851,9,5,2,9,4,-46,22,3,6,53,86
851,10,3,3,7,6,34,33,7,9,87,119
851,11,3,4,6,7,-67,-57,0,2,20,62
851,12,5,2,9,4,54,22,4,4,74,84
851,13,4,3,7,6,43,33,7,7,117,117
851,14,3,3,6,7,-67,-66,0,1,50,51
851,15,3,4,8,5,35,41,5,2,85,92
851,16,4,3,9,4,-55,31,0,3,30,123
851,17,3,4,6,7,33,43,3,6,63,166
851,18,3,4,6,7,33,43,6,9,96,209
851,19,4,3,9,4,-55,-69,1,0,41,140
851,20,3,4,5,8,32,44,3,4,73,184
851,21,2,4,3,10,21,-54,4,0,94,130
851,22,3,4,5,8,32,44,6,4,126,174
851,23,3,3,4,9,31,-64,7,0,157,110
851,24,2,5,5,8,-77,53,0,3,80,163
851,25,2,4,3,10,21,46,1,9,101,209
851,26,5,2,7,6,52,-76,3,3,153,133
851,27,5,2,10,3,55,21,8,4,208,154
851,28,3,4,6,7,-67,43,1,7,141,197
851,29,3,4,7,6,34,42,5,9,175,239
851,30,4,2,6,7,42,-75,7,4,217,164
851,31,5,2,8,5,-47,23,0,7,170,187
851,32,3,3,4,9,31,-64,1,3,201,123
851,33,3,3,5,8,32,35,3,8,233,158
851,34,4,2,8,5,44,-77,7,1,277,81
851,35,4,3,7,6,-57,33,0,4,220,114
851,36,2,4,5,8,23,44,3,8,243,158
851,37,2,5,6,7,24,-48,7,0,267,110
851,38,3,4,7,6,-66,42,1,2,201,152
851,39,3,3,7,6,34,33,5,5,235,185
851,40,4,2,11,2,-53,20,2,5,182,205
851,41,2,5,4,9,22,54,4,9,204,259
851,42,4,2,8,5,44,-77,8,2,248,182
851,43,2,5,4,9,-78,54,0,6,170,236
851,44,4,2,8,5,44,23,4,9,214,259
851,45,3,3,6,7,33,-66,7,3,247,193
851,46,3,4,6,7,-67,43,0,6,180,236
851,47,3,3,8,5,35,32,5,8,215,268
851,48,2,5,3,10,21,-45,6,3,236,223
851,49,4,3,7,6,43,33,9,6,279,256
851,50,3,4,5,8,-68,-56,1,0,211,200
851,51,3,3,6,7,33,34,4,4,244,234
851,52,5,2,10,3,55,21,9,5,299,255
851,53,4,3,7,6,-57,33,2,8,242,288
851,54,4,2,6,7,42,-75,4,3,284,213
851,55,4,2,5,8,41,26,5,9,325,239
851,56,3,3,7,6,34,-67,9,2,359,172
851,57,4,2,9,4,-55,22,4,4,304,194
851,58,5,3,7,6,52,33,6,7,356,227
851,59,3,3,7,6,-66,-67,0,0,290,160
851,60,3,3,6,7,33,34,3,4,323,194
851,61,4,2,7,6,43,24,6,8,366,218
851,62,4,2,7,6,43,-76,9,2,409,142
851,63,3,4,6,7,-67,43,2,5,342,185
851,64,4,3,7,6,43,33,5,8,385,218
851,65,3,3,7,6,34,-67,9,1,419,151
851,66,2,5,3,10,-79,55,0,6,340,206
851,67,3,3,8,5,35,32,5,8,375,238
851,68,4,3,7,6,43,-67,8,1,418,171
851,69,4,2,6,7,-58,25,0,6,360,196
851,70,3,4,8,5,35,41,5,7,395,237
851,71,2,5,4,9,22,-46,7,1,417,191
851,72,4,3,8,5,-56,32,1,3,361,223
851,73,3,3,8,5,35,32,6,5,396,255
851,74,5,2,10,3,-45,21,1,6,351,276
851,75,3,4,6,7,33,43,4,9,384,319
851,76,2,5,3,10,21,-45,5,4,405,274
851,77,4,3,8,5,44,32,9,6,449,306
851,78,2,5,4,9,-78,-46,1,0,371,260
851,79,3,3,5,8,32,35,3,5,403,295
851,80,2,4,5,8,23,44,6,9,426,339
851,81,3,4,4,9,31,-55,7,4,457,284
851,82,2,4,6,7,-76,43,1,7,381,327
851,83,2,4,3,10,21,-54,2,3,402,273
851,84,3,4,5,8,32,44,4,7,434,317
851,85,4,2,9,4,45,22,9,9,479,339
851,86,3,3,5,8,-68,-65,1,4,411,274
851,87,3,4,6,7,33,43,4,7,444,317
851,88,3,3,8,5,35,32,9,9,479,349
851,89,3,3,4,9,-69,-64,0,5,410,285
851,90,3,3,5,8,32,-65,2,0,442,220
851,91,3,4,6,7,33,43,5,3,475,263
851,92,3,4,5,8,32,44,7,7,507,307
852,1,2,4,6,7,24,43,4,3,24,43
852,2,4,3,8,5,44,32,8,5,68,75
852,3,3,3,7,6,-66,33,2,8,2,108
852,4,3,4,7,6,34,-58,6,0,36,50
852,5,2,5,5,8,23,53,9,3,59,103
852,6,4,3,5,8,-59,35,0,8,0,138
852,7,2,5,6,7,24,-48,4,0,24,90
852,8,2,5,3,10,21,55,5,5,45,145
852,9,5,3,8,5,53,32,8,7,98,177
852,10,2,4,6,7,-76,-57,2,0,22,120
852,11,3,4,7,6,34,42,6,2,56,162
852,12,5,2,7,6,52,24,8,6,108,186
852,13,4,2,7,6,-57,-76,1,0,51,110
852,14,2,5,4,9,22,54,3,4,73,164
852,15,5,2,11,2,56,20,9,4,129,184
852,16,2,5,3,10,-79,55,0,9,50,239
852,17,3,3,5,8,32,-65,2,4,82,174
852,18,5,2,8,5,53,23,5,7,135,197
852,19,2,4,4,9,22,-55,7,2,157,142
852,20,3,5,6,7,-67,52,0,4,90,194
852,21,3,3,9,4,36,31,6,5,126,225
852,22,2,4,4,9,22,-55,8,0,148,170
852,23,3,3,7,6,-66,33,2,3,82,203
852,24,2,5,4,9,22,54,4,7,104,257
852,25,5,2,7,6,52,-76,6,1,156,181
852,26,4,3,7,6,43,33,9,4,199,214
852,27,2,5,5,8,-77,53,2,7,122,267
852,28,2,5,7,6,25,51,7,8,147,318
852,29,2,5,3,10,21,-45,8,3,168,273
852,30,3,3,8,5,-65,32,3,5,103,305
852,31,2,4,5,8,23,44,6,9,126,349
852,32,3,5,6,7,33,-48,9,1,159,301
852,33,3,3,8,5,-65,32,4,3,94,333
852,34,3,3,7,6,34,33,8,6,128,366
852,35,3,3,6,7,-67,-66,1,0,61,300
852,36,4,2,9,4,45,22,6,2,106,322
852,37,3,3,8,5,-65,32,1,4,41,354
852,38,3,4,5,8,32,44,3,8,73,398
852,39,4,4,5,8,41,-56,4,2,114,342
852,40,2,4,4,9,22,45,6,7,136,387
852,41,2,5,4,9,22,-46,8,1,158,341
852,42,4,2,9,4,-55,22,3,3,103,363
852,43,4,2,7,6,43,24,6,7,146,387
852,44,5,2,5,8,50,-74,6,3,196,313
852,45,2,4,3,10,21,46,7,9,217,359
852,46,4,3,6,7,42,-66,9,3,259,293
852,47,3,3,5,8,-68,35,1,8,191,328
852,48,2,4,4,9,22,-55,3,3,213,273
852,49,2,5,2,11,20,56,3,9,233,329
852,50,3,3,5,8,32,-65,5,4,265,264
852,51,5,2,7,6,52,24,7,8,317,288
852,52,4,3,9,4,-55,31,2,9,262,319
852,53,3,3,6,7,33,-66,5,3,295,253
852,54,3,3,5,8,32,35,7,8,327,288
852,55,3,3,5,8,32,-65,9,3,359,223
852,56,3,4,3,10,30,46,9,9,389,269
852,57,3,3,9,4,-64,-69,5,0,325,200
852,58,3,3,6,7,33,34,8,4,358,234
852,59,2,5,5,8,-77,53,1,7,281,287
852,60,3,3,7,6,34,-67,5,0,315,220
852,61,4,2,9,4,-55,22,0,2,260,242
852,62,3,3,7,6,34,33,4,5,294,275
852,63,3,3,8,5,35,32,9,7,329,307
852,64,4,3,8,5,-56,32,3,9,273,339
852,65,2,4,3,10,21,-54,4,5,294,285
852,66,3,4,4,9,31,-55,5,0,325,230
852,67,4,3,5,8,41,35,6,5,366,265
852,68,3,4,6,7,33,43,9,8,399,308
852,69,2,5,5,8,-77,-47,2,1,322,261
852,70,3,4,7,6,34,42,6,3,356,303
852,71,2,4,4,9,22,45,8,8,378,348
852,72,2,4,5,8,-77,-56,1,2,301,292
852,73,3,4,5,8,32,44,3,6,333,336
852,74,2,5,5,8,23,53,6,9,356,389
852,75,2,4,5,8,23,-56,9,3,379,333
852,76,3,5,6,7,-67,52,2,5,312,385
852,77,2,5,5,8,23,53,5,8,335,438
852,78,4,3,6,7,42,-66,7,2,377,372
852,79,4,3,8,5,-56,32,1,4,321,404
852,80,3,4,7,6,34,42,5,6,355,446
852,81,4,2,6,7,42,-75,7,1,397,371
852,82,3,4,5,8,32,44,9,5,429,415
852,83,3,5,9,4,-64,-50,5,5,365,365
852,84,2,4,5,8,23,44,8,9,388,409
852,85,3,4,3,10,30,-54,8,5,418,355
852,86,3,3,8,5,-65,32,3,7,353,387
852,87,3,4,6,7,33,-57,6,0,386,330
852,88,5,2,11,2,-44,20,2,0,342,350
852,89,5,2,7,6,52,24,4,4,394,374
852,90,4,2,8,5,44,23,8,7,438,397
852,91,2,4,4,9,-78,-55,0,2,360,342
852,92,4,2,9,4,45,22,5,4,405,364
852,93,5,3,9,4,54,31,9,5,459,395
852,94,3,3,5,8,-68,-65,1,0,391,330
852,95,2,5,3,10,21,55,2,5,412,385
852,96,3,4,4,9,31,-55,3,0,443,330
852,97,2,5,5,8,23,53,6,3,466,383
852,98,2,5,3,10,21,55,7,8,487,438
852,99,3,4,7,6,-66,-58,1,0,421,380
852,100,3,5,6,7,33,52,4,2,454,432
852,101,3,3,7,6,34,33,8,5,488,465
852,102,2,5,6,7,-76,52,2,7,412,517
853,1,3,4,7,6,34,42,4,2,34,42
853,2,5,2,6,7,51,25,5,7,85,67
853,3,3,4,8,5,-65,41,0,8,20,108
853,4,3,4,6,7,33,-57,3,1,53,51
853,5,3,4,6,7,33,43,6,4,86,94
853,6,3,4,4,9,31,45,7,9,117,139
853,7,3,4,7,6,-66,-58,1,1,51,81
853,8,2,4,3,10,21,46,2,7,72,127
853,9,5,2,7,6,52,-76,4,1,124,51
853,10,3,4,5,8,32,44,6,5,156,95
853,11,3,3,8,5,-65,32,1,7,91,127
853,12,4,4,8,5,44,41,5,8,135,168
853,13,3,3,5,8,32,-65,7,3,167,103
853,14,2,6,4,9,22,63,9,6,189,166
853,15,3,3,7,6,-66,33,3,9,123,199
853,16,5,2,9,4,54,-78,7,1,177,121
853,17,2,4,6,7,-76,43,1,4,101,164
853,18,4,3,4,9,40,-64,1,0,141,100
853,19,4,3,8,5,44,32,5,2,185,132
853,20,3,3,5,8,32,35,7,7,217,167
853,21,4,4,6,7,42,-57,9,0,259,110
853,22,4,3,6,7,-58,34,1,4,201,144
853,23,2,6,6,7,24,61,5,5,225,205
853,24,3,3,7,6,34,33,9,8,259,238
853,25,3,3,8,5,-65,-68,4,0,194,170
853,26,4,2,8,5,44,23,8,3,238,193
853,27,2,4,7,6,-75,42,3,5,163,235
853,28,4,2,8,5,44,23,7,8,207,258
853,29,3,4,6,7,-67,-57,0,1,140,201
853,30,6,2,9,4,63,22,3,3,203,223
853,31,3,3,10,3,-63,30,0,3,140,253
853,32,4,3,8,5,44,32,4,5,184,285
853,33,3,3,10,3,-63,30,1,5,121,315
853,34,3,4,4,9,31,-55,2,0,152,260
853,35,2,5,5,8,23,53,5,3,175,313
853,36,3,3,7,6,34,33,9,6,209,346
853,37,3,4,6,7,-67,43,2,9,142,389
853,38,2,5,3,10,21,-45,3,4,163,344
853,39,2,6,3,10,21,64,4,8,184,408
853,40,2,5,6,7,24,-48,8,0,208,360
853,41,4,3,8,5,-56,32,2,2,152,392
853,42,5,2,11,2,56,20,8,2,208,412
853,43,2,5,3,10,21,55,9,7,229,467
853,44,5,3,8,5,-47,32,2,9,182,499
853,45,5,2,8,5,53,-77,5,2,235,422
853,46,3,3,8,5,-65,32,0,4,170,454
853,47,3,3,6,7,33,34,3,8,203,488
853,48,2,5,5,8,23,-47,6,1,226,441
853,49,3,3,5,8,32,35,8,6,258,476
853,50,3,3,8,5,-65,32,3,8,193,508
854,1,3,4,5,8,32,44,2,4,32,44
854,2,3,4,5,8,32,44,4,8,64,88
854,3,3,3,6,7,33,-66,7,2,97,22
854,4,3,3,8,5,-65,32,2,4,32,54
854,5,3,3,4,9,31,-64,3,0,63,-10
854,6,2,4,5,8,23,44,6,4,86,34
854,7,3,3,8,5,-65,32,1,6,21,66
854,8,5,2,10,3,55,21,6,7,76,87
854,9,3,4,4,9,31,-55,7,2,107,32
854,10,3,3,5,8,32,35,9,7,139,67
854,11,4,3,5,8,-59,-65,0,2,80,2
854,12,5,2,7,6,52,24,2,6,132,26
854,13,3,4,4,9,31,-55,3,1,163,-29
854,14,4,3,10,3,46,30,9,1,209,1
854,15,3,3,5,8,-68,35,1,6,141,36
854,16,2,5,4,9,22,-46,3,0,163,-10
854,17,4,3,7,6,43,33,6,3,206,23
854,18,3,3,3,10,30,-63,6,0,236,-40
854,19,4,4,6,7,42,43,8,3,278,3
854,20,2,5,2,11,20,56,8,9,298,59
854,21,4,3,8,5,-56,-68,2,1,242,-9
854,22,3,4,7,6,34,42,6,3,276,33
854,23,4,2,11,2,-53,20,3,3,223,53
854,24,3,4,4,9,31,45,4,8,254,98
854,25,2,4,3,10,21,-54,5,4,275,44
854,26,4,3,7,6,43,33,8,7,318,77
854,27,3,3,7,6,-66,-67,2,0,252,10
854,28,4,2,10,3,46,21,8,1,298,31
854,29,3,3,6,7,-67,34,1,5,231,65
854,30,3,4,6,7,33,43,4,8,264,108
854,31,5,2,8,5,53,-77,7,1,317,31
854,32,5,2,7,6,52,24,9,5,369,55
854,33,4,3,7,6,-57,33,2,8,312,88
854,34,2,4,5,8,23,-56,5,2,335,32
854,35,4,4,7,6,43,42,8,4,378,74
854,36,4,2,9,4,-55,22,3,6,323,96
854,37,2,5,2,11,20,-44,3,2,343,52
854,38,2,5,2,11,20,56,3,8,363,108
854,39,4,3,9,4,45,31,8,9,408,139
854,40,2,6,3,10,21,-36,9,3,429,103
854,41,4,3,6,7,-58,34,1,7,371,137
854,42,5,2,10,3,55,21,6,8,426,158
854,43,4,3,10,3,-54,30,2,8,372,188
854,44,3,3,6,7,33,-66,5,2,405,122
854,45,3,3,7,6,34,33,9,5,439,155
854,46,4,3,8,5,-56,32,3,7,383,187
854,47,3,3,7,6,34,-67,7,0,417,120
854,48,3,3,7,6,-66,33,1,3,351,153
854,49,2,4,2,11,20,-53,1,0,371,100
854,50,5,2,6,7,51,25,2,5,422,125
854,51,4,3,10,3,46,30,8,5,468,155
854,52,4,2,9,4,-55,22,3,7,413,177
854,53,2,4,4,9,22,-55,5,2,435,122
854,54,4,2,6,7,42,25,7,7,477,147
854,55,3,4,6,7,-67,-57,0,0,410,90
854,56,3,4,4,9,31,45,1,5,441,135
854,57,2,5,4,9,22,54,3,9,463,189
854,58,3,3,7,6,34,-67,7,2,497,122
854,59,4,3,7,6,-57,33,0,5,440,155
854,60,4,3,5,8,41,-65,1,0,481,90
854,61,4,2,9,4,45,22,6,2,526,112
855,1,2,4,6,7,24,43,4,3,24,43
855,2,3,3,7,6,34,33,8,6,58,76
855,3,3,3,8,5,-65,32,3,8,-7,108
855,4,3,4,4,9,31,-55,4,3,24,53
855,5,3,3,7,6,34,33,8,6,58,86
855,6,3,4,5,8,-68,-56,0,0,-10,30
855,7,2,4,6,7,24,43,4,3,14,73
855,8,4,2,8,5,44,23,8,6,58,96
855,9,2,4,5,8,-77,-56,1,0,-19,40
855,10,2,4,4,9,22,45,3,5,3,85
855,11,4,3,7,6,43,33,6,8,46,118
855,12,5,2,9,4,-46,-78,0,0,0,40
855,13,3,4,6,7,33,43,3,3,33,83
855,14,3,4,6,7,33,43,6,6,66,126
855,15,4,3,8,5,-56,32,0,8,10,158
855,16,3,3,7,6,34,-67,4,1,44,91
855,17,3,3,8,5,35,32,9,3,79,123
855,18,2,5,6,7,-76,52,3,5,3,175
855,19,3,4,4,9,31,-55,4,0,34,120
855,20,3,4,3,10,30,46,4,6,64,166
855,21,3,4,7,6,34,42,8,8,98,208
855,22,4,2,8,5,-56,-77,2,1,42,131
855,23,5,2,9,4,54,22,6,3,96,153
855,24,2,4,4,9,22,45,8,8,118,198
855,25,5,2,7,6,-48,-76,0,2,70,122
855,26,2,5,6,7,24,52,4,4,94,174
855,27,4,2,8,5,44,23,8,7,138,197
855,28,4,3,5,8,41,-65,9,2,179,132
855,29,5,2,10,3,-45,21,4,3,134,153
855,30,2,5,6,7,24,52,8,5,158,205
855,31,3,3,5,8,-68,-65,0,0,90,140
855,32,4,3,9,4,45,31,5,1,135,171
855,33,4,3,7,6,43,33,8,4,178,204
855,34,2,5,4,9,-78,54,0,8,100,258
855,35,3,3,5,8,32,-65,2,3,132,193
855,36,5,2,10,3,55,21,7,4,187,214
855,37,4,3,8,5,-56,32,1,6,131,246
855,38,4,2,10,3,46,21,7,7,177,267
855,39,2,4,5,8,-77,-56,0,1,100,211
855,40,5,2,10,3,55,21,5,2,155,232
855,41,4,3,7,6,43,33,8,5,198,265
855,42,5,2,7,6,-48,24,0,9,150,289
855,43,4,3,8,5,44,-68,4,1,194,221
855,44,5,2,8,5,53,23,7,4,247,244
855,45,3,3,8,5,-65,32,2,6,182,276
855,46,2,4,4,9,22,-55,4,1,204,221
855,47,2,5,4,9,22,54,6,5,226,275
855,48,4,3,4,9,40,-64,6,1,266,211
855,49,5,2,9,4,-46,22,0,3,220,233
855,50,2,4,4,9,22,45,2,8,242,278
855,51,4,2,9,4,45,-78,7,0,287,200
855,52,3,4,6,7,-67,43,0,3,220,243
855,53,2,4,5,8,23,44,3,7,243,287
855,54,3,4,4,9,31,-55,4,2,274,232
855,55,3,4,6,7,33,43,7,5,307,275
855,56,4,3,8,5,-56,32,1,7,251,307
855,57,2,5,6,7,24,52,5,9,275,359
855,58,3,3,7,6,34,-67,9,2,309,292
855,59,4,2,7,6,-57,24,2,6,252,316
855,60,2,4,6,7,24,43,6,9,276,359
855,61,4,3,8,5,-56,-68,0,1,220,291
855,62,2,4,4,9,22,45,2,6,242,336
855,63,5,2,10,3,55,21,7,7,297,357
855,64,4,3,7,6,-57,-67,0,0,240,290
855,65,3,3,7,6,34,33,4,3,274,323
855,66,3,4,8,5,35,41,9,4,309,364
855,67,2,5,2,11,20,-44,9,0,329,320
855,68,3,4,6,7,-67,43,2,3,262,363
855,69,4,3,6,7,42,34,4,7,304,397
855,70,3,3,6,7,33,-66,7,1,337,331
855,71,5,2,8,5,-47,23,0,4,290,354
855,72,4,2,9,4,45,22,5,6,335,376
855,73,3,3,7,6,34,33,9,9,369,409
855,74,5,2,10,3,-45,-79,4,0,324,330
855,75,3,3,6,7,33,34,7,4,357,364
855,76,4,2,7,6,-57,24,0,8,300,388
855,77,3,4,8,5,35,41,5,9,335,429
855,78,5,2,7,6,52,-76,7,3,387,353
855,79,3,3,6,7,-67,34,0,7,320,387
855,80,2,4,6,7,24,-57,4,0,344,330
855,81,4,2,8,5,44,23,8,3,388,353
855,82,4,3,8,5,-56,32,2,5,332,385
855,83,4,3,6,7,42,34,4,9,374,419
855,84,2,6,6,7,24,-39,8,0,398,380
855,85,2,4,6,7,-76,43,2,3,322,423
855,86,2,4,4,9,22,45,4,8,344,468
855,87,4,2,9,4,45,-78,9,0,389,390
855,88,2,4,6,7,-76,43,3,3,313,433
855,89,5,2,11,2,56,20,9,3,369,453
855,90,3,3,5,8,-68,35,1,8,301,488
855,91,4,3,9,4,45,31,6,9,346,519
856,1,2,5,3,10,21,55,1,5,21,55
856,2,3,4,4,9,31,-55,2,0,52,0
856,3,3,4,5,8,32,44,4,4,84,44
856,4,2,4,3,10,21,-54,5,0,105,-10
856,5,2,5,5,8,23,53,8,3,128,43
856,6,3,3,5,8,-68,35,0,8,60,78
856,7,3,4,5,8,32,-56,2,2,92,22
856,8,4,2,5,8,41,26,3,8,133,48
856,9,2,4,5,8,23,-56,6,2,156,-8
856,10,3,4,8,5,-65,41,1,3,91,33
856,11,3,3,6,7,33,34,4,7,124,67
856,12,4,4,6,7,42,-57,6,0,166,10
856,13,2,5,4,9,22,54,8,4,188,64
856,14,3,4,9,4,-64,40,4,4,124,104
856,15,3,4,5,8,32,44,6,8,156,148
856,16,4,3,6,7,42,-66,8,2,198,82
856,17,3,3,7,6,-66,33,2,5,132,115
856,18,4,3,5,8,41,-65,3,0,173,50
856,19,3,3,8,5,35,32,8,2,208,82
856,20,2,5,5,8,-77,53,1,5,131,135
856,21,3,3,9,4,36,31,7,6,167,166
856,22,2,4,7,6,-75,42,2,8,92,208
856,23,3,4,4,9,31,-55,3,3,123,153
856,24,4,3,6,7,42,34,5,7,165,187
856,25,2,4,4,9,22,-55,7,2,187,132
856,26,5,2,10,3,-45,21,2,3,142,153
856,27,5,2,10,3,55,21,7,4,197,174
856,28,6,2,11,2,-35,20,2,4,162,194
856,29,2,4,3,10,21,-54,3,0,183,140
856,30,4,3,8,5,44,32,7,2,227,172
856,31,3,3,8,5,-65,32,2,4,162,204
856,32,2,5,3,10,21,55,3,9,183,259
856,33,4,2,11,2,-53,20,0,9,130,279
856,34,2,5,2,11,20,-44,0,5,150,235
856,35,2,4,5,8,23,44,3,9,173,279
856,36,5,3,5,8,50,-65,3,4,223,214
856,37,4,2,7,6,43,24,6,8,266,238
856,38,2,4,6,7,-76,-57,0,1,190,181
856,39,2,5,5,8,23,53,3,4,213,234
856,40,4,2,10,3,46,21,9,5,259,255
856,41,3,3,7,6,-66,33,3,8,193,288
856,42,3,4,3,10,30,-54,3,4,223,234
856,43,3,3,7,6,34,33,7,7,257,267
856,44,3,3,6,7,-67,-66,0,1,190,201
856,45,3,3,5,8,32,35,2,6,222,236
856,46,5,3,10,3,55,30,7,6,277,266
856,47,4,3,8,5,-56,32,1,8,221,298
856,48,2,5,2,11,20,-44,1,4,241,254
856,49,2,6,4,9,22,63,3,7,263,317
856,50,4,3,5,8,41,-65,4,2,304,252
856,51,3,3,7,6,34,33,8,5,338,285
856,52,2,5,6,7,-76,52,2,7,262,337
856,53,5,2,8,5,53,-77,5,0,315,260
856,54,4,2,5,8,41,26,6,6,356,286
856,55,3,4,4,9,31,-55,7,1,387,231
856,56,2,4,5,8,-77,44,0,5,310,275
856,57,2,4,6,7,24,43,4,8,334,318
856,58,4,3,7,6,43,-67,7,1,377,251
856,59,3,4,3,10,30,46,7,7,407,297
856,60,2,5,2,11,20,-44,7,3,427,253
856,61,2,5,3,10,21,55,8,8,448,308
856,62,3,3,5,8,-68,-65,0,3,380,243
856,63,2,4,3,10,21,46,1,9,401,289
856,64,5,2,11,2,56,20,7,9,457,309
856,65,2,4,7,6,-75,-58,2,1,382,251
856,66,4,3,6,7,42,34,4,5,424,285
856,67,4,3,7,6,43,33,7,8,467,318
856,68,2,5,6,7,-76,-48,1,0,391,270
856,69,5,2,10,3,55,21,6,1,446,291
856,70,3,3,4,9,31,36,7,7,477,327
856,71,3,4,5,8,32,-56,9,1,509,271
857,1,5,2,8,5,53,23,3,3,53,23
857,2,3,3,5,8,32,35,5,8,85,58
857,3,2,5,4,9,22,-46,7,2,107,12
857,4,3,3,7,6,-66,33,1,5,41,45
857,5,3,3,5,8,32,-65,3,0,73,-20
857,6,3,4,6,7,33,43,6,3,106,23
857,7,5,3,8,5,53,32,9,5,159,55
857,8,4,3,7,6,-57,33,2,8,102,88
857,9,2,5,5,8,23,-47,5,1,125,41
857,10,4,3,6,7,42,34,7,5,167,75
857,11,4,3,9,4,-55,31,2,6,112,106
857,12,4,3,10,3,46,30,8,6,158,136
857,13,3,3,7,6,-66,33,2,9,92,169
857,14,3,3,7,6,34,-67,6,2,126,102
857,15,3,3,8,5,-65,32,1,4,61,134
857,16,3,3,8,5,35,32,6,6,96,166
857,17,4,3,8,5,-56,32,0,8,40,198
857,18,2,5,2,11,20,-44,0,4,60,154
857,19,2,5,5,8,23,53,3,7,83,207
857,20,3,4,8,5,35,41,8,8,118,248
857,21,5,2,9,4,-46,-78,2,0,72,170
857,22,3,4,6,7,33,43,5,3,105,213
857,23,5,2,10,3,-45,21,0,4,60,234
857,24,3,4,4,9,31,45,1,9,91,279
857,25,3,3,7,6,34,-67,5,2,125,212
857,26,4,2,11,2,-53,20,2,2,72,232
857,27,4,3,6,7,42,34,4,6,114,266
857,28,3,4,6,7,33,43,7,9,147,309
857,29,3,4,5,8,32,-56,9,3,179,253
857,30,5,2,8,5,-47,23,2,6,132,276
857,31,3,3,6,7,33,-66,5,0,165,210
857,32,3,4,4,9,31,45,6,5,196,255
857,33,2,4,4,9,22,-55,8,0,218,200
857,34,3,4,8,5,-65,41,3,1,153,241
857,35,3,3,8,5,35,32,8,3,188,273
857,36,3,4,4,9,31,45,9,8,219,318
857,37,4,3,6,7,-58,-66,1,2,161,252
857,38,5,2,9,4,54,22,5,4,215,274
857,39,3,3,7,6,34,33,9,7,249,307
857,40,3,3,5,8,-68,-65,1,2,181,242
857,41,4,3,6,7,42,34,3,6,223,276
857,42,5,2,9,4,54,22,7,8,277,298
857,43,5,2,7,6,52,-76,9,2,329,222
857,44,4,2,10,3,-54,21,5,3,275,243
857,45,4,2,7,6,43,24,8,7,318,267
857,46,2,4,3,10,21,-54,9,3,339,213
857,47,3,3,7,6,-66,33,3,6,273,246
857,48,5,2,11,2,56,20,9,6,329,266
857,49,4,2,9,4,-55,22,4,8,274,288
857,50,3,4,7,6,34,-58,8,0,308,230
857,51,4,2,6,7,-58,25,0,5,250,255
857,52,5,2,8,5,53,23,3,8,303,278
857,53,2,5,2,11,20,-44,3,4,323,234
857,54,4,3,9,4,45,31,8,5,368,265
857,55,3,4,5,8,-68,44,0,9,300,309
857,56,2,4,5,8,23,-56,3,3,323,253
857,57,3,4,8,5,35,41,8,4,358,294
857,58,5,2,8,5,-47,23,1,7,311,317
857,59,2,4,4,9,22,-55,3,2,333,262
857,60,2,4,5,8,23,44,6,6,356,306
857,61,2,5,3,10,21,-45,7,1,377,261
857,62,5,2,10,3,-45,21,2,2,332,282
857,63,4,3,8,5,44,32,6,4,376,314
857,64,6,2,10,3,-36,21,0,5,340,335
857,65,3,3,4,9,31,-64,1,1,371,271
857,66,4,3,5,8,41,35,2,6,412,306
857,67,5,3,7,6,52,33,4,9,464,339
857,68,5,2,9,4,54,-78,8,1,518,261
858,1,5,2,8,5,53,23,3,3,53,23
858,2,2,4,5,8,23,44,6,7,76,67
858,3,2,4,4,9,22,-55,8,2,98,12
858,4,3,3,8,5,-65,32,3,4,33,44
858,5,5,2,9,4,54,22,7,6,87,66
858,6,3,3,7,6,-66,33,1,9,21,99
858,7,3,4,8,5,35,-59,6,0,56,40
858,8,3,3,9,4,-64,31,2,1,-8,71
858,9,2,4,3,10,21,46,3,7,13,117
858,10,3,3,9,4,36,31,9,8,49,148
858,11,2,4,4,9,-78,-55,1,3,-29,93
858,12,2,5,4,9,22,54,3,7,-7,147
858,13,2,4,4,9,22,-55,5,2,15,92
858,14,2,5,6,7,24,52,9,4,39,144
858,15,2,4,4,9,-78,45,1,9,-39,189
858,16,5,2,8,5,53,-77,4,2,14,112
858,17,2,4,4,9,22,45,6,7,36,157
858,18,2,4,5,8,23,-56,9,1,59,101
858,19,4,2,8,5,-56,23,3,4,3,124
858,20,3,4,5,8,32,44,5,8,35,168
858,21,4,2,5,8,41,-74,6,4,76,94
858,22,4,2,8,5,-56,23,0,7,20,117
858,23,2,5,3,10,21,-45,1,2,41,72
858,24,2,5,4,9,22,54,3,6,63,126
858,25,3,3,9,4,36,31,9,7,99,157
858,26,4,4,8,5,-56,41,3,8,43,198
858,27,2,6,4,9,22,-37,5,1,65,161
858,28,2,5,6,7,24,52,9,3,89,213
858,29,4,2,8,5,-56,23,3,6,33,236
858,30,4,2,8,5,44,23,7,9,77,259
858,31,3,3,6,7,-67,-66,0,3,10,193
858,32,3,4,4,9,31,45,1,8,41,238
858,33,6,2,10,3,64,21,5,9,105,259
858,34,5,2,8,5,53,-77,8,2,158,182
858,35,4,3,9,4,-55,31,3,3,103,213
858,36,3,4,4,9,31,45,4,8,134,258
858,37,3,3,5,8,32,-65,6,3,166,193
858,38,5,2,10,3,-45,21,1,4,121,214
858,39,2,6,5,8,23,62,4,6,144,276
858,40,3,3,6,7,33,-66,7,0,177,210
858,41,4,3,8,5,-56,32,1,2,121,242
858,42,4,2,7,6,43,24,4,6,164,266
858,43,4,4,5,8,41,-56,5,0,205,210
858,44,2,6,2,11,20,65,5,5,225,275
858,45,4,2,6,7,42,-75,7,0,267,200
858,46,3,4,7,6,-66,42,1,2,201,242
858,47,3,3,8,5,35,32,6,4,236,274
858,48,3,4,7,6,-66,42,0,6,170,316
858,49,2,4,3,10,21,-54,1,2,191,262
858,50,2,4,5,8,23,44,4,6,214,306
858,51,4,3,10,3,-54,30,0,6,160,336
858,52,5,2,9,4,54,22,4,8,214,358
858,53,3,3,4,9,31,-64,5,4,245,294
858,54,4,3,6,7,42,34,7,8,287,328
858,55,5,2,10,3,-45,21,2,9,242,349
858,56,3,3,7,6,34,-67,6,2,276,282
858,57,2,4,4,9,22,45,8,7,298,327
858,58,4,2,7,6,-57,-76,1,1,241,251
858,59,3,4,6,7,33,43,4,4,274,294
858,60,5,2,9,4,54,22,8,6,328,316
858,61,3,4,6,7,-67,43,1,9,261,359
858,62,3,3,8,5,35,-68,6,1,296,291
858,63,2,5,6,7,-76,52,0,3,220,343
858,64,3,4,7,6,34,42,4,5,254,385
858,65,2,4,8,5,-74,41,0,6,180,426
858,66,4,3,9,4,45,31,5,7,225,457
858,67,2,5,3,10,21,-45,6,2,246,412
858,68,2,5,6,7,-76,52,0,4,170,464
858,69,2,5,3,10,21,55,1,9,191,519
859,1,2,5,3,10,21,55,1,5,21,55
859,2,2,4,6,7,24,43,5,8,45,98
859,3,4,3,5,8,41,-65,6,3,86,33
859,4,3,3,7,6,-66,33,0,6,20,66
859,5,4,4,7,6,43,42,3,8,63,108
859,6,4,3,9,4,45,31,8,9,108,139
859,7,3,3,3,10,30,-63,8,6,138,76
859,8,2,4,5,8,-77,-56,1,0,61,20
859,9,4,2,6,7,42,25,3,5,103,45
859,10,5,2,7,6,52,24,5,9,155,69
859,11,3,4,4,9,31,-55,6,4,186,14
859,12,4,3,5,8,41,35,7,9,227,49
859,13,3,3,8,5,-65,-68,2,1,162,-19
859,14,4,2,6,7,42,25,4,6,204,6
859,15,4,3,8,5,44,32,8,8,248,38
859,16,3,3,6,7,-67,-66,1,2,181,-28
859,17,5,2,8,5,53,23,4,5,234,-5
859,18,5,2,7,6,52,24,6,9,286,19
859,19,3,3,8,5,-65,-68,1,1,221,-49
859,20,5,2,8,5,53,23,4,4,274,-26
859,21,3,3,5,8,32,35,6,9,306,9
859,22,3,3,8,5,-65,-68,1,1,241,-59
859,23,4,2,7,6,43,24,4,5,284,-35
859,24,4,3,8,5,44,32,8,7,328,-3
859,25,5,2,8,5,-47,-77,1,0,281,-80
859,26,3,3,6,7,33,34,4,4,314,-46
859,27,3,4,4,9,31,45,5,9,345,-1
859,28,2,5,4,9,22,-46,7,3,367,-47
859,29,4,3,4,9,40,36,7,9,407,-11
859,30,3,3,6,7,-67,-66,0,3,340,-77
859,31,5,2,6,7,51,25,1,8,391,-52
859,32,3,3,4,9,31,-64,2,4,422,-116
859,33,3,3,4,9,31,-64,3,0,453,-180
859,34,3,3,4,9,31,36,4,6,484,-144
859,35,2,4,7,6,25,42,9,8,509,-102
860,1,3,3,7,6,34,33,4,3,34,33
860,2,4,3,8,5,44,32,8,5,78,65
860,3,5,2,8,5,-47,23,1,8,31,88
860,4,3,4,7,6,34,-58,5,0,65,30
860,5,4,3,8,5,44,32,9,2,109,62
860,6,3,4,4,9,-69,45,0,7,40,107
860,7,3,3,7,6,34,-67,4,0,74,40
860,8,5,3,7,6,52,33,6,3,126,73
860,9,2,5,4,9,22,54,8,7,148,127
860,10,3,3,8,5,-65,32,3,9,83,159
860,11,4,2,9,4,45,-78,8,1,128,81
860,12,3,4,5,8,-68,44,0,5,60,125
860,13,2,5,3,10,21,-45,1,0,81,80
860,14,3,5,4,9,31,54,2,4,112,134
860,15,2,5,4,9,22,54,4,8,134,188
860,16,5,2,10,3,55,21,9,9,189,209
860,17,4,3,8,5,-56,-68,3,1,133,141
860,18,3,4,7,6,34,42,7,3,167,183
860,19,5,2,8,5,-47,23,0,6,120,206
860,20,4,2,6,7,42,-75,2,1,162,131
860,21,4,3,6,7,42,34,4,5,204,165
860,22,3,3,7,6,34,33,8,8,238,198
860,23,2,5,5,8,-77,-47,1,1,161,151
860,24,2,5,3,10,21,55,2,6,182,206
860,25,4,3,7,6,43,33,5,9,225,239
860,26,3,5,4,9,31,-46,6,3,256,193
860,27,2,4,6,7,-76,43,0,6,180,236
860,28,3,3,7,6,34,33,4,9,214,269
860,29,5,2,8,5,53,-77,7,2,267,192
860,30,4,3,5,8,41,35,8,7,308,227
860,31,3,5,4,9,31,-46,9,1,339,181
860,32,4,2,8,5,-56,23,3,4,283,204
860,33,5,2,8,5,53,23,6,7,336,227
860,34,2,4,5,8,23,-56,9,1,359,171
860,35,4,3,7,6,-57,33,2,4,302,204
860,36,5,2,10,3,55,21,7,5,357,225
860,37,5,2,9,4,-46,22,1,7,311,247
860,38,4,3,7,6,43,-67,4,0,354,180
860,39,5,3,5,8,50,35,4,5,404,215
860,40,4,3,6,7,42,34,6,9,446,249
860,41,3,4,5,8,32,-56,8,3,478,193
860,42,4,3,8,5,-56,32,2,5,422,225
860,43,4,3,9,4,45,31,7,6,467,256
860,44,2,5,4,9,22,-46,9,0,489,210
860,45,3,3,5,8,-68,35,1,5,421,245
860,46,3,3,8,5,35,32,6,7,456,277
860,47,3,4,7,6,-66,42,0,9,390,319
860,48,2,5,5,8,23,-47,3,2,413,272
860,49,5,2,7,6,52,24,5,6,465,296
860,50,3,3,4,9,31,-64,6,2,496,232
860,51,4,4,6,7,42,43,8,5,538,275
861,1,2,5,5,8,23,53,3,3,23,53
861,2,5,2,9,4,54,22,7,5,77,75
861,3,3,4,3,10,30,-54,7,1,107,21
861,4,4,4,6,7,42,43,9,4,149,64
861,5,4,2,8,5,-56,23,3,7,93,87
861,6,5,2,7,6,52,-76,5,1,145,11
861,7,4,2,6,7,42,25,7,6,187,36
861,8,4,2,5,8,41,-74,8,2,228,-38
861,9,3,3,6,7,-67,34,1,6,161,-4
861,10,5,2,6,7,51,-75,2,1,212,-79
861,11,2,5,3,10,21,55,3,6,233,-24
861,12,2,4,3,10,21,-54,4,2,254,-78
861,13,2,5,5,8,23,53,7,5,277,-25
861,14,4,3,7,6,-57,33,0,8,220,8
861,15,3,3,7,6,34,-67,4,1,254,-59
861,16,2,5,7,6,25,51,9,2,279,-8
861,17,3,3,6,7,-67,34,2,6,212,26
861,18,2,5,2,11,20,-44,2,2,232,-18
861,19,3,4,5,8,32,44,4,6,264,26
861,20,2,5,2,11,20,-44,4,2,284,-18
861,21,4,2,6,7,42,25,6,7,326,7
861,22,6,2,11,2,-35,20,1,7,291,27
861,23,2,5,6,7,24,52,5,9,315,79
861,24,3,3,9,4,-64,-69,1,0,251,10
861,25,3,4,7,6,34,42,5,2,285,52
861,26,4,2,8,5,44,23,9,5,329,75
861,27,3,3,5,8,-68,-65,1,0,261,10
861,28,5,2,8,5,53,23,4,3,314,33
861,29,5,2,8,5,53,23,7,6,367,56
861,30,2,5,3,10,21,-45,8,1,388,11
861,31,4,3,6,7,-58,34,0,5,330,45
861,32,2,6,3,10,21,64,1,9,351,109
861,33,2,5,4,9,22,-46,3,3,373,63
861,34,4,2,8,5,44,23,7,6,417,86
861,35,2,4,6,7,-76,43,1,9,341,129
861,36,3,3,7,6,34,-67,5,2,375,62
861,37,4,2,7,6,43,24,8,6,418,86
861,38,3,3,8,5,-65,32,3,8,353,118
861,39,2,6,3,10,21,-36,4,2,374,82
861,40,3,3,6,7,33,34,7,6,407,116
861,41,3,3,6,7,-67,-66,0,0,340,50
861,42,2,6,4,9,22,63,2,3,362,113
861,43,2,5,4,9,22,54,4,7,384,167
861,44,3,3,5,8,32,-65,6,2,416,102
861,45,3,3,6,7,33,34,9,6,449,136
861,46,5,3,7,6,-48,33,1,9,401,169
861,47,3,3,4,9,31,-64,2,5,432,105
861,48,3,3,6,7,33,34,5,9,465,139
861,49,4,2,9,4,-55,-78,0,1,410,61
861,50,2,4,4,9,22,45,2,6,432,106
861,51,3,3,7,6,34,33,6,9,466,139
861,52,4,3,9,4,-55,-69,1,0,411,70
861,53,5,2,7,6,52,24,3,4,463,94
861,54,3,3,7,6,34,33,7,7,497,127
861,55,2,4,5,8,-77,-56,0,1,420,71
861,56,4,3,9,4,45,31,5,2,465,102
861,57,5,2,10,3,-45,21,0,3,420,123
861,58,5,2,9,4,54,22,4,5,474,145
861,59,3,4,3,10,30,-54,4,1,504,91
862,1,2,4,8,5,26,41,6,1,26,41
862,2,2,5,2,11,20,56,6,7,46,97
862,3,2,5,4,9,22,-46,8,1,68,51
862,4,3,4,8,5,-65,41,3,2,3,92
862,5,4,4,8,5,44,41,7,3,47,133
862,6,3,4,8,5,-65,41,2,4,-18,174
862,7,2,5,5,8,23,53,5,7,5,227
862,8,4,3,5,8,41,-65,6,2,46,162
862,9,2,4,5,8,23,44,9,6,69,206
862,10,4,3,8,5,-56,32,3,8,13,238
862,11,3,3,6,7,33,-66,6,2,46,172
862,12,4,3,6,7,42,34,8,6,88,206
862,13,3,3,8,5,-65,32,3,8,23,238
862,14,3,3,7,6,34,-67,7,1,57,171
862,15,3,4,5,8,32,44,9,5,89,215
862,16,2,4,5,8,-77,44,2,9,12,259
862,17,2,4,4,9,22,-55,4,4,34,204
862,18,3,4,6,7,33,43,7,7,67,247
862,19,6,2,12,1,-34,-20,3,7,33,227
862,20,3,3,6,7,33,-66,6,1,66,161
862,21,4,3,6,7,42,34,8,5,108,195
862,22,5,2,8,5,-47,23,1,8,61,218
862,23,4,3,6,7,42,-66,3,2,103,152
862,24,2,4,4,9,22,45,5,7,125,197
862,25,3,3,7,6,34,-67,9,0,159,130
862,26,4,3,8,5,-56,32,3,2,103,162
862,27,2,4,5,8,23,44,6,6,126,206
862,28,3,3,9,4,-64,31,2,7,62,237
862,29,2,4,4,9,22,-55,4,2,84,182
862,30,2,5,7,6,25,51,9,3,109,233
862,31,4,3,7,6,-57,33,2,6,52,266
862,32,3,4,4,9,31,-55,3,1,83,211
862,33,3,3,5,8,32,35,5,6,115,246
862,34,2,4,7,6,-75,42,0,8,40,288
862,35,5,2,8,5,53,-77,3,1,93,211
862,36,4,3,9,4,45,31,8,2,138,242
862,37,4,3,7,6,-57,33,1,5,81,275
862,38,4,2,9,4,45,22,6,7,126,297
862,39,4,3,7,6,43,-67,9,0,169,230
862,40,2,4,5,8,-77,44,2,4,92,274
862,41,4,3,6,7,42,34,4,8,134,308
862,42,3,3,6,7,33,-66,7,2,167,242
862,43,4,3,10,3,-54,30,3,2,113,272
862,44,3,3,6,7,33,34,6,6,146,306
862,45,5,2,7,6,52,-76,8,0,198,230
862,46,4,3,8,5,-56,32,2,2,142,262
862,47,2,4,5,8,23,44,5,6,165,306
862,48,6,2,10,3,64,21,9,7,229,327
862,49,4,3,8,5,-56,32,3,9,173,359
862,50,2,4,5,8,23,-56,6,3,196,303
862,51,4,2,7,6,43,24,9,7,239,327
862,52,3,3,10,3,-63,30,6,7,176,357
862,53,4,3,9,4,-55,31,1,8,121,388
862,54,4,3,9,4,45,31,6,9,166,419
862,55,3,4,5,8,32,-56,8,3,198,363
862,56,4,2,6,7,-58,25,0,8,140,388
862,57,3,4,8,5,35,41,5,9,175,429
862,58,5,2,10,3,-45,-79,0,0,130,350
862,59,3,4,5,8,32,44,2,4,162,394
862,60,3,4,4,9,31,45,3,9,193,439
862,61,3,3,5,8,32,-65,5,4,225,374
862,62,2,5,3,10,21,55,6,9,246,429
862,63,3,3,5,8,32,-65,8,4,278,364
862,64,3,3,7,6,-66,33,2,7,212,397
862,65,4,3,8,5,44,32,6,9,256,429
862,66,2,4,5,8,23,-56,9,3,279,373
862,67,4,4,8,5,-56,41,3,4,223,414
862,68,5,2,11,2,56,20,9,4,279,434
862,69,5,2,9,4,-46,22,3,6,233,456
862,70,4,3,10,3,46,30,9,6,279,486
862,71,5,2,7,6,-48,-76,1,0,231,410
862,72,4,2,8,5,44,23,5,3,275,433
862,73,4,3,10,3,-54,30,1,3,221,463
862,74,4,2,7,6,43,24,4,7,264,487
862,75,4,3,9,4,45,31,9,8,309,518
863,1,4,3,10,3,46,30,6,0,46,30
863,2,4,3,7,6,43,33,9,3,89,63
863,3,2,5,4,9,-78,54,1,7,11,117
863,4,3,3,8,5,35,32,6,9,46,149
863,5,3,4,5,8,32,-56,8,3,78,93
863,6,3,3,8,5,-65,32,3,5,13,125
863,7,2,4,6,7,24,43,7,8,37,168
863,8,3,3,10,3,-63,30,4,8,-26,198
863,9,3,4,5,8,32,-56,6,2,6,142
863,10,2,4,5,8,23,44,9,6,29,186
863,11,2,5,5,8,-77,53,2,9,-48,239
863,12,3,4,7,6,34,-58,6,1,-14,181
863,13,3,4,4,9,31,45,7,6,17,226
863,14,4,4,6,7,42,43,9,9,59,269
863,15,2,6,7,6,-75,60,4,9,-16,329
863,16,2,5,4,9,22,-46,6,3,6,283
863,17,2,5,4,9,22,54,8,7,28,337
863,18,2,4,6,7,-76,-57,2,0,-48,280
863,19,3,4,5,8,32,44,4,4,-16,324
863,20,4,3,4,9,40,-64,4,0,24,260
863,21,2,4,5,8,23,44,7,4,47,304
863,22,3,3,9,4,-64,31,3,5,-17,335
863,23,3,3,10,3,-63,30,0,5,-80,365
863,24,3,3,8,5,35,32,5,7,-45,397
863,25,2,4,6,7,24,-57,9,0,-21,340
863,26,3,4,4,9,-69,45,0,5,-90,385
863,27,5,2,9,4,54,22,4,7,-36,407
863,28,3,3,7,6,34,-67,8,0,-2,340
863,29,3,4,7,6,-66,42,2,2,-68,382
863,30,3,3,4,9,31,36,3,8,-37,418
863,31,3,4,3,10,30,-54,3,4,-7,364
863,32,4,3,7,6,43,33,6,7,36,397
863,33,4,2,7,6,43,-76,9,1,79,321
863,34,4,2,10,3,-54,21,5,2,25,342
863,35,4,2,7,6,43,24,8,6,68,366
863,36,3,3,10,3,-63,30,5,6,5,396
863,37,2,7,4,9,22,72,7,8,27,468
863,38,5,2,7,6,52,-76,9,2,79,392
863,39,5,2,9,4,-46,22,3,4,33,414
863,40,2,4,3,10,21,-54,4,0,54,360
863,41,2,4,3,10,21,46,5,6,75,406
863,42,2,4,4,9,22,-55,7,1,97,351
863,43,3,4,3,10,30,46,7,7,127,397
863,44,4,2,8,5,-56,-77,1,0,71,320
863,45,2,7,3,10,21,73,2,3,92,393
863,46,3,3,6,7,33,34,5,7,125,427
863,47,4,3,8,5,44,32,9,9,169,459
863,48,2,5,5,8,-77,-47,2,2,92,412
863,49,5,2,9,4,54,22,6,4,146,434
863,50,5,2,10,3,-45,21,1,5,101,455
863,51,2,5,4,9,22,54,3,9,123,509
864,1,2,5,2,11,20,56,0,6,20,56
864,2,3,4,7,6,34,42,4,8,54,98
864,3,3,3,4,9,31,-64,5,4,85,34
864,4,3,3,6,7,33,34,8,8,118,68
864,5,3,4,5,8,-68,-56,0,2,50,12
864,6,3,4,5,8,32,44,2,6,82,56
864,7,3,4,6,7,33,43,5,9,115,99
864,8,3,4,4,9,31,-55,6,4,146,44
864,9,3,3,7,6,-66,33,0,7,80,77
864,10,2,4,6,7,24,-57,4,0,104,20
864,11,4,3,5,8,41,35,5,5,145,55
864,12,6,2,11,2,-35,20,0,5,110,75
864,13,5,2,8,5,53,23,3,8,163,98
864,14,4,2,9,4,45,-78,8,0,208,20
864,15,3,4,5,8,-68,44,0,4,140,64
864,16,4,2,7,6,43,24,3,8,183,88
864,17,4,2,9,4,45,-78,8,0,228,10
864,18,2,4,4,9,-78,45,0,5,150,55
864,19,3,3,6,7,33,34,3,9,183,89
864,20,4,3,9,4,45,-69,8,0,228,20
864,21,4,3,8,5,-56,32,2,2,172,52
864,22,3,3,7,6,34,33,6,5,206,85
864,23,4,3,7,6,43,33,9,8,249,118
864,24,2,4,6,7,-76,-57,3,1,173,61
864,25,2,4,4,9,22,45,5,6,195,106
864,26,3,4,6,7,33,43,8,9,228,149
864,27,4,2,6,7,-58,-75,0,4,170,74
864,28,5,2,6,7,51,25,1,9,221,99
864,29,3,4,7,6,34,-58,5,1,255,41
864,30,5,2,11,2,-44,20,1,1,211,61
864,31,4,2,7,6,43,24,4,5,254,85
864,32,3,4,6,7,33,43,7,8,287,128
864,33,6,2,9,4,-37,-78,0,0,250,50
864,34,3,4,6,7,33,43,3,3,283,93
864,35,2,6,4,9,22,63,5,6,305,156
864,36,2,5,4,9,22,-46,7,0,327,110
864,37,3,3,6,7,-67,34,0,4,260,144
864,38,5,3,6,7,51,34,1,8,311,178
864,39,2,4,5,8,23,-56,4,2,334,122
864,40,5,2,9,4,54,22,8,4,388,144
864,41,2,5,4,9,-78,54,0,8,310,198
864,42,4,3,9,4,45,31,5,9,355,229
864,43,3,3,6,7,33,-66,8,3,388,163
864,44,3,3,8,5,-65,32,3,5,323,195
864,45,4,2,10,3,46,21,9,6,369,216
864,46,3,3,5,8,-68,-65,1,1,301,151
864,47,3,4,4,9,31,45,2,6,332,196
864,48,5,2,8,5,53,23,5,9,385,219
864,49,3,3,7,6,34,-67,9,2,419,152
864,50,2,5,3,10,-79,55,0,7,340,207
864,51,2,6,5,8,23,62,3,9,363,269
864,52,4,3,9,4,45,-69,8,0,408,200
864,53,3,4,3,10,30,46,8,6,438,246
864,54,3,5,5,8,-68,53,0,9,370,299
864,55,2,4,6,7,24,-57,4,2,394,242
864,56,3,3,7,6,34,33,8,5,428,275
864,57,2,4,7,6,-75,42,3,7,353,317
864,58,4,2,8,5,44,-77,7,0,397,240
864,59,3,3,8,5,-65,32,2,2,332,272
864,60,3,3,6,7,33,34,5,6,365,306
864,61,3,4,7,6,34,42,9,8,399,348
864,62,2,4,3,10,-79,-54,0,4,320,294
864,63,4,3,7,6,43,33,3,7,363,327
864,64,4,2,7,6,43,-76,6,1,406,251
864,65,4,2,8,5,-56,23,0,4,350,274
864,66,3,3,7,6,34,33,4,7,384,307
864,67,2,4,6,7,24,-57,8,0,408,250
864,68,3,3,7,6,-66,33,2,3,342,283
864,69,2,4,6,7,24,43,6,6,366,326
864,70,2,4,7,6,-75,42,1,8,291,368
864,71,3,3,8,5,35,-68,6,0,326,300
864,72,4,3,9,4,-55,31,1,1,271,331
864,73,2,5,4,9,22,54,3,5,293,385
864,74,3,4,5,8,32,44,5,9,325,429
864,75,3,4,5,8,32,-56,7,3,357,373
864,76,4,3,10,3,-54,30,3,3,303,403
864,77,4,2,8,5,44,23,7,6,347,426
864,78,3,4,6,7,-67,43,0,9,280,469
864,79,3,4,6,7,33,-57,3,2,313,412
864,80,4,3,6,7,42,34,5,6,355,446
864,81,4,3,4,9,40,-64,5,2,395,382
864,82,4,2,7,6,43,24,8,6,438,406
864,83,3,3,8,5,-65,32,3,8,373,438
864,84,4,2,7,6,43,-76,6,2,416,362
864,85,3,3,7,6,-66,33,0,5,350,395
864,86,4,3,8,5,44,32,4,7,394,427
864,87,4,2,9,4,45,22,9,9,439,449
864,88,3,4,8,5,-65,-59,4,0,374,390
864,89,4,3,9,4,45,31,9,1,419,421
864,90,4,3,9,4,-55,31,4,2,364,452
864,91,4,3,7,6,43,33,7,5,407,485
864,92,2,4,6,7,-76,43,1,8,331,528
865,1,4,2,9,4,45,22,5,2,45,22
865,2,3,3,7,6,34,33,9,5,79,55
865,3,2,5,3,10,-79,-45,0,0,0,10
865,4,3,4,6,7,33,43,3,3,33,53
865,5,4,3,8,5,44,32,7,5,77,85
865,6,5,3,9,4,-46,31,1,6,31,116
865,7,3,4,4,9,31,-55,2,1,62,61
865,8,3,3,7,6,34,33,6,4,96,94
865,9,3,4,5,8,32,44,8,8,128,138
865,10,5,3,9,4,-46,31,2,9,82,169
865,11,2,4,8,5,26,-59,8,0,108,110
865,12,3,3,5,8,-68,35,0,5,40,145
865,13,3,4,5,8,32,44,2,9,72,189
865,14,3,3,6,7,33,-66,5,3,105,123
865,15,4,3,7,6,43,33,8,6,148,156
865,16,3,4,5,8,-68,-56,0,0,80,100
865,17,2,5,5,8,23,53,3,3,103,153
865,18,3,4,7,6,34,42,7,5,137,195
865,19,2,4,6,7,-76,43,1,8,61,238
865,20,3,4,3,10,30,-54,1,4,91,184
865,21,3,3,8,5,35,32,6,6,126,216
865,22,3,4,5,8,32,-56,8,0,158,160
865,23,6,2,10,3,-36,21,2,1,122,181
865,24,4,2,8,5,44,23,6,4,166,204
865,25,4,2,8,5,-56,23,0,7,110,227
865,26,6,2,11,2,65,20,5,7,175,247
865,27,2,4,5,8,23,-56,8,1,198,191
865,28,3,4,4,9,31,45,9,6,229,236
865,29,3,3,8,5,-65,32,4,8,164,268
865,30,4,3,7,6,43,-67,7,1,207,201
865,31,4,3,6,7,42,34,9,5,249,235
865,32,4,3,6,7,-58,34,1,9,191,269
865,33,3,3,10,3,37,30,8,9,228,299
865,34,4,2,8,5,-56,-77,2,2,172,222
865,35,5,3,6,7,51,34,3,6,223,256
865,36,2,4,2,11,20,-53,3,3,243,203
865,37,4,4,4,9,40,45,3,8,283,248
865,38,3,3,9,4,36,31,9,9,319,279
865,39,3,3,8,5,-65,-68,4,1,254,211
865,40,3,4,4,9,31,45,5,6,285,256
865,41,3,3,8,5,-65,32,0,8,220,288
865,42,3,3,6,7,33,-66,3,2,253,222
865,43,2,4,5,8,23,44,6,6,276,266
865,44,2,4,6,7,-76,43,0,9,200,309
865,45,6,2,8,5,62,-77,2,2,262,232
865,46,4,4,6,7,42,43,4,5,304,275
865,47,3,4,6,7,33,43,7,8,337,318
865,48,4,3,6,7,42,-66,9,2,379,252
865,49,3,4,6,7,-67,43,2,5,312,295
865,50,3,3,3,10,30,-63,2,2,342,232
865,51,4,2,9,4,45,22,7,4,387,254
865,52,3,4,4,9,31,45,8,9,418,299
865,53,3,3,5,8,-68,-65,0,4,350,234
865,54,3,3,6,7,33,34,3,8,383,268
865,55,4,3,8,5,44,-68,7,0,427,200
865,56,4,2,8,5,-56,23,1,3,371,223
865,57,3,4,4,9,31,45,2,8,402,268
865,58,4,2,7,6,43,-76,5,2,445,192
865,59,3,3,7,6,34,33,9,5,479,225
865,60,3,3,7,6,-66,33,3,8,413,258
865,61,4,3,8,5,44,-68,7,0,457,190
865,62,4,2,9,4,-55,22,2,2,402,212
865,63,3,3,6,7,33,34,5,6,435,246
865,64,3,3,4,9,31,-64,6,2,466,182
865,65,3,3,6,7,33,34,9,6,499,216
865,66,2,4,5,8,-77,-56,2,0,422,160
865,67,3,3,7,6,34,33,6,3,456,193
865,68,4,3,5,8,41,35,7,8,497,228
865,69,4,3,9,4,-55,31,2,9,442,259
865,70,2,4,4,9,22,-55,4,4,464,204
865,71,4,2,11,2,-53,20,1,4,411,224
865,72,3,3,4,9,31,-64,2,0,442,160
865,73,3,3,6,7,33,34,5,4,475,194
865,74,4,2,10,3,-54,21,1,5,421,215
865,75,3,4,6,7,33,43,4,8,454,258
865,76,2,4,2,11,20,-53,4,5,474,205
865,77,5,2,7,6,52,24,6,9,526,229
866,1,3,4,5,8,32,44,2,4,32,44
866,2,3,3,10,3,37,30,9,4,69,74
866,3,2,4,3,10,-79,-54,0,0,-10,20
866,4,2,6,4,9,22,63,2,3,12,83
866,5,2,4,4,9,22,45,4,8,34,128
866,6,3,3,7,6,34,-67,8,1,68,61
866,7,4,3,7,6,-57,33,1,4,11,94
866,8,5,2,9,4,54,22,5,6,65,116
866,9,2,5,5,8,23,53,8,9,88,169
866,10,2,5,5,8,-77,-47,1,2,11,122
866,11,3,3,5,8,32,35,3,7,43,157
866,12,4,3,8,5,44,32,7,9,87,189
866,13,3,4,3,10,30,-54,7,5,117,135
866,14,4,3,9,4,-55,31,2,6,62,166
866,15,3,3,8,5,35,32,7,8,97,198
866,16,3,3,5,8,32,-65,9,3,129,133
866,17,5,2,9,4,-46,22,3,5,83,155
866,18,4,3,6,7,42,34,5,9,125,189
866,19,3,4,5,8,32,-56,7,3,157,133
866,20,4,3,8,5,-56,32,1,5,101,165
866,21,4,3,7,6,43,33,4,8,144,198
866,22,3,3,6,7,33,-66,7,2,177,132
866,23,3,4,5,8,32,44,9,6,209,176
866,24,5,2,8,5,-47,23,2,9,162,199
866,25,4,2,10,3,46,-79,8,0,208,120
866,26,4,3,7,6,-57,33,1,3,151,153
866,27,2,4,5,8,23,44,4,7,174,197
866,28,2,4,3,10,21,-54,5,3,195,143
866,29,4,3,8,5,44,32,9,5,239,175
866,30,2,4,4,9,-78,-55,1,0,161,120
866,31,2,5,5,8,23,53,4,3,184,173
866,32,3,4,7,6,34,42,8,5,218,215
866,33,2,4,3,10,21,-54,9,1,239,161
866,34,2,4,4,9,-78,45,1,6,161,206
866,35,5,2,11,2,56,20,7,6,217,226
866,36,3,4,5,8,32,-56,9,0,249,170
866,37,3,3,9,4,-64,31,5,1,185,201
866,38,4,3,7,6,43,33,8,4,228,234
866,39,4,2,5,8,41,-74,9,0,269,160
866,40,2,4,4,9,-78,45,1,5,191,205
866,41,3,4,4,9,31,-55,2,0,222,150
866,42,2,5,5,8,23,53,5,3,245,203
866,43,3,3,6,7,33,34,8,7,278,237
866,44,4,3,9,4,-55,31,3,8,223,268
866,45,3,4,6,7,33,-57,6,1,256,211
866,46,3,4,7,6,-66,42,0,3,190,253
866,47,4,2,8,5,44,23,4,6,234,276
866,48,3,4,4,9,31,-55,5,1,265,221
866,49,3,3,6,7,33,34,8,5,298,255
866,50,4,3,6,7,-58,34,0,9,240,289
866,51,3,3,7,6,34,-67,4,2,274,222
866,52,3,3,7,6,34,33,8,5,308,255
866,53,3,4,7,6,-66,42,2,7,242,297
866,54,5,2,10,3,55,21,7,8,297,318
866,55,3,4,6,7,-67,-57,0,1,230,261
866,56,5,2,10,3,55,21,5,2,285,282
866,57,4,3,9,4,-55,31,0,3,230,313
866,58,2,5,3,10,21,55,1,8,251,368
866,59,4,3,6,7,42,-66,3,2,293,302
866,60,4,2,9,4,45,22,8,4,338,324
866,61,3,4,6,7,-67,43,1,7,271,367
866,62,4,2,8,5,44,-77,5,0,315,290
866,63,5,2,9,4,54,22,9,2,369,312
866,64,2,5,7,6,-75,51,4,3,294,363
866,65,3,3,9,4,-64,31,0,4,230,394
866,66,4,2,7,6,43,24,3,8,273,418
866,67,4,3,5,8,41,-65,4,3,314,353
866,68,4,3,9,4,45,31,9,4,359,384
866,69,2,5,6,7,-76,52,3,6,283,436
866,70,5,3,8,5,53,32,6,8,336,468
866,71,3,3,7,6,-66,-67,0,1,270,401
866,72,3,4,8,5,35,41,5,2,305,442
866,73,2,5,2,11,20,56,5,8,325,498
866,74,5,2,10,3,-45,21,0,9,280,519
867,1,3,4,6,7,33,43,3,3,33,43
867,2,3,4,6,7,33,43,6,6,66,86
867,3,4,3,7,6,43,33,9,9,109,119
867,4,2,6,4,9,-78,-37,1,2,31,82
867,5,4,3,5,8,41,35,2,7,72,117
867,6,5,2,10,3,55,21,7,8,127,138
867,7,4,2,7,6,-57,-76,0,2,70,62
867,8,3,3,6,7,33,34,3,6,103,96
867,9,3,3,6,7,33,-66,6,0,136,30
867,10,4,3,7,6,43,33,9,3,179,63
867,11,3,3,7,6,-66,33,3,6,113,96
867,12,4,2,5,8,41,-74,4,2,154,22
867,13,2,6,4,9,22,63,6,5,176,85
867,14,4,2,11,2,-53,20,3,5,123,105
867,15,3,4,5,8,32,44,5,9,155,149
867,16,5,2,10,3,-45,-79,0,0,110,70
867,17,3,3,7,6,34,33,4,3,144,103
867,18,3,4,5,8,32,44,6,7,176,147
867,19,3,4,8,5,-65,41,1,8,111,188
867,20,2,5,3,10,21,-45,2,3,132,143
867,21,3,3,5,8,32,35,4,8,164,178
867,22,3,3,6,7,33,-66,7,2,197,112
867,23,3,3,6,7,-67,34,0,6,130,146
867,24,5,2,7,6,52,-76,2,0,182,70
867,25,2,5,4,9,22,54,4,4,204,124
867,26,3,5,6,7,33,52,7,6,237,176
867,27,4,3,9,4,-55,31,2,7,182,207
867,28,3,3,4,9,31,-64,3,3,213,143
867,29,2,4,6,7,24,43,7,6,237,186
867,30,2,5,5,8,-77,53,0,9,160,239
867,31,5,2,11,2,56,20,6,9,216,259
867,32,3,3,7,6,-66,-67,0,2,150,192
867,33,2,4,7,6,25,42,5,4,175,234
867,34,4,2,9,4,-55,22,0,6,120,256
867,35,4,4,5,8,41,-56,1,0,161,200
867,36,3,3,6,7,33,34,4,4,194,234
867,37,2,4,6,7,24,43,8,7,218,277
867,38,4,2,8,5,-56,-77,2,0,162,200
867,39,2,4,4,9,22,45,4,5,184,245
867,40,3,3,6,7,33,34,7,9,217,279
867,41,4,3,7,6,-57,-67,0,2,160,212
867,42,3,3,6,7,33,34,3,6,193,246
867,43,3,4,7,6,34,42,7,8,227,288
867,44,3,4,6,7,-67,-57,0,1,160,231
867,45,2,5,4,9,22,54,2,5,182,285
867,46,2,5,5,8,23,53,5,8,205,338
867,47,4,3,5,8,41,-65,6,3,246,273
867,48,2,5,4,9,22,54,8,7,268,327
867,49,5,2,9,4,-46,22,2,9,222,349
867,50,4,2,8,5,44,-77,6,2,266,272
867,51,3,3,6,7,33,34,9,6,299,306
867,52,4,3,9,4,-55,31,4,7,244,337
867,53,4,2,7,6,43,-76,7,1,287,261
867,54,3,4,8,5,-65,41,2,2,222,302
867,55,3,4,8,5,35,41,7,3,257,343
867,56,3,4,7,6,-66,42,1,5,191,385
867,57,2,4,4,9,22,-55,3,0,213,330
867,58,3,4,9,4,36,40,9,0,249,370
867,59,3,4,6,7,-67,43,2,3,182,413
867,60,2,5,6,7,24,52,6,5,206,465
867,61,3,3,6,7,33,34,9,9,239,499
867,62,3,4,7,6,-66,-58,3,1,173,441
867,63,3,3,7,6,34,33,7,4,207,474
867,64,2,7,3,10,21,73,8,7,228,547
868,1,3,3,10,3,37,30,7,0,37,30
868,2,4,2,11,2,-53,20,4,0,-16,50
868,3,2,5,5,8,23,53,7,3,7,103
868,4,4,3,6,7,42,34,9,7,49,137
868,5,3,3,8,5,-65,32,4,9,-16,169
868,6,2,4,4,9,22,-55,6,4,6,114
868,7,3,3,6,7,33,34,9,8,39,148
868,8,3,4,5,8,-68,-56,1,2,-29,92
868,9,3,3,6,7,33,34,4,6,4,126
868,10,3,3,6,7,33,-66,7,0,37,60
868,11,4,2,6,7,42,25,9,5,79,85
868,12,3,3,8,5,-65,32,4,7,14,117
868,13,3,3,8,5,35,32,9,9,49,149
868,14,5,2,9,4,-46,-78,3,1,3,71
868,15,4,3,7,6,43,33,6,4,46,104
868,16,4,3,6,7,42,34,8,8,88,138
868,17,2,5,2,11,20,-44,8,4,108,94
868,18,2,5,4,9,-78,54,0,8,30,148
868,19,2,4,7,6,25,-58,5,0,55,90
868,20,4,4,8,5,44,41,9,1,99,131
868,21,2,5,6,7,-76,52,3,3,23,183
868,22,2,6,3,10,21,64,4,7,44,247
868,23,4,3,6,7,42,-66,6,1,86,181
868,24,2,4,5,8,23,44,9,5,109,225
868,25,2,4,5,8,-77,44,2,9,32,269
868,26,2,5,4,9,22,-46,4,3,54,223
868,27,4,3,5,8,41,35,5,8,95,258
868,28,4,3,8,5,44,-68,9,0,139,190
868,29,3,4,8,5,-65,41,4,1,74,231
868,30,3,3,8,5,35,32,9,3,109,263
868,31,5,2,9,4,-46,22,3,5,63,285
868,32,4,2,7,6,43,24,6,9,106,309
868,33,4,3,6,7,42,-66,8,3,148,243
868,34,3,4,7,6,-66,42,2,5,82,285
868,35,4,2,9,4,45,22,7,7,127,307
868,36,5,2,8,5,-47,-77,0,0,80,230
868,37,2,4,4,9,22,45,2,5,102,275
868,38,2,5,3,10,21,-45,3,0,123,230
868,39,3,3,6,7,33,34,6,4,156,264
868,40,3,4,5,8,32,44,8,8,188,308
868,41,3,3,5,8,-68,-65,0,3,120,243
868,42,4,2,8,5,44,23,4,6,164,266
868,43,4,2,8,5,44,23,8,9,208,289
868,44,2,5,6,7,-76,-48,2,1,132,241
868,45,2,4,5,8,23,44,5,5,155,285
868,46,3,3,4,9,31,-64,6,1,186,221
868,47,2,5,3,10,21,55,7,6,207,276
868,48,4,3,7,6,-57,33,0,9,150,309
868,49,3,3,8,5,35,-68,5,1,185,241
868,50,4,3,7,6,43,33,8,4,228,274
868,51,3,3,6,7,-67,34,1,8,161,308
868,52,2,4,4,9,22,-55,3,3,183,253
868,53,3,4,4,9,31,45,4,8,214,298
868,54,2,4,7,6,25,-58,9,0,239,240
868,55,4,2,6,7,-58,25,1,5,181,265
868,56,2,4,6,7,24,43,5,8,205,308
868,57,5,2,8,5,53,-77,8,1,258,231
868,58,5,2,8,5,-47,23,1,4,211,254
868,59,3,3,7,6,34,33,5,7,245,287
868,60,4,3,9,4,-55,31,0,8,190,318
868,61,5,2,10,3,55,21,5,9,245,339
868,62,4,4,6,7,42,-57,7,2,287,282
868,63,5,2,9,4,-46,22,1,4,241,304
868,64,5,2,8,5,53,23,4,7,294,327
868,65,3,3,5,8,32,-65,6,2,326,262
868,66,4,3,9,4,-55,31,1,3,271,293
868,67,2,4,5,8,23,44,4,7,294,337
868,68,2,4,4,9,22,-55,6,2,316,282
868,69,5,3,9,4,-46,31,0,3,270,313
868,70,3,4,5,8,32,44,2,7,302,357
868,71,5,2,10,3,55,21,7,8,357,378
868,72,4,3,7,6,-57,-67,0,1,300,311
868,73,2,5,4,9,22,54,2,5,322,365
868,74,3,3,4,9,31,-64,3,1,353,301
868,75,3,4,6,7,33,43,6,4,386,344
868,76,4,2,9,4,-55,22,1,6,331,366
868,77,5,2,9,4,54,22,5,8,385,388
868,78,4,3,6,7,42,-66,7,2,427,322
868,79,2,4,6,7,-76,43,1,5,351,365
868,80,2,6,3,10,21,64,2,9,372,429
868,81,3,3,6,7,33,-66,5,3,405,363
868,82,4,3,8,5,44,32,9,5,449,395
868,83,3,4,5,8,-68,44,1,9,381,439
868,84,4,3,8,5,44,-68,5,1,425,371
868,85,2,5,4,9,22,54,7,5,447,425
868,86,3,3,5,8,32,-65,9,0,479,360
868,87,3,4,4,9,-69,45,0,5,410,405
868,88,4,3,6,7,42,34,2,9,452,439
868,89,4,3,4,9,40,-64,2,5,492,375
868,90,5,2,8,5,53,23,5,8,545,398
869,1,3,5,3,10,30,55,0,5,30,55
869,2,3,4,7,6,34,42,4,7,64,97
869,3,3,3,8,5,35,32,9,9,99,129
869,4,4,2,7,6,-57,-76,2,3,42,53
869,5,4,3,10,3,46,30,8,3,88,83
869,6,2,5,4,9,-78,54,0,7,10,137
869,7,3,3,9,4,36,31,6,8,46,168
869,8,5,2,10,3,-45,21,1,9,1,189
869,9,3,5,5,8,32,-47,3,2,33,142
869,10,3,4,6,7,33,43,6,5,66,185
869,11,2,4,4,9,22,-55,8,0,88,130
869,12,5,2,6,7,51,25,9,5,139,155
869,13,3,4,5,8,-68,44,1,9,71,199
869,14,3,4,6,7,33,-57,4,2,104,142
869,15,5,2,9,4,54,22,8,4,158,164
869,16,4,3,6,7,-58,34,0,8,100,198
869,17,4,2,11,2,47,20,7,8,147,218
869,18,5,2,10,3,-45,21,2,9,102,239
869,19,5,2,7,6,52,-76,4,3,154,163
869,20,3,3,6,7,33,34,7,7,187,197
869,21,3,3,5,8,32,-65,9,2,219,132
869,22,4,3,8,5,-56,32,3,4,163,164
869,23,2,5,5,8,23,53,6,7,186,217
869,24,2,5,4,9,22,-46,8,1,208,171
869,25,3,3,7,6,-66,33,2,4,142,204
869,26,5,2,8,5,53,23,5,7,195,227
869,27,4,2,9,4,-55,22,0,9,140,249
869,28,4,2,5,8,41,-74,1,5,181,175
869,29,5,2,9,4,54,22,5,7,235,197
869,30,5,2,8,5,53,-77,8,0,288,120
869,31,3,3,8,5,-65,32,3,2,223,152
869,32,3,3,6,7,33,34,6,6,256,186
869,33,4,3,7,6,43,33,9,9,299,219
869,34,2,6,3,10,-79,-36,0,3,220,183
869,35,3,4,7,6,34,42,4,5,254,225
869,36,3,3,7,6,34,33,8,8,288,258
869,37,3,3,6,7,-67,-66,1,2,221,192
869,38,6,2,10,3,64,21,5,3,285,213
869,39,2,5,3,10,21,55,6,8,306,268
869,40,2,5,5,8,23,-47,9,1,329,221
869,41,3,3,7,6,-66,33,3,4,263,254
869,42,3,3,7,6,34,33,7,7,297,287
869,43,2,5,4,9,22,-46,9,1,319,241
869,44,4,3,8,5,-56,32,3,3,263,273
869,45,3,3,6,7,33,34,6,7,296,307
869,46,3,4,4,9,31,-55,7,2,327,252
869,47,3,4,6,7,-67,43,0,5,260,295
869,48,3,3,5,8,32,-65,2,0,292,230
869,49,3,3,7,6,34,33,6,3,326,263
869,50,3,3,3,10,30,-63,6,0,356,200
869,51,2,4,4,9,22,45,8,5,378,245
869,52,4,3,6,7,-58,34,0,9,320,279
869,53,2,4,4,9,22,-55,2,4,342,224
869,54,5,2,7,6,52,24,4,8,394,248
869,55,3,5,8,5,35,50,9,8,429,298
869,56,2,4,5,8,-77,-56,2,2,352,242
869,57,2,5,5,8,23,53,5,5,375,295
869,58,4,2,5,8,41,-74,6,1,416,221
869,59,4,2,9,4,-55,22,1,3,361,243
869,60,5,2,8,5,53,23,4,6,414,266
869,61,3,3,5,8,32,-65,6,1,446,201
869,62,4,3,8,5,-56,32,0,3,390,233
869,63,3,4,5,8,32,44,2,7,422,277
869,64,4,3,8,5,44,32,6,9,466,309
869,65,3,4,4,9,31,-55,7,4,497,254
869,66,3,4,5,8,32,44,9,8,529,298
870,1,3,3,6,7,33,34,3,4,33,34
870,2,5,2,7,6,52,24,5,8,85,58
870,3,2,4,6,7,24,-57,9,1,109,1
870,4,5,3,8,5,-47,32,2,3,62,33
870,5,2,4,3,10,21,46,3,9,83,79
870,6,5,2,10,3,55,-79,8,0,138,0
870,7,4,3,9,4,-55,31,3,1,83,31
870,8,3,5,5,8,32,53,5,4,115,84
870,9,2,5,4,9,22,54,7,8,137,138
870,10,2,4,3,10,21,-54,8,4,158,84
870,11,3,3,6,7,-67,34,1,8,91,118
870,12,4,2,10,3,46,21,7,9,137,139
870,13,5,3,7,6,52,-67,9,2,189,72
870,14,4,2,8,5,-56,23,3,5,133,95
870,15,4,2,8,5,44,23,7,8,177,118
870,16,5,2,8,5,-47,-77,0,1,130,41
870,17,6,2,9,4,63,22,3,3,193,63
870,18,3,3,5,8,32,35,5,8,225,98
870,19,3,3,8,5,-65,-68,0,0,160,30
870,20,4,3,7,6,43,33,3,3,203,63
870,21,2,4,4,9,22,45,5,8,225,108
870,22,3,4,5,8,32,-56,7,2,257,52
870,23,3,3,6,7,-67,34,0,6,190,86
870,24,4,3,10,3,46,30,6,6,236,116
870,25,5,2,11,2,-44,20,2,6,192,136
870,26,3,3,9,4,36,31,8,7,228,167
870,27,3,3,8,5,-65,32,3,9,163,199
870,28,5,3,10,3,55,30,8,9,218,229
870,29,2,5,3,10,21,-45,9,4,239,184
870,30,3,3,6,7,-67,34,2,8,172,218
870,31,3,4,6,7,33,-57,5,1,205,161
870,32,3,4,8,5,-65,41,0,2,140,202
870,33,5,3,6,7,51,34,1,6,191,236
870,34,4,3,5,8,41,-65,2,1,232,171
870,35,4,2,10,3,46,21,8,2,278,192
870,36,4,2,4,9,40,27,8,9,318,219
870,37,3,3,5,8,-68,-65,0,4,250,154
870,38,3,3,7,6,34,33,4,7,284,187
870,39,5,2,8,5,53,-77,7,0,337,110
870,40,2,5,4,9,22,54,9,4,359,164
870,41,3,4,4,9,-69,45,0,9,290,209
870,42,4,2,9,4,45,-78,5,1,335,131
870,43,2,5,3,10,21,55,6,6,356,186
870,44,3,4,7,6,-66,42,0,8,290,228
870,45,5,2,10,3,55,21,5,9,345,249
870,46,5,2,9,4,54,-78,9,1,399,171
870,47,3,4,4,9,-69,45,0,6,330,216
870,48,3,4,5,8,32,-56,2,0,362,160
870,49,4,3,8,5,44,32,6,2,406,192
870,50,4,2,9,4,-55,22,1,4,351,214
870,51,4,2,5,8,41,-74,2,0,392,140
870,52,4,3,7,6,43,33,5,3,435,173
870,53,5,2,9,4,54,22,9,5,489,195
870,54,4,3,5,8,-59,-65,0,0,430,130
870,55,3,3,8,5,35,32,5,2,465,162
870,56,2,4,5,8,23,44,8,6,488,206
870,57,2,6,5,8,-77,62,1,8,411,268
870,58,2,5,4,9,22,-46,3,2,433,222
870,59,2,4,5,8,23,44,6,6,456,266
870,60,4,2,8,5,-56,23,0,9,400,289
870,61,3,3,7,6,34,-67,4,2,434,222
870,62,3,3,7,6,34,33,8,5,468,255
870,63,4,3,7,6,-57,33,1,8,411,288
870,64,3,3,6,7,33,-66,4,2,444,222
870,65,3,4,5,8,32,44,6,6,476,266
870,66,4,3,9,4,-55,31,1,7,421,297
870,67,3,3,7,6,34,-67,5,0,455,230
870,68,3,3,5,8,32,35,7,5,487,265
870,69,2,5,2,11,20,-44,7,1,507,221
871,1,2,5,5,8,23,53,3,3,23,53
871,2,5,2,8,5,53,23,6,6,76,76
871,3,3,3,7,6,-66,33,0,9,10,109
871,4,3,4,8,5,35,-59,5,0,45,50
871,5,3,3,4,9,31,36,6,6,76,86
871,6,4,4,8,5,-56,41,0,7,20,127
871,7,2,5,3,10,21,-45,1,2,41,82
871,8,3,4,4,9,31,45,2,7,72,127
871,9,4,3,8,5,44,32,6,9,116,159
871,10,4,3,8,5,-56,-68,0,1,60,91
871,11,3,3,6,7,33,34,3,5,93,125
871,12,3,3,6,7,33,34,6,9,126,159
871,13,3,3,8,5,-65,-68,1,1,61,91
871,14,2,4,6,7,24,43,5,4,85,134
871,15,3,4,7,6,34,42,9,6,119,176
871,16,4,2,7,6,-57,-76,2,0,62,100
871,17,4,3,7,6,43,33,5,3,105,133
871,18,4,3,8,5,44,32,9,5,149,165
871,19,4,3,9,4,-55,31,4,6,94,196
871,20,3,3,10,3,-63,30,1,6,31,226
871,21,4,2,9,4,45,22,6,8,76,248
871,22,4,3,7,6,43,-67,9,1,119,181
871,23,5,2,10,3,-45,21,4,2,74,202
871,24,4,2,6,7,42,25,6,7,116,227
871,25,3,3,9,4,-64,31,2,8,52,258
871,26,5,2,10,3,55,21,7,9,107,279
871,27,4,3,6,7,42,-66,9,3,149,213
871,28,2,4,7,6,-75,42,4,5,74,255
871,29,4,3,8,5,44,32,8,7,118,287
871,30,4,2,8,5,-56,-77,2,0,62,210
871,31,2,6,5,8,23,62,5,2,85,272
871,32,4,3,7,6,43,33,8,5,128,305
871,33,3,3,6,7,-67,34,1,9,61,339
871,34,2,4,4,9,22,-55,3,4,83,284
871,35,3,3,10,3,-63,30,0,4,20,314
871,36,3,3,8,5,35,32,5,6,55,346
871,37,2,4,6,7,24,43,9,9,79,389
871,38,4,3,9,4,-55,-69,4,0,24,320
871,39,3,3,7,6,34,33,8,3,58,353
871,40,5,2,8,5,-47,23,1,6,11,376
871,41,4,2,8,5,44,23,5,9,55,399
871,42,3,4,4,9,31,-55,6,4,86,344
871,43,3,3,8,5,-65,32,1,6,21,376
871,44,4,3,6,7,42,-66,3,0,63,310
871,45,2,4,4,9,22,45,5,5,85,355
871,46,3,3,8,5,-65,32,0,7,20,387
871,47,6,2,10,3,64,21,4,8,84,408
871,48,5,2,8,5,53,-77,7,1,137,331
871,49,4,2,6,7,42,25,9,6,179,356
871,50,5,2,7,6,-48,-76,1,0,131,280
871,51,3,4,5,8,32,44,3,4,163,324
871,52,2,5,6,7,24,52,7,6,187,376
871,53,2,4,6,7,-76,43,1,9,111,419
871,54,3,4,6,7,33,-57,4,2,144,362
871,55,5,2,8,5,53,23,7,5,197,385
871,56,5,2,9,4,-46,22,1,7,151,407
871,57,3,3,7,6,34,-67,5,0,185,340
871,58,2,5,7,6,-75,51,0,1,110,391
871,59,2,4,5,8,23,44,3,5,133,435
871,60,3,3,6,7,33,34,6,9,166,469
871,61,2,5,6,7,-76,-48,0,1,90,421
871,62,4,2,7,6,43,24,3,5,133,445
871,63,4,2,11,2,-53,20,0,5,80,465
871,64,3,3,9,4,36,31,6,6,116,496
871,65,3,3,7,6,-66,33,0,9,50,529
872,1,3,4,9,4,36,40,6,0,36,40
872,2,3,3,4,9,31,36,7,6,67,76
872,3,3,4,5,8,32,-56,9,0,99,20
872,4,2,5,3,10,-79,55,0,5,20,75
872,5,2,4,5,8,23,44,3,9,43,119
872,6,5,2,8,5,53,-77,6,2,96,42
872,7,2,4,4,9,22,45,8,7,118,87
872,8,4,3,9,4,-55,31,3,8,63,118
872,9,3,3,8,5,35,-68,8,0,98,50
872,10,3,3,9,4,-64,31,4,1,34,81
872,11,4,3,6,7,42,34,6,5,76,115
872,12,4,3,9,4,-55,31,1,6,21,146
872,13,5,2,8,5,53,23,4,9,74,169
872,14,4,3,9,4,45,-69,9,0,119,100
872,15,5,2,9,4,-46,22,3,2,73,122
872,16,4,3,6,7,42,34,5,6,115,156
872,17,2,5,3,10,21,-45,6,1,136,111
872,18,3,4,4,9,31,45,7,6,167,156
872,19,4,3,10,3,-54,30,3,6,113,186
872,20,6,2,10,3,64,21,7,7,177,207
872,21,4,2,7,6,-57,-76,0,1,120,131
872,22,2,4,4,9,22,45,2,6,142,176
872,23,2,5,4,9,22,-46,4,0,164,130
872,24,5,2,8,5,53,23,7,3,217,153
872,25,2,4,4,9,22,45,9,8,239,198
872,26,5,2,10,3,-45,21,4,9,194,219
872,27,3,3,5,8,32,-65,6,4,226,154
872,28,3,3,5,8,32,35,8,9,258,189
872,29,3,4,7,6,-66,-58,2,1,192,131
872,30,2,4,4,9,22,45,4,6,214,176
872,31,4,3,6,7,42,-66,6,0,256,110
872,32,3,4,5,8,32,44,8,4,288,154
872,33,4,3,8,5,-56,32,2,6,232,186
872,34,4,2,10,3,46,21,8,7,278,207
872,35,4,2,8,5,-56,-77,2,0,222,130
872,36,4,3,6,7,42,34,4,4,264,164
872,37,3,3,8,5,35,32,9,6,299,196
872,38,3,3,7,6,-66,33,3,9,233,229
872,39,3,3,8,5,35,-68,8,1,268,161
872,40,2,5,6,7,-76,52,2,3,192,213
872,41,3,3,7,6,34,33,6,6,226,246
872,42,3,4,7,6,-66,42,0,8,160,288
872,43,3,3,4,9,31,-64,1,4,191,224
872,44,3,4,6,7,33,43,4,7,224,267
872,45,2,4,3,10,21,-54,5,3,245,213
872,46,2,4,4,9,22,45,7,8,267,258
872,47,4,3,6,7,42,-66,9,2,309,192
872,48,3,4,6,7,-67,43,2,5,242,235
872,49,3,4,5,8,32,44,4,9,274,279
872,50,3,4,6,7,33,-57,7,2,307,222
872,51,6,2,9,4,-37,22,0,4,270,244
872,52,2,4,7,6,25,42,5,6,295,286
872,53,3,3,8,5,-65,32,0,8,230,318
872,54,5,2,8,5,53,-77,3,1,283,241
872,55,5,3,9,4,54,31,7,2,337,272
872,56,4,3,5,8,41,35,8,7,378,307
872,57,3,4,6,7,-67,-57,1,0,311,250
872,58,4,2,10,3,46,21,7,1,357,271
872,59,4,3,6,7,42,34,9,5,399,305
872,60,3,4,5,8,-68,44,1,9,331,349
872,61,3,4,8,5,35,-59,6,0,366,290
872,62,3,4,7,6,-66,42,0,2,300,332
872,63,3,3,9,4,36,31,6,3,336,363
872,64,5,2,9,4,-46,22,0,5,290,385
872,65,3,3,6,7,33,34,3,9,323,419
872,66,2,4,5,8,23,-56,6,3,346,363
872,67,5,2,8,5,53,23,9,6,399,386
872,68,4,2,6,7,-58,-75,1,1,341,311
872,69,3,3,8,5,35,32,6,3,376,343
872,70,5,2,8,5,53,23,9,6,429,366
872,71,3,4,6,7,-67,43,2,9,362,409
872,72,3,3,7,6,34,-67,6,2,396,342
872,73,2,5,4,9,22,54,8,6,418,396
872,74,3,3,4,9,31,-64,9,2,449,332
872,75,3,3,6,7,-67,34,2,6,382,366
872,76,2,5,4,9,22,-46,4,0,404,320
872,77,2,5,3,10,21,55,5,5,425,375
872,78,4,3,9,4,-55,31,0,6,370,406
872,79,2,4,4,9,22,-55,2,1,392,351
872,80,5,2,7,6,52,24,4,5,444,375
872,81,3,3,4,9,31,-64,5,1,475,311
872,82,2,4,4,9,22,45,7,6,497,356
872,83,3,4,5,8,32,-56,9,0,529,300
873,1,3,3,8,5,35,32,5,2,35,32
873,2,4,3,7,6,43,33,8,5,78,65
873,3,4,2,7,6,-57,24,1,9,21,89
873,4,3,3,7,6,34,-67,5,2,55,22
873,5,2,4,5,8,23,44,8,6,78,66
873,6,2,5,4,9,-78,-46,0,0,0,20
873,7,2,4,5,8,23,44,3,4,23,64
873,8,3,4,4,9,31,45,4,9,54,109
873,9,3,4,4,9,31,-55,5,4,85,54
873,10,3,4,6,7,33,43,8,7,118,97
873,11,4,2,9,4,-55,22,3,9,63,119
873,12,2,5,3,10,21,-45,4,4,84,74
873,13,4,3,7,6,43,33,7,7,127,107
873,14,4,2,9,4,-55,22,2,9,72,129
873,15,3,3,7,6,34,-67,6,2,106,62
873,16,2,4,3,10,21,46,7,8,127,108
873,17,5,2,10,3,-45,21,2,9,82,129
873,18,4,2,6,7,42,-75,4,4,124,54
873,19,4,2,9,4,45,22,9,6,169,76
873,20,4,3,7,6,-57,33,2,9,112,109
873,21,4,4,7,6,43,-58,5,1,155,51
873,22,3,4,5,8,32,44,7,5,187,95
873,23,4,3,8,5,-56,32,1,7,131,127
873,24,4,2,9,4,45,22,6,9,176,149
873,25,3,4,6,7,33,-57,9,2,209,92
873,26,3,4,5,8,-68,44,1,6,141,136
873,27,4,2,7,6,43,-76,4,0,184,60
873,28,2,5,3,10,21,55,5,5,205,115
873,29,3,3,6,7,33,34,8,9,238,149
873,30,2,5,3,10,21,-45,9,4,259,104
873,31,2,4,3,10,-79,-54,0,0,180,50
873,32,5,2,9,4,54,22,4,2,234,72
873,33,4,3,7,6,43,33,7,5,277,105
873,34,3,3,8,5,-65,32,2,7,212,137
873,35,4,2,8,5,44,-77,6,0,256,60
873,36,3,3,8,5,-65,32,1,2,191,92
873,37,5,2,11,2,56,20,7,2,247,112
873,38,4,3,7,6,-57,33,0,5,190,145
873,39,3,3,7,6,34,33,4,8,224,178
873,40,3,4,5,8,32,-56,6,2,256,122
873,41,3,3,5,8,32,35,8,7,288,157
873,42,3,3,5,8,-68,-65,0,2,220,92
873,43,3,3,6,7,33,34,3,6,253,126
873,44,4,2,5,8,41,-74,4,2,294,52
873,45,4,3,6,7,42,34,6,6,336,86
873,46,5,2,8,5,53,23,9,9,389,109
873,47,3,3,6,7,-67,-66,2,3,322,43
873,48,3,4,4,9,31,45,3,8,353,88
873,49,3,3,7,6,34,-67,7,1,387,21
873,50,2,5,2,11,20,56,7,7,407,77
873,51,3,3,6,7,-67,-66,0,1,340,11
873,52,2,4,3,10,21,46,1,7,361,57
873,53,5,2,7,6,52,-76,3,1,413,-19
873,54,2,4,4,9,22,45,5,6,435,26
873,55,4,2,9,4,-55,22,0,8,380,48
873,56,4,2,9,4,45,-78,5,0,425,-30
873,57,3,3,8,5,-65,32,0,2,360,2
873,58,2,5,8,5,26,50,6,2,386,52
873,59,3,4,5,8,32,44,8,6,418,96
873,60,5,3,7,6,-48,33,0,9,370,129
873,61,4,2,7,6,43,-76,3,3,413,53
873,62,4,2,10,3,46,21,9,4,459,74
873,63,3,4,5,8,-68,44,1,8,391,118
873,64,4,3,7,6,43,-67,4,1,434,51
873,65,4,2,11,2,-53,20,1,1,381,71
873,66,2,5,3,10,21,55,2,6,402,126
873,67,2,4,7,6,25,42,7,8,427,168
873,68,3,3,9,4,-64,31,3,9,363,199
873,69,4,2,9,4,45,-78,8,1,408,121
873,70,4,3,9,4,-55,31,3,2,353,152
873,71,4,2,9,4,45,22,8,4,398,174
873,72,4,3,7,6,-57,33,1,7,341,207
873,73,3,4,4,9,31,-55,2,2,372,152
873,74,4,3,5,8,41,35,3,7,413,187
873,75,3,3,7,6,34,-67,7,0,447,120
873,76,4,2,7,6,-57,24,0,4,390,144
873,77,3,4,6,7,33,43,3,7,423,187
873,78,4,3,6,7,42,-66,5,1,465,121
873,79,3,3,7,6,34,33,9,4,499,154
873,80,2,4,6,7,-76,43,3,7,423,197
873,81,5,2,9,4,54,22,7,9,477,219
873,82,4,3,6,7,42,-66,9,3,519,153
874,1,3,3,5,8,32,35,2,5,32,35
874,2,4,3,9,4,45,31,7,6,77,66
874,3,4,2,6,7,42,-75,9,1,119,-9
874,4,5,3,6,7,-49,34,0,5,70,25
874,5,2,4,4,9,22,-55,2,0,92,-30
874,6,2,5,5,8,23,53,5,3,115,23
874,7,3,5,5,8,32,53,7,6,147,76
874,8,4,2,8,5,-56,23,1,9,91,99
874,9,4,3,5,8,41,-65,2,4,132,34
874,10,3,3,6,7,33,34,5,8,165,68
874,11,2,5,4,9,22,-46,7,2,187,22
874,12,3,3,7,6,-66,33,1,5,121,55
874,13,4,3,6,7,42,34,3,9,163,89
874,14,3,4,4,9,31,-55,4,4,194,34
874,15,2,5,5,8,23,53,7,7,217,87
874,16,2,5,6,7,-76,52,1,9,141,139
874,17,3,4,5,8,32,-56,3,3,173,83
874,18,4,3,6,7,42,34,5,7,215,117
874,19,3,3,7,6,34,-67,9,0,249,50
874,20,3,3,9,4,-64,31,5,1,185,81
874,21,3,3,4,9,31,36,6,7,216,117
874,22,5,2,10,3,-45,21,1,8,171,138
874,23,5,2,9,4,54,-78,5,0,225,60
874,24,4,4,4,9,40,45,5,5,265,105
874,25,3,4,4,9,31,-55,6,0,296,50
874,26,3,3,5,8,32,35,8,5,328,85
874,27,4,2,9,4,-55,22,3,7,273,107
874,28,4,3,9,4,45,31,8,8,318,138
874,29,2,4,8,5,-74,41,4,9,244,179
874,30,3,3,7,6,34,-67,8,2,278,112
874,31,3,3,7,6,-66,33,2,5,212,145
874,32,2,5,3,10,21,-45,3,0,233,100
874,33,5,2,9,4,54,22,7,2,287,122
874,34,4,3,8,5,-56,32,1,4,231,154
874,35,2,5,3,10,21,55,2,9,252,209
874,36,4,3,6,7,42,-66,4,3,294,143
874,37,4,3,6,7,42,34,6,7,336,177
874,38,5,2,8,5,53,-77,9,0,389,100
874,39,2,4,4,9,-78,45,1,5,311,145
874,40,4,2,6,7,42,-75,3,0,353,70
874,41,4,3,9,4,45,31,8,1,398,101
874,42,3,4,4,9,31,45,9,6,429,146
874,43,4,3,8,5,-56,32,3,8,373,178
874,44,3,4,6,7,33,-57,6,1,406,121
874,45,2,5,4,9,22,54,8,5,428,175
874,46,4,3,10,3,-54,30,4,5,374,205
874,47,2,5,5,8,23,53,7,8,397,258
874,48,2,5,3,10,21,-45,8,3,418,213
874,49,4,2,7,6,-57,24,1,7,361,237
874,50,5,2,7,6,52,-76,3,1,413,161
874,51,2,4,4,9,22,45,5,6,435,206
874,52,3,3,4,9,31,-64,6,2,466,142
874,53,3,4,5,8,32,44,8,6,498,186
874,54,3,3,8,5,-65,32,3,8,433,218
874,55,4,3,6,7,42,-66,5,2,475,152
874,56,3,3,5,8,32,35,7,7,507,187
875,1,2,4,4,9,22,45,2,5,22,45
875,2,3,4,7,6,34,42,6,7,56,87
875,3,3,4,8,5,-65,41,1,8,-9,128
875,4,2,5,5,8,23,-47,4,1,14,81
875,5,2,4,6,7,24,43,8,4,38,124
875,6,5,2,8,5,-47,23,1,7,-9,147
875,7,4,3,6,7,42,-66,3,1,33,81
875,8,2,4,5,8,23,44,6,5,56,125
875,9,2,4,4,9,22,-55,8,0,78,70
875,10,4,2,10,3,-54,21,4,1,24,91
875,11,3,4,4,9,31,45,5,6,55,136
875,12,2,4,4,9,22,-55,7,1,77,81
875,13,4,3,8,5,-56,32,1,3,21,113
875,14,4,2,7,6,43,24,4,7,64,137
875,15,3,3,9,4,-64,31,0,8,0,168
875,16,2,4,6,7,24,-57,4,1,24,111
875,17,2,4,7,6,25,42,9,3,49,153
875,18,4,2,6,7,-58,25,1,8,-9,178
875,19,3,3,4,9,31,-64,2,4,22,114
875,20,4,3,6,7,42,34,4,8,64,148
875,21,2,4,5,8,23,-56,7,2,87,92
875,22,3,4,5,8,32,44,9,6,119,136
875,23,4,2,7,6,-57,-76,2,0,62,60
875,24,2,5,4,9,22,54,4,4,84,114
875,25,4,2,9,4,45,22,9,6,129,136
875,26,2,5,4,9,-78,-46,1,0,51,90
875,27,2,4,4,9,22,45,3,5,73,135
875,28,4,3,5,8,41,-65,4,0,114,70
875,29,2,5,4,9,22,54,6,4,136,124
875,30,4,3,9,4,-55,31,1,5,81,155
875,31,3,3,6,7,33,34,4,9,114,189
875,32,3,4,8,5,35,-59,9,0,149,130
875,33,3,3,5,8,-68,35,1,5,81,165
875,34,2,5,4,9,22,54,3,9,103,219
875,35,3,5,5,8,32,-47,5,2,135,172
875,36,3,4,8,5,-65,41,0,3,70,213
875,37,4,3,5,8,41,35,1,8,111,248
875,38,4,2,9,4,45,-78,6,0,156,170
875,39,3,5,7,6,-66,51,0,1,90,221
875,40,3,3,3,10,30,37,0,8,120,258
875,41,3,4,5,8,32,-56,2,2,152,202
875,42,2,5,6,7,24,52,6,4,176,254
875,43,4,2,10,3,-54,21,2,5,122,275
875,44,5,2,11,2,56,20,8,5,178,295
875,45,3,4,9,4,-64,40,4,5,114,335
875,46,4,3,10,3,-54,30,0,5,60,365
875,47,2,4,4,9,22,-55,2,0,82,310
875,48,4,3,8,5,44,32,6,2,126,342
875,49,2,4,3,10,21,46,7,8,147,388
875,50,4,2,9,4,-55,-78,2,0,92,310
875,51,4,3,7,6,43,33,5,3,135,343
875,52,4,2,8,5,44,23,9,6,179,366
875,53,4,2,7,6,-57,-76,2,0,122,290
875,54,3,3,7,6,34,33,6,3,156,323
875,55,4,2,9,4,-55,22,1,5,101,345
875,56,4,3,5,8,41,-65,2,0,142,280
875,57,4,3,7,6,43,33,5,3,185,313
875,58,4,3,7,6,43,33,8,6,228,346
875,59,4,3,5,8,41,-65,9,1,269,281
875,60,4,3,7,6,-57,33,2,4,212,314
875,61,4,2,7,6,43,24,5,8,255,338
875,62,4,2,8,5,44,-77,9,1,299,261
875,63,4,3,8,5,-56,32,3,3,243,293
875,64,2,6,5,8,23,62,6,5,266,355
875,65,2,4,5,8,23,44,9,9,289,399
875,66,4,3,7,6,-57,-67,2,2,232,332
875,67,2,4,9,4,27,40,9,2,259,372
875,68,3,3,6,7,-67,34,2,6,192,406
875,69,3,3,8,5,35,32,7,8,227,438
875,70,5,3,6,7,51,-66,8,2,278,372
875,71,3,3,10,3,-63,30,5,2,215,402
875,72,4,3,5,8,41,35,6,7,256,437
875,73,4,4,5,8,41,-56,7,1,297,381
875,74,2,5,6,7,-76,52,1,3,221,433
875,75,3,4,4,9,31,45,2,8,252,478
875,76,2,4,6,7,24,-57,6,1,276,421
875,77,5,2,7,6,52,24,8,5,328,445
875,78,2,5,2,11,20,-44,8,1,348,401
875,79,3,3,7,6,-66,33,2,4,282,434
875,80,4,2,10,3,46,21,8,5,328,455
875,81,3,4,8,5,-65,41,3,6,263,496
875,82,4,3,7,6,43,33,6,9,306,529
876,1,4,2,7,6,43,24,3,4,43,24
876,2,2,5,4,9,22,54,5,8,65,78
876,3,5,2,11,2,-44,20,1,8,21,98
876,4,3,3,7,6,34,-67,5,1,55,31
876,5,4,3,7,6,43,33,8,4,98,64
876,6,4,2,8,5,-56,23,2,7,42,87
876,7,4,4,8,5,44,41,6,8,86,128
876,8,3,4,5,8,32,-56,8,2,118,72
876,9,5,2,8,5,-47,23,1,5,71,95
876,10,4,4,4,9,40,-55,1,0,111,40
876,11,3,3,8,5,35,32,6,2,146,72
876,12,5,2,11,2,-44,20,2,2,102,92
876,13,3,4,6,7,33,43,5,5,135,135
876,14,2,4,6,7,24,43,9,8,159,178
876,15,4,3,8,5,-56,-68,3,0,103,110
876,16,5,2,10,3,55,21,8,1,158,131
876,17,3,4,7,6,-66,42,2,3,92,173
876,18,4,3,7,6,43,33,5,6,135,206
876,19,3,4,6,7,33,43,8,9,168,249
876,20,4,2,6,7,-58,-75,0,4,110,174
876,21,3,3,6,7,33,34,3,8,143,208
876,22,2,6,4,9,22,-37,5,1,165,171
876,23,4,2,8,5,44,23,9,4,209,194
876,24,5,2,10,3,-45,21,4,5,164,215
876,25,5,2,10,3,55,21,9,6,219,236
876,26,4,3,7,6,-57,33,2,9,162,269
876,27,4,3,7,6,43,-67,5,2,205,202
876,28,2,5,7,6,-75,51,0,3,130,253
876,29,2,5,4,9,22,54,2,7,152,307
876,30,4,2,7,6,43,-76,5,1,195,231
876,31,3,4,5,8,32,44,7,5,227,275
876,32,2,4,4,9,22,-55,9,0,249,220
876,33,3,3,7,6,-66,33,3,3,183,253
876,34,4,2,7,6,43,24,6,7,226,277
876,35,3,3,5,8,32,-65,8,2,258,212
876,36,3,3,6,7,-67,34,1,6,191,246
876,37,4,3,8,5,44,32,5,8,235,278
876,38,3,3,6,7,33,-66,8,2,268,212
876,39,3,4,4,9,31,45,9,7,299,257
876,40,2,4,3,10,-79,-54,0,3,220,203
876,41,3,3,8,5,35,32,5,5,255,235
876,42,2,4,3,10,21,-54,6,1,276,181
876,43,3,5,4,9,31,54,7,5,307,235
876,44,3,4,7,6,-66,42,1,7,241,277
876,45,3,3,7,6,34,-67,5,0,275,210
876,46,5,2,10,3,-45,21,0,1,230,231
876,47,4,3,8,5,44,32,4,3,274,263
876,48,4,3,8,5,44,32,8,5,318,295
876,49,3,5,4,9,31,54,9,9,349,349
876,50,3,3,9,4,-64,-69,5,0,285,280
876,51,6,2,10,3,64,21,9,1,349,301
876,52,2,4,3,10,-79,46,0,7,270,347
876,53,3,3,5,8,32,-65,2,2,302,282
876,54,4,3,8,5,44,32,6,4,346,314
876,55,5,2,8,5,53,23,9,7,399,337
876,56,4,2,8,5,-56,-77,3,0,343,260
876,57,3,4,5,8,32,44,5,4,375,304
876,58,2,4,5,8,23,44,8,8,398,348
876,59,3,3,6,7,-67,-66,1,2,331,282
876,60,4,3,5,8,41,35,2,7,372,317
876,61,4,3,9,4,45,31,7,8,417,348
876,62,2,4,5,8,-77,-56,0,2,340,292
876,63,4,3,8,5,44,32,4,4,384,324
876,64,4,3,6,7,42,34,6,8,426,358
876,65,5,2,9,4,-46,-78,0,0,380,280
876,66,3,4,7,6,34,42,4,2,414,322
876,67,3,4,6,7,33,43,7,5,447,365
876,68,2,4,4,9,22,-55,9,0,469,310
876,69,3,3,8,5,-65,32,4,2,404,342
876,70,4,3,9,4,45,31,9,3,449,373
876,71,4,3,5,8,-59,35,0,8,390,408
876,72,3,3,5,8,32,-65,2,3,422,343
876,73,4,3,7,6,43,33,5,6,465,376
876,74,4,2,7,6,43,-76,8,0,508,300
877,1,3,3,6,7,33,34,3,4,33,34
877,2,3,3,9,4,36,31,9,5,69,65
877,3,2,5,8,5,-74,50,5,5,-5,115
877,4,4,3,7,6,43,33,8,8,38,148
877,5,2,4,5,8,-77,-56,1,2,-39,92
877,6,2,4,6,7,24,43,5,5,-15,135
877,7,5,2,8,5,53,23,8,8,38,158
877,8,4,3,6,7,-58,-66,0,2,-20,92
877,9,2,5,4,9,22,54,2,6,2,146
877,10,3,3,6,7,33,-66,5,0,35,80
877,11,3,3,6,7,33,34,8,4,68,114
877,12,3,3,6,7,-67,34,1,8,1,148
877,13,3,4,3,10,30,-54,1,4,31,94
877,14,2,4,5,8,23,44,4,8,54,138
877,15,4,2,10,3,-54,21,0,9,0,159
877,16,4,3,8,5,44,-68,4,1,44,91
877,17,2,4,4,9,22,45,6,6,66,136
877,18,2,6,2,11,20,-35,6,1,86,101
877,19,3,4,6,7,33,43,9,4,119,144
877,20,3,4,6,7,-67,43,2,7,52,187
877,21,3,3,5,8,32,-65,4,2,84,122
877,22,2,4,8,5,-74,41,0,3,10,163
877,23,3,4,6,7,33,43,3,6,43,206
877,24,4,2,6,7,42,-75,5,1,85,131
877,25,3,3,5,8,32,35,7,6,117,166
877,26,2,5,3,10,21,-45,8,1,138,121
877,27,2,4,2,11,20,47,8,8,158,168
877,28,2,4,6,7,-76,-57,2,1,82,111
877,29,3,4,8,5,35,41,7,2,117,152
877,30,3,3,5,8,32,35,9,7,149,187
877,31,5,2,10,3,-45,21,4,8,104,208
877,32,4,3,7,6,43,-67,7,1,147,141
877,33,4,2,10,3,-54,21,3,2,93,162
877,34,2,5,5,8,23,53,6,5,116,215
877,35,2,5,4,9,22,54,8,9,138,269
877,36,4,2,6,7,-58,-75,0,4,80,194
877,37,2,4,7,6,25,42,5,6,105,236
877,38,4,2,8,5,44,23,9,9,149,259
877,39,4,3,8,5,-56,-68,3,1,93,191
877,40,2,5,5,8,23,53,6,4,116,244
877,41,3,4,5,8,32,44,8,8,148,288
877,42,2,4,8,5,-74,41,4,9,74,329
877,43,2,6,2,11,20,-35,4,4,94,294
877,44,5,2,10,3,55,21,9,5,149,315
877,45,3,3,4,9,-69,-64,0,1,80,251
877,46,5,2,9,4,54,22,4,3,134,273
877,47,2,5,2,11,20,56,4,9,154,329
877,48,5,2,9,4,54,-78,8,1,208,251
877,49,4,3,8,5,-56,32,2,3,152,283
877,50,2,4,3,10,21,46,3,9,173,329
877,51,3,3,5,8,32,-65,5,4,205,264
877,52,3,3,9,4,-64,31,1,5,141,295
877,53,3,3,6,7,33,34,4,9,174,329
877,54,3,3,8,5,35,-68,9,1,209,261
877,55,4,2,8,5,-56,23,3,4,153,284
877,56,4,2,5,8,41,-74,4,0,194,210
877,57,4,3,7,6,43,33,7,3,237,243
877,58,4,3,8,5,-56,32,1,5,181,275
877,59,3,4,6,7,33,43,4,8,214,318
877,60,3,3,5,8,32,-65,6,3,246,253
877,61,2,4,4,9,22,45,8,8,268,298
877,62,3,4,7,6,-66,-58,2,0,202,240
877,63,2,5,3,10,21,55,3,5,223,295
877,64,5,3,9,4,54,31,7,6,277,326
877,65,4,3,10,3,-54,30,3,6,223,356
877,66,5,2,10,3,55,21,8,7,278,377
877,67,3,4,7,6,-66,42,2,9,212,419
877,68,3,3,7,6,34,-67,6,2,246,352
877,69,4,3,9,4,-55,31,1,3,191,383
877,70,4,2,9,4,45,22,6,5,236,405
877,71,3,4,8,5,-65,41,1,6,171,446
877,72,5,2,9,4,54,22,5,8,225,468
877,73,3,4,7,6,34,-58,9,0,259,410
877,74,4,3,9,4,-55,31,4,1,204,441
877,75,3,4,8,5,35,41,9,2,239,482
877,76,2,4,5,8,-77,44,2,6,162,526
878,1,4,2,7,6,43,24,3,4,43,24
878,2,3,3,7,6,34,33,7,7,77,57
878,3,4,3,7,6,-57,-67,0,0,20,-10
878,4,5,2,8,5,53,23,3,3,73,13
878,5,3,4,6,7,33,43,6,6,106,56
878,6,4,3,9,4,-55,31,1,7,51,87
878,7,2,4,4,9,22,-55,3,2,73,32
878,8,2,4,4,9,22,45,5,7,95,77
878,9,3,3,4,9,31,-64,6,3,126,13
878,10,4,2,5,8,41,26,7,9,167,39
878,11,3,3,7,6,-66,-67,1,2,101,-28
878,12,2,4,6,7,24,43,5,5,125,15
878,13,5,2,7,6,52,24,7,9,177,39
878,14,3,4,3,10,30,-54,7,5,207,-15
878,15,5,2,10,3,-45,21,2,6,162,6
878,16,3,3,6,7,33,-66,5,0,195,-60
878,17,3,3,8,5,-65,32,0,2,130,-28
878,18,3,3,6,7,33,34,3,6,163,6
878,19,4,2,9,4,45,22,8,8,208,28
878,20,3,4,8,5,-65,41,3,9,143,69
878,21,4,2,8,5,44,-77,7,2,187,-8
878,22,3,4,5,8,32,44,9,6,219,36
878,23,2,5,3,10,-79,-45,0,1,140,-9
878,24,5,2,9,4,54,22,4,3,194,13
878,25,3,3,9,4,-64,31,0,4,130,44
878,26,3,3,8,5,35,32,5,6,165,76
878,27,2,4,6,7,24,43,9,9,189,119
878,28,3,4,7,6,-66,-58,3,1,123,61
878,29,4,2,9,4,45,22,8,3,168,83
878,30,5,2,11,2,-44,20,4,3,124,103
878,31,3,5,7,6,34,51,8,4,158,154
878,32,3,4,8,5,-65,41,3,5,93,195
878,33,5,2,9,4,54,22,7,7,147,217
878,34,4,3,8,5,-56,32,1,9,91,249
878,35,4,3,8,5,44,-68,5,1,135,181
878,36,2,5,4,9,22,54,7,5,157,235
878,37,2,5,2,11,20,-44,7,1,177,191
878,38,6,2,11,2,-35,20,2,1,142,211
878,39,3,3,5,8,32,35,4,6,174,246
878,40,3,3,8,5,35,32,9,8,209,278
878,41,3,3,6,7,-67,-66,2,2,142,212
878,42,5,2,9,4,54,22,6,4,196,234
878,43,4,3,9,4,-55,31,1,5,141,265
878,44,4,2,9,4,45,22,6,7,186,287
878,45,3,4,8,5,-65,41,1,8,121,328
878,46,3,3,4,9,31,-64,2,4,152,264
878,47,4,3,7,6,43,33,5,7,195,297
878,48,4,3,8,5,44,32,9,9,239,329
878,49,2,6,2,11,20,-35,9,4,259,294
878,50,2,4,3,10,-79,-54,0,0,180,240
878,51,4,3,9,4,45,31,5,1,225,271
878,52,5,2,9,4,54,22,9,3,279,293
878,53,4,2,9,4,-55,22,4,5,224,315
878,54,3,3,6,7,33,34,7,9,257,349
878,55,2,4,5,8,-77,-56,0,3,180,293
878,56,2,4,5,8,23,44,3,7,203,337
878,57,2,4,5,8,23,-56,6,1,226,281
878,58,5,2,9,4,-46,22,0,3,180,303
878,59,3,3,7,6,34,33,4,6,214,336
878,60,4,4,8,5,44,41,8,7,258,377
878,61,2,5,6,7,-76,52,2,9,182,429
878,62,3,4,5,8,32,-56,4,3,214,373
878,63,4,3,7,6,43,33,7,6,257,406
878,64,2,4,3,10,21,-54,8,2,278,352
878,65,4,3,6,7,-58,34,0,6,220,386
878,66,3,3,6,7,33,-66,3,0,253,320
878,67,5,2,10,3,55,21,8,1,308,341
878,68,3,3,7,6,-66,33,2,4,242,374
878,69,2,5,4,9,22,54,4,8,264,428
878,70,3,4,8,5,35,41,9,9,299,469
878,71,2,5,6,7,-76,-48,3,1,223,421
878,72,6,2,10,3,64,21,7,2,287,442
878,73,2,5,4,9,22,54,9,6,309,496
878,74,5,2,8,5,-47,23,2,9,262,519
879,1,4,3,5,8,41,35,1,5,41,35
879,2,2,5,3,10,21,-45,2,0,62,-10
879,3,4,3,5,8,41,35,3,5,103,25
879,4,4,3,8,5,44,32,7,7,147,57
879,5,2,5,3,10,21,-45,8,2,168,12
879,6,3,4,5,8,-68,44,0,6,100,56
879,7,3,4,5,8,32,-56,2,0,132,0
879,8,2,4,5,8,23,44,5,4,155,44
879,9,4,3,6,7,42,34,7,8,197,78
879,10,3,4,6,7,-67,-57,0,1,130,21
879,11,3,3,8,5,35,32,5,3,165,53
879,12,3,4,3,10,30,46,5,9,195,99
879,13,2,5,6,7,24,-48,9,1,219,51
879,14,3,4,6,7,-67,43,2,4,152,94
879,15,5,2,8,5,53,23,5,7,205,117
879,16,4,2,11,2,-53,20,2,7,152,137
879,17,3,3,7,6,34,-67,6,0,186,70
879,18,3,3,6,7,33,34,9,4,219,104
879,19,3,3,6,7,-67,34,2,8,152,138
879,20,4,3,8,5,44,-68,6,0,196,70
879,21,3,5,5,8,32,53,8,3,228,123
879,22,4,2,9,4,-55,22,3,5,173,145
879,23,2,5,5,8,23,53,6,8,196,198
879,24,3,3,5,8,32,-65,8,3,228,133
879,25,2,5,6,7,-76,52,2,5,152,185
879,26,3,3,6,7,33,34,5,9,185,219
879,27,2,5,4,9,22,-46,7,3,207,173
879,28,4,2,8,5,-56,23,1,6,151,196
879,29,2,5,4,9,22,-46,3,0,173,150
879,30,3,3,3,10,30,37,3,7,203,187
879,31,3,3,9,4,36,31,9,8,239,218
879,32,3,4,5,8,-68,-56,1,2,171,162
879,33,3,3,6,7,33,34,4,6,204,196
879,34,4,3,9,4,45,31,9,7,249,227
879,35,4,2,7,6,-57,-76,2,1,192,151
879,36,3,3,6,7,33,34,5,5,225,185
879,37,3,3,4,9,31,-64,6,1,256,121
879,38,3,3,8,5,-65,32,1,3,191,153
879,39,2,4,4,9,22,45,3,8,213,198
879,40,4,2,7,6,43,-76,6,2,256,122
879,41,4,2,11,2,-53,20,3,2,203,142
879,42,3,4,6,7,33,43,6,5,236,185
879,43,3,3,8,5,-65,32,1,7,171,217
879,44,3,3,8,5,35,32,6,9,206,249
879,45,5,2,9,4,-46,-78,0,1,160,171
879,46,4,3,8,5,44,32,4,3,204,203
879,47,2,5,3,10,21,55,5,8,225,258
879,48,2,4,2,11,20,-53,5,5,245,205
879,49,2,4,5,8,23,44,8,9,268,249
879,50,2,4,2,11,20,-53,8,6,288,196
879,51,4,3,7,6,-57,33,1,9,231,229
879,52,5,2,8,5,53,-77,4,2,284,152
879,53,5,2,11,2,-44,20,0,2,240,172
879,54,3,3,7,6,34,33,4,5,274,205
879,55,3,3,6,7,33,34,7,9,307,239
879,56,3,3,8,5,-65,-68,2,1,242,171
879,57,4,2,10,3,46,21,8,2,288,192
879,58,3,3,6,7,-67,34,1,6,221,226
879,59,3,4,6,7,33,43,4,9,254,269
879,60,4,2,8,5,44,-77,8,2,298,192
879,61,3,3,5,8,-68,35,0,7,230,227
879,62,4,3,8,5,44,32,4,9,274,259
879,63,3,4,6,7,33,-57,7,2,307,202
879,64,3,3,8,5,-65,32,2,4,242,234
879,65,2,4,4,9,22,45,4,9,264,279
879,66,3,4,7,6,34,-58,8,1,298,221
879,67,4,3,6,7,-58,34,0,5,240,255
879,68,4,3,4,9,40,-64,0,1,280,191
879,69,3,3,8,5,35,32,5,3,315,223
879,70,3,3,6,7,33,34,8,7,348,257
879,71,3,4,8,5,-65,41,3,8,283,298
879,72,4,2,10,3,46,21,9,9,329,319
879,73,3,4,8,5,-65,-59,4,0,264,260
879,74,3,4,8,5,35,41,9,1,299,301
879,75,2,4,4,9,-78,45,1,6,221,346
879,76,2,4,5,8,23,-56,4,0,244,290
879,77,5,2,8,5,53,23,7,3,297,313
879,78,4,2,9,4,-55,22,2,5,242,335
879,79,2,6,2,11,20,-35,2,0,262,300
879,80,4,2,9,4,45,22,7,2,307,322
879,81,4,3,9,4,-55,31,2,3,252,353
879,82,3,3,6,7,33,34,5,7,285,387
879,83,5,2,10,3,-45,21,0,8,240,408
879,84,5,2,7,6,52,-76,2,2,292,332
879,85,5,3,8,5,53,32,5,4,345,364
879,86,3,3,8,5,-65,32,0,6,280,396
879,87,2,5,2,11,20,-44,0,2,300,352
879,88,5,2,7,6,52,24,2,6,352,376
879,89,3,4,7,6,34,42,6,8,386,418
879,90,3,3,4,9,31,-64,7,4,417,354
879,91,5,2,10,3,-45,21,2,5,372,375
879,92,3,3,7,6,34,33,6,8,406,408
879,93,3,4,5,8,32,-56,8,2,438,352
879,94,4,3,7,6,-57,33,1,5,381,385
879,95,4,2,7,6,43,24,4,9,424,409
879,96,3,3,7,6,34,-67,8,2,458,342
879,97,3,4,8,5,-65,41,3,3,393,383
879,98,3,3,8,5,35,32,8,5,428,415
879,99,4,3,7,6,-57,33,1,8,371,448
879,100,4,3,8,5,44,-68,5,0,415,380
879,101,3,3,6,7,33,34,8,4,448,414
879,102,3,4,7,6,-66,42,2,6,382,456
879,103,3,3,4,9,31,-64,3,2,413,392
879,104,3,4,6,7,33,43,6,5,446,435
879,105,4,4,7,6,43,42,9,7,489,477
879,106,2,5,5,8,-77,-47,2,0,412,430
879,107,4,2,7,6,43,24,5,4,455,454
879,108,5,2,10,3,-45,21,0,5,410,475
879,109,4,2,6,7,42,-75,2,0,452,400
879,110,3,3,6,7,33,34,5,4,485,434
879,111,5,2,8,5,53,23,8,7,538,457
880,1,2,5,5,8,23,53,3,3,23,53
880,2,2,5,4,9,22,54,5,7,45,107
880,3,4,4,7,6,43,42,8,9,88,149
880,4,5,2,7,6,-48,-76,0,3,40,73
880,5,4,3,7,6,43,33,3,6,83,106
880,6,3,4,6,7,33,43,6,9,116,149
880,7,3,3,5,8,32,-65,8,4,148,84
880,8,3,3,6,7,-67,34,1,8,81,118
880,9,4,3,9,4,45,31,6,9,126,149
880,10,4,3,7,6,43,-67,9,2,169,82
880,11,2,4,4,9,-78,45,1,7,91,127
880,12,3,3,8,5,35,32,6,9,126,159
880,13,4,3,6,7,42,-66,8,3,168,93
880,14,4,2,6,7,-58,25,0,8,110,118
880,15,4,3,6,7,42,-66,2,2,152,52
880,16,5,2,9,4,54,22,6,4,206,74
880,17,4,2,8,5,-56,23,0,7,150,97
880,18,3,4,3,10,30,-54,0,3,180,43
880,19,4,3,6,7,42,34,2,7,222,77
880,20,5,2,7,6,52,-76,4,1,274,1
880,21,3,3,7,6,34,33,8,4,308,34
880,22,5,2,9,4,-46,22,2,6,262,56
880,23,3,4,4,9,31,-55,3,1,293,1
880,24,4,2,9,4,45,22,8,3,338,23
880,25,4,3,8,5,-56,32,2,5,282,55
880,26,3,4,5,8,32,44,4,9,314,99
880,27,4,2,9,4,45,-78,9,1,359,21
880,28,2,4,6,7,-76,43,3,4,283,64
880,29,4,3,7,6,43,33,6,7,326,97
880,30,2,4,7,6,-75,42,1,9,251,139
880,31,4,2,9,4,45,-78,6,1,296,61
880,32,5,2,10,3,-45,21,1,2,251,82
880,33,5,2,7,6,52,24,3,6,303,106
880,34,3,4,6,7,33,43,6,9,336,149
880,35,2,5,4,9,22,-46,8,3,358,103
880,36,2,4,6,7,-76,43,2,6,282,146
880,37,4,3,7,6,43,33,5,9,325,179
880,38,4,3,6,7,42,-66,7,3,367,113
880,39,4,3,5,8,41,35,8,8,408,148
880,40,4,3,10,3,-54,30,4,8,354,178
880,41,4,3,8,5,44,-68,8,0,398,110
880,42,5,2,7,6,-48,24,0,4,350,134
880,43,3,4,8,5,35,41,5,5,385,175
880,44,3,3,7,6,34,33,9,8,419,208
880,45,4,3,8,5,-56,-68,3,0,363,140
880,46,2,5,4,9,22,54,5,4,385,194
880,47,6,2,10,3,64,21,9,5,449,215
880,48,4,3,8,5,-56,32,3,7,393,247
880,49,4,3,6,7,42,-66,5,1,435,181
880,50,3,4,5,8,32,44,7,5,467,225
880,51,5,3,8,5,-47,32,0,7,420,257
880,52,5,2,8,5,53,-77,3,0,473,180
880,53,5,2,9,4,54,22,7,2,527,202
881,1,2,5,3,10,21,55,1,5,21,55
881,2,4,3,7,6,43,33,4,8,64,88
881,3,5,2,9,4,54,-78,8,0,118,10
881,4,4,3,7,6,-57,33,1,3,61,43
881,5,2,6,4,9,22,63,3,6,83,106
881,6,3,3,7,6,34,33,7,9,117,139
881,7,3,3,8,5,-65,-68,2,1,52,71
881,8,4,3,7,6,43,33,5,4,95,104
881,9,3,3,6,7,33,34,8,8,128,138
881,10,3,3,8,5,-65,-68,3,0,63,70
881,11,3,3,5,8,32,35,5,5,95,105
881,12,4,3,7,6,43,33,8,8,138,138
881,13,3,3,5,8,-68,-65,0,3,70,73
881,14,4,2,10,3,46,21,6,4,116,94
881,15,4,3,9,4,-55,31,1,5,61,125
881,16,2,5,3,10,21,-45,2,0,82,80
881,17,3,4,5,8,32,44,4,4,114,124
881,18,3,4,4,9,31,45,5,9,145,169
881,19,4,2,7,6,43,-76,8,3,188,93
881,20,3,4,6,7,-67,43,1,6,121,136
881,21,3,3,7,6,34,33,5,9,155,169
881,22,3,3,8,5,-65,-68,0,1,90,101
881,23,4,2,7,6,43,24,3,5,133,125
881,24,3,4,8,5,35,41,8,6,168,166
881,25,3,3,6,7,-67,-66,1,0,101,100
881,26,3,3,6,7,33,34,4,4,134,134
881,27,3,3,7,6,34,33,8,7,168,167
881,28,4,3,6,7,-58,-66,0,1,110,101
881,29,5,2,8,5,53,23,3,4,163,124
881,30,4,3,9,4,45,31,8,5,208,155
881,31,4,2,6,7,-58,-75,0,0,150,80
881,32,3,4,7,6,34,42,4,2,184,122
881,33,4,3,8,5,44,32,8,4,228,154
881,34,2,5,3,10,21,55,9,9,249,209
881,35,2,4,6,7,-76,-57,3,2,173,152
881,36,2,5,3,10,21,55,4,7,194,207
881,37,4,2,10,3,-54,21,0,8,140,228
881,38,3,3,8,5,35,-68,5,0,175,160
881,39,2,4,7,6,-75,42,0,2,100,202
881,40,3,4,8,5,35,41,5,3,135,243
881,41,2,4,8,5,-74,41,1,4,61,284
881,42,4,3,7,6,43,33,4,7,104,317
881,43,3,4,5,8,32,-56,6,1,136,261
881,44,4,2,7,6,43,24,9,5,179,285
881,45,5,2,8,5,-47,23,2,8,132,308
881,46,3,4,5,8,32,-56,4,2,164,252
881,47,4,2,5,8,41,26,5,8,205,278
881,48,5,2,10,3,-45,21,0,9,160,299
881,49,5,3,7,6,52,-67,2,2,212,232
881,50,4,2,7,6,43,24,5,6,255,256
881,51,2,4,5,8,23,-56,8,0,278,200
881,52,3,3,8,5,-65,32,3,2,213,232
881,53,2,4,6,7,24,43,7,5,237,275
881,54,2,5,4,9,22,54,9,9,259,329
881,55,3,4,5,8,-68,-56,1,3,191,273
881,56,3,4,6,7,33,43,4,6,224,316
881,57,4,3,7,6,43,33,7,9,267,349
881,58,2,4,4,9,22,-55,9,4,289,294
881,59,5,2,9,4,-46,22,3,6,243,316
881,60,5,3,9,4,54,31,7,7,297,347
881,61,2,4,5,8,-77,-56,0,1,220,291
881,62,3,3,4,9,31,36,1,7,251,327
881,63,2,4,5,8,23,-56,4,1,274,271
881,64,4,2,8,5,44,23,8,4,318,294
881,65,3,4,4,9,31,45,9,9,349,339
881,66,2,4,4,9,-78,-55,1,4,271,284
881,67,2,4,4,9,22,45,3,9,293,329
881,68,2,4,5,8,23,-56,6,3,316,273
881,69,5,2,9,4,-46,22,0,5,270,295
881,70,4,2,8,5,44,23,4,8,314,318
881,71,4,2,6,7,42,-75,6,3,356,243
881,72,4,3,7,6,43,33,9,6,399,276
881,73,4,2,11,2,-53,20,6,6,346,296
881,74,3,5,5,8,32,53,8,9,378,349
881,75,2,4,3,10,21,-54,9,5,399,295
881,76,4,2,7,6,-57,24,2,9,342,319
881,77,4,4,8,5,44,-59,6,0,386,260
881,78,4,3,7,6,43,33,9,3,429,293
881,79,4,3,9,4,-55,31,4,4,374,324
881,80,2,4,6,7,24,43,8,7,398,367
881,81,2,4,3,10,21,-54,9,3,419,313
881,82,3,3,7,6,-66,33,3,6,353,346
881,83,4,3,8,5,44,32,7,8,397,378
881,84,4,2,5,8,41,-74,8,4,438,304
881,85,2,4,3,10,21,-54,9,0,459,250
881,86,4,2,9,4,-55,22,4,2,404,272
881,87,4,3,8,5,44,32,8,4,448,304
881,88,3,3,5,8,-68,35,0,9,380,339
881,89,3,4,5,8,32,-56,2,3,412,283
881,90,3,3,7,6,34,33,6,6,446,316
881,91,2,5,2,11,20,-44,6,2,466,272
881,92,2,5,6,7,-76,52,0,4,390,324
881,93,2,4,6,7,24,43,4,7,414,367
881,94,5,2,7,6,52,-76,6,1,466,291
881,95,3,3,5,8,32,35,8,6,498,326
881,96,2,4,5,8,-77,-56,1,0,421,270
881,97,4,2,9,4,45,22,6,2,466,292
881,98,2,5,3,10,21,55,7,7,487,347
881,99,3,4,4,9,31,-55,8,2,518,292
882,1,3,3,8,5,35,32,5,2,35,32
882,2,2,4,7,6,-75,42,0,4,-40,74
882,3,2,4,4,9,22,45,2,9,-18,119
882,4,4,2,6,7,42,-75,4,4,24,44
882,5,4,2,6,7,42,25,6,9,66,69
882,6,4,3,7,6,43,-67,9,2,109,2
882,7,3,4,5,8,-68,44,1,6,41,46
882,8,4,3,6,7,42,-66,3,0,83,-20
882,9,4,3,8,5,44,32,7,2,127,12
882,10,3,3,8,5,-65,32,2,4,62,44
882,11,3,4,6,7,33,43,5,7,95,87
882,12,3,4,8,5,-65,41,0,8,30,128
882,13,2,5,6,7,24,-48,4,0,54,80
882,14,4,2,8,5,44,23,8,3,98,103
882,15,3,3,7,6,-66,33,2,6,32,136
882,16,3,3,7,6,34,33,6,9,66,169
882,17,3,4,6,7,33,-57,9,2,99,112
882,18,2,5,4,9,-78,54,1,6,21,166
882,19,4,2,9,4,45,22,6,8,66,188
882,20,3,4,5,8,32,-56,8,2,98,132
882,21,4,2,5,8,41,26,9,8,139,158
882,22,3,4,5,8,-68,-56,1,2,71,102
882,23,3,3,7,6,34,33,5,5,105,135
882,24,5,2,7,6,52,24,7,9,157,159
882,25,3,3,6,7,-67,-66,0,3,90,93
882,26,3,3,5,8,32,35,2,8,122,128
882,27,3,4,4,9,31,-55,3,3,153,73
882,28,2,5,3,10,21,55,4,8,174,128
882,29,3,4,5,8,32,-56,6,2,206,72
882,30,4,2,7,6,43,24,9,6,249,96
882,31,3,4,5,8,-68,-56,1,0,181,40
882,32,3,4,7,6,34,42,5,2,215,82
882,33,4,2,8,5,44,23,9,5,259,105
882,34,4,2,6,7,-58,-75,1,0,201,30
882,35,3,4,5,8,32,44,3,4,233,74
882,36,4,3,9,4,45,31,8,5,278,105
882,37,3,4,5,8,-68,44,0,9,210,149
882,38,3,4,8,5,35,-59,5,0,245,90
882,39,4,3,7,6,43,33,8,3,288,123
882,40,3,3,8,5,-65,32,3,5,223,155
882,41,4,4,6,7,42,43,5,8,265,198
882,42,2,4,6,7,24,-57,9,1,289,141
882,43,3,3,5,8,-68,35,1,6,221,176
882,44,3,4,6,7,33,43,4,9,254,219
882,45,4,2,8,5,44,-77,8,2,298,142
882,46,3,3,5,8,-68,35,0,7,230,177
882,47,3,3,7,6,34,-67,4,0,264,110
882,48,4,2,7,6,43,24,7,4,307,134
882,49,2,4,4,9,22,45,9,9,329,179
882,50,3,3,8,5,-65,-68,4,1,264,111
882,51,4,2,11,2,-53,20,1,1,211,131
882,52,3,3,8,5,35,32,6,3,246,163
882,53,2,5,4,9,22,54,8,7,268,217
882,54,2,4,7,6,-75,42,3,9,193,259
882,55,2,4,4,9,22,-55,5,4,215,204
882,56,3,3,6,7,33,34,8,8,248,238
882,57,6,2,10,3,-36,21,2,9,212,259
882,58,2,4,6,7,24,-57,6,2,236,202
882,59,2,4,7,6,-75,42,1,4,161,244
882,60,3,4,8,5,35,41,6,5,196,285
882,61,3,4,3,10,30,-54,6,1,226,231
882,62,4,3,6,7,42,34,8,5,268,265
882,63,4,2,5,8,41,-74,9,1,309,191
882,64,3,4,6,7,-67,43,2,4,242,234
882,65,5,2,7,6,52,24,4,8,294,258
882,66,4,3,9,4,45,31,9,9,339,289
882,67,3,3,5,8,-68,-65,1,4,271,224
882,68,5,2,8,5,53,23,4,7,324,247
882,69,3,3,4,9,31,-64,5,3,355,183
882,70,2,4,7,6,-75,42,0,5,280,225
882,71,4,2,8,5,44,23,4,8,324,248
882,72,5,2,11,2,-44,20,0,8,280,268
882,73,4,3,9,4,45,31,5,9,325,299
882,74,4,3,10,3,-54,30,1,9,271,329
882,75,3,3,7,6,34,-67,5,2,305,262
882,76,5,2,10,3,-45,21,0,3,260,283
882,77,5,2,10,3,55,21,5,4,315,304
882,78,3,4,6,7,33,43,8,7,348,347
882,79,4,2,8,5,-56,-77,2,0,292,270
882,80,4,3,7,6,43,33,5,3,335,303
882,81,3,4,6,7,33,43,8,6,368,346
882,82,4,2,8,5,-56,23,2,9,312,369
882,83,3,4,7,6,34,-58,6,1,346,311
882,84,5,2,8,5,53,23,9,4,399,334
882,85,3,4,4,9,-69,45,0,9,330,379
882,86,3,4,5,8,32,-56,2,3,362,323
882,87,4,3,5,8,41,35,3,8,403,358
882,88,3,3,6,7,33,-66,6,2,436,292
882,89,4,2,7,6,43,24,9,6,479,316
882,90,6,2,9,4,-37,22,2,8,442,338
882,91,4,3,6,7,42,-66,4,2,484,272
882,92,4,2,6,7,42,25,6,7,526,297
883,1,5,2,10,3,55,21,5,1,55,21
883,2,4,2,9,4,-55,22,0,3,0,43
883,3,2,4,5,8,23,44,3,7,23,87
883,4,5,3,10,3,55,30,8,7,78,117
883,5,4,2,10,3,-54,21,4,8,24,138
883,6,3,4,5,8,32,-56,6,2,56,82
883,7,2,6,3,10,21,64,7,6,77,146
883,8,3,4,5,8,32,-56,9,0,109,90
883,9,3,3,6,7,-67,34,2,4,42,124
883,10,3,3,4,9,31,-64,3,0,73,60
883,11,3,4,7,6,34,42,7,2,107,102
883,12,2,4,6,7,-76,43,1,5,31,145
883,13,5,2,9,4,54,22,5,7,85,167
883,14,3,3,8,5,-65,32,0,9,20,199
883,15,4,2,7,6,43,-76,3,3,63,123
883,16,5,2,8,5,53,23,6,6,116,146
883,17,2,5,4,9,22,-46,8,0,138,100
883,18,4,3,8,5,-56,32,2,2,82,132
883,19,2,4,7,6,25,42,7,4,107,174
883,20,6,2,10,3,-36,21,1,5,71,195
883,21,2,4,4,9,22,-55,3,0,93,140
883,22,3,3,7,6,34,33,7,3,127,173
883,23,5,2,8,5,-47,23,0,6,80,196
883,24,2,4,5,8,23,-56,3,0,103,140
883,25,4,3,4,9,40,36,3,6,143,176
883,26,4,2,9,4,45,22,8,8,188,198
883,27,4,2,9,4,-55,-78,3,0,133,120
883,28,2,4,8,5,26,41,9,1,159,161
883,29,3,3,8,5,-65,32,4,3,94,193
883,30,5,2,9,4,54,22,8,5,148,215
883,31,3,4,6,7,-67,43,1,8,81,258
883,32,3,3,4,9,31,-64,2,4,112,194
883,33,4,2,6,7,42,25,4,9,154,219
883,34,5,2,10,3,55,-79,9,0,209,140
883,35,2,6,4,9,-78,63,1,3,131,203
883,36,3,4,6,7,33,43,4,6,164,246
883,37,3,4,5,8,32,-56,6,0,196,190
883,38,2,4,3,10,21,46,7,6,217,236
883,39,3,3,4,9,31,-64,8,2,248,172
883,40,3,3,6,7,-67,34,1,6,181,206
883,41,4,3,5,8,41,-65,2,1,222,141
883,42,4,3,8,5,44,32,6,3,266,173
883,43,4,2,7,6,43,24,9,7,309,197
883,44,3,4,5,8,-68,-56,1,1,241,141
883,45,5,2,9,4,54,22,5,3,295,163
883,46,4,3,8,5,44,32,9,5,339,195
883,47,4,2,9,4,-55,22,4,7,284,217
883,48,3,4,7,6,34,42,8,9,318,259
883,49,4,3,6,7,-58,-66,0,3,260,193
883,50,4,2,6,7,42,25,2,8,302,218
883,51,3,4,5,8,32,-56,4,2,334,162
883,52,3,4,6,7,33,43,7,5,367,205
883,53,3,3,8,5,-65,32,2,7,302,237
883,54,3,3,6,7,33,-66,5,1,335,171
883,55,4,4,7,6,43,42,8,3,378,213
883,56,2,4,2,11,20,-53,8,0,398,160
883,57,3,3,7,6,-66,33,2,3,332,193
883,58,4,2,7,6,43,24,5,7,375,217
883,59,2,5,4,9,22,-46,7,1,397,171
883,60,4,4,5,8,41,44,8,5,438,215
883,61,5,2,11,2,-44,20,4,5,394,235
883,62,5,2,6,7,51,-75,5,0,445,160
883,63,4,3,9,4,-55,31,0,1,390,191
883,64,3,3,6,7,33,34,3,5,423,225
883,65,3,4,7,6,34,42,7,7,457,267
883,66,3,4,6,7,-67,-57,0,0,390,210
883,67,4,3,7,6,43,33,3,3,433,243
883,68,4,2,9,4,45,22,8,5,478,265
883,69,3,3,8,5,-65,32,3,7,413,297
883,70,3,3,7,6,34,-67,7,0,447,230
883,71,4,3,8,5,-56,32,1,2,391,262
883,72,4,3,7,6,43,33,4,5,434,295
883,73,4,3,9,4,45,31,9,6,479,326
883,74,2,4,4,9,-78,-55,1,1,401,271
883,75,2,4,3,10,21,46,2,7,422,317
883,76,2,5,6,7,24,52,6,9,446,369
883,77,4,4,6,7,42,-57,8,2,488,312
883,78,4,3,6,7,-58,34,0,6,430,346
883,79,4,3,10,3,46,30,6,6,476,376
883,80,4,2,9,4,-55,22,1,8,421,398
883,81,3,3,8,5,35,-68,6,0,456,330
883,82,2,6,5,8,23,62,9,2,479,392
883,83,4,2,8,5,-56,23,3,5,423,415
883,84,4,3,8,5,44,32,7,7,467,447
883,85,3,4,4,9,31,-55,8,2,498,392
883,86,3,3,8,5,-65,32,3,4,433,424
883,87,4,3,8,5,44,32,7,6,477,456
883,88,4,2,9,4,-55,22,2,8,422,478
883,89,2,4,7,6,25,-58,7,0,447,420
883,90,5,2,9,4,-46,22,1,2,401,442
883,91,2,5,3,10,21,55,2,7,422,497
883,92,3,3,8,5,35,32,7,9,457,529
884,1,5,2,8,5,53,23,3,3,53,23
884,2,2,6,3,10,21,64,4,7,74,87
884,3,4,3,9,4,45,31,9,8,119,118
884,4,3,3,4,9,-69,-64,0,4,50,54
884,5,2,5,3,10,21,55,1,9,71,109
884,6,5,3,7,6,52,-67,3,2,123,42
884,7,3,4,6,7,33,43,6,5,156,85
884,8,4,2,8,5,-56,23,0,8,100,108
884,9,4,3,6,7,42,-66,2,2,142,42
884,10,5,3,9,4,54,31,6,3,196,73
884,11,3,4,5,8,32,44,8,7,228,117
884,12,4,2,9,4,-55,22,3,9,173,139
884,13,4,3,6,7,42,-66,5,3,215,73
884,14,5,2,11,2,-44,20,1,3,171,93
884,15,3,4,6,7,33,43,4,6,204,136
884,16,2,4,4,9,22,-55,6,1,226,81
884,17,3,4,6,7,33,43,9,4,259,124
884,18,4,2,9,4,-55,22,4,6,204,146
884,19,4,2,8,5,44,23,8,9,248,169
884,20,3,3,7,6,-66,-67,2,2,182,102
884,21,4,3,8,5,44,32,6,4,226,134
884,22,3,3,5,8,32,35,8,9,258,169
884,23,2,4,7,6,-75,-58,3,1,183,111
884,24,3,4,5,8,32,44,5,5,215,155
884,25,5,2,8,5,53,23,8,8,268,178
884,26,6,2,8,5,-38,-77,0,1,230,101
884,27,5,2,8,5,53,23,3,4,283,124
884,28,2,6,3,10,21,64,4,8,304,188
884,29,4,2,9,4,45,-78,9,0,349,110
884,30,4,2,7,6,-57,24,2,4,292,134
884,31,3,3,8,5,35,32,7,6,327,166
884,32,4,3,5,8,41,-65,8,1,368,101
884,33,4,2,10,3,-54,21,4,2,314,122
884,34,2,4,4,9,22,45,6,7,336,167
884,35,5,2,8,5,53,-77,9,0,389,90
884,36,3,4,5,8,-68,44,1,4,321,134
884,37,3,4,8,5,35,41,6,5,356,175
884,38,4,3,8,5,-56,32,0,7,300,207
884,39,3,4,7,6,34,42,4,9,334,249
884,40,3,3,5,8,32,-65,6,4,366,184
884,41,2,6,3,10,21,64,7,8,387,248
884,42,3,3,9,4,-64,31,3,9,323,279
884,43,4,3,6,7,42,-66,5,3,365,213
884,44,3,5,3,10,30,55,5,8,395,268
884,45,3,3,9,4,-64,31,1,9,331,299
884,46,5,2,10,3,55,-79,6,0,386,220
884,47,3,4,5,8,32,44,8,4,418,264
884,48,4,3,7,6,-57,33,1,7,361,297
884,49,2,4,3,10,21,-54,2,3,382,243
884,50,4,2,9,4,45,22,7,5,427,265
884,51,3,3,7,6,-66,33,1,8,361,298
884,52,5,2,9,4,54,-78,5,0,415,220
884,53,3,3,6,7,33,34,8,4,448,254
884,54,3,4,6,7,-67,43,1,7,381,297
884,55,3,3,8,5,35,32,6,9,416,329
884,56,5,2,11,2,-44,20,2,9,372,349
884,57,5,2,7,6,52,-76,4,3,424,273
884,58,4,2,9,4,45,22,9,5,469,295
884,59,5,2,10,3,-45,21,4,6,424,316
884,60,3,3,8,5,35,32,9,8,459,348
884,61,5,2,10,3,-45,21,4,9,414,369
884,62,4,2,8,5,44,-77,8,2,458,292
884,63,4,3,6,7,-58,34,0,6,400,326
884,64,4,3,6,7,42,-66,2,0,442,260
884,65,2,4,3,10,21,46,3,6,463,306
884,66,4,2,9,4,45,22,8,8,508,328
885,1,4,3,5,8,41,35,1,5,41,35
885,2,3,4,4,9,31,-55,2,0,72,-20
885,3,3,3,6,7,33,34,5,4,105,14
885,4,3,4,7,6,34,42,9,6,139,56
885,5,2,5,4,9,-78,-46,1,0,61,10
885,6,4,3,8,5,44,32,5,2,105,42
885,7,5,2,10,3,-45,21,0,3,60,63
885,8,3,3,7,6,34,33,4,6,94,96
885,9,4,2,8,5,44,23,8,9,138,119
885,10,2,6,4,9,-78,-37,0,2,60,82
885,11,3,3,8,5,35,32,5,4,95,114
885,12,4,3,7,6,43,33,8,7,138,147
885,13,3,3,7,6,-66,-67,2,0,72,80
885,14,4,2,10,3,46,21,8,1,118,101
885,15,4,2,8,5,-56,23,2,4,62,124
885,16,5,2,11,2,56,20,8,4,118,144
885,17,3,3,6,7,-67,34,1,8,51,178
885,18,3,3,3,10,30,-63,1,5,81,115
885,19,4,3,10,3,46,30,7,5,127,145
885,20,3,3,8,5,-65,32,2,7,62,177
885,21,3,4,7,6,34,42,6,9,96,219
885,22,4,3,6,7,42,-66,8,3,138,153
885,23,4,2,9,4,-55,22,3,5,83,175
885,24,5,3,10,3,55,30,8,5,138,205
885,25,3,4,6,7,-67,43,1,8,71,248
885,26,3,3,6,7,33,-66,4,2,104,182
885,27,2,4,6,7,24,43,8,5,128,225
885,28,4,2,8,5,-56,23,2,8,72,248
885,29,3,4,7,6,34,-58,6,0,106,190
885,30,3,4,5,8,32,44,8,4,138,234
885,31,4,2,8,5,-56,23,2,7,82,257
885,32,3,3,8,5,35,32,7,9,117,289
885,33,5,2,11,2,-44,20,3,9,73,309
885,34,2,4,2,11,20,-53,3,6,93,256
885,35,3,3,7,6,34,33,7,9,127,289
885,36,3,3,9,4,-64,-69,3,0,63,220
885,37,4,3,7,6,43,33,6,3,106,253
885,38,5,2,10,3,-45,21,1,4,61,274
885,39,3,4,7,6,34,42,5,6,95,316
885,40,5,2,10,3,-45,21,0,7,50,337
885,41,2,5,5,8,23,-47,3,0,73,290
885,42,4,4,8,5,44,41,7,1,117,331
885,43,3,4,8,5,-65,41,2,2,52,372
885,44,4,2,9,4,45,22,7,4,97,394
885,45,4,2,6,7,42,25,9,9,139,419
885,46,2,4,8,5,-74,-59,5,0,65,360
885,47,2,5,3,10,21,55,6,5,86,415
885,48,3,3,8,5,-65,32,1,7,21,447
885,49,2,4,7,6,25,42,6,9,46,489
885,50,4,3,6,7,42,-66,8,3,88,423
885,51,3,5,5,8,-68,53,0,6,20,476
885,52,5,2,10,3,55,21,5,7,75,497
885,53,5,2,7,6,52,-76,7,1,127,421
885,54,2,4,6,7,-76,43,1,4,51,464
885,55,4,2,5,8,41,-74,2,0,92,390
885,56,5,2,10,3,55,21,7,1,147,411
885,57,4,2,10,3,-54,21,3,2,93,432
885,58,3,3,8,5,35,32,8,4,128,464
885,59,5,2,9,4,-46,22,2,6,82,486
885,60,6,2,9,4,63,22,5,8,145,508
886,1,2,4,6,7,24,43,4,3,24,43
886,2,2,5,3,10,21,55,5,8,45,98
886,3,3,3,9,4,-64,31,1,9,-19,129
886,4,5,3,9,4,54,-69,5,0,35,60
886,5,3,3,6,7,33,34,8,4,68,94
886,6,4,3,10,3,-54,30,4,4,14,124
886,7,4,4,6,7,42,43,6,7,56,167
886,8,3,3,4,9,31,-64,7,3,87,103
886,9,3,4,4,9,31,45,8,8,118,148
886,10,2,4,4,9,-78,-55,0,3,40,93
886,11,3,3,5,8,32,35,2,8,72,128
886,12,4,3,9,4,45,31,7,9,117,159
886,13,3,4,6,7,-67,-57,0,2,50,102
886,14,3,3,5,8,32,35,2,7,82,137
886,15,3,3,5,8,32,-65,4,2,114,72
886,16,3,3,5,8,32,35,6,7,146,107
886,17,4,3,8,5,-56,32,0,9,90,139
886,18,3,3,7,6,34,-67,4,2,124,72
886,19,3,3,8,5,35,32,9,4,159,104
886,20,2,5,3,10,-79,55,0,9,80,159
886,21,2,4,4,9,22,-55,2,4,102,104
886,22,2,4,7,6,25,42,7,6,127,146
886,23,4,3,7,6,-57,33,0,9,70,179
886,24,4,3,5,8,41,-65,1,4,111,114
886,25,5,2,9,4,54,22,5,6,165,136
886,26,4,2,5,8,41,-74,6,2,206,62
886,27,3,4,6,7,33,43,9,5,239,105
886,28,4,3,8,5,-56,32,3,7,183,137
886,29,4,2,8,5,44,-77,7,0,227,60
886,30,4,3,6,7,42,34,9,4,269,94
886,31,3,4,7,6,-66,42,3,6,203,136
886,32,2,5,6,7,24,52,7,8,227,188
886,33,3,3,5,8,32,-65,9,3,259,123
886,34,3,4,5,8,-68,44,1,7,191,167
886,35,4,3,5,8,41,-65,2,2,232,102
886,36,2,4,7,6,25,42,7,4,257,144
886,37,5,2,9,4,-46,22,1,6,211,166
886,38,2,4,6,7,24,43,5,9,235,209
886,39,3,4,7,6,34,-58,9,1,269,151
886,40,3,3,5,8,-68,35,1,6,201,186
886,41,3,3,8,5,35,32,6,8,236,218
886,42,5,3,9,4,-46,31,0,9,190,249
886,43,4,2,5,8,41,-74,1,5,231,175
886,44,3,4,5,8,32,44,3,9,263,219
886,45,3,4,5,8,32,-56,5,3,295,163
886,46,2,5,4,9,22,54,7,7,317,217
886,47,6,2,10,3,-36,21,1,8,281,238
886,48,3,3,4,9,31,-64,2,4,312,174
886,49,2,5,4,9,22,54,4,8,334,228
886,50,4,3,7,6,43,-67,7,1,377,161
886,51,4,3,8,5,-56,32,1,3,321,193
886,52,2,4,6,7,24,43,5,6,345,236
886,53,4,2,9,4,-55,22,0,8,290,258
886,54,2,5,3,10,21,-45,1,3,311,213
886,55,5,3,9,4,54,31,5,4,365,244
886,56,5,3,8,5,53,32,8,6,418,276
886,57,3,4,6,7,-67,43,1,9,351,319
886,58,4,3,4,9,40,-64,1,5,391,255
886,59,3,5,7,6,34,51,5,6,425,306
886,60,3,3,6,7,33,-66,8,0,458,240
886,61,2,4,7,6,-75,42,3,2,383,282
886,62,2,5,4,9,22,54,5,6,405,336
886,63,2,4,6,7,24,43,9,9,429,379
886,64,4,2,8,5,-56,-77,3,2,373,302
886,65,2,4,7,6,25,42,8,4,398,344
886,66,5,3,8,5,-47,32,1,6,351,376
886,67,2,4,5,8,23,-56,4,0,374,320
886,68,3,4,8,5,35,41,9,1,409,361
886,69,2,4,5,8,-77,44,2,5,332,405
886,70,4,3,10,3,46,30,8,5,378,435
886,71,3,3,6,7,-67,34,1,9,311,469
886,72,5,3,10,3,55,30,6,9,366,499
886,73,4,2,8,5,-56,-77,0,2,310,422
886,74,2,4,6,7,24,43,4,5,334,465
886,75,2,4,5,8,23,44,7,9,357,509
887,1,3,4,3,10,30,46,0,6,30,46
887,2,2,4,7,6,25,42,5,8,55,88
887,3,3,4,6,7,33,-57,8,1,88,31
887,4,4,4,4,9,40,45,8,6,128,76
887,5,4,3,5,8,41,-65,9,1,169,11
887,6,2,4,4,9,-78,45,1,6,91,56
887,7,4,4,7,6,43,42,4,8,134,98
887,8,3,4,8,5,35,41,9,9,169,139
887,9,4,3,9,4,-55,-69,4,0,114,70
887,10,4,3,8,5,44,32,8,2,158,102
887,11,3,3,6,7,-67,34,1,6,91,136
887,12,3,4,5,8,32,-56,3,0,123,80
887,13,3,3,6,7,33,34,6,4,156,114
887,14,5,2,11,2,-44,20,2,4,112,134
887,15,3,3,6,7,33,34,5,8,145,168
887,16,2,4,6,7,24,-57,9,1,169,111
887,17,3,4,7,6,-66,42,3,3,103,153
887,18,3,3,5,8,32,35,5,8,135,188
887,19,4,3,9,4,-55,31,0,9,80,219
887,20,4,3,6,7,42,-66,2,3,122,153
887,21,2,4,2,11,20,-53,2,0,142,100
887,22,2,4,5,8,23,44,5,4,165,144
887,23,3,3,6,7,33,34,8,8,198,178
887,24,3,4,5,8,-68,-56,0,2,130,122
887,25,3,4,5,8,32,44,2,6,162,166
887,26,5,2,11,2,56,20,8,6,218,186
887,27,3,3,6,7,-67,-66,1,0,151,120
887,28,2,4,7,6,25,42,6,2,176,162
887,29,3,4,6,7,33,43,9,5,209,205
887,30,3,4,4,9,-69,-55,0,0,140,150
887,31,5,2,8,5,53,23,3,3,193,173
887,32,2,5,4,9,22,54,5,7,215,227
887,33,3,4,6,7,33,-57,8,0,248,170
887,34,3,3,5,8,-68,35,0,5,180,205
887,35,4,2,8,5,44,23,4,8,224,228
887,36,3,3,9,4,-64,31,0,9,160,259
887,37,4,2,6,7,42,-75,2,4,202,184
887,38,5,2,9,4,54,22,6,6,256,206
887,39,3,3,8,5,-65,32,1,8,191,238
887,40,4,2,5,8,41,-74,2,4,232,164
887,41,4,3,9,4,45,31,7,5,277,195
887,42,4,3,5,8,41,-65,8,0,318,130
887,43,6,2,9,4,-37,22,1,2,281,152
887,44,5,2,8,5,53,23,4,5,334,175
887,45,2,4,7,6,25,42,9,7,359,217
887,46,4,2,7,6,-57,-76,2,1,302,141
887,47,3,4,4,9,31,45,3,6,333,186
887,48,4,2,7,6,43,-76,6,0,376,110
887,49,4,3,6,7,42,34,8,4,418,144
887,50,3,4,3,10,30,-54,8,0,448,90
887,51,5,3,7,6,-48,33,0,3,400,123
887,52,3,3,6,7,33,34,3,7,433,157
887,53,2,4,3,10,21,-54,4,3,454,103
887,54,3,4,7,6,34,42,8,5,488,145
887,55,3,3,7,6,-66,33,2,8,422,178
887,56,2,5,3,10,21,-45,3,3,443,133
887,57,4,2,8,5,44,23,7,6,487,156
887,58,3,4,4,9,31,-55,8,1,518,101
888,1,5,2,7,6,52,24,2,4,52,24
888,2,3,3,7,6,34,33,6,7,86,57
888,3,5,2,10,3,-45,21,1,8,41,78
888,4,5,2,9,4,54,-78,5,0,95,0
888,5,5,2,9,4,54,22,9,2,149,22
888,6,5,2,10,3,-45,21,4,3,104,43
888,7,3,3,4,9,31,36,5,9,135,79
888,8,4,4,8,5,44,-59,9,0,179,20
888,9,3,4,5,8,-68,44,1,4,111,64
888,10,2,5,5,8,23,53,4,7,134,117
888,11,4,2,10,3,-54,21,0,8,80,138
888,12,3,4,4,9,31,-55,1,3,111,83
888,13,2,4,6,7,24,43,5,6,135,126
888,14,3,4,6,7,33,43,8,9,168,169
888,15,2,4,6,7,-76,-57,2,2,92,112
888,16,3,3,9,4,36,31,8,3,128,143
888,17,3,3,7,6,-66,33,2,6,62,176
888,18,3,3,6,7,33,-66,5,0,95,110
888,19,2,4,6,7,24,43,9,3,119,153
888,20,4,3,5,8,-59,35,0,8,60,188
888,21,4,3,7,6,43,-67,3,1,103,121
888,22,3,4,5,8,32,44,5,5,135,165
888,23,4,3,8,5,44,32,9,7,179,197
888,24,3,4,4,9,-69,-55,0,2,110,142
888,25,3,3,5,8,32,35,2,7,142,177
888,26,2,5,5,8,23,-47,5,0,165,130
888,27,4,3,9,4,-55,31,0,1,110,161
888,28,3,3,6,7,33,34,3,5,143,195
888,29,3,3,6,7,33,34,6,9,176,229
888,30,2,5,4,9,22,-46,8,3,198,183
888,31,3,4,3,10,30,46,8,9,228,229
888,32,3,3,7,6,-66,-67,2,2,162,162
888,33,4,3,6,7,42,34,4,6,204,196
888,34,3,3,8,5,35,32,9,8,239,228
888,35,4,3,6,7,-58,-66,1,2,181,162
888,36,5,2,8,5,53,23,4,5,234,185
888,37,4,2,7,6,43,24,7,9,277,209
888,38,3,4,5,8,32,-56,9,3,309,153
888,39,2,5,3,10,-79,55,0,8,230,208
888,40,4,3,9,4,45,31,5,9,275,239
888,41,2,4,7,6,-75,-58,0,1,200,181
888,42,3,4,5,8,32,44,2,5,232,225
888,43,4,3,6,7,42,34,4,9,274,259
888,44,5,2,9,4,54,-78,8,1,328,181
888,45,5,2,9,4,-46,22,2,3,282,203
888,46,2,5,3,10,21,55,3,8,303,258
888,47,4,3,7,6,43,-67,6,1,346,191
888,48,2,5,7,6,-75,51,1,2,271,242
888,49,3,4,5,8,32,44,3,6,303,286
888,50,4,4,7,6,43,42,6,8,346,328
888,51,5,2,10,3,-45,21,1,9,301,349
888,52,3,4,5,8,32,-56,3,3,333,293
888,53,5,2,8,5,53,23,6,6,386,316
888,54,3,4,5,8,32,-56,8,0,418,260
888,55,3,4,5,8,-68,44,0,4,350,304
888,56,2,5,2,11,20,-44,0,0,370,260
888,57,2,6,3,10,21,64,1,4,391,324
888,58,5,2,8,5,53,23,4,7,444,347
888,59,2,5,5,8,23,-47,7,0,467,300
888,60,5,2,11,2,-44,20,3,0,423,320
888,61,2,5,6,7,24,52,7,2,447,372
888,62,2,4,6,7,-76,43,1,5,371,415
888,63,2,5,5,8,23,53,4,8,394,468
888,64,2,6,3,10,21,-36,5,2,415,432
888,65,2,5,4,9,22,54,7,6,437,486
888,66,4,3,9,4,-55,31,2,7,382,517
889,1,5,2,9,4,54,22,4,2,54,22
889,2,2,4,6,7,24,43,8,5,78,65
889,3,3,3,9,4,-64,31,4,6,14,96
889,4,3,3,6,7,33,-66,7,0,47,30
889,5,4,4,8,5,-56,41,1,1,-9,71
889,6,3,3,8,5,35,32,6,3,26,103
889,7,4,2,9,4,-55,22,1,5,-29,125
889,8,4,2,11,2,47,20,8,5,18,145
889,9,3,4,6,7,-67,43,1,8,-49,188
889,10,3,3,4,9,31,-64,2,4,-18,124
889,11,4,2,10,3,46,21,8,5,28,145
889,12,4,2,9,4,-55,22,3,7,-27,167
889,13,4,3,4,9,40,-64,3,3,13,103
889,14,2,5,5,8,23,53,6,6,36,156
889,15,2,5,3,10,21,-45,7,1,57,111
889,16,4,3,6,7,42,34,9,5,99,145
889,17,4,2,9,4,-55,22,4,7,44,167
889,18,2,5,4,9,22,-46,6,1,66,121
889,19,2,5,4,9,22,54,8,5,88,175
889,20,4,2,9,4,-55,22,3,7,33,197
889,21,3,3,4,9,31,-64,4,3,64,133
889,22,2,6,2,11,20,65,4,8,84,198
889,23,3,3,8,5,35,-68,9,0,119,130
889,24,2,5,6,7,-76,52,3,2,43,182
889,25,5,2,8,5,53,23,6,5,96,205
889,26,3,4,3,10,30,-54,6,1,126,151
889,27,3,4,4,9,31,45,7,6,157,196
889,28,3,4,5,8,32,-56,9,0,189,140
889,29,4,3,7,6,-57,33,2,3,132,173
889,30,5,2,9,4,54,22,6,5,186,195
889,31,3,4,5,8,32,44,8,9,218,239
889,32,2,4,6,7,-76,-57,2,2,142,182
889,33,3,3,8,5,35,32,7,4,177,214
889,34,3,4,6,7,-67,43,0,7,110,257
889,35,3,4,4,9,31,-55,1,2,141,202
889,36,5,3,8,5,53,32,4,4,194,234
889,37,4,3,8,5,44,32,8,6,238,266
889,38,5,2,9,4,-46,22,2,8,192,288
889,39,3,4,7,6,34,-58,6,0,226,230
889,40,4,2,5,8,41,26,7,6,267,256
889,41,2,5,4,9,22,-46,9,0,289,210
889,42,3,3,9,4,-64,31,5,1,225,241
889,43,4,2,8,5,44,23,9,4,269,264
889,44,2,4,7,6,-75,42,4,6,194,306
889,45,4,2,8,5,44,23,8,9,238,329
889,46,5,2,8,5,-47,-77,1,2,191,252
889,47,3,4,7,6,34,42,5,4,225,294
889,48,3,3,4,9,31,-64,6,0,256,230
889,49,2,6,2,11,20,65,6,5,276,295
889,50,3,4,7,6,-66,42,0,7,210,337
889,51,5,2,9,4,54,22,4,9,264,359
889,52,2,5,5,8,23,-47,7,2,287,312
889,53,3,4,5,8,32,44,9,6,319,356
889,54,3,3,8,5,-65,32,4,8,254,388
889,55,2,4,4,9,22,-55,6,3,276,333
889,56,4,3,8,5,-56,32,0,5,220,365
889,57,4,4,5,8,41,44,1,9,261,409
889,58,3,4,6,7,33,-57,4,2,294,352
889,59,4,3,5,8,41,35,5,7,335,387
889,60,5,2,7,6,52,-76,7,1,387,311
889,61,2,4,7,6,-75,42,2,3,312,353
889,62,4,2,7,6,43,24,5,7,355,377
889,63,3,3,8,5,-65,32,0,9,290,409
889,64,5,2,9,4,54,-78,4,1,344,331
889,65,4,3,8,5,44,32,8,3,388,363
889,66,2,5,4,9,-78,54,0,7,310,417
889,67,3,4,8,5,35,41,5,8,345,458
889,68,3,3,7,6,34,-67,9,1,379,391
889,69,2,5,3,10,-79,55,0,6,300,446
889,70,3,4,8,5,35,41,5,7,335,487
889,71,2,5,6,7,24,52,9,9,359,539
890,1,6,2,10,3,64,21,4,1,64,21
890,2,2,4,5,8,23,44,7,5,87,65
890,3,3,3,8,5,-65,32,2,7,22,97
890,4,4,3,10,3,46,30,8,7,68,127
890,5,3,4,5,8,-68,-56,0,1,0,71
890,6,4,3,8,5,44,32,4,3,44,103
890,7,3,3,6,7,33,34,7,7,77,137
890,8,5,3,9,4,-46,31,1,8,31,168
890,9,4,3,6,7,42,-66,3,2,73,102
890,10,2,5,3,10,21,55,4,7,94,157
890,11,4,2,8,5,44,-77,8,0,138,80
890,12,4,3,6,7,-58,34,0,4,80,114
890,13,4,2,9,4,45,22,5,6,125,136
890,14,5,2,10,3,-45,21,0,7,80,157
890,15,3,4,6,7,33,-57,3,0,113,100
890,16,3,3,9,4,36,31,9,1,149,131
890,17,3,3,6,7,-67,34,2,5,82,165
890,18,4,2,8,5,44,23,6,8,126,188
890,19,2,4,4,9,22,-55,8,3,148,133
890,20,3,5,7,6,-66,51,2,4,82,184
890,21,4,2,7,6,43,24,5,8,125,208
890,22,2,4,5,8,23,-56,8,2,148,152
890,23,3,4,7,6,-66,42,2,4,82,194
890,24,4,3,8,5,44,32,6,6,126,226
890,25,4,3,6,7,42,-66,8,0,168,160
890,26,3,3,7,6,-66,33,2,3,102,193
890,27,3,3,6,7,33,34,5,7,135,227
890,28,3,4,5,8,32,-56,7,1,167,171
890,29,3,4,5,8,32,44,9,5,199,215
890,30,3,3,7,6,-66,33,3,8,133,248
890,31,5,3,9,4,54,31,7,9,187,279
890,32,4,4,8,5,-56,-59,1,0,131,220
890,33,4,3,6,7,42,34,3,4,173,254
890,34,4,3,8,5,44,32,7,6,217,286
890,35,4,3,6,7,42,-66,9,0,259,220
890,36,4,2,9,4,-55,22,4,2,204,242
890,37,3,3,7,6,34,33,8,5,238,275
890,38,2,5,4,9,-78,54,0,9,160,329
890,39,4,3,8,5,44,-68,4,1,204,261
890,40,3,3,5,8,32,35,6,6,236,296
890,41,4,3,6,7,42,-66,8,0,278,230
890,42,4,3,8,5,-56,32,2,2,222,262
890,43,2,5,4,9,22,54,4,6,244,316
890,44,3,4,6,7,33,43,7,9,277,359
890,45,2,5,5,8,-77,-47,0,2,200,312
890,46,3,4,9,4,36,40,6,2,236,352
890,47,3,3,8,5,-65,32,1,4,171,384
890,48,2,5,4,9,22,54,3,8,193,438
890,49,3,4,6,7,33,-57,6,1,226,381
890,50,2,5,4,9,22,54,8,5,248,435
890,51,4,3,7,6,-57,33,1,8,191,468
890,52,5,2,7,6,52,-76,3,2,243,392
890,53,4,3,8,5,44,32,7,4,287,424
890,54,4,2,9,4,-55,22,2,6,232,446
890,55,3,3,8,5,35,32,7,8,267,478
890,56,5,2,7,6,52,-76,9,2,319,402
890,57,4,2,8,5,-56,23,3,5,263,425
890,58,3,3,7,6,34,33,7,8,297,458
890,59,4,2,10,3,-54,21,3,9,243,479
890,60,5,2,9,4,54,-78,7,1,297,401
890,61,3,3,6,7,-67,34,0,5,230,435
890,62,2,5,5,8,23,53,3,8,253,488
890,63,3,3,6,7,33,-66,6,2,286,422
890,64,5,2,8,5,53,23,9,5,339,445
890,65,3,3,6,7,-67,34,2,9,272,479
890,66,2,5,5,8,23,-47,5,2,295,432
890,67,2,4,4,9,22,45,7,7,317,477
890,68,3,5,7,6,-66,51,1,8,251,528
891,1,2,5,3,10,21,55,1,5,21,55
891,2,3,4,7,6,34,42,5,7,55,97
891,3,4,3,9,4,-55,31,0,8,0,128
891,4,5,2,9,4,54,-78,4,0,54,50
891,5,5,2,7,6,52,24,6,4,106,74
891,6,4,3,7,6,43,33,9,7,149,107
891,7,4,2,9,4,-55,22,4,9,94,129
891,8,3,3,4,9,31,-64,5,5,125,65
891,9,3,4,4,9,31,-55,6,0,156,10
891,10,2,5,2,11,20,56,6,6,176,66
891,11,2,4,5,8,23,-56,9,0,199,10
891,12,4,2,10,3,-54,21,5,1,145,31
891,13,2,5,5,8,23,53,8,4,168,84
891,14,2,4,6,7,-76,43,2,7,92,127
891,15,4,3,8,5,44,32,6,9,136,159
891,16,4,3,7,6,43,-67,9,2,179,92
891,17,4,3,9,4,-55,31,4,3,124,123
891,18,4,2,11,2,-53,20,1,3,71,143
891,19,2,4,6,7,24,43,5,6,95,186
891,20,4,4,4,9,40,-55,5,1,135,131
891,21,4,3,6,7,42,34,7,5,177,165
891,22,3,4,6,7,-67,43,0,8,110,208
891,23,3,4,7,6,34,-58,4,0,144,150
891,24,4,3,8,5,44,32,8,2,188,182
891,25,4,3,9,4,-55,31,3,3,133,213
891,26,3,3,3,10,30,-63,3,0,163,150
891,27,2,6,4,9,22,63,5,3,185,213
891,28,4,3,6,7,42,34,7,7,227,247
891,29,4,2,6,7,42,-75,9,2,269,172
891,30,3,3,8,5,-65,32,4,4,204,204
891,31,4,3,9,4,45,31,9,5,249,235
891,32,3,4,6,7,-67,43,2,8,182,278
891,33,4,3,8,5,44,-68,6,0,226,210
891,34,3,3,9,4,-64,31,2,1,162,241
891,35,4,2,11,2,47,20,9,1,209,261
891,36,2,5,4,9,-78,54,1,5,131,315
891,37,3,4,6,7,33,43,4,8,164,358
891,38,3,4,5,8,32,-56,6,2,196,302
891,39,4,2,7,6,43,24,9,6,239,326
891,40,2,5,4,9,-78,-46,1,0,161,280
891,41,4,2,9,4,45,22,6,2,206,302
891,42,3,3,5,8,32,35,8,7,238,337
891,43,4,3,6,7,-58,-66,0,1,180,271
891,44,4,3,8,5,44,32,4,3,224,303
891,45,2,4,4,9,22,45,6,8,246,348
891,46,2,4,3,10,21,-54,7,4,267,294
891,47,3,4,7,6,-66,42,1,6,201,336
891,48,4,3,9,4,45,31,6,7,246,367
891,49,3,3,7,6,-66,-67,0,0,180,300
891,50,2,4,4,9,22,45,2,5,202,345
891,51,3,4,4,9,31,-55,3,0,233,290
891,52,3,4,5,8,32,44,5,4,265,334
891,53,3,4,6,7,33,43,8,7,298,377
891,54,4,3,7,6,-57,-67,1,0,241,310
891,55,3,4,6,7,33,43,4,3,274,353
891,56,2,4,7,6,25,42,9,5,299,395
891,57,4,3,7,6,-57,33,2,8,242,428
891,58,2,4,5,8,23,-56,5,2,265,372
891,59,2,5,4,9,22,54,7,6,287,426
891,60,3,5,4,9,31,-46,8,0,318,380
891,61,5,2,8,5,-47,23,1,3,271,403
891,62,3,3,4,9,31,36,2,9,302,439
891,63,4,2,5,8,41,-74,3,5,343,365
891,64,4,2,6,7,42,-75,5,0,385,290
891,65,5,2,7,6,52,24,7,4,437,314
891,66,3,4,6,7,-67,43,0,7,370,357
891,67,2,4,6,7,24,-57,4,0,394,300
891,68,3,4,7,6,34,42,8,2,428,342
891,69,4,3,8,5,-56,32,2,4,372,374
891,70,4,2,8,5,44,23,6,7,416,397
891,71,4,2,7,6,43,-76,9,1,459,321
891,72,5,2,9,4,-46,22,3,3,413,343
891,73,2,5,3,10,21,55,4,8,434,398
891,74,4,3,9,4,45,31,9,9,479,429
891,75,3,3,7,6,-66,-67,3,2,413,362
891,76,2,4,6,7,24,43,7,5,437,405
891,77,6,2,10,3,-36,21,1,6,401,426
891,78,3,4,5,8,32,-56,3,0,433,370
891,79,3,3,6,7,33,34,6,4,466,404
891,80,4,4,8,5,-56,41,0,5,410,445
891,81,4,4,7,6,43,42,3,7,453,487
891,82,2,4,3,10,21,-54,4,3,474,433
891,83,4,3,5,8,41,35,5,8,515,468
892,1,4,3,10,3,46,30,6,0,46,30
892,2,4,3,7,6,43,33,9,3,89,63
892,3,4,2,10,3,-54,21,5,4,35,84
892,4,2,4,4,9,22,45,7,9,57,129
892,5,5,2,10,3,-45,-79,2,0,12,50
892,6,3,3,5,8,32,35,4,5,44,85
892,7,3,4,8,5,35,41,9,6,79,126
892,8,2,4,4,9,-78,-55,1,1,1,71
892,9,4,2,8,5,44,23,5,4,45,94
892,10,3,4,5,8,32,44,7,8,77,138
892,11,4,2,6,7,42,-75,9,3,119,63
892,12,3,3,4,9,-69,36,0,9,50,99
892,13,3,4,7,6,34,-58,4,1,84,41
892,14,3,3,6,7,33,34,7,5,117,75
892,15,3,3,5,8,32,-65,9,0,149,10
892,16,5,2,11,2,-44,20,5,0,105,30
892,17,4,2,8,5,44,23,9,3,149,53
892,18,2,5,3,10,-79,55,0,8,70,108
892,19,4,3,6,7,42,-66,2,2,112,42
892,20,3,4,8,5,35,41,7,3,147,83
892,21,3,4,6,7,-67,43,0,6,80,126
892,22,3,3,8,5,35,32,5,8,115,158
892,23,4,2,10,3,-54,21,1,9,61,179
892,24,5,2,8,5,53,-77,4,2,114,102
892,25,4,3,8,5,44,32,8,4,158,134
892,26,3,4,3,10,30,-54,8,0,188,80
892,27,3,3,6,7,-67,34,1,4,121,114
892,28,3,4,3,10,30,-54,1,0,151,60
892,29,2,6,2,11,20,65,1,5,171,125
892,30,3,3,4,9,31,-64,2,1,202,61
892,31,2,5,3,10,21,55,3,6,223,116
892,32,3,4,4,9,31,-55,4,1,254,61
892,33,3,4,7,6,34,42,8,3,288,103
892,34,2,4,3,10,21,46,9,9,309,149
892,35,2,5,4,9,-78,-46,1,3,231,103
892,36,2,5,5,8,23,53,4,6,254,156
892,37,3,3,4,9,31,-64,5,2,285,92
892,38,2,5,6,7,24,52,9,4,309,144
892,39,4,3,9,4,-55,31,4,5,254,175
892,40,4,3,5,8,41,-65,5,0,295,110
892,41,3,3,10,3,-63,30,2,0,232,140
892,42,4,2,9,4,45,22,7,2,277,162
892,43,4,3,5,8,41,35,8,7,318,197
892,44,5,2,9,4,-46,22,2,9,272,219
892,45,4,3,7,6,43,-67,5,2,315,152
892,46,2,5,4,9,22,54,7,6,337,206
892,47,5,2,10,3,-45,21,2,7,292,227
892,48,5,2,8,5,53,-77,5,0,345,150
892,49,3,3,5,8,32,35,7,5,377,185
892,50,4,2,5,8,41,-74,8,1,418,111
892,51,2,4,2,11,20,47,8,8,438,158
892,52,3,4,5,8,-68,-56,0,2,370,102
892,53,2,4,6,7,24,43,4,5,394,145
892,54,4,3,9,4,45,31,9,6,439,176
892,55,2,4,4,9,-78,-55,1,1,361,121
892,56,2,4,3,10,21,46,2,7,382,167
892,57,5,2,8,5,53,-77,5,0,435,90
892,58,3,4,8,5,-65,41,0,1,370,131
892,59,4,3,8,5,44,32,4,3,414,163
892,60,4,2,7,6,43,24,7,7,457,187
892,61,3,3,7,6,-66,-67,1,0,391,120
892,62,4,3,8,5,44,32,5,2,435,152
892,63,4,3,6,7,42,34,7,6,477,186
892,64,4,3,8,5,-56,32,1,8,421,218
892,65,4,3,4,9,40,-64,1,4,461,154
892,66,3,3,8,5,35,32,6,6,496,186
892,67,5,2,8,5,53,23,9,9,549,209
893,1,2,4,6,7,24,43,4,3,24,43
893,2,2,4,4,9,22,45,6,8,46,88
893,3,2,4,7,6,-75,-58,1,0,-29,30
893,4,3,4,5,8,32,44,3,4,3,74
893,5,5,2,8,5,53,23,6,7,56,97
893,6,3,3,8,5,-65,32,1,9,-9,129
893,7,3,4,7,6,34,-58,5,1,25,71
893,8,4,3,6,7,42,34,7,5,67,105
893,9,3,3,8,5,-65,32,2,7,2,137
893,10,4,2,6,7,42,-75,4,2,44,62
893,11,4,3,8,5,44,32,8,4,88,94
893,12,3,3,3,10,30,-63,8,1,118,31
893,13,3,4,4,9,31,45,9,6,149,76
893,14,4,4,4,9,40,-55,9,1,189,21
893,15,3,4,6,7,-67,43,2,4,122,64
893,16,3,3,8,5,35,32,7,6,157,96
893,17,5,2,8,5,-47,23,0,9,110,119
893,18,4,4,7,6,43,-58,3,1,153,61
893,19,2,4,2,11,20,47,3,8,173,108
893,20,2,6,4,9,22,-37,5,1,195,71
893,21,4,4,7,6,43,42,8,3,238,113
893,22,3,4,8,5,-65,41,3,4,173,154
893,23,2,5,5,8,23,53,6,7,196,207
893,24,2,4,6,7,-76,-57,0,0,120,150
893,25,4,2,8,5,44,23,4,3,164,173
893,26,3,4,6,7,33,43,7,6,197,216
893,27,4,3,8,5,-56,32,1,8,141,248
893,28,2,4,2,11,20,-53,1,5,161,195
893,29,3,4,6,7,33,43,4,8,194,238
893,30,2,4,4,9,22,-55,6,3,216,183
893,31,3,3,6,7,33,34,9,7,249,217
893,32,3,3,6,7,-67,-66,2,1,182,151
893,33,3,3,6,7,33,34,5,5,215,185
893,34,5,2,9,4,54,22,9,7,269,207
893,35,4,3,4,9,40,-64,9,3,309,143
893,36,2,4,5,8,-77,44,2,7,232,187
893,37,2,5,5,8,23,-47,5,0,255,140
893,38,3,3,5,8,32,35,7,5,287,175
893,39,5,2,11,2,-44,20,3,5,243,195
893,40,2,5,5,8,23,53,6,8,266,248
893,41,4,3,8,5,-56,-68,0,0,210,180
893,42,4,3,6,7,42,34,2,4,252,214
893,43,3,3,5,8,32,35,4,9,284,249
893,44,2,5,4,9,22,-46,6,3,306,203
893,45,2,5,3,10,21,55,7,8,327,258
893,46,4,3,7,6,-57,-67,0,1,270,191
893,47,4,2,7,6,43,24,3,5,313,215
893,48,3,4,4,9,31,-55,4,0,344,160
893,49,4,4,6,7,42,43,6,3,386,203
893,50,3,4,5,8,32,44,8,7,418,247
893,51,6,2,9,4,-37,22,1,9,381,269
893,52,4,4,6,7,42,-57,3,2,423,212
893,53,4,2,10,3,46,21,9,3,469,233
893,54,3,3,3,10,30,-63,9,0,499,170
893,55,2,4,4,9,-78,45,1,5,421,215
893,56,4,3,10,3,46,30,7,5,467,245
893,57,2,5,6,7,-76,52,1,7,391,297
893,58,2,4,3,10,21,-54,2,3,412,243
893,59,3,3,6,7,33,34,5,7,445,277
893,60,2,5,7,6,-75,51,0,8,370,328
893,61,3,3,6,7,33,-66,3,2,403,262
893,62,4,2,7,6,43,24,6,6,446,286
893,63,2,4,2,11,20,-53,6,3,466,233
893,64,5,2,10,3,-45,21,1,4,421,254
893,65,3,3,4,9,31,-64,2,0,452,190
893,66,4,3,7,6,43,33,5,3,495,223
893,67,3,3,4,9,31,36,6,9,526,259
894,1,2,4,4,9,22,45,2,5,22,45
894,2,3,3,4,9,31,-64,3,1,53,-19
894,3,3,3,6,7,33,34,6,5,86,15
894,4,3,4,4,9,31,-55,7,0,117,-40
894,5,4,2,10,3,-54,21,3,1,63,-19
894,6,3,3,6,7,33,34,6,5,96,15
894,7,2,5,6,7,-76,52,0,7,20,67
894,8,3,3,6,7,33,-66,3,1,53,1
894,9,4,2,6,7,42,25,5,6,95,26
894,10,3,4,4,9,31,-55,6,1,126,-29
894,11,5,2,8,5,53,23,9,4,179,-6
894,12,3,4,6,7,-67,43,2,7,112,37
894,13,3,4,5,8,32,-56,4,1,144,-19
894,14,3,4,7,6,34,42,8,3,178,23
894,15,3,3,5,8,-68,35,0,8,110,58
894,16,3,3,7,6,34,-67,4,1,144,-9
894,17,3,4,5,8,32,44,6,5,176,35
894,18,4,3,7,6,43,33,9,8,219,68
894,19,3,3,6,7,-67,-66,2,2,152,2
894,20,3,4,8,5,35,41,7,3,187,43
894,21,5,2,9,4,-46,22,1,5,141,65
894,22,5,2,10,3,55,21,6,6,196,86
894,23,3,4,4,9,31,-55,7,1,227,31
894,24,4,3,8,5,-56,32,1,3,171,63
894,25,3,3,7,6,34,33,5,6,205,96
894,26,3,4,5,8,32,-56,7,0,237,40
894,27,5,2,7,6,52,24,9,4,289,64
894,28,4,2,7,6,-57,24,2,8,232,88
894,29,4,2,10,3,46,21,8,9,278,109
894,30,5,2,8,5,-47,-77,1,2,231,32
894,31,2,4,6,7,24,43,5,5,255,75
894,32,4,3,8,5,44,32,9,7,299,107
894,33,2,4,2,11,20,-53,9,4,319,54
894,34,2,5,3,10,-79,55,0,9,240,109
894,35,5,2,9,4,54,-78,4,1,294,31
894,36,2,5,4,9,22,54,6,5,316,85
894,37,3,4,6,7,33,43,9,8,349,128
894,38,2,4,3,10,-79,-54,0,4,270,74
894,39,2,4,3,10,21,-54,1,0,291,20
894,40,4,3,7,6,43,33,4,3,334,53
894,41,3,3,4,9,31,36,5,9,365,89
894,42,5,3,10,3,-45,30,0,9,320,119
894,43,3,3,5,8,32,-65,2,4,352,54
894,44,3,4,4,9,31,45,3,9,383,99
894,45,4,3,7,6,43,-67,6,2,426,32
894,46,3,4,4,9,31,45,7,7,457,77
894,47,4,3,7,6,-57,-67,0,0,400,10
894,48,5,2,10,3,55,21,5,1,455,31
894,49,2,5,3,10,21,55,6,6,476,86
894,50,3,3,5,8,32,-65,8,1,508,21
895,1,4,3,6,7,42,34,2,4,42,34
895,2,3,3,8,5,35,32,7,6,77,66
895,3,2,5,4,9,22,-46,9,0,99,20
895,4,2,4,5,8,-77,44,2,4,22,64
895,5,4,3,8,5,44,32,6,6,66,96
895,6,2,5,4,9,22,-46,8,0,88,50
895,7,5,2,9,4,-46,22,2,2,42,72
895,8,2,5,7,6,25,51,7,3,67,123
895,9,4,3,7,6,-57,33,0,6,10,156
895,10,6,2,8,5,62,23,2,9,72,179
895,11,3,3,9,4,36,-69,8,0,108,110
895,12,4,2,10,3,-54,21,4,1,54,131
895,13,4,3,9,4,45,31,9,2,99,162
895,14,3,3,5,8,-68,35,1,7,31,197
895,15,4,3,6,7,42,-66,3,1,73,131
895,16,4,3,6,7,42,34,5,5,115,165
895,17,4,3,8,5,44,32,9,7,159,197
895,18,5,2,10,3,-45,21,4,8,114,218
895,19,2,4,7,6,25,-58,9,0,139,160
895,20,3,4,5,8,-68,44,1,4,71,204
895,21,3,4,4,9,31,45,2,9,102,249
895,22,3,3,5,8,32,-65,4,4,134,184
895,23,5,2,10,3,55,21,9,5,189,205
895,24,2,6,3,10,-79,64,0,9,110,269
895,25,2,5,5,8,23,-47,3,2,133,222
895,26,3,3,7,6,34,33,7,5,167,255
895,27,4,2,8,5,-56,23,1,8,111,278
895,28,3,4,5,8,32,-56,3,2,143,222
895,29,4,3,8,5,44,32,7,4,187,254
895,30,2,5,3,10,21,55,8,9,208,309
895,31,4,3,10,3,-54,30,4,9,154,339
895,32,5,2,9,4,54,-78,8,1,208,261
895,33,3,4,8,5,-65,41,3,2,143,302
895,34,2,5,5,8,23,53,6,5,166,355
895,35,3,4,6,7,33,43,9,8,199,398
895,36,4,3,11,2,-53,-30,6,8,146,368
895,37,2,4,5,8,23,-56,9,2,169,312
895,38,5,2,10,3,-45,21,4,3,124,333
895,39,4,3,8,5,44,32,8,5,168,365
895,40,3,4,5,8,-68,44,0,9,100,409
895,41,2,4,6,7,24,-57,4,2,124,352
895,42,4,3,8,5,44,32,8,4,168,384
895,43,3,3,6,7,-67,34,1,8,101,418
895,44,3,3,6,7,33,-66,4,2,134,352
895,45,3,3,4,9,31,36,5,8,165,388
895,46,3,3,5,8,32,-65,7,3,197,323
895,47,3,4,5,8,32,44,9,7,229,367
895,48,3,3,4,9,-69,-64,0,3,160,303
895,49,3,3,7,6,34,33,4,6,194,336
895,50,2,4,8,5,-74,41,0,7,120,377
895,51,3,4,6,7,33,-57,3,0,153,320
895,52,4,3,6,7,42,34,5,4,195,354
895,53,4,2,11,2,-53,20,2,4,142,374
895,54,4,2,7,6,43,24,5,8,185,398
895,55,4,3,10,3,-54,30,1,8,131,428
895,56,3,4,5,8,32,-56,3,2,163,372
895,57,4,3,6,7,42,34,5,6,205,406
895,58,4,3,8,5,44,32,9,8,249,438
895,59,3,3,7,6,-66,-67,3,1,183,371
895,60,4,4,6,7,42,43,5,4,225,414
895,61,3,3,9,4,-64,31,1,5,161,445
895,62,3,3,6,7,33,34,4,9,194,479
895,63,3,3,9,4,-64,-69,0,0,130,410
895,64,2,4,2,11,20,47,0,7,150,457
895,65,2,4,6,7,24,-57,4,0,174,400
895,66,3,3,7,6,34,33,8,3,208,433
895,67,3,3,9,4,-64,31,4,4,144,464
895,68,5,2,8,5,53,23,7,7,197,487
895,69,3,3,5,8,32,-65,9,2,229,422
895,70,4,3,9,4,-55,31,4,3,174,453
895,71,3,3,6,7,33,34,7,7,207,487
895,72,4,3,7,6,-57,-67,0,0,150,420
895,73,2,5,4,9,22,54,2,4,172,474
895,74,4,2,8,5,44,23,6,7,216,497
895,75,4,2,8,5,-56,-77,0,0,160,420
895,76,3,4,6,7,33,43,3,3,193,463
895,77,4,3,7,6,43,33,6,6,236,496
895,78,5,2,8,5,53,23,9,9,289,519
896,1,2,4,8,5,26,41,6,1,26,41
896,2,5,3,9,4,-46,31,0,2,-20,72
896,3,4,3,7,6,43,33,3,5,23,105
896,4,3,3,6,7,33,34,6,9,56,139
896,5,6,2,10,3,-36,-79,0,0,20,60
896,6,4,3,8,5,44,32,4,2,64,92
896,7,5,2,9,4,54,22,8,4,118,114
896,8,2,5,5,8,-77,53,1,7,41,167
896,9,2,4,8,5,26,41,7,8,67,208
896,10,4,3,6,7,42,-66,9,2,109,142
896,11,4,2,7,6,-57,24,2,6,52,166
896,12,4,2,8,5,44,23,6,9,96,189
896,13,4,3,6,7,42,-66,8,3,138,123
896,14,3,3,6,7,-67,34,1,7,71,157
896,15,3,3,6,7,33,-66,4,1,104,91
896,16,3,4,8,5,35,41,9,2,139,132
896,17,3,3,6,7,-67,34,2,6,72,166
896,18,2,5,6,7,24,52,6,8,96,218
896,19,4,2,8,5,-56,-77,0,1,40,141
896,20,5,2,8,5,53,23,3,4,93,164
896,21,4,3,5,8,41,35,4,9,134,199
896,22,4,3,6,7,42,-66,6,3,176,133
896,23,2,5,3,10,21,55,7,8,197,188
896,24,3,4,6,7,-67,-57,0,1,130,131
896,25,3,4,5,8,32,44,2,5,162,175
896,26,5,2,9,4,54,22,6,7,216,197
896,27,3,4,4,9,31,-55,7,2,247,142
896,28,2,4,4,9,22,45,9,7,269,187
896,29,2,4,3,10,-79,-54,0,3,190,133
896,30,3,4,4,9,31,45,1,8,221,178
896,31,4,2,8,5,44,-77,5,1,265,101
896,32,3,3,9,4,-64,31,1,2,201,132
896,33,2,4,4,9,22,45,3,7,223,177
896,34,3,3,6,7,33,-66,6,1,256,111
896,35,3,4,4,9,31,45,7,6,287,156
896,36,4,2,8,5,-56,23,1,9,231,179
896,37,4,2,10,3,46,-79,7,0,277,100
896,38,4,3,7,6,-57,33,0,3,220,133
896,39,3,4,5,8,32,44,2,7,252,177
896,40,3,3,7,6,34,-67,6,0,286,110
896,41,5,2,8,5,53,23,9,3,339,133
896,42,3,4,3,10,30,46,9,9,369,179
896,43,4,3,8,5,-56,-68,3,1,313,111
896,44,4,3,6,7,42,34,5,5,355,145
896,45,4,3,7,6,43,33,8,8,398,178
896,46,5,2,8,5,-47,-77,1,1,351,101
896,47,5,2,8,5,53,23,4,4,404,124
896,48,3,4,8,5,35,41,9,5,439,165
896,49,3,4,5,8,-68,44,1,9,371,209
896,50,2,5,2,11,20,-44,1,5,391,165
896,51,3,3,4,9,31,-64,2,1,422,101
896,52,3,4,8,5,35,41,7,2,457,142
896,53,5,3,8,5,-47,32,0,4,410,174
896,54,3,4,7,6,34,42,4,6,444,216
896,55,2,4,2,11,20,-53,4,3,464,163
896,56,4,3,5,8,41,35,5,8,505,198
897,1,2,6,2,11,20,65,0,5,20,65
897,2,2,5,4,9,22,54,2,9,42,119
897,3,3,4,9,4,36,40,8,9,78,159
897,4,3,4,6,7,-67,-57,1,2,11,102
897,5,4,3,7,6,43,33,4,5,54,135
897,6,5,3,9,4,54,31,8,6,108,166
897,7,3,3,7,6,-66,33,2,9,42,199
897,8,3,3,9,4,36,-69,8,0,78,130
897,9,5,3,9,4,-46,31,2,1,32,161
897,10,3,4,6,7,33,43,5,4,65,204
897,11,3,4,5,8,32,44,7,8,97,248
897,12,3,4,5,8,32,-56,9,2,129,192
897,13,3,4,8,5,-65,41,4,3,64,233
897,14,2,5,3,10,21,55,5,8,85,288
897,15,4,3,7,6,43,-67,8,1,128,221
897,16,5,2,7,6,-48,24,0,5,80,245
897,17,3,3,7,6,34,33,4,8,114,278
897,18,4,3,6,7,42,-66,6,2,156,212
897,19,5,3,9,4,-46,31,0,3,110,243
897,20,4,3,6,7,42,34,2,7,152,277
897,21,3,3,8,5,35,32,7,9,187,309
897,22,2,6,3,10,21,-36,8,3,208,273
897,23,3,3,3,10,30,-63,8,0,238,210
897,24,3,3,7,6,-66,33,2,3,172,243
897,25,3,4,6,7,33,43,5,6,205,286
897,26,2,5,2,11,20,-44,5,2,225,242
897,27,4,2,9,4,-55,22,0,4,170,264
897,28,2,4,7,6,25,42,5,6,195,306
897,29,3,4,6,7,33,43,8,9,228,349
897,30,3,3,5,8,-68,-65,0,4,160,284
897,31,4,2,8,5,44,23,4,7,204,307
897,32,3,4,5,8,32,-56,6,1,236,251
897,33,5,2,8,5,53,23,9,4,289,274
897,34,3,4,4,9,-69,45,0,9,220,319
897,35,2,4,8,5,26,-59,6,0,246,260
897,36,3,3,7,6,-66,33,0,3,180,293
897,37,4,3,8,5,44,32,4,5,224,325
897,38,3,4,4,9,31,-55,5,0,255,270
897,39,4,3,9,4,-55,31,0,1,200,301
897,40,2,5,4,9,22,54,2,5,222,355
897,41,3,3,7,6,34,33,6,8,256,388
897,42,2,4,8,5,-74,41,2,9,182,429
897,43,4,3,6,7,42,-66,4,3,224,363
897,44,4,3,8,5,44,32,8,5,268,395
897,45,3,4,3,10,30,-54,8,1,298,341
897,46,2,4,5,8,-77,44,1,5,221,385
897,47,3,4,9,4,36,40,7,5,257,425
897,48,4,2,8,5,-56,23,1,8,201,448
897,49,3,3,7,6,34,-67,5,1,235,381
897,50,2,4,4,9,22,45,7,6,257,426
897,51,2,5,4,9,22,-46,9,0,279,380
897,52,3,3,4,9,-69,36,0,6,210,416
897,53,3,3,4,9,31,-64,1,2,241,352
897,54,3,3,8,5,35,32,6,4,276,384
897,55,4,3,9,4,-55,31,1,5,221,415
897,56,4,3,6,7,42,34,3,9,263,449
897,57,4,2,6,7,42,-75,5,4,305,374
897,58,4,3,7,6,43,33,8,7,348,407
897,59,3,3,5,8,-68,-65,0,2,280,342
897,60,5,2,7,6,52,24,2,6,332,366
897,61,5,2,10,3,55,21,7,7,387,387
897,62,4,3,7,6,-57,-67,0,0,330,320
897,63,2,5,3,10,21,55,1,5,351,375
897,64,2,4,7,6,25,42,6,7,376,417
897,65,4,3,8,5,-56,32,0,9,320,449
897,66,4,3,6,7,42,-66,2,3,362,383
897,67,6,2,11,2,65,20,7,3,427,403
897,68,3,4,6,7,-67,43,0,6,360,446
897,69,3,3,6,7,33,-66,3,0,393,380
897,70,4,2,6,7,42,25,5,5,435,405
897,71,3,3,9,4,-64,31,1,6,371,436
897,72,3,4,6,7,33,43,4,9,404,479
897,73,4,4,7,6,43,-58,7,1,447,421
897,74,3,4,8,5,-65,41,2,2,382,462
897,75,2,5,3,10,21,55,3,7,403,517
898,1,3,4,5,8,32,44,2,4,32,44
898,2,3,4,6,7,33,43,5,7,65,87
898,3,6,2,8,5,62,-77,7,0,127,10
898,4,3,4,7,6,-66,42,1,2,61,52
898,5,2,4,7,6,25,42,6,4,86,94
898,6,4,3,7,6,43,33,9,7,129,127
898,7,2,4,3,10,-79,-54,0,3,50,73
898,8,3,3,7,6,34,33,4,6,84,106
898,9,3,4,5,8,32,-56,6,0,116,50
898,10,5,2,10,3,-45,21,1,1,71,71
898,11,4,3,7,6,43,33,4,4,114,104
898,12,3,3,5,8,32,35,6,9,146,139
898,13,2,5,3,10,21,-45,7,4,167,94
898,14,2,4,6,7,-76,43,1,7,91,137
898,15,3,4,4,9,31,-55,2,2,122,82
898,16,3,4,5,8,32,44,4,6,154,126
898,17,3,5,4,9,31,-46,5,0,185,80
898,18,3,3,6,7,33,34,8,4,218,114
898,19,2,5,4,9,-78,54,0,8,140,168
898,20,3,3,7,6,34,-67,4,1,174,101
898,21,3,3,6,7,33,34,7,5,207,135
898,22,2,4,5,8,-77,44,0,9,130,179
898,23,2,4,2,11,20,-53,0,6,150,126
898,24,2,5,4,9,22,-46,2,0,172,80
898,25,3,3,5,8,32,35,4,5,204,115
898,26,3,4,6,7,33,43,7,8,237,158
898,27,3,4,6,7,-67,-57,0,1,170,101
898,28,4,3,9,4,45,31,5,2,215,132
898,29,4,2,8,5,44,23,9,5,259,155
898,30,3,4,5,8,-68,44,1,9,191,199
898,31,3,3,6,7,33,-66,4,3,224,133
898,32,3,3,5,8,32,35,6,8,256,168
898,33,3,3,7,6,-66,-67,0,1,190,101
898,34,5,2,7,6,52,24,2,5,242,125
898,35,2,5,2,11,20,-44,2,1,262,81
898,36,3,4,7,6,34,42,6,3,296,123
898,37,2,4,4,9,22,45,8,8,318,168
898,38,3,3,5,8,-68,-65,0,3,250,103
898,39,3,3,6,7,33,34,3,7,283,137
898,40,3,3,6,7,33,-66,6,1,316,71
898,41,5,2,10,3,-45,21,1,2,271,92
898,42,3,4,3,10,30,46,1,8,301,138
898,43,2,5,3,10,21,-45,2,3,322,93
898,44,3,4,8,5,35,41,7,4,357,134
898,45,3,3,6,7,-67,34,0,8,290,168
898,46,3,3,8,5,35,-68,5,0,325,100
898,47,5,2,11,2,-44,20,1,0,281,120
898,48,2,4,4,9,22,45,3,5,303,165
898,49,2,4,6,7,24,43,7,8,327,208
898,50,3,3,8,5,-65,-68,2,0,262,140
898,51,2,4,4,9,22,45,4,5,284,185
898,52,5,2,9,4,54,22,8,7,338,207
898,53,3,4,7,6,-66,42,2,9,272,249
898,54,3,3,5,8,32,-65,4,4,304,184
898,55,4,2,9,4,45,22,9,6,349,206
898,56,4,2,7,6,-57,-76,2,0,292,130
898,57,4,3,7,6,43,33,5,3,335,163
898,58,5,2,10,3,-45,21,0,4,290,184
898,59,3,3,7,6,34,33,4,7,324,217
898,60,3,3,8,5,35,32,9,9,359,249
898,61,5,2,7,6,-48,-76,1,3,311,173
898,62,3,4,7,6,34,42,5,5,345,215
898,63,2,5,2,11,20,-44,5,1,365,171
898,64,3,3,10,3,-63,30,2,1,302,201
898,65,5,2,9,4,54,22,6,3,356,223
898,66,4,2,6,7,42,25,8,8,398,248
898,67,2,5,6,7,-76,-48,2,0,322,200
898,68,5,2,9,4,54,22,6,2,376,222
898,69,2,4,4,9,22,45,8,7,398,267
898,70,3,3,6,7,-67,-66,1,1,331,201
898,71,2,5,5,8,23,53,4,4,354,254
898,72,3,4,7,6,34,42,8,6,388,296
898,73,4,3,5,8,41,-65,9,1,429,231
898,74,4,3,8,5,-56,32,3,3,373,263
898,75,3,4,3,10,30,46,3,9,403,309
898,76,3,5,6,7,33,-48,6,1,436,261
898,77,3,3,8,5,-65,32,1,3,371,293
898,78,3,3,7,6,34,33,5,6,405,326
898,79,5,2,9,4,54,22,9,8,459,348
898,80,2,5,3,10,-79,-45,0,3,380,303
898,81,2,4,6,7,24,43,4,6,404,346
898,82,4,3,8,5,44,32,8,8,448,378
898,83,4,3,7,6,-57,-67,1,1,391,311
898,84,2,5,5,8,23,53,4,4,414,364
898,85,4,4,7,6,43,42,7,6,457,406
898,86,5,2,10,3,-45,21,2,7,412,427
898,87,2,4,4,9,22,-55,4,2,434,372
898,88,3,4,6,7,33,43,7,5,467,415
898,89,3,3,6,7,-67,34,0,9,400,449
898,90,3,4,8,5,35,-59,5,0,435,390
898,91,3,4,5,8,32,44,7,4,467,434
898,92,3,3,5,8,32,35,9,9,499,469
898,93,3,4,7,6,-66,-58,3,1,433,411
898,94,2,4,4,9,22,45,5,6,455,456
898,95,4,3,7,6,43,33,8,9,498,489
898,96,2,4,6,7,-76,-57,2,2,422,432
898,97,4,2,8,5,44,23,6,5,466,455
898,98,2,5,4,9,22,54,8,9,488,509
899,1,4,2,6,7,42,25,2,5,42,25
899,2,3,3,6,7,33,34,5,9,75,59
899,3,2,4,6,7,24,-57,9,2,99,2
899,4,2,5,4,9,-78,54,1,6,21,56
899,5,3,3,5,8,32,-65,3,1,53,-9
899,6,3,4,5,8,32,44,5,5,85,35
899,7,2,4,4,9,22,-55,7,0,107,-20
899,8,4,3,5,8,41,35,8,5,148,15
899,9,3,4,6,7,-67,43,1,8,81,58
899,10,2,5,3,10,21,-45,2,3,102,13
899,11,2,4,5,8,23,44,5,7,125,57
899,12,2,5,3,10,21,-45,6,2,146,12
899,13,4,3,6,7,42,34,8,6,188,46
899,14,5,2,9,4,-46,22,2,8,142,68
899,15,4,3,6,7,42,-66,4,2,184,2
899,16,3,4,5,8,32,44,6,6,216,46
899,17,3,4,7,6,-66,42,0,8,150,88
899,18,5,2,8,5,53,-77,3,1,203,11
899,19,4,2,6,7,42,25,5,6,245,36
899,20,3,3,9,4,-64,31,1,7,181,67
899,21,4,3,9,4,45,31,6,8,226,98
899,22,3,4,6,7,33,-57,9,1,259,41
899,23,4,4,6,7,-58,43,1,4,201,84
899,24,3,4,5,8,32,44,3,8,233,128
899,25,3,4,7,6,34,-58,7,0,267,70
899,26,5,2,9,4,-46,22,1,2,221,92
899,27,4,2,8,5,44,23,5,5,265,115
899,28,4,3,8,5,44,32,9,7,309,147
899,29,3,3,7,6,-66,-67,3,0,243,80
899,30,3,3,3,10,30,37,3,7,273,117
899,31,2,4,5,8,23,-56,6,1,296,61
899,32,3,3,8,5,-65,32,1,3,231,93
899,33,4,3,8,5,44,32,5,5,275,125
899,34,3,4,4,9,31,-55,6,0,306,70
899,35,3,4,5,8,32,44,8,4,338,114
899,36,3,5,6,7,-67,52,1,6,271,166
899,37,4,3,6,7,42,-66,3,0,313,100
899,38,3,3,7,6,34,33,7,3,347,133
899,39,4,3,6,7,42,34,9,7,389,167
899,40,5,2,10,3,-45,21,4,8,344,188
899,41,2,5,2,11,20,-44,4,4,364,144
899,42,2,5,3,10,21,55,5,9,385,199
899,43,5,2,8,5,53,-77,8,2,438,122
899,44,4,2,8,5,-56,23,2,5,382,145
899,45,2,4,6,7,24,43,6,8,406,188
899,46,4,3,7,6,43,-67,9,1,449,121
899,47,4,3,8,5,-56,32,3,3,393,153
899,48,3,3,8,5,35,32,8,5,428,185
899,49,3,3,8,5,-65,32,3,7,363,217
899,50,2,5,4,9,22,-46,5,1,385,171
899,51,2,4,6,7,24,43,9,4,409,214
899,52,3,5,6,7,-67,52,2,6,342,266
899,53,5,2,7,6,52,-76,4,0,394,190
899,54,2,6,3,10,21,64,5,4,415,254
899,55,3,5,6,7,33,52,8,6,448,306
899,56,3,3,6,7,-67,-66,1,0,381,240
899,57,2,5,4,9,22,54,3,4,403,294
899,58,2,4,7,6,25,42,8,6,428,336
899,59,3,3,5,8,-68,-65,0,1,360,271
899,60,5,2,8,5,53,23,3,4,413,294
899,61,3,4,3,10,30,-54,3,0,443,240
899,62,4,3,7,6,43,33,6,3,486,273
899,63,5,2,10,3,-45,21,1,4,441,294
899,64,3,4,7,6,34,42,5,6,475,336
899,65,3,3,8,5,-65,32,0,8,410,368
899,66,3,3,8,5,35,-68,5,0,445,300
899,67,3,4,7,6,34,42,9,2,479,342
899,68,3,3,5,8,-68,35,1,7,411,377
899,69,3,3,8,5,35,32,6,9,446,409
899,70,4,3,8,5,-56,-68,0,1,390,341
899,71,4,2,10,3,46,21,6,2,436,362
899,72,4,3,8,5,-56,32,0,4,380,394
899,73,3,4,4,9,31,45,1,9,411,439
899,74,2,4,4,9,22,-55,3,4,433,384
899,75,4,3,7,6,43,33,6,7,476,417
899,76,4,3,6,7,42,-66,8,1,518,351
900,1,3,3,3,10,30,37,0,7,30,37
900,2,2,5,4,9,22,-46,2,1,52,-9
900,3,5,2,10,3,55,21,7,2,107,12
900,4,3,3,7,6,-66,33,1,5,41,45
900,5,4,2,9,4,45,22,6,7,86,67
900,6,3,3,7,6,-66,-67,0,0,20,0
900,7,4,3,8,5,44,32,4,2,64,32
900,8,2,4,5,8,23,44,7,6,87,76
900,9,2,5,6,7,-76,52,1,8,11,128
900,10,3,3,7,6,34,-67,5,1,45,61
900,11,5,2,10,3,-45,21,0,2,0,82
900,12,4,3,7,6,43,33,3,5,43,115
900,13,3,4,7,6,34,42,7,7,77,157
900,14,3,4,3,10,30,-54,7,3,107,103
900,15,4,2,7,6,-57,24,0,7,50,127
900,16,3,3,9,4,36,31,6,8,86,158
900,17,4,4,4,9,40,-55,6,3,126,103
900,18,2,5,5,8,23,53,9,6,149,156
900,19,2,5,3,10,-79,-45,0,1,70,111
900,20,3,4,5,8,32,44,2,5,102,155
900,21,3,3,6,7,33,34,5,9,135,189
900,22,3,4,4,9,31,-55,6,4,166,134
900,23,3,3,6,7,33,34,9,8,199,168
900,24,3,3,8,5,-65,-68,4,0,134,100
900,25,4,3,9,4,45,31,9,1,179,131
900,26,2,5,5,8,-77,53,2,4,102,184
900,27,3,4,10,3,37,-40,9,4,139,144
900,28,3,5,7,6,-66,51,3,5,73,195
900,29,3,4,4,9,31,-55,4,0,104,140
900,30,4,2,6,7,42,25,6,5,146,165
900,31,5,2,9,4,-46,22,0,7,100,187
900,32,4,2,8,5,44,-77,4,0,144,110
900,33,4,3,5,8,41,35,5,5,185,145
900,34,3,4,9,4,-64,40,1,5,121,185
900,35,2,5,4,9,22,54,3,9,143,239
900,36,2,5,4,9,22,-46,5,3,165,193
900,37,3,4,4,9,31,45,6,8,196,238
900,38,3,4,4,9,31,-55,7,3,227,183
900,39,3,3,7,6,-66,33,1,6,161,216
900,40,2,5,4,9,22,-46,3,0,183,170
900,41,2,4,5,8,23,44,6,4,206,214
900,42,4,3,7,6,43,33,9,7,249,247
900,43,3,3,5,8,-68,-65,1,2,181,182
900,44,3,3,8,5,35,32,6,4,216,214
900,45,2,5,5,8,23,53,9,7,239,267
900,46,4,2,9,4,-55,22,4,9,184,289
900,47,2,4,3,10,21,-54,5,5,205,235
900,48,3,4,6,7,33,43,8,8,238,278
900,49,4,2,8,5,-56,-77,2,1,182,201
900,50,4,2,7,6,43,24,5,5,225,225
900,51,4,4,4,9,40,-55,5,0,265,170
900,52,2,5,8,5,-74,50,1,0,191,220
900,53,2,4,4,9,22,45,3,5,213,265
900,54,3,3,5,8,32,-65,5,0,245,200
900,55,3,4,5,8,32,44,7,4,277,244
900,56,5,2,10,3,-45,21,2,5,232,265
900,57,4,2,7,6,43,24,5,9,275,289
900,58,3,4,6,7,33,-57,8,2,308,232
900,59,3,3,6,7,-67,34,1,6,241,266
900,60,3,4,7,6,34,42,5,8,275,308
900,61,3,4,8,5,-65,41,0,9,210,349
900,62,4,2,6,7,42,-75,2,4,252,274
900,63,2,5,5,8,23,53,5,7,275,327
900,64,3,5,5,8,32,-47,7,0,307,280
900,65,4,2,8,5,-56,23,1,3,251,303
900,66,3,3,7,6,34,33,5,6,285,336
900,67,2,5,6,7,24,52,9,8,309,388
900,68,4,3,8,5,-56,-68,3,0,253,320
900,69,5,3,8,5,53,32,6,2,306,352
900,70,5,2,8,5,53,23,9,5,359,375
900,71,4,2,8,5,-56,23,3,8,303,398
900,72,2,5,6,7,24,-48,7,0,327,350
900,73,3,5,5,8,32,53,9,3,359,403
900,74,3,3,7,6,-66,33,3,6,293,436
900,75,2,5,5,8,23,53,6,9,316,489
900,76,3,4,7,6,-66,-58,0,1,250,431
900,77,4,2,7,6,43,24,3,5,293,455
900,78,3,4,6,7,33,43,6,8,326,498
900,79,3,4,5,8,32,-56,8,2,358,442
900,80,3,4,6,7,-67,43,1,5,291,485
900,81,3,4,6,7,33,43,4,8,324,528
901,1,3,3,4,9,31,36,1,6,31,36
901,2,5,2,6,7,51,-75,2,1,82,-39
901,3,3,4,4,9,31,45,3,6,113,6
901,4,2,6,4,9,22,63,5,9,135,69
901,5,4,2,8,5,44,-77,9,2,179,-8
901,6,5,2,9,4,-46,22,3,4,133,14
901,7,3,3,4,9,31,-64,4,0,164,-50
901,8,3,4,6,7,33,43,7,3,197,-7
901,9,5,2,11,2,-44,20,3,3,153,13
901,10,2,4,5,8,23,44,6,7,176,57
901,11,3,4,4,9,31,-55,7,2,207,2
901,12,4,3,4,9,40,36,7,8,247,38
901,13,3,4,8,5,-65,41,2,9,182,79
901,14,2,4,5,8,23,-56,5,3,205,23
901,15,5,3,8,5,53,32,8,5,258,55
901,16,2,4,4,9,-78,-55,0,0,180,0
901,17,6,2,9,4,63,22,3,2,243,22
901,18,3,4,3,10,30,46,3,8,273,68
901,19,4,2,7,6,43,-76,6,2,316,-8
901,20,4,3,9,4,-55,31,1,3,261,23
901,21,3,4,6,7,33,43,4,6,294,66
901,22,4,3,8,5,44,32,8,8,338,98
901,23,4,3,8,5,-56,-68,2,0,282,30
901,24,3,3,5,8,32,35,4,5,314,65
901,25,3,4,6,7,33,43,7,8,347,108
901,26,2,4,7,6,-75,-58,2,0,272,50
901,27,2,4,5,8,23,44,5,4,295,94
901,28,3,4,5,8,32,44,7,8,327,138
901,29,2,4,7,6,-75,-58,2,0,252,80
901,30,4,3,6,7,42,34,4,4,294,114
901,31,2,4,7,6,25,42,9,6,319,156
901,32,2,5,5,8,-77,53,2,9,242,209
901,33,2,5,6,7,24,-48,6,1,266,161
901,34,6,2,9,4,63,22,9,3,329,183
901,35,3,4,5,8,-68,44,1,7,261,227
901,36,2,6,3,10,21,-36,2,1,282,191
901,37,3,3,6,7,33,34,5,5,315,225
901,38,4,3,9,4,-55,31,0,6,260,256
901,39,2,5,3,10,21,-45,1,1,281,211
901,40,6,2,9,4,63,22,4,3,344,233
901,41,4,3,8,5,44,32,8,5,388,265
901,42,3,4,5,8,-68,44,0,9,320,309
901,43,3,3,7,6,34,-67,4,2,354,242
901,44,3,3,7,6,34,33,8,5,388,275
901,45,4,2,8,5,-56,23,2,8,332,298
901,46,3,3,10,3,37,30,9,8,369,328
901,47,3,3,5,8,-68,-65,1,3,301,263
901,48,2,5,5,8,23,53,4,6,324,316
901,49,3,4,6,7,33,43,7,9,357,359
901,50,3,3,6,7,-67,-66,0,3,290,293
901,51,4,3,9,4,45,31,5,4,335,324
901,52,4,2,9,4,-55,22,0,6,280,346
901,53,3,5,5,8,32,53,2,9,312,399
901,54,4,3,8,5,44,-68,6,1,356,331
901,55,3,4,7,6,-66,42,0,3,290,373
901,56,3,3,9,4,36,31,6,4,326,404
901,57,2,4,4,9,22,45,8,9,348,449
901,58,4,2,9,4,-55,-78,3,1,293,371
901,59,4,2,10,3,46,21,9,2,339,392
901,60,3,3,8,5,-65,32,4,4,274,424
901,61,2,5,6,7,24,52,8,6,298,476
901,62,2,4,7,6,-75,42,3,8,223,518
902,1,2,4,7,6,25,42,5,2,25,42
902,2,5,3,10,3,-45,30,0,2,-20,72
902,3,5,3,8,5,53,32,3,4,33,104
902,4,4,2,8,5,44,23,7,7,77,127
902,5,3,4,5,8,32,-56,9,1,109,71
902,6,4,2,7,6,-57,24,2,5,52,95
902,7,4,3,8,5,44,32,6,7,96,127
902,8,4,2,10,3,-54,21,2,8,42,148
902,9,3,4,7,6,34,-58,6,0,76,90
902,10,5,2,10,3,-45,21,1,1,31,111
902,11,4,3,4,9,40,36,1,7,71,147
902,12,3,4,5,8,32,-56,3,1,103,91
902,13,2,5,4,9,22,54,5,5,125,145
902,14,4,2,9,4,-55,22,0,7,70,167
902,15,4,3,7,6,43,-67,3,0,113,100
902,16,2,5,5,8,23,53,6,3,136,153
902,17,4,2,7,6,43,24,9,7,179,177
902,18,3,4,8,5,-65,41,4,8,114,218
902,19,5,2,10,3,55,21,9,9,169,239
902,20,3,3,5,8,-68,-65,1,4,101,174
902,21,3,4,5,8,32,44,3,8,133,218
902,22,4,2,7,6,43,-76,6,2,176,142
902,23,4,2,8,5,-56,23,0,5,120,165
902,24,2,4,6,7,24,43,4,8,144,208
902,25,4,3,6,7,42,-66,6,2,186,142
902,26,4,2,7,6,43,24,9,6,229,166
902,27,4,3,6,7,-58,-66,1,0,171,100
902,28,2,5,3,10,21,55,2,5,192,155
902,29,2,6,2,11,20,-35,2,0,212,120
902,30,3,4,6,7,33,43,5,3,245,163
902,31,5,2,7,6,52,24,7,7,297,187
902,32,4,3,6,7,42,-66,9,1,339,121
902,33,4,2,5,8,-59,26,0,7,280,147
902,34,3,3,6,7,33,-66,3,1,313,81
902,35,4,2,8,5,44,23,7,4,357,104
902,36,4,2,9,4,-55,22,2,6,302,126
902,37,3,4,4,9,31,-55,3,1,333,71
902,38,4,3,6,7,42,34,5,5,375,105
902,39,3,3,6,7,33,34,8,9,408,139
902,40,3,4,7,6,-66,-58,2,1,342,81
902,41,5,2,10,3,55,21,7,2,397,102
902,42,6,2,8,5,62,23,9,5,459,125
902,43,4,4,7,6,-57,42,2,7,402,167
902,44,4,3,8,5,44,32,6,9,446,199
902,45,3,3,6,7,33,-66,9,3,479,133
902,46,4,2,10,3,-54,21,5,4,425,154
902,47,3,4,4,9,31,45,6,9,456,199
902,48,4,2,10,3,-54,-79,2,0,402,120
902,49,3,4,7,6,34,42,6,2,436,162
902,50,4,3,8,5,-56,32,0,4,380,194
902,51,2,5,5,8,23,53,3,7,403,247
902,52,3,4,7,6,34,42,7,9,437,289
902,53,3,4,4,9,31,-55,8,4,468,234
902,54,3,4,5,8,-68,44,0,8,400,278
902,55,3,5,6,7,33,-48,3,0,433,230
902,56,4,3,5,8,41,35,4,5,474,265
902,57,4,3,7,6,43,33,7,8,517,298
903,1,5,2,9,4,54,22,4,2,54,22
903,2,3,3,9,4,-64,31,0,3,-10,53
903,3,3,3,6,7,33,34,3,7,23,87
903,4,4,3,9,4,45,31,8,8,68,118
903,5,4,2,8,5,-56,-77,2,1,12,41
903,6,5,3,9,4,54,31,6,2,66,72
903,7,4,4,6,7,42,43,8,5,108,115
903,8,3,3,8,5,-65,32,3,7,43,147
903,9,3,3,6,7,33,-66,6,1,76,81
903,10,4,3,9,4,-55,31,1,2,21,112
903,11,5,2,7,6,52,24,3,6,73,136
903,12,2,5,4,9,22,-46,5,0,95,90
903,13,3,5,4,9,31,54,6,4,126,144
903,14,2,4,3,10,21,-54,7,0,147,90
903,15,3,4,6,7,-67,43,0,3,80,133
903,16,2,5,4,9,22,54,2,7,102,187
903,17,2,5,2,11,20,-44,2,3,122,143
903,18,3,4,5,8,32,44,4,7,154,187
903,19,3,4,7,6,34,42,8,9,188,229
903,20,2,4,5,8,-77,-56,1,3,111,173
903,21,2,4,6,7,24,43,5,6,135,216
903,22,2,5,4,9,22,-46,7,0,157,170
903,23,5,2,7,6,52,24,9,4,209,194
903,24,2,4,4,9,-78,45,1,9,131,239
903,25,3,3,5,8,32,-65,3,4,163,174
903,26,3,3,7,6,34,33,7,7,197,207
903,27,2,4,4,9,22,-55,9,2,219,152
903,28,3,3,6,7,-67,34,2,6,152,186
903,29,5,3,9,4,54,31,6,7,206,217
903,30,2,4,4,9,22,-55,8,2,228,162
903,31,5,2,9,4,-46,22,2,4,182,184
903,32,4,3,8,5,44,32,6,6,226,216
903,33,4,3,8,5,-56,32,0,8,170,248
903,34,2,5,4,9,22,-46,2,2,192,202
903,35,5,2,10,3,55,21,7,3,247,223
903,36,3,4,5,8,32,44,9,7,279,267
903,37,3,3,6,7,-67,-66,2,1,212,201
903,38,3,5,8,5,35,50,7,1,247,251
903,39,4,3,8,5,-56,32,1,3,191,283
903,40,3,3,5,8,32,35,3,8,223,318
903,41,2,4,5,8,23,-56,6,2,246,262
903,42,3,3,6,7,33,34,9,6,279,296
903,43,4,3,9,4,-55,31,4,7,224,327
903,44,3,3,5,8,32,-65,6,2,256,262
903,45,5,2,9,4,-46,22,0,4,210,284
903,46,3,5,5,8,32,53,2,7,242,337
903,47,2,5,3,10,21,-45,3,2,263,292
903,48,3,3,7,6,34,33,7,5,297,325
903,49,3,3,5,8,32,-65,9,0,329,260
903,50,2,5,3,10,-79,55,0,5,250,315
903,51,3,4,7,6,34,42,4,7,284,357
903,52,3,3,6,7,33,-66,7,1,317,291
903,53,2,4,4,9,22,45,9,6,339,336
903,54,2,4,4,9,-78,-55,1,1,261,281
903,55,4,3,9,4,45,31,6,2,306,312
903,56,3,3,5,8,32,35,8,7,338,347
903,57,3,3,9,4,-64,31,4,8,274,378
903,58,4,3,9,4,45,31,9,9,319,409
903,59,5,3,9,4,-46,-69,3,0,273,340
903,60,4,2,9,4,45,22,8,2,318,362
903,61,2,4,3,10,21,46,9,8,339,408
903,62,4,3,6,7,-58,-66,1,2,281,342
903,63,3,3,8,5,35,32,6,4,316,374
903,64,4,3,7,6,43,33,9,7,359,407
903,65,3,3,3,10,30,-63,9,4,389,344
903,66,4,2,6,7,-58,25,1,9,331,369
903,67,2,4,7,6,25,-58,6,1,356,311
903,68,3,3,4,9,31,36,7,7,387,347
903,69,4,2,5,8,41,-74,8,3,428,273
903,70,2,5,3,10,21,55,9,8,449,328
903,71,3,4,8,5,-65,41,4,9,384,369
903,72,4,3,7,6,43,-67,7,2,427,302
903,73,4,3,7,6,-57,33,0,5,370,335
903,74,3,3,5,8,32,-65,2,0,402,270
903,75,4,3,5,8,41,35,3,5,443,305
903,76,4,3,10,3,46,30,9,5,489,335
903,77,3,5,7,6,-66,51,3,6,423,386
903,78,2,4,8,5,26,41,9,7,449,427
903,79,2,5,3,10,-79,-45,0,2,370,382
903,80,2,6,5,8,23,62,3,4,393,444
903,81,2,4,3,10,21,-54,4,0,414,390
903,82,3,3,6,7,33,34,7,4,447,424
903,83,4,3,7,6,-57,33,0,7,390,457
903,84,3,4,5,8,32,-56,2,1,422,401
903,85,2,4,5,8,23,44,5,5,445,445
903,86,2,4,6,7,24,43,9,8,469,488
903,87,2,4,2,11,20,-53,9,5,489,435
903,88,4,2,8,5,-56,23,3,8,433,458
903,89,3,4,5,8,32,-56,5,2,465,402
903,90,3,3,8,5,-65,32,0,4,400,434
903,91,2,5,5,8,23,53,3,7,423,487
903,92,3,4,5,8,32,-56,5,1,455,431
903,93,2,5,5,8,23,53,8,4,478,484
903,94,2,5,5,8,-77,53,1,7,401,537
904,1,4,2,9,4,45,22,5,2,45,22
904,2,4,3,6,7,42,34,7,6,87,56
904,3,4,2,8,5,-56,23,1,9,31,79
904,4,5,2,10,3,55,-79,6,0,86,0
904,5,2,4,4,9,22,45,8,5,108,45
904,6,3,3,5,8,-68,-65,0,0,40,-20
904,7,2,4,5,8,23,44,3,4,63,24
904,8,4,3,7,6,43,33,6,7,106,57
904,9,2,5,5,8,23,-47,9,0,129,10
904,10,4,3,9,4,-55,31,4,1,74,41
904,11,5,2,10,3,55,21,9,2,129,62
904,12,3,3,6,7,-67,34,2,6,62,96
904,13,3,3,8,5,35,32,7,8,97,128
904,14,4,3,8,5,-56,-68,1,0,41,60
904,15,4,3,8,5,44,32,5,2,85,92
904,16,3,3,5,8,32,35,7,7,117,127
904,17,2,5,4,9,22,-46,9,1,139,81
904,18,4,2,9,4,-55,22,4,3,84,103
904,19,3,5,6,7,33,52,7,5,117,155
904,20,3,4,6,7,-67,43,0,8,50,198
904,21,5,2,9,4,54,-78,4,0,104,120
904,22,5,2,7,6,52,24,6,4,156,144
904,23,3,4,7,6,-66,42,0,6,90,186
904,24,4,3,7,6,43,33,3,9,133,219
904,25,4,2,5,8,41,-74,4,5,174,145
904,26,2,5,5,8,23,53,7,8,197,198
904,27,4,3,8,5,-56,-68,1,0,141,130
904,28,4,3,6,7,42,34,3,4,183,164
904,29,3,3,7,6,34,33,7,7,217,197
904,30,2,4,6,7,-76,-57,1,0,141,140
904,31,4,3,7,6,43,33,4,3,184,173
904,32,4,3,5,8,41,35,5,8,225,208
904,33,2,5,5,8,23,-47,8,1,248,161
904,34,2,5,6,7,-76,52,2,3,172,213
904,35,4,3,8,5,44,32,6,5,216,245
904,36,4,3,7,6,43,33,9,8,259,278
904,37,3,3,9,4,-64,31,5,9,195,309
904,38,2,4,5,8,23,-56,8,3,218,253
904,39,5,2,10,3,-45,21,3,4,173,274
904,40,4,3,7,6,43,33,6,7,216,307
904,41,4,3,5,8,41,-65,7,2,257,242
904,42,2,5,4,9,22,54,9,6,279,296
904,43,4,3,6,7,-58,-66,1,0,221,230
904,44,4,2,7,6,43,24,4,4,264,254
904,45,2,4,7,6,25,42,9,6,289,296
904,46,3,3,8,5,-65,32,4,8,224,328
904,47,4,3,6,7,42,-66,6,2,266,262
904,48,4,2,8,5,-56,23,0,5,210,285
904,49,2,4,3,10,21,-54,1,1,231,231
904,50,2,5,4,9,22,54,3,5,253,285
904,51,3,3,6,7,33,34,6,9,286,319
904,52,3,3,5,8,32,-65,8,4,318,254
904,53,3,3,7,6,-66,33,2,7,252,287
904,54,3,3,5,8,32,-65,4,2,284,222
904,55,2,4,6,7,24,43,8,5,308,265
904,56,3,4,6,7,-67,43,1,8,241,308
904,57,4,3,8,5,44,-68,5,0,285,240
904,58,2,4,2,11,20,47,5,7,305,287
904,59,3,3,6,7,33,-66,8,1,338,221
904,60,3,4,6,7,-67,43,1,4,271,264
904,61,4,2,6,7,42,25,3,9,313,289
904,62,3,3,7,6,34,-67,7,2,347,222
904,63,4,3,8,5,-56,32,1,4,291,254
904,64,4,3,9,4,45,31,6,5,336,285
904,65,4,3,5,8,41,-65,7,0,377,220
904,66,3,4,4,9,31,45,8,5,408,265
904,67,2,4,3,10,21,-54,9,1,429,211
904,68,6,2,9,4,-37,22,2,3,392,233
904,69,4,3,7,6,43,33,5,6,435,266
904,70,4,2,7,6,43,-76,8,0,478,190
904,71,3,3,6,7,-67,34,1,4,411,224
904,72,4,2,10,3,46,21,7,5,457,245
904,73,3,4,4,9,31,-55,8,0,488,190
904,74,5,2,9,4,-46,22,2,2,442,212
904,75,3,3,4,9,31,36,3,8,473,248
904,76,2,5,5,8,23,-47,6,1,496,201
904,77,3,4,5,8,32,44,8,5,528,245
905,1,5,2,10,3,55,21,5,1,55,21
905,2,2,4,6,7,24,43,9,4,79,64
905,3,2,5,3,10,-79,55,0,9,0,119
905,4,2,5,3,10,21,-45,1,4,21,74
905,5,4,3,8,5,44,32,5,6,65,106
905,6,2,5,6,7,24,52,9,8,89,158
905,7,3,4,5,8,-68,-56,1,2,21,102
905,8,4,2,7,6,43,24,4,6,64,126
905,9,5,2,8,5,53,23,7,9,117,149
905,10,4,3,9,4,-55,-69,2,0,62,80
905,11,4,2,10,3,46,21,8,1,108,101
905,12,4,2,10,3,-54,21,4,2,54,122
905,13,5,2,6,7,51,25,5,7,105,147
905,14,3,4,8,5,-65,41,0,8,40,188
905,15,2,4,3,10,21,-54,1,4,61,134
905,16,3,3,7,6,34,33,5,7,95,167
905,17,4,3,6,7,42,-66,7,1,137,101
905,18,4,2,6,7,42,25,9,6,179,126
905,19,2,5,3,10,-79,-45,0,1,100,81
905,20,2,6,2,11,20,65,0,6,120,146
905,21,4,2,10,3,46,21,6,7,166,167
905,22,3,3,8,5,-65,32,1,9,101,199
905,23,4,3,8,5,44,-68,5,1,145,131
905,24,2,4,3,10,21,46,6,7,166,177
905,25,4,2,8,5,-56,-77,0,0,110,100
905,26,4,3,9,4,45,31,5,1,155,131
905,27,5,2,9,4,54,22,9,3,209,153
905,28,2,4,5,8,-77,44,2,7,132,197
905,29,3,4,7,6,34,42,6,9,166,239
905,30,3,3,4,9,31,-64,7,5,197,175
905,31,3,3,9,4,-64,31,3,6,133,206
905,32,5,3,8,5,53,32,6,8,186,238
905,33,5,2,7,6,52,-76,8,2,238,162
905,34,4,2,5,8,41,26,9,8,279,188
905,35,5,2,8,5,-47,-77,2,1,232,111
905,36,5,2,10,3,55,21,7,2,287,132
905,37,2,5,5,8,-77,53,0,5,210,185
905,38,4,2,5,8,41,-74,1,1,251,111
905,39,4,3,9,4,45,31,6,2,296,142
905,40,2,4,7,6,-75,42,1,4,221,184
905,41,3,3,7,6,34,33,5,7,255,217
905,42,3,4,4,9,31,-55,6,2,286,162
905,43,3,4,8,5,-65,41,1,3,221,203
905,44,5,2,11,2,56,20,7,3,277,223
905,45,3,4,4,9,31,45,8,8,308,268
905,46,2,5,5,8,-77,-47,1,1,231,221
905,47,3,4,8,5,35,41,6,2,266,262
905,48,4,2,7,6,43,24,9,6,309,286
905,49,2,4,4,9,-78,-55,1,1,231,231
905,50,3,3,7,6,34,33,5,4,265,264
905,51,3,3,7,6,34,33,9,7,299,297
905,52,6,2,10,3,-36,21,3,8,263,318
905,53,5,2,9,4,54,-78,7,0,317,240
905,54,3,4,4,9,31,45,8,5,348,285
905,55,3,3,7,6,-66,33,2,8,282,318
905,56,2,4,7,6,25,-58,7,0,307,260
905,57,3,4,6,7,-67,43,0,3,240,303
905,58,4,3,8,5,44,32,4,5,284,335
905,59,3,3,6,7,33,34,7,9,317,369
905,60,4,2,9,4,-55,-78,2,1,262,291
905,61,3,4,7,6,34,42,6,3,296,333
905,62,3,3,4,9,31,36,7,9,327,369
905,63,4,3,9,4,-55,-69,2,0,272,300
905,64,3,3,7,6,34,33,6,3,306,333
905,65,2,4,5,8,23,44,9,7,329,377
905,66,4,3,6,7,-58,-66,1,1,271,311
905,67,3,4,4,9,31,45,2,6,302,356
905,68,5,2,7,6,52,-76,4,0,354,280
905,69,5,2,9,4,54,22,8,2,408,302
905,70,3,3,6,7,-67,34,1,6,341,336
905,71,5,2,9,4,54,22,5,8,395,358
905,72,3,4,6,7,33,-57,8,1,428,301
905,73,3,4,9,4,-64,40,4,1,364,341
905,74,3,3,8,5,35,32,9,3,399,373
905,75,3,3,6,7,-67,34,2,7,332,407
905,76,3,3,8,5,35,32,7,9,367,439
905,77,5,2,10,3,-45,-79,2,0,322,360
905,78,3,4,7,6,34,42,6,2,356,402
905,79,3,3,6,7,33,34,9,6,389,436
905,80,5,2,8,5,-47,23,2,9,342,459
905,81,3,3,8,5,35,-68,7,1,377,391
905,82,4,3,6,7,42,34,9,5,419,425
905,83,5,2,9,4,-46,22,3,7,373,447
905,84,4,3,9,4,45,31,8,8,418,478
905,85,2,5,4,9,-78,-46,0,2,340,432
905,86,2,4,5,8,23,44,3,6,363,476
905,87,2,4,5,8,23,-56,6,0,386,420
905,88,3,3,8,5,-65,32,1,2,321,452
905,89,2,5,4,9,22,54,3,6,343,506
906,1,4,3,7,6,43,33,3,3,43,33
906,2,6,2,10,3,64,21,7,4,107,54
906,3,4,4,9,4,-55,40,2,4,52,94
906,4,5,2,6,7,51,25,3,9,103,119
906,5,6,2,10,3,64,-79,7,0,167,40
906,6,4,2,9,4,-55,22,2,2,112,62
906,7,4,2,9,4,45,22,7,4,157,84
906,8,4,2,9,4,-55,22,2,6,102,106
906,9,3,3,8,5,35,32,7,8,137,138
906,10,5,2,11,2,-44,20,3,8,93,158
906,11,3,4,5,8,32,-56,5,2,125,102
906,12,2,5,2,11,20,56,5,8,145,158
906,13,5,2,8,5,53,-77,8,1,198,81
906,14,3,3,8,5,-65,32,3,3,133,113
906,15,2,6,2,11,20,65,3,8,153,178
906,16,3,3,7,6,34,-67,7,1,187,111
906,17,2,6,3,10,21,64,8,5,208,175
906,18,4,2,9,4,-55,22,3,7,153,197
906,19,3,4,6,7,33,-57,6,0,186,140
906,20,2,5,2,11,20,56,6,6,206,196
906,21,3,4,7,6,-66,42,0,8,140,238
906,22,3,3,8,5,35,-68,5,0,175,170
906,23,4,3,7,6,43,33,8,3,218,203
906,24,4,3,7,6,-57,33,1,6,161,236
906,25,4,2,5,8,41,-74,2,2,202,162
906,26,5,2,9,4,54,22,6,4,256,184
906,27,5,2,9,4,-46,22,0,6,210,206
906,28,4,3,4,9,40,-64,0,2,250,142
906,29,2,5,5,8,23,53,3,5,273,195
906,30,3,3,9,4,36,31,9,6,309,226
906,31,4,3,7,6,-57,33,2,9,252,259
906,32,4,3,6,7,42,-66,4,3,294,193
906,33,4,3,6,7,42,34,6,7,336,227
906,34,5,2,9,4,-46,22,0,9,290,249
906,35,6,2,10,3,64,-79,4,0,354,170
906,36,4,4,8,5,44,41,8,1,398,211
906,37,3,4,8,5,-65,41,3,2,333,252
906,38,3,3,8,5,35,32,8,4,368,284
906,39,4,4,7,6,-57,42,1,6,311,326
906,40,4,2,10,3,46,21,7,7,357,347
906,41,2,4,6,7,-76,-57,1,0,281,290
906,42,4,4,8,5,44,41,5,1,325,331
906,43,4,2,8,5,44,23,9,4,369,354
906,44,5,3,7,6,-48,33,1,7,321,387
906,45,3,4,4,9,31,-55,2,2,352,332
906,46,3,3,6,7,33,34,5,6,385,366
906,47,4,3,7,6,43,33,8,9,428,399
906,48,4,2,8,5,-56,-77,2,2,372,322
906,49,3,4,6,7,33,43,5,5,405,365
906,50,3,3,5,8,32,-65,7,0,437,300
906,51,5,3,8,5,-47,32,0,2,390,332
906,52,5,3,10,3,55,30,5,2,445,362
906,53,4,2,7,6,43,24,8,6,488,386
906,54,2,4,6,7,-76,43,2,9,412,429
906,55,3,4,4,9,31,-55,3,4,443,374
906,56,2,4,8,5,26,41,9,5,469,415
906,57,3,4,7,6,-66,42,3,7,403,457
906,58,2,5,4,9,22,-46,5,1,425,411
906,59,3,4,8,5,-65,41,0,2,360,452
906,60,4,3,8,5,44,32,4,4,404,484
906,61,3,5,4,9,31,54,5,8,435,538
907,1,3,3,7,6,34,33,4,3,34,33
907,2,2,4,7,6,25,42,9,5,59,75
907,3,3,3,8,5,-65,32,4,7,-6,107
907,4,4,2,8,5,44,-77,8,0,38,30
907,5,4,3,9,4,-55,31,3,1,-17,61
907,6,3,3,8,5,35,32,8,3,18,93
907,7,6,2,8,5,-38,23,0,6,-20,116
907,8,4,3,7,6,43,33,3,9,23,149
907,9,3,5,5,8,32,-47,5,2,55,102
907,10,2,4,7,6,-75,42,0,4,-20,144
907,11,2,5,4,9,22,54,2,8,2,198
907,12,4,2,8,5,44,-77,6,1,46,121
907,13,3,4,6,7,33,43,9,4,79,164
907,14,4,3,8,5,-56,32,3,6,23,196
907,15,3,3,8,5,35,32,8,8,58,228
907,16,6,2,7,6,61,-76,9,2,119,152
907,17,4,4,6,7,-58,43,1,5,61,195
907,18,2,4,7,6,25,42,6,7,86,237
907,19,5,2,10,3,-45,21,1,8,41,258
907,20,2,4,5,8,23,-56,4,2,64,202
907,21,5,2,8,5,53,23,7,5,117,225
907,22,3,3,9,4,-64,31,3,6,53,256
907,23,2,5,6,7,24,52,7,8,77,308
907,24,3,4,4,9,31,-55,8,3,108,253
907,25,4,3,8,5,-56,32,2,5,52,285
907,26,3,3,7,6,34,33,6,8,86,318
907,27,4,2,9,4,-55,-78,1,0,31,240
907,28,4,3,5,8,41,35,2,5,72,275
907,29,3,4,5,8,32,44,4,9,104,319
907,30,2,4,8,5,-74,-59,0,0,30,260
907,31,2,5,4,9,22,54,2,4,52,314
907,32,3,4,2,11,-30,-53,2,1,22,261
907,33,3,4,6,7,33,43,5,4,55,304
907,34,4,3,7,6,43,33,8,7,98,337
907,35,3,3,7,6,-66,-67,2,0,32,270
907,36,3,4,6,7,33,43,5,3,65,313
907,37,2,5,5,8,23,53,8,6,88,366
907,38,4,2,9,4,-55,22,3,8,33,388
907,39,2,4,4,9,22,-55,5,3,55,333
907,40,3,4,8,5,-65,41,0,4,-10,374
907,41,3,3,6,7,33,34,3,8,23,408
907,42,3,3,8,5,35,-68,8,0,58,340
907,43,3,4,9,4,-64,40,4,0,-6,380
907,44,2,4,6,7,24,43,8,3,18,423
907,45,2,5,4,9,-78,54,0,7,-60,477
907,46,2,4,7,6,25,42,5,9,-35,519
908,1,3,4,7,6,34,42,4,2,34,42
908,2,4,2,7,6,43,24,7,6,77,66
908,3,4,3,9,4,-55,31,2,7,22,97
908,4,3,3,7,6,34,-67,6,0,56,30
908,5,4,2,9,4,-55,22,1,2,1,52
908,6,4,4,7,6,43,42,4,4,44,94
908,7,4,3,8,5,44,32,8,6,88,126
908,8,3,4,7,6,-66,42,2,8,22,168
908,9,4,4,5,8,41,-56,3,2,63,112
908,10,3,4,5,8,32,44,5,6,95,156
908,11,2,6,3,10,21,-36,6,0,116,120
908,12,3,4,5,8,32,44,8,4,148,164
908,13,4,3,8,5,-56,32,2,6,92,196
908,14,2,4,4,9,22,-55,4,1,114,141
908,15,4,2,8,5,44,23,8,4,158,164
908,16,4,2,10,3,-54,21,4,5,104,185
908,17,5,2,7,6,52,24,6,9,156,209
908,18,2,5,5,8,23,-47,9,2,179,162
908,19,3,3,7,6,-66,33,3,5,113,195
908,20,4,2,7,6,43,24,6,9,156,219
908,21,2,4,7,6,-75,-58,1,1,81,161
908,22,4,3,7,6,43,33,4,4,124,194
908,23,2,4,4,9,22,45,6,9,146,239
908,24,4,3,7,6,43,-67,9,2,189,172
908,25,4,2,7,6,-57,24,2,6,132,196
908,26,4,3,10,3,46,30,8,6,178,226
908,27,4,3,7,6,-57,33,1,9,121,259
908,28,4,3,6,7,42,-66,3,3,163,193
908,29,4,3,5,8,41,35,4,8,204,228
908,30,4,2,9,4,45,-78,9,0,249,150
908,31,4,2,9,4,-55,22,4,2,194,172
908,32,3,3,8,5,35,32,9,4,229,204
908,33,2,4,3,10,-79,-54,0,0,150,150
908,34,3,4,7,6,34,42,4,2,184,192
908,35,4,3,7,6,43,33,7,5,227,225
908,36,4,3,9,4,-55,31,2,6,172,256
908,37,3,3,6,7,33,-66,5,0,205,190
908,38,3,3,9,4,-64,31,1,1,141,221
908,39,4,2,9,4,45,22,6,3,186,243
908,40,3,4,4,9,31,45,7,8,217,288
908,41,3,3,7,6,-66,-67,1,1,151,221
908,42,3,4,7,6,34,42,5,3,185,263
908,43,2,4,6,7,24,43,9,6,209,306
908,44,4,3,6,7,-58,-66,1,0,151,240
908,45,2,4,2,11,20,47,1,7,171,287
908,46,3,4,5,8,32,-56,3,1,203,231
908,47,4,2,8,5,44,23,7,4,247,254
908,48,5,2,8,5,-47,23,0,7,200,277
908,49,4,3,6,7,42,-66,2,1,242,211
908,50,3,3,5,8,32,35,4,6,274,246
908,51,3,4,7,6,34,42,8,8,308,288
908,52,2,5,3,10,21,-45,9,3,329,243
908,53,3,4,4,9,-69,45,0,8,260,288
908,54,4,3,8,5,44,-68,4,0,304,220
908,55,3,4,5,8,32,44,6,4,336,264
908,56,2,5,6,7,-76,52,0,6,260,316
908,57,4,2,9,4,45,22,5,8,305,338
908,58,2,4,7,6,-75,-58,0,0,230,280
908,59,3,3,5,8,32,35,2,5,262,315
908,60,4,4,9,4,45,40,7,5,307,355
908,61,3,3,7,6,-66,33,1,8,241,388
908,62,4,3,8,5,44,-68,5,0,285,320
908,63,2,5,2,11,20,56,5,6,305,376
908,64,4,3,8,5,44,32,9,8,349,408
908,65,3,3,7,6,-66,-67,3,1,283,341
908,66,4,3,6,7,42,34,5,5,325,375
908,67,2,4,4,9,22,-55,7,0,347,320
908,68,3,4,7,6,-66,42,1,2,281,362
908,69,5,2,10,3,55,21,6,3,336,383
908,70,5,2,8,5,53,23,9,6,389,406
908,71,4,3,6,7,-58,-66,1,0,331,340
908,72,3,4,7,6,34,42,5,2,365,382
908,73,2,4,4,9,22,45,7,7,387,427
908,74,2,4,4,9,22,-55,9,2,409,372
908,75,4,2,9,4,-55,22,4,4,354,394
908,76,4,2,9,4,45,22,9,6,399,416
908,77,3,4,6,7,-67,43,2,9,332,459
908,78,5,2,8,5,53,-77,5,2,385,382
908,79,3,3,4,9,31,36,6,8,416,418
908,80,4,2,9,4,-55,-78,1,0,361,340
908,81,2,5,3,10,21,55,2,5,382,395
908,82,4,2,6,7,42,-75,4,0,424,320
908,83,4,3,9,4,45,31,9,1,469,351
908,84,3,3,8,5,-65,32,4,3,404,383
908,85,5,2,11,2,-44,20,0,3,360,403
908,86,4,3,10,3,46,30,6,3,406,433
908,87,3,4,6,7,33,43,9,6,439,476
908,88,3,3,4,9,-69,-64,0,2,370,412
908,89,3,3,7,6,34,33,4,5,404,445
908,90,4,3,5,8,41,-65,5,0,445,380
908,91,4,3,8,5,44,32,9,2,489,412
908,92,4,3,9,4,-55,31,4,3,434,443
908,93,5,2,10,3,55,21,9,4,489,464
908,94,4,3,8,5,-56,32,3,6,433,496
908,95,3,3,6,7,33,-66,6,0,466,430
908,96,4,2,10,3,-54,21,2,1,412,451
908,97,3,3,7,6,34,33,6,4,446,484
908,98,4,2,9,4,-55,22,1,6,391,506
909,1,3,5,4,9,31,54,1,4,31,54
909,2,2,4,6,7,24,43,5,7,55,97
909,3,3,4,8,5,-65,41,0,8,-10,138
909,4,4,3,6,7,42,-66,2,2,32,72
909,5,5,2,8,5,53,23,5,5,85,95
909,6,2,5,5,8,23,53,8,8,108,148
909,7,3,3,7,6,-66,-67,2,1,42,81
909,8,4,2,8,5,44,23,6,4,86,104
909,9,4,3,8,5,-56,32,0,6,30,136
909,10,4,3,5,8,41,-65,1,1,71,71
909,11,2,5,2,11,20,56,1,7,91,127
909,12,2,4,6,7,24,-57,5,0,115,70
909,13,2,6,4,9,22,63,7,3,137,133
909,14,4,2,10,3,-54,21,3,4,83,154
909,15,2,5,4,9,22,54,5,8,105,208
909,16,2,5,5,8,23,-47,8,1,128,161
909,17,3,4,5,8,-68,44,0,5,60,205
909,18,3,4,4,9,31,-55,1,0,91,150
909,19,3,4,4,9,31,45,2,5,122,195
909,20,3,3,5,8,32,-65,4,0,154,130
909,21,2,5,3,10,21,55,5,5,175,185
909,22,5,2,8,5,53,23,8,8,228,208
909,23,2,5,6,7,-76,-48,2,0,152,160
909,24,2,4,7,6,25,42,7,2,177,202
909,25,3,3,3,10,30,37,7,9,207,239
909,26,2,5,2,11,20,-44,7,5,227,195
909,27,4,4,5,8,41,44,8,9,268,239
909,28,2,4,7,6,-75,-58,3,1,193,181
909,29,4,2,7,6,43,24,6,5,236,205
909,30,4,2,7,6,43,24,9,9,279,229
909,31,2,5,4,9,-78,-46,1,3,201,183
909,32,2,4,4,9,22,45,3,8,223,228
909,33,4,3,8,5,44,-68,7,0,267,160
909,34,5,2,11,2,-44,20,3,0,223,180
909,35,3,3,5,8,32,35,5,5,255,215
909,36,3,3,7,6,34,33,9,8,289,248
909,37,3,4,6,7,-67,-57,2,1,222,191
909,38,4,2,8,5,44,23,6,4,266,214
909,39,3,3,6,7,33,34,9,8,299,248
909,40,3,4,6,7,-67,-57,2,1,232,191
909,41,5,2,8,5,53,23,5,4,285,214
909,42,5,2,9,4,54,22,9,6,339,236
909,43,3,4,5,8,-68,-56,1,0,271,180
909,44,3,3,3,10,30,37,1,7,301,217
909,45,4,3,5,8,41,-65,2,2,342,152
909,46,4,3,8,5,44,32,6,4,386,184
909,47,4,2,9,4,-55,22,1,6,331,206
909,48,2,5,3,10,21,-45,2,1,352,161
909,49,4,3,9,4,45,31,7,2,397,192
909,50,3,4,5,8,32,44,9,6,429,236
909,51,4,2,8,5,-56,23,3,9,373,259
909,52,2,4,5,8,23,-56,6,3,396,203
909,53,2,4,4,9,22,45,8,8,418,248
909,54,4,2,8,5,-56,-77,2,1,362,171
909,55,4,4,7,6,43,42,5,3,405,213
909,56,3,3,9,4,-64,31,1,4,341,244
909,57,2,5,6,7,24,52,5,6,365,296
909,58,2,5,2,11,20,-44,5,2,385,252
909,59,3,4,9,4,-64,40,1,2,321,292
909,60,3,4,7,6,34,42,5,4,355,334
909,61,6,2,8,5,62,23,7,7,417,357
909,62,4,4,9,4,-55,40,2,7,362,397
909,63,3,3,8,5,35,32,7,9,397,429
909,64,3,4,6,7,-67,-57,0,2,330,372
909,65,3,3,5,8,32,35,2,7,362,407
909,66,3,3,4,9,31,-64,3,3,393,343
909,67,2,5,5,8,23,53,6,6,416,396
909,68,2,4,7,6,-75,42,1,8,341,438
909,69,5,2,9,4,54,-78,5,0,395,360
909,70,4,2,9,4,-55,22,0,2,340,382
909,71,4,2,7,6,43,24,3,6,383,406
909,72,2,5,5,8,23,53,6,9,406,459
909,73,3,3,7,6,-66,-67,0,2,340,392
909,74,3,3,7,6,34,33,4,5,374,425
909,75,2,4,5,8,23,44,7,9,397,469
909,76,3,3,5,8,32,-65,9,4,429,404
909,77,2,5,3,10,-79,55,0,9,350,459
909,78,4,3,7,6,43,-67,3,2,393,392
909,79,3,3,4,9,31,36,4,8,424,428
909,80,3,3,6,7,33,-66,7,2,457,362
909,81,2,5,3,10,21,55,8,7,478,417
909,82,4,2,11,2,-53,20,5,7,425,437
909,83,2,4,4,9,22,-55,7,2,447,382
909,84,4,3,7,6,-57,33,0,5,390,415
909,85,4,2,7,6,43,24,3,9,433,439
909,86,3,3,7,6,34,-67,7,2,467,372
909,87,4,2,10,3,-54,21,3,3,413,393
909,88,3,4,6,7,33,43,6,6,446,436
909,89,4,3,8,5,-56,32,0,8,390,468
909,90,4,3,8,5,44,-68,4,0,434,400
909,91,2,4,6,7,24,43,8,3,458,443
909,92,5,2,7,6,-48,24,0,7,410,467
909,93,2,5,5,8,23,-47,3,0,433,420
909,94,2,5,2,11,20,56,3,6,453,476
909,95,3,3,6,7,33,-66,6,0,486,410
909,96,5,2,6,7,51,25,7,5,537,435
910,1,3,3,5,8,32,35,2,5,32,35
910,2,3,3,4,9,31,-64,3,1,63,-29
910,3,3,4,4,9,31,45,4,6,94,16
910,4,2,5,5,8,23,53,7,9,117,69
910,5,4,3,8,5,-56,-68,1,1,61,1
910,6,2,4,9,4,27,40,8,1,88,41
910,7,5,2,10,3,-45,21,3,2,43,62
910,8,5,2,9,4,54,22,7,4,97,84
910,9,3,4,5,8,32,44,9,8,129,128
910,10,5,2,7,6,-48,-76,1,2,81,52
910,11,2,5,5,8,23,53,4,5,104,105
910,12,5,2,10,3,55,21,9,6,159,126
910,13,3,4,4,9,-69,-55,0,1,90,71
910,14,2,5,4,9,22,54,2,5,112,125
910,15,3,4,4,9,31,-55,3,0,143,70
910,16,4,3,8,5,44,32,7,2,187,102
910,17,5,2,9,4,-46,22,1,4,141,124
910,18,4,3,9,4,45,31,6,5,186,155
910,19,2,5,4,9,22,54,8,9,208,209
910,20,3,3,6,7,-67,-66,1,3,141,143
910,21,4,3,7,6,43,33,4,6,184,176
910,22,4,3,7,6,43,33,7,9,227,209
910,23,2,6,2,11,20,-35,7,4,247,174
910,24,4,2,9,4,-55,22,2,6,192,196
910,25,4,2,8,5,44,23,6,9,236,219
910,26,3,3,5,8,32,-65,8,4,268,154
910,27,4,4,5,8,41,44,9,8,309,198
910,28,2,5,4,9,-78,-46,1,2,231,152
910,29,4,3,8,5,44,32,5,4,275,184
910,30,3,3,4,9,31,-64,6,0,306,120
910,31,3,4,6,7,33,43,9,3,339,163
910,32,3,3,8,5,-65,32,4,5,274,195
910,33,4,3,8,5,44,32,8,7,318,227
910,34,3,4,6,7,-67,-57,1,0,251,170
910,35,3,3,8,5,35,32,6,2,286,202
910,36,3,5,6,7,33,52,9,4,319,254
910,37,2,5,4,9,-78,54,1,8,241,308
910,38,3,3,8,5,35,-68,6,0,276,240
910,39,2,5,2,11,20,56,6,6,296,296
910,40,4,3,6,7,42,-66,8,0,338,230
910,41,3,5,3,10,30,55,8,5,368,285
910,42,2,4,5,8,-77,44,1,9,291,329
910,43,3,3,8,5,35,-68,6,1,326,261
910,44,3,4,5,8,32,44,8,5,358,305
910,45,2,4,8,5,-74,41,4,6,284,346
910,46,5,2,9,4,54,22,8,8,338,368
910,47,2,5,3,10,21,-45,9,3,359,323
910,48,2,5,5,8,-77,53,2,6,282,376
910,49,3,3,9,4,36,31,8,7,318,407
910,50,6,2,11,2,-35,20,3,7,283,427
910,51,3,3,8,5,35,32,8,9,318,459
910,52,4,3,8,5,-56,-68,2,1,262,391
910,53,4,2,5,8,41,26,3,7,303,417
910,54,3,4,5,8,32,-56,5,1,335,361
910,55,3,4,6,7,33,43,8,4,368,404
910,56,3,3,8,5,-65,32,3,6,303,436
910,57,2,4,6,7,24,43,7,9,327,479
910,58,4,3,9,4,-55,-69,2,0,272,410
910,59,2,5,6,7,24,52,6,2,296,462
910,60,4,2,8,5,-56,23,0,5,240,485
910,61,2,5,3,10,21,-45,1,0,261,440
910,62,3,4,7,6,34,42,5,2,295,482
910,63,3,4,7,6,34,42,9,4,329,524
911,1,2,4,6,7,24,43,4,3,24,43
911,2,4,2,7,6,43,24,7,7,67,67
911,3,4,2,6,7,42,-75,9,2,109,-8
911,4,4,3,6,7,-58,34,1,6,51,26
911,5,3,3,8,5,35,32,6,8,86,58
911,6,4,4,5,8,41,-56,7,2,127,2
911,7,4,2,5,8,41,26,8,8,168,28
911,8,4,4,6,7,-58,-57,0,1,110,-29
911,9,3,4,6,7,33,43,3,4,143,14
911,10,4,2,9,4,45,22,8,6,188,36
911,11,3,3,6,7,-67,-66,1,0,121,-30
911,12,5,2,9,4,54,22,5,2,175,-8
911,13,2,4,6,7,24,43,9,5,199,35
911,14,2,5,5,8,-77,53,2,8,122,88
911,15,4,3,6,7,42,-66,4,2,164,22
911,16,4,2,9,4,45,22,9,4,209,44
911,17,2,4,6,7,-76,43,3,7,133,87
911,18,4,3,8,5,44,32,7,9,177,119
911,19,4,2,7,6,-57,-76,0,3,120,43
911,20,3,3,9,4,36,31,6,4,156,74
911,21,2,5,4,9,22,54,8,8,178,128
911,22,4,4,6,7,-58,-57,0,1,120,71
911,23,2,5,4,9,22,54,2,5,142,125
911,24,3,4,6,7,33,43,5,8,175,168
911,25,3,4,4,9,31,-55,6,3,206,113
911,26,3,4,8,5,-65,41,1,4,141,154
911,27,4,2,7,6,43,24,4,8,184,178
911,28,2,5,4,9,22,-46,6,2,206,132
911,29,4,2,10,3,-54,21,2,3,152,153
911,30,3,5,5,8,32,53,4,6,184,206
911,31,4,3,6,7,42,-66,6,0,226,140
911,32,4,2,5,8,41,26,7,6,267,166
911,33,2,4,3,10,21,-54,8,2,288,112
911,34,5,2,9,4,-46,22,2,4,242,134
911,35,3,3,6,7,33,34,5,8,275,168
911,36,2,6,1,12,-20,-34,5,4,255,134
911,37,4,2,10,3,-54,21,1,5,201,155
911,38,5,2,7,6,52,24,3,9,253,179
911,39,5,2,8,5,53,-77,6,2,306,102
911,40,3,3,8,5,-65,32,1,4,241,134
911,41,2,4,5,8,23,44,4,8,264,178
911,42,4,3,6,7,42,-66,6,2,306,112
911,43,3,3,7,6,-66,33,0,5,240,145
911,44,4,2,5,8,41,-74,1,1,281,71
911,45,2,5,5,8,23,53,4,4,304,124
911,46,4,3,4,9,40,-64,4,0,344,60
911,47,3,4,5,8,32,44,6,4,376,104
911,48,3,4,7,6,-66,42,0,6,310,146
911,49,3,3,5,8,32,-65,2,1,342,81
911,50,2,5,6,7,24,52,6,3,366,133
911,51,3,4,5,8,32,44,8,7,398,177
911,52,4,3,8,5,-56,32,2,9,342,209
911,53,2,5,5,8,23,-47,5,2,365,162
911,54,3,3,7,6,34,33,9,5,399,195
911,55,2,4,3,10,-79,-54,0,1,320,141
911,56,2,4,5,8,23,44,3,5,343,185
911,57,3,3,3,10,30,-63,3,2,373,122
911,58,3,4,7,6,34,42,7,4,407,164
911,59,3,3,6,7,-67,34,0,8,340,198
911,60,4,3,7,6,43,-67,3,1,383,131
911,61,3,4,5,8,32,44,5,5,415,175
911,62,4,3,8,5,44,32,9,7,459,207
911,63,3,4,5,8,-68,-56,1,1,391,151
911,64,4,4,8,5,44,41,5,2,435,192
911,65,5,2,10,3,-45,21,0,3,390,213
911,66,3,3,7,6,34,33,4,6,424,246
911,67,4,2,7,6,43,-76,7,0,467,170
911,68,5,2,9,4,-46,22,1,2,421,192
911,69,4,3,8,5,44,32,5,4,465,224
911,70,3,3,4,9,31,-64,6,0,496,160
911,71,4,3,10,3,-54,30,2,0,442,190
911,72,3,4,7,6,34,42,6,2,476,232
911,73,5,2,9,4,-46,22,0,4,430,254
911,74,2,4,7,6,25,42,5,6,455,296
911,75,3,4,4,9,31,-55,6,1,486,241
911,76,4,2,10,3,-54,21,2,2,432,262
911,77,5,2,8,5,53,23,5,5,485,285
911,78,4,2,9,4,-55,22,0,7,430,307
911,79,5,2,11,2,56,20,6,7,486,327
911,80,3,3,7,6,-66,-67,0,0,420,260
911,81,3,3,6,7,33,34,3,4,453,294
911,82,3,3,4,9,31,-64,4,0,484,230
911,83,2,5,5,8,23,53,7,3,507,283
912,1,4,3,10,3,46,30,6,0,46,30
912,2,3,4,4,9,31,45,7,5,77,75
912,3,3,3,8,5,-65,32,2,7,12,107
912,4,2,4,4,9,22,-55,4,2,34,52
912,5,4,3,6,7,42,34,6,6,76,86
912,6,4,3,7,6,43,33,9,9,119,119
912,7,2,4,5,8,-77,-56,2,3,42,63
912,8,2,5,7,6,25,51,7,4,67,114
912,9,3,3,4,9,31,-64,8,0,98,50
912,10,3,4,5,8,-68,44,0,4,30,94
912,11,4,3,8,5,44,32,4,6,74,126
912,12,3,4,4,9,31,-55,5,1,105,71
912,13,4,3,6,7,42,34,7,5,147,105
912,14,3,3,8,5,-65,32,2,7,82,137
912,15,4,3,9,4,45,31,7,8,127,168
912,16,2,5,3,10,21,-45,8,3,148,123
912,17,3,3,4,9,31,36,9,9,179,159
912,18,4,3,7,6,-57,-67,2,2,122,92
912,19,3,4,4,9,31,45,3,7,153,137
912,20,2,4,5,8,23,-56,6,1,176,81
912,21,3,3,5,8,32,35,8,6,208,116
912,22,3,4,8,5,-65,41,3,7,143,157
912,23,2,5,3,10,21,-45,4,2,164,112
912,24,2,6,3,10,21,64,5,6,185,176
912,25,2,4,6,7,24,43,9,9,209,219
912,26,3,3,6,7,-67,-66,2,3,142,153
912,27,2,5,6,7,24,52,6,5,166,205
912,28,3,4,5,8,32,44,8,9,198,249
912,29,3,4,5,8,-68,-56,0,3,130,193
912,30,4,3,8,5,44,32,4,5,174,225
912,31,5,2,8,5,53,23,7,8,227,248
912,32,3,3,5,8,32,-65,9,3,259,183
912,33,4,2,10,3,-54,21,5,4,205,204
912,34,3,3,7,6,34,33,9,7,239,237
912,35,4,3,8,5,-56,32,3,9,183,269
912,36,4,3,7,6,43,-67,6,2,226,202
912,37,2,4,5,8,23,44,9,6,249,246
912,38,4,2,7,6,-57,-76,2,0,192,170
912,39,2,4,7,6,25,42,7,2,217,212
912,40,4,2,9,4,-55,22,2,4,162,234
912,41,3,4,4,9,31,45,3,9,193,279
912,42,2,5,4,9,22,-46,5,3,215,233
912,43,2,5,2,11,20,56,5,9,235,289
912,44,3,4,7,6,34,-58,9,1,269,231
912,45,2,5,4,9,-78,54,1,5,191,285
912,46,4,3,7,6,43,33,4,8,234,318
912,47,3,3,6,7,33,-66,7,2,267,252
912,48,5,3,8,5,-47,32,0,4,220,284
912,49,3,4,4,9,31,45,1,9,251,329
912,50,2,5,6,7,24,-48,5,1,275,281
912,51,2,6,4,9,22,63,7,4,297,344
912,52,3,3,5,8,32,35,9,9,329,379
912,53,4,2,9,4,-55,-78,4,1,274,301
912,54,3,3,6,7,33,34,7,5,307,335
912,55,3,4,4,9,31,-55,8,0,338,280
912,56,4,3,7,6,-57,33,1,3,281,313
912,57,4,2,7,6,43,24,4,7,324,337
912,58,4,3,8,5,44,32,8,9,368,369
912,59,3,3,7,6,-66,-67,2,2,302,302
912,60,4,2,7,6,43,24,5,6,345,326
912,61,3,3,8,5,-65,32,0,8,280,358
912,62,2,4,6,7,24,-57,4,1,304,301
912,63,2,5,2,11,20,56,4,7,324,357
912,64,4,2,11,2,-53,20,1,7,271,377
912,65,3,4,8,5,35,41,6,8,306,418
912,66,3,3,5,8,32,-65,8,3,338,353
912,67,2,4,7,6,-75,42,3,5,263,395
912,68,4,3,6,7,42,34,5,9,305,429
912,69,3,4,6,7,33,-57,8,2,338,372
912,70,5,2,11,2,-44,20,4,2,294,392
912,71,3,4,6,7,33,43,7,5,327,435
912,72,2,5,4,9,22,54,9,9,349,489
912,73,2,4,4,9,-78,-55,1,4,271,434
912,74,2,4,9,4,27,40,8,4,298,474
912,75,2,4,3,10,21,-54,9,0,319,420
912,76,3,4,4,9,-69,45,0,5,250,465
912,77,2,4,5,8,23,44,3,9,273,509
913,1,4,2,9,4,45,22,5,2,45,22
913,2,3,3,7,6,34,33,9,5,79,55
913,3,3,4,5,8,-68,44,1,9,11,99
913,4,3,4,5,8,32,-56,3,3,43,43
913,5,3,3,9,4,36,31,9,4,79,74
913,6,3,4,6,7,-67,43,2,7,12,117
913,7,4,2,8,5,44,-77,6,0,56,40
913,8,4,2,7,6,43,24,9,4,99,64
913,9,4,3,6,7,-58,34,1,8,41,98
913,10,5,2,10,3,55,21,6,9,96,119
913,11,5,3,9,4,-46,-69,0,0,50,50
913,12,4,2,7,6,43,24,3,4,93,74
913,13,5,2,8,5,53,23,6,7,146,97
913,14,5,3,5,8,50,-65,6,2,196,32
913,15,3,4,6,7,33,43,9,5,229,75
913,16,3,4,5,8,-68,44,1,9,161,119
913,17,4,3,8,5,44,-68,5,1,205,51
913,18,4,3,8,5,44,32,9,3,249,83
913,19,3,4,8,5,-65,41,4,4,184,124
913,20,2,4,3,10,21,-54,5,0,205,70
913,21,3,3,8,5,-65,32,0,2,140,102
913,22,3,3,7,6,34,33,4,5,174,135
913,23,4,2,9,4,45,22,9,7,219,157
913,24,3,4,5,8,-68,-56,1,1,151,101
913,25,4,3,9,4,45,31,6,2,196,132
913,26,2,5,4,9,22,54,8,6,218,186
913,27,4,2,9,4,-55,22,3,8,163,208
913,28,3,3,6,7,33,-66,6,2,196,142
913,29,2,4,6,7,-76,43,0,5,120,185
913,30,2,5,3,10,21,-45,1,0,141,140
913,31,4,2,10,3,46,21,7,1,187,161
913,32,2,4,6,7,-76,43,1,4,111,204
913,33,4,3,9,4,45,31,6,5,156,235
913,34,4,3,8,5,-56,32,0,7,100,267
913,35,3,3,3,10,30,-63,0,4,130,204
913,36,2,4,3,10,21,-54,1,0,151,150
913,37,5,3,8,5,53,32,4,2,204,182
913,38,4,3,7,6,43,33,7,5,247,215
913,39,4,3,8,5,-56,32,1,7,191,247
913,40,4,3,9,4,45,31,6,8,236,278
913,41,3,3,7,6,-66,-67,0,1,170,211
913,42,4,4,8,5,44,41,4,2,214,252
913,43,2,4,8,5,-74,41,0,3,140,293
913,44,5,2,11,2,56,20,6,3,196,313
913,45,4,3,9,4,-55,31,1,4,141,344
913,46,5,2,10,3,55,21,6,5,196,365
913,47,2,4,3,10,21,-54,7,1,217,311
913,48,4,3,5,8,41,35,8,6,258,346
913,49,3,4,5,8,-68,-56,0,0,190,290
913,50,4,3,7,6,43,33,3,3,233,323
913,51,2,4,6,7,24,43,7,6,257,366
913,52,2,4,7,6,-75,42,2,8,182,408
913,53,5,2,11,2,56,20,8,8,238,428
913,54,4,3,9,4,-55,31,3,9,183,459
913,55,4,4,8,5,44,-59,7,0,227,400
913,56,2,5,5,8,-77,53,0,3,150,453
913,57,3,4,7,6,34,42,4,5,184,495
913,58,2,4,6,7,24,43,8,8,208,538
914,1,4,2,9,4,45,22,5,2,45,22
914,2,3,4,5,8,32,44,7,6,77,66
914,3,4,3,7,6,-57,33,0,9,20,99
914,4,4,3,5,8,41,-65,1,4,61,34
914,5,3,3,6,7,33,34,4,8,94,68
914,6,6,2,10,3,64,21,8,9,158,89
914,7,3,3,9,4,-64,-69,4,0,94,20
914,8,4,3,6,7,42,34,6,4,136,54
914,9,3,4,5,8,32,44,8,8,168,98
914,10,5,2,10,3,-45,21,3,9,123,119
914,11,3,3,6,7,33,-66,6,3,156,53
914,12,2,4,5,8,23,44,9,7,179,97
914,13,2,5,3,10,-79,-45,0,2,100,52
914,14,4,3,8,5,44,32,4,4,144,84
914,15,4,3,8,5,44,32,8,6,188,116
914,16,4,2,7,6,-57,-76,1,0,131,40
914,17,4,3,8,5,44,32,5,2,175,72
914,18,2,5,3,10,21,55,6,7,196,127
914,19,4,2,7,6,43,-76,9,1,239,51
914,20,5,2,9,4,-46,22,3,3,193,73
914,21,4,3,7,6,43,33,6,6,236,106
914,22,3,3,7,6,-66,33,0,9,170,139
914,23,3,3,5,8,32,-65,2,4,202,74
914,24,3,3,7,6,34,33,6,7,236,107
914,25,2,4,7,6,-75,42,1,9,161,149
914,26,5,2,10,3,55,-79,6,0,216,70
914,27,2,5,2,11,20,56,6,6,236,126
914,28,4,3,8,5,-56,32,0,8,180,158
914,29,2,5,4,9,22,-46,2,2,202,112
914,30,3,4,6,7,33,43,5,5,235,155
914,31,4,3,6,7,42,34,7,9,277,189
914,32,2,5,4,9,22,-46,9,3,299,143
914,33,4,2,5,8,-59,26,0,9,240,169
914,34,2,5,2,11,20,-44,0,5,260,125
914,35,3,3,8,5,35,32,5,7,295,157
914,36,2,5,4,9,22,-46,7,1,317,111
914,37,3,3,6,7,-67,34,0,5,250,145
914,38,3,3,6,7,33,34,3,9,283,179
914,39,4,3,8,5,44,-68,7,1,327,111
914,40,3,4,5,8,32,44,9,5,359,155
914,41,4,3,6,7,-58,34,1,9,301,189
914,42,3,3,8,5,35,-68,6,1,336,121
914,43,3,4,8,5,-65,41,1,2,271,162
914,44,3,3,8,5,35,32,6,4,306,194
914,45,3,3,6,7,33,34,9,8,339,228
914,46,3,3,7,6,-66,-67,3,1,273,161
914,47,3,3,3,10,30,37,3,8,303,198
914,48,3,4,5,8,32,-56,5,2,335,142
914,49,3,4,5,8,32,44,7,6,367,186
914,50,2,5,5,8,-77,53,0,9,290,239
914,51,4,3,8,5,44,-68,4,1,334,171
914,52,2,4,5,8,23,44,7,5,357,215
914,53,3,3,5,8,32,-65,9,0,389,150
914,54,4,3,9,4,-55,31,4,1,334,181
914,55,3,4,5,8,32,44,6,5,366,225
914,56,5,2,7,6,52,24,8,9,418,249
914,57,2,4,4,9,-78,-55,0,4,340,194
914,58,4,3,5,8,41,35,1,9,381,229
914,59,3,4,5,8,32,-56,3,3,413,173
914,60,3,4,7,6,34,42,7,5,447,215
914,61,5,2,8,5,-47,23,0,8,400,238
914,62,2,4,4,9,22,-55,2,3,422,183
914,63,3,3,9,4,36,31,8,4,458,214
914,64,2,4,5,8,-77,44,1,8,381,258
914,65,4,3,7,6,43,-67,4,1,424,191
914,66,3,4,6,7,33,43,7,4,457,234
914,67,3,3,6,7,-67,34,0,8,390,268
914,68,4,3,9,4,45,31,5,9,435,299
914,69,4,3,6,7,42,-66,7,3,477,233
914,70,4,2,6,7,42,25,9,8,519,258
915,1,2,5,3,10,21,55,1,5,21,55
915,2,5,2,6,7,51,-75,2,0,72,-20
915,3,3,4,5,8,32,44,4,4,104,24
915,4,2,4,6,7,24,43,8,7,128,67
915,5,3,3,5,8,-68,-65,0,2,60,2
915,6,4,3,4,9,40,36,0,8,100,38
915,7,2,5,5,8,23,-47,3,1,123,-9
915,8,2,4,3,10,21,46,4,7,144,37
915,9,4,3,7,6,43,-67,7,0,187,-30
915,10,4,2,9,4,-55,22,2,2,132,-8
915,11,3,4,6,7,33,43,5,5,165,35
915,12,3,3,5,8,32,-65,7,0,197,-30
915,13,6,2,10,3,-36,21,1,1,161,-9
915,14,4,4,5,8,41,44,2,5,202,35
915,15,2,4,6,7,24,43,6,8,226,78
915,16,3,3,5,8,32,-65,8,3,258,13
915,17,2,5,3,10,21,55,9,8,279,68
915,18,3,3,6,7,-67,-66,2,2,212,2
915,19,3,3,7,6,34,33,6,5,246,35
915,20,3,4,6,7,33,43,9,8,279,78
915,21,3,3,7,6,-66,-67,3,1,213,11
915,22,2,5,4,9,22,54,5,5,235,65
915,23,4,3,6,7,42,34,7,9,277,99
915,24,2,5,8,5,-74,50,3,9,203,149
915,25,3,4,5,8,32,-56,5,3,235,93
915,26,3,3,6,7,33,34,8,7,268,127
915,27,4,3,6,7,-58,-66,0,1,210,61
915,28,3,3,5,8,32,35,2,6,242,96
915,29,3,4,6,7,33,43,5,9,275,139
915,30,5,2,10,3,-45,-79,0,0,230,60
915,31,3,5,6,7,33,52,3,2,263,112
915,32,3,3,5,8,32,35,5,7,295,147
915,33,3,3,6,7,33,-66,8,1,328,81
915,34,2,5,3,10,21,55,9,6,349,136
915,35,2,5,3,10,-79,-45,0,1,270,91
915,36,2,4,7,6,25,42,5,3,295,133
915,37,2,4,6,7,24,43,9,6,319,176
915,38,4,4,4,9,40,-55,9,1,359,121
915,39,3,4,7,6,-66,42,3,3,293,163
915,40,4,2,7,6,43,24,6,7,336,187
915,41,2,5,4,9,22,-46,8,1,358,141
915,42,3,3,6,7,-67,34,1,5,291,175
915,43,4,2,6,7,42,-75,3,0,333,100
915,44,4,2,6,7,42,25,5,5,375,125
915,45,2,4,5,8,23,44,8,9,398,169
915,46,3,4,3,10,30,-54,8,5,428,115
915,47,2,4,4,9,-78,-55,0,0,350,60
915,48,5,2,8,5,53,23,3,3,403,83
915,49,3,4,5,8,32,44,5,7,435,127
915,50,2,5,5,8,23,-47,8,0,458,80
915,51,3,3,5,8,-68,35,0,5,390,115
915,52,3,3,7,6,34,33,4,8,424,148
915,53,2,5,4,9,22,-46,6,2,446,102
915,54,4,3,8,5,-56,32,0,4,390,134
915,55,3,3,6,7,33,34,3,8,423,168
915,56,4,4,9,4,45,40,8,8,468,208
915,57,5,2,11,2,-44,20,4,8,424,228
915,58,4,2,7,6,43,-76,7,2,467,152
915,59,2,5,3,10,21,55,8,7,488,207
915,60,6,2,11,2,-35,20,3,7,453,227
915,61,4,2,9,4,45,22,8,9,498,249
915,62,4,4,8,5,-56,-59,2,0,442,190
915,63,2,4,4,9,22,45,4,5,464,235
915,64,4,3,9,4,45,31,9,6,509,266
916,1,4,2,10,3,46,21,6,1,46,21
916,2,5,3,10,3,-45,30,1,1,1,51
916,3,4,3,8,5,44,32,5,3,45,83
916,4,3,3,5,8,32,35,7,8,77,118
916,5,3,3,4,9,31,-64,8,4,108,54
916,6,3,3,6,7,-67,34,1,8,41,88
916,7,4,2,5,8,41,-74,2,4,82,14
916,8,3,3,7,6,34,33,6,7,116,47
916,9,4,3,7,6,43,-67,9,0,159,-20
916,10,4,3,5,8,-59,35,0,5,100,15
916,11,2,4,6,7,24,43,4,8,124,58
916,12,5,2,9,4,54,-78,8,0,178,-20
916,13,2,5,6,7,-76,52,2,2,102,32
916,14,3,3,7,6,34,33,6,5,136,65
916,15,3,4,5,8,32,44,8,9,168,109
916,16,3,4,6,7,-67,-57,1,2,101,52
916,17,4,2,9,4,45,22,6,4,146,74
916,18,2,4,5,8,23,44,9,8,169,118
916,19,4,2,8,5,-56,-77,3,1,113,41
916,20,4,2,9,4,45,22,8,3,158,63
916,21,4,2,10,3,-54,21,4,4,104,84
916,22,3,4,8,5,35,41,9,5,139,125
916,23,5,2,8,5,-47,23,2,8,92,148
916,24,4,3,8,5,44,-68,6,0,136,80
916,25,2,6,3,10,21,64,7,4,157,144
916,26,5,2,9,4,-46,22,1,6,111,166
916,27,5,2,9,4,54,22,5,8,165,188
916,28,4,2,11,2,-53,20,2,8,112,208
916,29,3,4,7,6,34,-58,6,0,146,150
916,30,3,3,6,7,33,34,9,4,179,184
916,31,4,3,6,7,-58,34,1,8,121,218
916,32,2,4,3,10,21,-54,2,4,142,164
916,33,4,2,6,7,42,25,4,9,184,189
916,34,2,5,3,10,21,-45,5,4,205,144
916,35,2,4,5,8,23,44,8,8,228,188
916,36,2,5,2,11,20,-44,8,4,248,144
916,37,3,3,8,5,-65,32,3,6,183,176
916,38,4,3,4,9,40,-64,3,2,223,112
916,39,3,3,8,5,35,32,8,4,258,144
916,40,4,2,6,7,-58,25,0,9,200,169
916,41,3,4,5,8,32,-56,2,3,232,113
916,42,3,3,5,8,32,35,4,8,264,148
916,43,4,4,5,8,41,-56,5,2,305,92
916,44,2,4,4,9,22,45,7,7,327,137
916,45,3,4,7,6,-66,42,1,9,261,179
916,46,2,4,6,7,24,-57,5,2,285,122
916,47,4,3,8,5,44,32,9,4,329,154
916,48,2,4,4,9,-78,45,1,9,251,199
916,49,2,4,5,8,23,-56,4,3,274,143
916,50,2,4,5,8,23,44,7,7,297,187
916,51,6,2,10,3,-36,21,1,8,261,208
916,52,5,2,8,5,53,-77,4,1,314,131
916,53,2,5,5,8,23,53,7,4,337,184
916,54,3,4,8,5,-65,41,2,5,272,225
916,55,2,5,2,11,20,-44,2,1,292,181
916,56,3,3,8,5,35,32,7,3,327,213
916,57,4,2,11,2,-53,20,4,3,274,233
916,58,2,5,3,10,21,55,5,8,295,288
916,59,3,4,5,8,32,-56,7,2,327,232
916,60,4,3,5,8,41,35,8,7,368,267
916,61,4,3,6,7,-58,-66,0,1,310,201
916,62,4,2,9,4,45,22,5,3,355,223
916,63,3,3,6,7,33,34,8,7,388,257
916,64,2,4,3,10,21,-54,9,3,409,203
916,65,3,3,6,7,-67,34,2,7,342,237
916,66,2,4,3,10,21,-54,3,3,363,183
916,67,4,2,8,5,44,23,7,6,407,206
916,68,4,3,9,4,-55,31,2,7,352,237
916,69,3,4,6,7,33,-57,5,0,385,180
916,70,3,4,7,6,34,42,9,2,419,222
916,71,2,4,6,7,-76,43,3,5,343,265
916,72,5,2,9,4,54,22,7,7,397,287
916,73,5,2,10,3,-45,21,2,8,352,308
916,74,3,4,5,8,32,-56,4,2,384,252
916,75,2,5,5,8,23,53,7,5,407,305
916,76,3,4,5,8,32,44,9,9,439,349
916,77,3,3,6,7,-67,-66,2,3,372,283
916,78,3,4,8,5,35,41,7,4,407,324
916,79,2,5,5,8,-77,53,0,7,330,377
916,80,3,3,6,7,33,-66,3,1,363,311
916,81,3,5,6,7,33,52,6,3,396,363
916,82,4,3,8,5,-56,32,0,5,340,395
916,83,5,2,8,5,53,23,3,8,393,418
916,84,2,5,6,7,24,-48,7,0,417,370
916,85,3,4,5,8,32,44,9,4,449,414
916,86,4,2,9,4,-55,22,4,6,394,436
916,87,3,3,8,5,35,32,9,8,429,468
916,88,3,3,7,6,-66,-67,3,1,363,401
916,89,4,3,6,7,42,34,5,5,405,435
916,90,3,3,8,5,-65,32,0,7,340,467
916,91,5,2,9,4,54,22,4,9,394,489
916,92,3,3,6,7,33,-66,7,3,427,423
916,93,3,4,8,5,-65,41,2,4,362,464
916,94,3,3,4,9,31,-64,3,0,393,400
916,95,5,2,9,4,54,22,7,2,447,422
916,96,3,3,9,4,-64,31,3,3,383,453
916,97,3,4,7,6,34,42,7,5,417,495
916,98,4,3,8,5,-56,32,1,7,361,527
917,1,3,3,4,9,31,36,1,6,31,36
917,2,3,3,7,6,34,33,5,9,65,69
917,3,2,5,3,10,21,-45,6,4,86,24
917,4,5,2,6,7,51,25,7,9,137,49
917,5,5,2,10,3,-45,-79,2,0,92,-30
917,6,2,5,5,8,23,53,5,3,115,23
917,7,4,2,7,6,43,24,8,7,158,47
917,8,5,2,7,6,-48,-76,0,1,110,-29
917,9,3,3,5,8,32,35,2,6,142,6
917,10,4,2,7,6,43,-76,5,0,185,-70
917,11,4,2,7,6,43,24,8,4,228,-46
917,12,3,4,4,9,31,45,9,9,259,-1
917,13,5,2,8,5,-47,-77,2,2,212,-78
917,14,3,4,5,8,32,44,4,6,244,-34
917,15,2,4,6,7,24,43,8,9,268,9
917,16,2,4,4,9,-78,-55,0,4,190,-46
917,17,2,5,2,11,20,-44,0,0,210,-90
917,18,2,6,2,11,20,65,0,5,230,-25
917,19,4,2,10,3,46,21,6,6,276,-4
917,20,3,3,6,7,33,-66,9,0,309,-70
917,21,2,5,4,9,-78,54,1,4,231,-16
917,22,3,4,4,9,31,45,2,9,262,29
917,23,4,2,9,4,45,-78,7,1,307,-49
917,24,3,4,7,6,-66,42,1,3,241,-7
917,25,4,3,9,4,45,31,6,4,286,24
917,26,4,3,5,8,41,35,7,9,327,59
917,27,2,5,5,8,-77,-47,0,2,250,12
917,28,4,2,8,5,44,23,4,5,294,35
917,29,3,3,5,8,32,-65,6,0,326,-30
917,30,4,3,8,5,-56,32,0,2,270,2
917,31,3,3,8,5,35,32,5,4,305,34
917,32,4,3,9,4,-55,31,0,5,250,65
917,33,3,4,9,4,36,40,6,5,286,105
917,34,4,3,8,5,-56,32,0,7,230,137
917,35,4,2,8,5,44,-77,4,0,274,60
917,36,3,4,5,8,32,44,6,4,306,104
917,37,3,4,7,6,-66,42,0,6,240,146
917,38,4,3,8,5,44,32,4,8,284,178
917,39,2,4,4,9,22,-55,6,3,306,123
917,40,4,2,10,3,-54,21,2,4,252,144
917,41,3,3,7,6,34,33,6,7,286,177
917,42,3,4,4,9,31,-55,7,2,317,122
917,43,2,4,3,10,21,46,8,8,338,168
917,44,3,3,6,7,-67,-66,1,2,271,102
917,45,2,5,4,9,22,54,3,6,293,156
917,46,5,2,8,5,53,23,6,9,346,179
917,47,2,4,3,10,21,-54,7,5,367,125
917,48,3,3,6,7,-67,34,0,9,300,159
917,49,4,3,5,8,41,-65,1,4,341,94
917,50,5,2,10,3,55,21,6,5,396,115
917,51,3,4,6,7,33,43,9,8,429,158
917,52,3,4,5,8,-68,-56,1,2,361,102
917,53,2,4,6,7,24,43,5,5,385,145
917,54,4,3,5,8,41,-65,6,0,426,80
917,55,5,2,9,4,-46,22,0,2,380,102
917,56,2,5,2,11,20,56,0,8,400,158
917,57,2,5,5,8,23,-47,3,1,423,111
917,58,2,4,6,7,24,43,7,4,447,154
917,59,3,3,7,6,-66,33,1,7,381,187
917,60,5,2,9,4,54,22,5,9,435,209
917,61,2,5,6,7,24,-48,9,1,459,161
917,62,5,2,10,3,-45,21,4,2,414,182
917,63,4,2,7,6,43,24,7,6,457,206
917,64,5,2,9,4,-46,22,1,8,411,228
917,65,2,5,4,9,22,-46,3,2,433,182
917,66,2,5,6,7,24,52,7,4,457,234
917,67,4,3,9,4,-55,31,2,5,402,265
917,68,4,2,9,4,45,22,7,7,447,287
917,69,4,3,10,3,-54,30,3,7,393,317
917,70,3,3,8,5,35,32,8,9,428,349
917,71,3,4,7,6,-66,-58,2,1,362,291
917,72,4,3,7,6,43,33,5,4,405,324
917,73,2,4,4,9,22,45,7,9,427,369
917,74,3,3,6,7,-67,-66,0,3,360,303
917,75,3,3,7,6,34,33,4,6,394,336
917,76,2,5,6,7,24,52,8,8,418,388
917,77,3,3,4,9,31,-64,9,4,449,324
917,78,3,4,8,5,-65,41,4,5,384,365
917,79,2,4,5,8,23,44,7,9,407,409
917,80,3,4,8,5,-65,-59,2,0,342,350
917,81,5,2,9,4,54,22,6,2,396,372
917,82,3,4,7,6,-66,42,0,4,330,414
917,83,3,4,6,7,33,43,3,7,363,457
917,84,3,4,5,8,32,-56,5,1,395,401
917,85,3,3,5,8,32,35,7,6,427,436
917,86,2,5,4,9,22,-46,9,0,449,390
917,87,2,5,2,11,20,56,9,6,469,446
917,88,4,3,8,5,-56,32,3,8,413,478
917,89,4,2,8,5,44,-77,7,1,457,401
917,90,3,3,6,7,-67,34,0,5,390,435
917,91,3,3,9,4,36,31,6,6,426,466
917,92,3,3,4,9,31,-64,7,2,457,402
917,93,3,4,7,6,-66,42,1,4,391,444
917,94,2,4,4,9,22,45,3,9,413,489
917,95,3,4,5,8,32,-56,5,3,445,433
917,96,3,3,6,7,33,34,8,7,478,467
917,97,3,3,7,6,-66,-67,2,0,412,400
917,98,3,3,6,7,33,34,5,4,445,434
917,99,3,4,4,9,31,45,6,9,476,479
917,100,5,3,10,3,-45,30,1,9,431,509
918,1,3,4,7,6,34,42,4,2,34,42
918,2,3,4,4,9,31,45,5,7,65,87
918,3,2,5,4,9,22,-46,7,1,87,41
918,4,3,4,8,5,-65,41,2,2,22,82
918,5,4,3,9,4,45,31,7,3,67,113
918,6,4,3,7,6,-57,33,0,6,10,146
918,7,4,2,7,6,43,-76,3,0,53,70
918,8,2,4,5,8,23,44,6,4,76,114
918,9,3,4,6,7,33,43,9,7,109,157
918,10,2,5,4,9,-78,-46,1,1,31,111
918,11,4,2,7,6,43,24,4,5,74,135
918,12,3,4,5,8,32,44,6,9,106,179
918,13,5,2,9,4,-46,-78,0,1,60,101
918,14,2,4,5,8,23,44,3,5,83,145
918,15,2,4,7,6,25,42,8,7,108,187
918,16,3,4,5,8,-68,-56,0,1,40,131
918,17,5,2,11,2,56,20,6,1,96,151
918,18,2,5,2,11,20,56,6,7,116,207
918,19,5,2,8,5,53,-77,9,0,169,130
918,20,3,3,7,6,-66,33,3,3,103,163
918,21,4,2,9,4,45,22,8,5,148,185
918,22,2,4,7,6,-75,42,3,7,73,227
918,23,5,3,8,5,53,32,6,9,126,259
918,24,5,3,7,6,52,-67,8,2,178,192
918,25,4,3,8,5,-56,32,2,4,122,224
918,26,3,4,6,7,33,43,5,7,155,267
918,27,3,3,5,8,32,-65,7,2,187,202
918,28,2,6,2,11,20,65,7,7,207,267
918,29,4,2,10,3,-54,21,3,8,153,288
918,30,5,2,10,3,55,21,8,9,208,309
918,31,3,3,5,8,-68,-65,0,4,140,244
918,32,3,3,6,7,33,34,3,8,173,278
918,33,2,4,7,6,25,-58,8,0,198,220
918,34,2,4,4,9,-78,45,0,5,120,265
918,35,3,4,5,8,32,44,2,9,152,309
918,36,3,5,7,6,34,-49,6,0,186,260
918,37,2,5,5,8,23,53,9,3,209,313
918,38,4,2,7,6,-57,24,2,7,152,337
918,39,4,3,7,6,43,-67,5,0,195,270
918,40,5,2,8,5,53,23,8,3,248,293
918,41,3,4,8,5,-65,41,3,4,183,334
918,42,2,5,4,9,22,54,5,8,205,388
918,43,4,2,8,5,44,-77,9,1,249,311
918,44,5,3,8,5,-47,32,2,3,202,343
918,45,4,4,5,8,41,44,3,7,243,387
918,46,3,3,6,7,33,-66,6,1,276,321
918,47,5,3,6,7,51,34,7,5,327,355
918,48,4,3,6,7,42,34,9,9,369,389
918,49,6,2,9,4,-37,-78,2,1,332,311
918,50,3,3,9,4,36,31,8,2,368,342
918,51,3,4,6,7,-67,43,1,5,301,385
918,52,4,2,8,5,44,23,5,8,345,408
918,53,5,3,9,4,54,31,9,9,399,439
918,54,3,4,5,8,-68,-56,1,3,331,383
918,55,3,3,6,7,33,34,4,7,364,417
918,56,4,2,6,7,42,-75,6,2,406,342
918,57,4,4,9,4,-55,40,1,2,351,382
918,58,5,2,11,2,56,20,7,2,407,402
918,59,2,4,7,6,-75,42,2,4,332,444
918,60,4,2,9,4,45,22,7,6,377,466
918,61,3,4,5,8,32,-56,9,0,409,410
918,62,5,2,10,3,-45,21,4,1,364,431
918,63,4,2,8,5,44,23,8,4,408,454
918,64,2,5,6,7,-76,52,2,6,332,506
919,1,3,4,7,6,34,42,4,2,34,42
919,2,4,4,9,4,45,40,9,2,79,82
919,3,4,3,9,4,-55,31,4,3,24,113
919,4,4,3,6,7,42,34,6,7,66,147
919,5,5,2,10,3,-45,21,1,8,21,168
919,6,2,4,4,9,22,-55,3,3,43,113
919,7,2,4,8,5,26,41,9,4,69,154
919,8,4,3,6,7,-58,34,1,8,11,188
919,9,4,3,6,7,42,-66,3,2,53,122
919,10,4,3,9,4,45,31,8,3,98,153
919,11,2,4,8,5,-74,41,4,4,24,194
919,12,3,3,6,7,33,34,7,8,57,228
919,13,6,2,8,5,62,-77,9,1,119,151
919,14,3,3,7,6,-66,33,3,4,53,184
919,15,4,3,7,6,43,33,6,7,96,217
919,16,4,3,5,8,41,-65,7,2,137,152
919,17,2,5,5,8,-77,53,0,5,60,205
919,18,2,5,4,9,22,54,2,9,82,259
919,19,4,4,9,4,45,40,7,9,127,299
919,20,2,4,7,6,-75,-58,2,1,52,241
919,21,4,2,7,6,43,24,5,5,95,265
919,22,3,4,7,6,34,42,9,7,129,307
919,23,3,3,6,7,-67,-66,2,1,62,241
919,24,4,2,7,6,43,24,5,5,105,265
919,25,2,4,7,6,-75,42,0,7,30,307
919,26,2,4,5,8,23,-56,3,1,53,251
919,27,3,3,7,6,34,33,7,4,87,284
919,28,3,4,7,6,-66,42,1,6,21,326
919,29,2,4,7,6,25,42,6,8,46,368
919,30,3,4,6,7,33,-57,9,1,79,311
919,31,3,3,5,8,-68,35,1,6,11,346
919,32,3,4,6,7,33,43,4,9,44,389
919,33,2,5,3,10,21,-45,5,4,65,344
919,34,3,3,6,7,33,34,8,8,98,378
919,35,3,4,7,6,-66,-58,2,0,32,320
919,36,4,3,6,7,42,34,4,4,74,354
919,37,3,4,7,6,34,42,8,6,108,396
919,38,2,4,5,8,-77,-56,1,0,31,340
919,39,3,3,5,8,32,35,3,5,63,375
919,40,4,4,5,8,41,44,4,9,104,419
919,41,4,2,9,4,45,-78,9,1,149,341
919,42,4,3,4,9,40,36,9,7,189,377
919,43,4,2,10,3,-54,21,5,8,135,398
919,44,2,4,4,9,22,-55,7,3,157,343
919,45,4,3,7,6,-57,33,0,6,100,376
919,46,4,3,8,5,44,32,4,8,144,408
919,47,3,3,8,5,35,-68,9,0,179,340
919,48,2,6,5,8,-77,62,2,2,102,402
919,49,4,2,8,5,44,23,6,5,146,425
919,50,5,2,7,6,52,24,8,9,198,449
919,51,4,3,8,5,-56,-68,2,1,142,381
919,52,3,3,5,8,32,35,4,6,174,416
919,53,4,2,10,3,-54,21,0,7,120,437
919,54,3,4,7,6,34,42,4,9,154,479
919,55,4,3,8,5,44,-68,8,1,198,411
919,56,3,4,5,8,-68,44,0,5,130,455
919,57,2,4,4,9,22,-55,2,0,152,400
919,58,4,2,6,7,42,25,4,5,194,425
919,59,2,5,6,7,24,52,8,7,218,477
919,60,2,5,6,7,-76,52,2,9,142,529
920,1,3,4,7,6,34,42,4,2,34,42
920,2,3,3,7,6,34,33,8,5,68,75
920,3,2,5,3,10,21,-45,9,0,89,30
920,4,2,4,6,7,-76,43,3,3,13,73
920,5,3,3,5,8,32,35,5,8,45,108
920,6,4,2,7,6,43,-76,8,2,88,32
920,7,4,3,8,5,-56,32,2,4,32,64
920,8,4,3,6,7,42,34,4,8,74,98
920,9,2,5,5,8,23,-47,7,1,97,51
920,10,2,4,5,8,-77,44,0,5,20,95
920,11,3,3,7,6,34,33,4,8,54,128
920,12,4,2,7,6,43,-76,7,2,97,52
920,13,4,3,10,3,-54,30,3,2,43,82
920,14,2,5,6,7,24,52,7,4,67,134
920,15,4,2,6,7,42,25,9,9,109,159
920,16,3,4,6,7,-67,-57,2,2,42,102
920,17,4,3,8,5,44,32,6,4,86,134
920,18,3,3,6,7,33,34,9,8,119,168
920,19,3,3,6,7,-67,-66,2,2,52,102
920,20,2,4,5,8,23,44,5,6,75,146
920,21,3,4,6,7,33,43,8,9,108,189
920,22,4,3,6,7,-58,-66,0,3,50,123
920,23,5,2,8,5,53,23,3,6,103,146
920,24,2,5,5,8,23,53,6,9,126,199
920,25,2,4,5,8,23,-56,9,3,149,143
920,26,4,2,8,5,-56,23,3,6,93,166
920,27,2,4,4,9,22,-55,5,1,115,111
920,28,5,2,7,6,52,24,7,5,167,135
920,29,3,3,9,4,-64,31,3,6,103,166
920,30,4,3,8,5,44,32,7,8,147,198
920,31,3,4,6,7,-67,-57,0,1,80,141
920,32,4,3,7,6,43,33,3,4,123,174
920,33,2,5,5,8,23,53,6,7,146,227
920,34,2,5,6,7,-76,52,0,9,70,279
920,35,5,2,8,5,53,-77,3,2,123,202
920,36,3,4,5,8,32,44,5,6,155,246
920,37,4,2,5,8,41,-74,6,2,196,172
920,38,2,5,6,7,-76,52,0,4,120,224
920,39,3,4,8,5,35,41,5,5,155,265
920,40,2,4,4,9,22,-55,7,0,177,210
920,41,2,4,5,8,-77,44,0,4,100,254
920,42,3,4,7,6,34,42,4,6,134,296
920,43,2,4,2,11,20,-53,4,3,154,243
920,44,2,4,5,8,23,44,7,7,177,287
920,45,2,6,3,10,21,-36,8,1,198,251
920,46,4,3,9,4,-55,31,3,2,143,282
920,47,2,6,4,9,22,63,5,5,165,345
920,48,4,2,9,4,-55,22,0,7,110,367
920,49,3,3,5,8,32,-65,2,2,142,302
920,50,3,4,4,9,31,45,3,7,173,347
920,51,6,2,8,5,62,-77,5,0,235,270
920,52,4,2,9,4,-55,22,0,2,180,292
920,53,3,3,4,9,31,36,1,8,211,328
920,54,4,3,9,4,45,31,6,9,256,359
920,55,3,4,5,8,32,-56,8,3,288,303
920,56,4,3,8,5,-56,32,2,5,232,335
920,57,3,4,5,8,32,44,4,9,264,379
920,58,4,2,10,3,-54,-79,0,0,210,300
920,59,4,2,8,5,44,23,4,3,254,323
920,60,3,3,7,6,34,33,8,6,288,356
920,61,4,2,6,7,-58,-75,0,1,230,281
920,62,2,4,4,9,22,45,2,6,252,326
920,63,4,3,9,4,45,31,7,7,297,357
920,64,4,3,6,7,42,-66,9,1,339,291
920,65,4,3,8,5,-56,32,3,3,283,323
920,66,3,4,6,7,33,43,6,6,316,366
920,67,2,4,6,7,-76,43,0,9,240,409
920,68,4,2,5,8,41,-74,1,5,281,335
920,69,2,4,5,8,23,44,4,9,304,379
920,70,5,2,10,3,55,-79,9,0,359,300
920,71,3,5,6,7,-67,52,2,2,292,352
920,72,2,6,4,9,22,63,4,5,314,415
920,73,3,3,7,6,34,33,8,8,348,448
920,74,5,2,10,3,-45,21,3,9,303,469
920,75,4,3,9,4,45,-69,8,0,348,400
920,76,2,5,4,9,-78,54,0,4,270,454
920,77,5,2,9,4,54,22,4,6,324,476
920,78,3,3,4,9,31,-64,5,2,355,412
920,79,4,2,9,4,-55,22,0,4,300,434
920,80,2,4,3,10,21,-54,1,0,321,380
920,81,5,2,10,3,55,21,6,1,376,401
920,82,4,2,8,5,-56,23,0,4,320,424
920,83,4,2,7,6,43,24,3,8,363,448
920,84,3,4,3,10,30,-54,3,4,393,394
920,85,3,3,6,7,33,34,6,8,426,428
920,86,4,3,8,5,-56,-68,0,0,370,360
920,87,4,3,3,10,-40,37,0,7,330,397
920,88,3,4,4,9,31,-55,1,2,361,342
920,89,2,5,3,10,21,55,2,7,382,397
920,90,3,3,6,7,33,-66,5,1,415,331
920,91,3,3,7,6,34,33,9,4,449,364
920,92,2,4,6,7,-76,43,3,7,373,407
920,93,3,3,6,7,33,-66,6,1,406,341
920,94,4,3,6,7,42,34,8,5,448,375
920,95,6,2,10,3,-36,21,2,6,412,396
920,96,3,3,7,6,34,33,6,9,446,429
920,97,4,2,7,6,43,-76,9,3,489,353
920,98,6,2,9,4,-37,22,2,5,452,375
920,99,4,2,8,5,44,23,6,8,496,398
920,100,4,3,9,4,-55,31,1,9,441,429
920,101,2,4,3,10,21,-54,2,5,462,375
920,102,4,2,10,3,46,21,8,6,508,396
921,1,4,2,10,3,46,21,6,1,46,21
921,2,4,3,8,5,-56,32,0,3,-10,53
921,3,3,4,5,8,32,44,2,7,22,97
921,4,2,5,3,10,21,-45,3,2,43,52
921,5,5,2,9,4,54,22,7,4,97,74
921,6,3,4,7,6,-66,42,1,6,31,116
921,7,2,4,4,9,22,-55,3,1,53,61
921,8,4,3,10,3,46,30,9,1,99,91
921,9,3,4,7,6,-66,42,3,3,33,133
921,10,3,3,5,8,32,35,5,8,65,168
921,11,2,4,9,4,-73,40,2,8,-8,208
921,12,4,3,4,9,40,-64,2,4,32,144
921,13,3,4,5,8,32,44,4,8,64,188
921,14,3,3,7,6,34,-67,8,1,98,121
921,15,3,3,6,7,-67,34,1,5,31,155
921,16,2,4,8,5,26,41,7,6,57,196
921,17,3,3,8,5,-65,32,2,8,-8,228
921,18,4,2,9,4,45,-78,7,0,37,150
921,19,4,3,9,4,-55,31,2,1,-18,181
921,20,5,2,9,4,54,22,6,3,36,203
921,21,3,3,9,4,-64,31,2,4,-28,234
921,22,4,3,7,6,43,33,5,7,15,267
921,23,3,3,5,8,32,-65,7,2,47,202
921,24,3,4,7,6,-66,42,1,4,-19,244
921,25,4,2,8,5,44,23,5,7,25,267
921,26,4,3,8,5,44,32,9,9,69,299
921,27,3,5,3,10,30,-45,9,4,99,254
921,28,4,3,7,6,-57,33,2,7,42,287
921,29,3,4,4,9,31,-55,3,2,73,232
921,30,5,2,11,2,56,20,9,2,129,252
921,31,2,4,7,6,-75,42,4,4,54,294
921,32,4,3,5,8,41,35,5,9,95,329
921,33,5,3,10,3,-45,30,0,9,50,359
921,34,2,5,5,8,23,-47,3,2,73,312
921,35,4,2,9,4,45,22,8,4,118,334
921,36,4,3,7,6,-57,33,1,7,61,367
921,37,3,4,4,9,31,-55,2,2,92,312
921,38,4,3,4,9,40,36,2,8,132,348
921,39,2,4,3,10,21,-54,3,4,153,294
921,40,2,4,2,11,20,-53,3,1,173,241
921,41,5,2,8,5,53,23,6,4,226,264
921,42,2,4,6,7,-76,43,0,7,150,307
921,43,3,4,4,9,31,-55,1,2,181,252
921,44,5,3,7,6,52,33,3,5,233,285
921,45,5,3,9,4,54,31,7,6,287,316
921,46,3,3,6,7,-67,-66,0,0,220,250
921,47,3,4,4,9,31,45,1,5,251,295
921,48,3,3,8,5,35,32,6,7,286,327
921,49,5,2,11,2,-44,20,2,7,242,347
921,50,4,3,6,7,42,-66,4,1,284,281
921,51,3,4,8,5,35,41,9,2,319,322
921,52,2,4,4,9,-78,45,1,7,241,367
921,53,4,3,8,5,44,32,5,9,285,399
921,54,2,5,3,10,21,-45,6,4,306,354
921,55,4,3,6,7,42,34,8,8,348,388
921,56,3,3,6,7,-67,-66,1,2,281,322
921,57,4,3,9,4,45,31,6,3,326,353
921,58,4,3,6,7,42,34,8,7,368,387
921,59,3,4,9,4,-64,40,4,7,304,427
921,60,2,5,2,11,20,-44,4,3,324,383
921,61,3,3,9,4,-64,31,0,4,260,414
921,62,3,3,6,7,33,34,3,8,293,448
921,63,4,3,9,4,45,31,8,9,338,479
921,64,4,3,8,5,-56,-68,2,1,282,411
921,65,4,3,8,5,44,32,6,3,326,443
921,66,3,4,3,10,30,46,6,9,356,489
921,67,2,5,5,8,23,-47,9,2,379,442
921,68,2,5,3,10,-79,55,0,7,300,497
921,69,3,3,8,5,35,32,5,9,335,529
922,1,3,3,7,6,34,33,4,3,34,33
922,2,5,2,10,3,55,21,9,4,89,54
922,3,4,2,9,4,-55,22,4,6,34,76
922,4,4,3,9,4,45,31,9,7,79,107
922,5,4,3,4,9,40,-64,9,3,119,43
922,6,2,5,5,8,-77,53,2,6,42,96
922,7,4,3,8,5,44,32,6,8,86,128
922,8,3,4,5,8,32,-56,8,2,118,72
922,9,3,3,5,8,-68,35,0,7,50,107
922,10,4,2,9,4,45,22,5,9,95,129
922,11,2,4,5,8,23,-56,8,3,118,73
922,12,2,5,2,11,20,56,8,9,138,129
922,13,4,3,7,6,-57,-67,1,2,81,62
922,14,3,3,5,8,32,35,3,7,113,97
922,15,4,2,8,5,44,-77,7,0,157,20
922,16,3,3,6,7,-67,34,0,4,90,54
922,17,3,4,3,10,30,-54,0,0,120,0
922,18,4,2,4,9,40,27,0,7,160,27
922,19,6,2,11,2,65,20,5,7,225,47
922,20,3,4,8,5,-65,41,0,8,160,88
922,21,3,3,7,6,34,-67,4,1,194,21
922,22,5,2,10,3,55,21,9,2,249,42
922,23,3,4,7,6,-66,42,3,4,183,84
922,24,4,3,9,4,45,31,8,5,228,115
922,25,3,4,5,8,-68,44,0,9,160,159
922,26,3,4,7,6,34,-58,4,1,194,101
922,27,3,4,7,6,34,42,8,3,228,143
922,28,3,4,5,8,-68,44,0,7,160,187
922,29,2,5,3,10,21,-45,1,2,181,142
922,30,3,3,7,6,34,33,5,5,215,175
922,31,4,3,6,7,42,34,7,9,257,209
922,32,4,2,7,6,-57,-76,0,3,200,133
922,33,4,2,7,6,43,24,3,7,243,157
922,34,4,4,7,6,43,42,6,9,286,199
922,35,2,4,9,4,-73,40,3,9,213,239
922,36,2,4,6,7,24,-57,7,2,237,182
922,37,4,4,6,7,42,43,9,5,279,225
922,38,3,3,4,9,-69,-64,0,1,210,161
922,39,3,3,9,4,36,31,6,2,246,192
922,40,3,3,7,6,-66,33,0,5,180,225
922,41,3,4,5,8,32,44,2,9,212,269
922,42,3,3,4,9,31,-64,3,5,243,205
922,43,5,2,11,2,56,20,9,5,299,225
922,44,3,4,6,7,-67,43,2,8,232,268
922,45,3,3,7,6,34,-67,6,1,266,201
922,46,2,5,6,7,-76,52,0,3,190,253
922,47,2,4,5,8,23,44,3,7,213,297
922,48,3,3,5,8,32,-65,5,2,245,232
922,49,3,4,6,7,33,43,8,5,278,275
922,50,3,3,8,5,-65,32,3,7,213,307
922,51,4,3,8,5,44,32,7,9,257,339
922,52,3,3,4,9,31,-64,8,5,288,275
922,53,3,4,7,6,-66,42,2,7,222,317
922,54,4,3,6,7,42,-66,4,1,264,251
922,55,3,4,8,5,35,41,9,2,299,292
922,56,5,3,7,6,-48,33,1,5,251,325
922,57,3,4,6,7,33,43,4,8,284,368
922,58,2,5,4,9,22,-46,6,2,306,322
922,59,2,5,2,11,20,56,6,8,326,378
922,60,4,3,7,6,43,-67,9,1,369,311
922,61,2,4,5,8,-77,44,2,5,292,355
922,62,2,4,2,11,20,-53,2,2,312,302
922,63,4,2,8,5,44,23,6,5,356,325
922,64,4,2,7,6,43,24,9,9,399,349
922,65,4,3,9,4,-55,-69,4,0,344,280
922,66,2,6,5,8,23,62,7,2,367,342
922,67,3,4,7,6,-66,42,1,4,301,384
922,68,2,5,2,11,20,-44,1,0,321,340
922,69,2,4,5,8,23,44,4,4,344,384
922,70,4,2,10,3,-54,21,0,5,290,405
922,71,4,3,6,7,42,34,2,9,332,439
922,72,2,4,7,6,25,-58,7,1,357,381
922,73,3,3,7,6,-66,33,1,4,291,414
922,74,2,4,4,9,22,45,3,9,313,459
922,75,4,4,7,6,43,-58,6,1,356,401
922,76,2,5,2,11,20,56,6,7,376,457
922,77,3,4,5,8,32,-56,8,1,408,401
922,78,2,4,4,9,-78,45,0,6,330,446
922,79,3,3,4,9,31,-64,1,2,361,382
922,80,4,3,9,4,45,31,6,3,406,413
922,81,5,3,6,7,51,34,7,7,457,447
922,82,3,3,5,8,32,-65,9,2,489,382
922,83,2,5,3,10,-79,55,0,7,410,437
922,84,4,3,7,6,43,-67,3,0,453,370
922,85,4,3,6,7,42,34,5,4,495,404
922,86,3,3,6,7,33,34,8,8,528,438
923,1,3,4,6,7,33,43,3,3,33,43
923,2,4,2,9,4,45,22,8,5,78,65
923,3,3,3,4,9,31,-64,9,1,109,1
923,4,3,4,4,9,-69,45,0,6,40,46
923,5,4,2,7,6,43,-76,3,0,83,-30
923,6,4,2,7,6,43,24,6,4,126,-6
923,7,4,4,8,5,-56,41,0,5,70,35
923,8,4,2,7,6,43,24,3,9,113,59
923,9,2,5,3,10,21,-45,4,4,134,14
923,10,3,4,6,7,33,43,7,7,167,57
923,11,4,3,6,7,42,-66,9,1,209,-9
923,12,3,3,6,7,-67,34,2,5,142,25
923,13,3,4,7,6,34,42,6,7,176,67
923,14,4,2,10,3,-54,21,2,8,122,88
923,15,5,2,9,4,54,-78,6,0,176,10
923,16,3,4,6,7,33,43,9,3,209,53
923,17,2,5,6,7,-76,52,3,5,133,105
923,18,6,2,11,2,65,20,8,5,198,125
923,19,2,5,4,9,-78,54,0,9,120,179
923,20,4,2,9,4,45,-78,5,1,165,101
923,21,3,4,7,6,34,42,9,3,199,143
923,22,3,3,4,9,-69,36,0,9,130,179
923,23,4,2,7,6,43,-76,3,3,173,103
923,24,2,5,2,11,20,56,3,9,193,159
923,25,4,3,8,5,44,-68,7,1,237,91
923,26,3,3,7,6,-66,33,1,4,171,124
923,27,3,4,5,8,32,44,3,8,203,168
923,28,2,5,5,8,23,-47,6,1,226,121
923,29,3,3,8,5,-65,32,1,3,161,153
923,30,4,3,6,7,42,34,3,7,203,187
923,31,3,3,7,6,34,-67,7,0,237,120
923,32,2,4,5,8,-77,44,0,4,160,164
923,33,3,3,5,8,32,35,2,9,192,199
923,34,5,2,7,6,52,-76,4,3,244,123
923,35,3,5,5,8,32,53,6,6,276,176
923,36,2,5,4,9,22,-46,8,0,298,130
923,37,4,3,6,7,-58,34,0,4,240,164
923,38,2,4,5,8,23,44,3,8,263,208
923,39,3,3,7,6,34,-67,7,1,297,141
923,40,5,2,9,4,-46,22,1,3,251,163
923,41,3,4,4,9,31,45,2,8,282,208
923,42,3,4,6,7,33,-57,5,1,315,151
923,43,3,4,6,7,33,43,8,4,348,194
923,44,2,5,6,7,-76,52,2,6,272,246
923,45,3,5,6,7,33,52,5,8,305,298
923,46,3,3,6,7,33,-66,8,2,338,232
923,47,2,5,6,7,-76,52,2,4,262,284
923,48,3,3,4,9,31,-64,3,0,293,220
923,49,3,4,4,9,31,45,4,5,324,265
923,50,3,4,6,7,33,43,7,8,357,308
923,51,4,3,6,7,42,-66,9,2,399,242
923,52,4,3,7,6,-57,33,2,5,342,275
923,53,3,3,7,6,34,33,6,8,376,308
923,54,3,3,5,8,32,-65,8,3,408,243
923,55,4,4,5,8,41,44,9,7,449,287
923,56,4,3,9,4,-55,31,4,8,394,318
923,57,2,4,3,10,21,-54,5,4,415,264
923,58,5,2,11,2,-44,20,1,4,371,284
923,59,5,2,10,3,55,21,6,5,426,305
923,60,2,4,6,7,-76,43,0,8,350,348
923,61,3,4,4,9,31,-55,1,3,381,293
923,62,3,4,7,6,34,42,5,5,415,335
923,63,3,3,6,7,33,34,8,9,448,369
923,64,3,3,6,7,-67,-66,1,3,381,303
923,65,4,2,10,3,46,21,7,4,427,324
923,66,2,4,7,6,-75,42,2,6,352,366
923,67,3,4,5,8,32,-56,4,0,384,310
923,68,3,4,5,8,32,44,6,4,416,354
923,69,3,3,7,6,-66,33,0,7,350,387
923,70,4,2,7,6,43,-76,3,1,393,311
923,71,3,4,8,5,35,41,8,2,428,352
923,72,4,2,10,3,-54,21,4,3,374,373
923,73,3,3,8,5,35,32,9,5,409,405
923,74,4,4,8,5,-56,41,3,6,353,446
923,75,4,2,7,6,43,-76,6,0,396,370
923,76,5,2,8,5,53,23,9,3,449,393
923,77,2,4,7,6,-75,42,4,5,374,435
923,78,4,3,8,5,44,32,8,7,418,467
923,79,3,4,3,10,30,-54,8,3,448,413
923,80,2,4,5,8,-77,44,1,7,371,457
923,81,2,5,4,9,22,-46,3,1,393,411
923,82,3,3,5,8,32,35,5,6,425,446
923,83,4,2,8,5,44,23,9,9,469,469
923,84,4,3,8,5,-56,-68,3,1,413,401
923,85,2,4,6,7,24,43,7,4,437,444
923,86,4,3,7,6,-57,33,0,7,380,477
923,87,4,3,9,4,45,31,5,8,425,508
924,1,2,4,5,8,23,44,3,4,23,44
924,2,3,3,6,7,33,34,6,8,56,78
924,3,4,3,6,7,42,-66,8,2,98,12
924,4,4,2,8,5,-56,23,2,5,42,35
924,5,3,4,5,8,32,44,4,9,74,79
924,6,2,4,4,9,22,-55,6,4,96,24
924,7,3,3,6,7,33,34,9,8,129,58
924,8,3,3,7,6,-66,-67,3,1,63,-9
924,9,3,4,5,8,32,44,5,5,95,35
924,10,5,2,10,3,-45,21,0,6,50,56
924,11,4,3,9,4,45,31,5,7,95,87
924,12,3,4,6,7,33,-57,8,0,128,30
924,13,4,2,9,4,-55,22,3,2,73,52
924,14,2,6,3,10,21,64,4,6,94,116
924,15,2,6,3,10,21,-36,5,0,115,80
924,16,3,3,3,10,30,37,5,7,145,117
924,17,2,5,4,9,22,-46,7,1,167,71
924,18,4,3,9,4,-55,31,2,2,112,102
924,19,3,3,6,7,33,34,5,6,145,136
924,20,4,3,6,7,42,-66,7,0,187,70
924,21,4,2,7,6,-57,24,0,4,130,94
924,22,4,4,8,5,44,41,4,5,174,135
924,23,3,3,8,5,35,32,9,7,209,167
924,24,3,3,6,7,-67,-66,2,1,142,101
924,25,4,2,8,5,44,23,6,4,186,124
924,26,4,3,7,6,43,33,9,7,229,157
924,27,5,2,7,6,-48,-76,1,1,181,81
924,28,3,3,6,7,33,34,4,5,214,115
924,29,2,4,4,9,22,-55,6,0,236,60
924,30,3,4,7,6,-66,42,0,2,170,102
924,31,2,5,4,9,22,54,2,6,192,156
924,32,3,4,6,7,33,43,5,9,225,199
924,33,2,6,4,9,22,-37,7,2,247,162
924,34,2,4,4,9,22,45,9,7,269,207
924,35,3,4,5,8,-68,-56,1,1,201,151
924,36,2,4,5,8,23,44,4,5,224,195
924,37,4,3,5,8,41,-65,5,0,265,130
924,38,6,2,11,2,-35,20,0,0,230,150
924,39,4,2,7,6,43,24,3,4,273,174
924,40,5,2,8,5,53,23,6,7,326,197
924,41,3,3,3,10,30,-63,6,4,356,134
924,42,4,3,7,6,43,33,9,7,399,167
924,43,2,5,6,7,-76,52,3,9,323,219
924,44,4,2,8,5,44,-77,7,2,367,142
924,45,3,4,7,6,-66,42,1,4,301,184
924,46,3,3,6,7,33,34,4,8,334,218
924,47,4,3,6,7,42,-66,6,2,376,152
924,48,5,2,8,5,53,23,9,5,429,175
924,49,3,3,7,6,-66,33,3,8,363,208
924,50,4,3,7,6,43,-67,6,1,406,141
924,51,2,5,7,6,-75,51,1,2,331,192
924,52,4,3,7,6,43,33,4,5,374,225
924,53,4,2,10,3,-54,21,0,6,320,246
924,54,5,2,8,5,53,23,3,9,373,269
924,55,4,3,9,4,45,-69,8,0,418,200
924,56,3,4,7,6,-66,42,2,2,352,242
924,57,2,4,8,5,26,41,8,3,378,283
924,58,4,4,6,7,-58,43,0,6,320,326
924,59,2,4,8,5,26,41,6,7,346,367
924,60,2,6,4,9,22,-37,8,0,368,330
924,61,4,3,8,5,-56,32,2,2,312,362
924,62,5,2,10,3,55,21,7,3,367,383
924,63,3,3,8,5,-65,32,2,5,302,415
924,64,2,6,3,10,21,64,3,9,323,479
924,65,4,3,8,5,44,-68,7,1,367,411
924,66,4,3,5,8,41,35,8,6,408,446
924,67,4,2,9,4,-55,22,3,8,353,468
924,68,3,3,9,4,36,31,9,9,389,499
924,69,4,3,6,7,-58,-66,1,3,331,433
924,70,3,3,4,9,31,36,2,9,362,469
924,71,3,3,7,6,34,-67,6,2,396,402
924,72,4,3,7,6,43,33,9,5,439,435
924,73,3,3,7,6,-66,33,3,8,373,468
924,74,4,3,7,6,43,-67,6,1,416,401
924,75,5,2,11,2,-44,20,2,1,372,421
924,76,2,5,3,10,21,55,3,6,393,476
924,77,4,2,5,8,41,-74,4,2,434,402
924,78,3,3,6,7,33,34,7,6,467,436
924,79,2,5,3,10,21,-45,8,1,488,391
924,80,5,2,9,4,-46,22,2,3,442,413
924,81,3,3,7,6,34,33,6,6,476,446
924,82,3,3,7,6,-66,33,0,9,410,479
924,83,2,4,4,9,22,-55,2,4,432,424
924,84,4,3,6,7,42,34,4,8,474,458
924,85,6,2,9,4,63,-78,7,0,537,380
925,1,3,4,9,4,36,40,6,0,36,40
925,2,4,3,7,6,43,33,9,3,79,73
925,3,4,3,8,5,-56,32,3,5,23,105
925,4,3,4,4,9,31,-55,4,0,54,50
925,5,3,3,9,4,-64,31,0,1,-10,81
925,6,4,2,11,2,47,20,7,1,37,101
925,7,3,3,7,6,-66,33,1,4,-29,134
925,8,4,2,8,5,44,23,5,7,15,157
925,9,2,4,7,6,-75,42,0,9,-60,199
925,10,4,2,8,5,44,-77,4,2,-16,122
925,11,3,4,6,7,33,43,7,5,17,165
925,12,4,2,10,3,-54,21,3,6,-37,186
925,13,3,3,6,7,33,-66,6,0,-4,120
925,14,4,3,9,4,-55,31,1,1,-59,151
925,15,4,2,7,6,43,24,4,5,-16,175
925,16,5,2,9,4,54,22,8,7,38,197
925,17,5,2,10,3,-45,21,3,8,-7,218
925,18,4,2,9,4,45,-78,8,0,38,140
925,19,2,6,4,9,-78,63,0,3,-40,203
925,20,3,3,4,9,31,36,1,9,-9,239
925,21,4,3,8,5,44,-68,5,1,35,171
925,22,4,2,10,3,-54,21,1,2,-19,192
925,23,4,3,6,7,42,34,3,6,23,226
925,24,2,5,6,7,24,52,7,8,47,278
925,25,2,4,7,6,-75,-58,2,0,-28,220
925,26,2,4,4,9,22,45,4,5,-6,265
925,27,2,4,5,8,23,44,7,9,17,309
925,28,5,2,8,5,-47,-77,0,2,-30,232
925,29,5,2,6,7,51,25,1,7,21,257
925,30,2,4,8,5,26,41,7,8,47,298
925,31,4,2,6,7,42,-75,9,3,89,223
925,32,4,3,4,9,40,36,9,9,129,259
925,33,3,3,8,5,-65,-68,4,1,64,191
925,34,2,4,6,7,24,43,8,4,88,234
925,35,4,3,7,6,-57,33,1,7,31,267
925,36,3,3,9,4,36,31,7,8,67,298
925,37,3,4,4,9,31,-55,8,3,98,243
925,38,2,4,7,6,-75,42,3,5,23,285
925,39,2,5,5,8,23,53,6,8,46,338
925,40,2,4,5,8,23,-56,9,2,69,282
925,41,3,3,6,7,-67,34,2,6,2,316
925,42,2,4,4,9,22,-55,4,1,24,261
925,43,2,4,5,8,23,44,7,5,47,305
925,44,4,2,9,4,-55,22,2,7,-8,327
925,45,4,2,6,7,42,-75,4,2,34,252
925,46,3,3,8,5,35,32,9,4,69,284
925,47,2,4,6,7,-76,43,3,7,-7,327
925,48,3,3,4,9,31,-64,4,3,24,263
925,49,3,3,6,7,33,34,7,7,57,297
925,50,4,3,9,4,-55,31,2,8,2,328
925,51,2,5,2,11,20,-44,2,4,22,284
925,52,4,3,6,7,42,34,4,8,64,318
925,53,2,4,5,8,23,-56,7,2,87,262
925,54,4,3,9,4,-55,31,2,3,32,293
925,55,3,4,5,8,32,44,4,7,64,337
925,56,5,2,8,5,53,-77,7,0,117,260
925,57,2,6,2,11,20,65,7,5,137,325
925,58,5,2,8,5,-47,23,0,8,90,348
925,59,4,3,5,8,41,-65,1,3,131,283
925,60,4,4,6,7,42,43,3,6,173,326
925,61,2,4,4,9,22,-55,5,1,195,271
925,62,3,4,6,7,33,43,8,4,228,314
925,63,4,3,7,6,-57,33,1,7,171,347
925,64,4,3,8,5,44,32,5,9,215,379
925,65,3,4,5,8,32,-56,7,3,247,323
925,66,5,2,7,6,52,24,9,7,299,347
925,67,4,3,4,9,40,-64,9,3,339,283
925,68,4,3,9,4,-55,31,4,4,284,314
925,69,3,3,8,5,35,32,9,6,319,346
925,70,3,3,8,5,-65,32,4,8,254,378
925,71,3,5,5,8,32,-47,6,1,286,331
925,72,3,3,5,8,32,35,8,6,318,366
925,73,2,6,3,10,21,-36,9,0,339,330
925,74,4,3,7,6,-57,33,2,3,282,363
925,75,4,2,9,4,45,22,7,5,327,385
925,76,3,3,9,4,-64,31,3,6,263,416
925,77,2,4,5,8,23,-56,6,0,286,360
925,78,2,4,5,8,23,44,9,4,309,404
925,79,4,2,6,7,-58,25,1,9,251,429
925,80,3,4,8,5,35,-59,6,0,286,370
925,81,3,4,7,6,-66,42,0,2,220,412
925,82,3,4,4,9,31,45,1,7,251,457
925,83,5,2,9,4,54,22,5,9,305,479
925,84,4,3,5,8,41,-65,6,4,346,414
925,85,2,5,6,7,-76,52,0,6,270,466
925,86,4,3,7,6,43,33,3,9,313,499
925,87,3,4,7,6,34,-58,7,1,347,441
925,88,3,4,5,8,32,44,9,5,379,485
925,89,4,3,6,7,-58,34,1,9,321,519
926,1,4,2,8,5,44,23,4,3,44,23
926,2,2,4,6,7,24,43,8,6,68,66
926,3,4,4,8,5,-56,41,2,7,12,107
926,4,4,3,8,5,44,32,6,9,56,139
926,5,4,3,8,5,-56,-68,0,1,0,71
926,6,5,3,8,5,53,32,3,3,53,103
926,7,3,4,6,7,33,43,6,6,86,146
926,8,4,3,5,8,41,-65,7,1,127,81
926,9,2,4,7,6,-75,42,2,3,52,123
926,10,3,4,6,7,33,43,5,6,85,166
926,11,5,3,7,6,52,33,7,9,137,199
926,12,4,3,9,4,-55,-69,2,0,82,130
926,13,3,4,6,7,33,43,5,3,115,173
926,14,3,3,6,7,33,34,8,7,148,207
926,15,5,2,9,4,-46,22,2,9,102,229
926,16,4,3,8,5,44,-68,6,1,146,161
926,17,5,2,10,3,-45,21,1,2,101,182
926,18,3,3,5,8,32,35,3,7,133,217
926,19,4,2,8,5,44,-77,7,0,177,140
926,20,4,3,8,5,-56,32,1,2,121,172
926,21,3,4,5,8,32,44,3,6,153,216
926,22,3,4,6,7,33,43,6,9,186,259
926,23,3,3,9,4,-64,-69,2,0,122,190
926,24,4,2,8,5,44,23,6,3,166,213
926,25,3,3,6,7,33,34,9,7,199,247
926,26,3,3,7,6,-66,-67,3,0,133,180
926,27,5,2,8,5,53,23,6,3,186,203
926,28,3,4,4,9,31,45,7,8,217,248
926,29,5,2,8,5,-47,-77,0,1,170,171
926,30,5,2,9,4,54,22,4,3,224,193
926,31,3,3,8,5,35,32,9,5,259,225
926,32,4,3,5,8,-59,-65,0,0,200,160
926,33,3,4,5,8,32,44,2,4,232,204
926,34,4,3,7,6,43,33,5,7,275,237
926,35,4,2,9,4,-55,22,0,9,220,259
926,36,4,2,9,4,45,-78,5,1,265,181
926,37,2,6,4,9,22,63,7,4,287,244
926,38,3,3,9,4,-64,31,3,5,223,275
926,39,2,4,7,6,25,42,8,7,248,317
926,40,2,4,6,7,-76,-57,2,0,172,260
926,41,3,5,4,9,31,54,3,4,203,314
926,42,3,4,3,10,30,-54,3,0,233,260
926,43,4,3,8,5,44,32,7,2,277,292
926,44,4,3,7,6,-57,33,0,5,220,325
926,45,3,3,6,7,33,34,3,9,253,359
926,46,2,4,6,7,24,-57,7,2,277,302
926,47,3,3,7,6,-66,33,1,5,211,335
926,48,3,4,8,5,35,41,6,6,246,376
926,49,4,2,7,6,43,-76,9,0,289,300
926,50,4,2,9,4,-55,22,4,2,234,322
926,51,3,3,7,6,34,33,8,5,268,355
926,52,2,4,5,8,-77,44,1,9,191,399
926,53,5,2,8,5,53,-77,4,2,244,322
926,54,2,5,4,9,22,54,6,6,266,376
926,55,3,4,7,6,-66,42,0,8,200,418
926,56,3,4,8,5,35,41,5,9,235,459
926,57,4,3,7,6,43,-67,8,2,278,392
926,58,3,3,5,8,-68,35,0,7,210,427
926,59,5,2,10,3,55,21,5,8,265,448
926,60,4,2,7,6,43,-76,8,2,308,372
926,61,3,3,8,5,-65,32,3,4,243,404
926,62,2,5,3,10,21,55,4,9,264,459
926,63,2,5,4,9,22,-46,6,3,286,413
926,64,2,6,2,11,20,65,6,8,306,478
926,65,2,5,6,7,-76,-48,0,0,230,430
926,66,5,2,10,3,55,21,5,1,285,451
926,67,3,3,7,6,34,33,9,4,319,484
926,68,3,4,3,10,30,-54,9,0,349,430
926,69,4,3,9,4,-55,31,4,1,294,461
926,70,2,5,3,10,21,55,5,6,315,516
927,1,3,4,6,7,33,43,3,3,33,43
927,2,3,4,6,7,33,43,6,6,66,86
927,3,3,3,6,7,33,-66,9,0,99,20
927,4,4,3,8,5,-56,32,3,2,43,52
927,5,5,2,8,5,53,23,6,5,96,75
927,6,3,4,5,8,32,44,8,9,128,119
927,7,2,5,3,10,21,-45,9,4,149,74
927,8,3,3,10,3,-63,30,6,4,86,104
927,9,3,3,6,7,33,34,9,8,119,138
927,10,3,3,7,6,-66,-67,3,1,53,71
927,11,4,3,5,8,41,35,4,6,94,106
927,12,3,4,3,10,30,-54,4,2,124,52
927,13,2,4,4,9,22,45,6,7,146,97
927,14,4,2,8,5,-56,-77,0,0,90,20
927,15,5,3,6,7,51,34,1,4,141,54
927,16,3,3,9,4,36,31,7,5,177,85
927,17,4,3,6,7,42,34,9,9,219,119
927,18,5,2,9,4,-46,-78,3,1,173,41
927,19,3,4,4,9,31,45,4,6,204,86
927,20,6,2,10,3,64,21,8,7,268,107
927,21,2,4,4,9,-78,-55,0,2,190,52
927,22,3,3,5,8,32,35,2,7,222,87
927,23,3,4,6,7,33,-57,5,0,255,30
927,24,4,2,6,7,42,25,7,5,297,55
927,25,4,3,10,3,-54,30,3,5,243,85
927,26,3,4,6,7,33,43,6,8,276,128
927,27,3,3,5,8,32,-65,8,3,308,63
927,28,3,3,8,5,-65,32,3,5,243,95
927,29,3,4,8,5,35,41,8,6,278,136
927,30,4,4,6,7,-58,43,0,9,220,179
927,31,5,2,9,4,54,-78,4,1,274,101
927,32,3,4,7,6,34,42,8,3,308,143
927,33,3,3,6,7,-67,34,1,7,241,177
927,34,5,2,10,3,55,21,6,8,296,198
927,35,3,3,6,7,33,-66,9,2,329,132
927,36,3,4,6,7,-67,43,2,5,262,175
927,37,2,5,5,8,23,53,5,8,285,228
927,38,4,3,7,6,43,-67,8,1,328,161
927,39,3,3,6,7,-67,34,1,5,261,195
927,40,4,2,8,5,44,23,5,8,305,218
927,41,2,4,7,6,-75,-58,0,0,230,160
927,42,2,4,5,8,23,44,3,4,253,204
927,43,3,4,4,9,31,45,4,9,284,249
927,44,2,4,7,6,25,-58,9,1,309,191
927,45,3,4,7,6,-66,42,3,3,243,233
927,46,4,3,7,6,43,33,6,6,286,266
927,47,3,3,6,7,33,-66,9,0,319,200
927,48,3,3,7,6,-66,33,3,3,253,233
927,49,4,4,7,6,43,42,6,5,296,275
927,50,4,3,7,6,43,33,9,8,339,308
927,51,3,3,6,7,-67,-66,2,2,272,242
927,52,3,4,6,7,33,43,5,5,305,285
927,53,5,2,8,5,53,23,8,8,358,308
927,54,5,2,7,6,-48,-76,0,2,310,232
927,55,4,3,6,7,42,34,2,6,352,266
927,56,4,3,10,3,46,30,8,6,398,296
927,57,4,2,7,6,-57,-76,1,0,341,220
927,58,2,4,8,5,26,41,7,1,367,261
927,59,5,2,10,3,-45,21,2,2,322,282
927,60,5,2,7,6,52,24,4,6,374,306
927,61,4,3,8,5,44,32,8,8,418,338
927,62,2,4,4,9,-78,-55,0,3,340,283
927,63,3,3,7,6,34,33,4,6,374,316
927,64,2,4,5,8,23,-56,7,0,397,260
927,65,2,6,4,9,22,63,9,3,419,323
927,66,3,3,5,8,-68,35,1,8,351,358
927,67,6,2,9,4,63,-78,4,0,414,280
927,68,2,5,4,9,22,54,6,4,436,334
927,69,6,2,11,2,-35,20,1,4,401,354
927,70,4,3,9,4,45,31,6,5,446,385
927,71,2,5,6,7,-76,52,0,7,370,437
927,72,3,3,5,8,32,-65,2,2,402,372
927,73,5,2,8,5,53,23,5,5,455,395
927,74,2,6,3,10,21,64,6,9,476,459
927,75,3,3,6,7,33,-66,9,3,509,393
928,1,2,4,6,7,24,43,4,3,24,43
928,2,3,4,4,9,31,45,5,8,55,88
928,3,3,3,6,7,33,-66,8,2,88,22
928,4,4,3,4,9,40,36,8,8,128,58
928,5,4,2,10,3,-54,21,4,9,74,79
928,6,4,2,7,6,43,-76,7,3,117,3
928,7,3,5,5,8,32,53,9,6,149,56
928,8,5,2,8,5,-47,23,2,9,102,79
928,9,4,2,8,5,44,-77,6,2,146,2
928,10,3,3,7,6,-66,33,0,5,80,35
928,11,4,3,9,4,45,31,5,6,125,66
928,12,4,3,5,8,41,-65,6,1,166,1
928,13,2,4,4,9,22,45,8,6,188,46
928,14,5,2,8,5,-47,23,1,9,141,69
928,15,2,4,5,8,23,-56,4,3,164,13
928,16,5,2,7,6,52,24,6,7,216,37
928,17,3,3,5,8,32,-65,8,2,248,-28
928,18,2,4,4,9,-78,45,0,7,170,17
928,19,2,5,3,10,21,-45,1,2,191,-28
928,20,3,3,9,4,36,31,7,3,227,3
928,21,5,2,10,3,-45,21,2,4,182,24
928,22,3,3,6,7,33,34,5,8,215,58
928,23,5,3,7,6,52,-67,7,1,267,-9
928,24,3,4,5,8,32,44,9,5,299,35
928,25,3,3,6,7,-67,34,2,9,232,69
928,26,3,3,9,4,36,-69,8,0,268,0
928,27,4,4,9,4,-55,40,3,0,213,40
928,28,3,5,4,9,31,54,4,4,244,94
928,29,4,3,9,4,45,31,9,5,289,125
928,30,4,3,6,7,-58,34,1,9,231,159
928,31,3,3,7,6,34,-67,5,2,265,92
928,32,5,2,8,5,53,23,8,5,318,115
928,33,3,3,9,4,-64,31,4,6,254,146
928,34,4,2,10,3,-54,21,0,7,200,167
928,35,3,3,10,3,37,30,7,7,237,197
928,36,4,3,7,6,-57,-67,0,0,180,130
928,37,3,3,5,8,32,35,2,5,212,165
928,38,3,3,5,8,32,-65,4,0,244,100
928,39,2,4,3,10,21,46,5,6,265,146
928,40,4,3,9,4,-55,31,0,7,210,177
928,41,3,4,8,5,35,41,5,8,245,218
928,42,2,4,7,6,-75,-58,0,0,170,160
928,43,2,4,3,10,21,46,1,6,191,206
928,44,2,5,5,8,23,53,4,9,214,259
928,45,3,3,7,6,34,-67,8,2,248,192
928,46,3,5,4,9,31,54,9,6,279,246
928,47,2,5,4,9,-78,-46,1,0,201,200
928,48,4,3,6,7,42,34,3,4,243,234
928,49,5,2,8,5,53,23,6,7,296,257
928,50,2,4,7,6,-75,42,1,9,221,299
928,51,4,3,6,7,42,-66,3,3,263,233
928,52,2,5,3,10,21,55,4,8,284,288
928,53,5,2,10,3,55,21,9,9,339,309
928,54,2,4,8,5,-74,-59,5,0,265,250
928,55,2,5,4,9,22,54,7,4,287,304
928,56,3,3,4,9,31,-64,8,0,318,240
928,57,2,4,7,6,-75,42,3,2,243,282
928,58,3,4,5,8,32,44,5,6,275,326
928,59,2,4,5,8,23,-56,8,0,298,270
928,60,3,3,6,7,-67,34,1,4,231,304
928,61,4,2,7,6,43,24,4,8,274,328
928,62,3,4,7,6,34,-58,8,0,308,270
928,63,4,3,7,6,-57,33,1,3,251,303
928,64,4,3,7,6,43,33,4,6,294,336
928,65,2,4,3,10,21,-54,5,2,315,282
928,66,2,4,7,6,-75,42,0,4,240,324
928,67,4,2,9,4,45,22,5,6,285,346
928,68,3,3,7,6,34,33,9,9,319,379
928,69,3,3,7,6,-66,-67,3,2,253,312
928,70,2,5,4,9,22,54,5,6,275,366
928,71,3,3,5,8,32,-65,7,1,307,301
928,72,4,4,8,5,-56,41,1,2,251,342
928,73,4,2,9,4,45,22,6,4,296,364
928,74,4,3,7,6,43,33,9,7,339,397
928,75,2,5,2,11,20,-44,9,3,359,353
928,76,3,4,6,7,-67,43,2,6,292,396
928,77,3,3,7,6,34,33,6,9,326,429
928,78,3,4,6,7,33,-57,9,2,359,372
928,79,3,3,8,5,-65,32,4,4,294,404
928,80,2,5,5,8,23,53,7,7,317,457
928,81,4,2,9,4,-55,22,2,9,262,479
928,82,3,4,4,9,31,-55,3,4,293,424
928,83,5,2,8,5,53,23,6,7,346,447
928,84,3,4,5,8,32,-56,8,1,378,391
928,85,3,3,5,8,-68,35,0,6,310,426
928,86,3,4,6,7,33,43,3,9,343,469
928,87,4,2,8,5,44,-77,7,2,387,392
928,88,4,4,6,7,42,43,9,5,429,435
928,89,3,3,4,9,-69,-64,0,1,360,371
928,90,2,5,5,8,23,53,3,4,383,424
928,91,4,3,6,7,42,34,5,8,425,458
928,92,2,5,4,9,22,-46,7,2,447,412
928,93,2,5,6,7,-76,52,1,4,371,464
928,94,4,3,6,7,42,34,3,8,413,498
928,95,4,3,6,7,42,-66,5,2,455,432
928,96,3,4,6,7,33,43,8,5,488,475
928,97,2,4,6,7,-76,43,2,8,412,518
929,1,2,4,3,10,21,46,1,6,21,46
929,2,3,3,9,4,36,31,7,7,57,77
929,3,4,2,7,6,-57,-76,0,1,0,1
929,4,4,3,7,6,43,33,3,4,43,34
929,5,5,2,11,2,56,20,9,4,99,54
929,6,2,5,4,9,-78,54,1,8,21,108
929,7,3,4,8,5,35,41,6,9,56,149
929,8,4,3,8,5,-56,-68,0,1,0,81
929,9,5,2,8,5,53,23,3,4,53,104
929,10,3,3,7,6,34,33,7,7,87,137
929,11,5,2,7,6,52,-76,9,1,139,61
929,12,3,3,6,7,-67,34,2,5,72,95
929,13,2,4,6,7,24,43,6,8,96,138
929,14,4,3,8,5,-56,-68,0,0,40,70
929,15,5,2,10,3,55,21,5,1,95,91
929,16,5,2,10,3,-45,21,0,2,50,112
929,17,3,3,6,7,33,34,3,6,83,146
929,18,3,3,8,5,35,32,8,8,118,178
929,19,2,5,2,11,20,-44,8,4,138,134
929,20,3,3,5,8,-68,35,0,9,70,169
929,21,2,4,3,10,21,-54,1,5,91,115
929,22,3,4,6,7,33,43,4,8,124,158
929,23,3,4,6,7,33,-57,7,1,157,101
929,24,2,5,4,9,22,54,9,5,179,155
929,25,4,2,6,7,-58,-75,1,0,121,80
929,26,5,2,11,2,56,20,7,0,177,100
929,27,3,3,7,6,-66,33,1,3,111,133
929,28,4,2,9,4,45,22,6,5,156,155
929,29,3,4,6,7,33,43,9,8,189,198
929,30,4,3,8,5,-56,-68,3,0,133,130
929,31,2,5,6,7,24,52,7,2,157,182
929,32,3,4,7,6,-66,42,1,4,91,224
929,33,5,2,10,3,55,21,6,5,146,245
929,34,4,3,8,5,-56,32,0,7,90,277
929,35,2,4,5,8,23,-56,3,1,113,221
929,36,2,4,4,9,22,45,5,6,135,266
929,37,3,4,7,6,34,42,9,8,169,308
929,38,3,4,8,5,-65,41,4,9,104,349
929,39,4,2,4,9,40,-73,4,6,144,276
929,40,3,4,6,7,33,43,7,9,177,319
929,41,2,4,4,9,22,-55,9,4,199,264
929,42,5,2,11,2,-44,20,5,4,155,284
929,43,4,3,9,4,-55,31,0,5,100,315
929,44,3,4,6,7,33,43,3,8,133,358
929,45,2,4,3,10,21,-54,4,4,154,304
929,46,2,4,4,9,22,45,6,9,176,349
929,47,5,2,10,3,-45,-79,1,0,131,270
929,48,5,2,10,3,55,21,6,1,186,291
929,49,4,2,6,7,42,25,8,6,228,316
929,50,2,4,5,8,-77,-56,1,0,151,260
929,51,3,4,6,7,33,43,4,3,184,303
929,52,4,2,9,4,45,22,9,5,229,325
929,53,4,4,8,5,-56,41,3,6,173,366
929,54,5,2,8,5,53,23,6,9,226,389
929,55,2,5,4,9,22,-46,8,3,248,343
929,56,5,2,9,4,-46,22,2,5,202,365
929,57,4,3,7,6,43,33,5,8,245,398
929,58,3,4,5,8,32,-56,7,2,277,342
929,59,2,4,4,9,22,45,9,7,299,387
929,60,2,5,3,10,-79,-45,0,2,220,342
929,61,2,5,3,10,21,55,1,7,241,397
929,62,2,4,6,7,24,-57,5,0,265,340
929,63,2,5,3,10,21,55,6,5,286,395
929,64,3,3,8,5,-65,32,1,7,221,427
929,65,2,5,3,10,21,-45,2,2,242,382
929,66,5,2,8,5,53,23,5,5,295,405
929,67,3,3,7,6,34,33,9,8,329,438
929,68,5,2,7,6,-48,-76,1,2,281,362
929,69,5,2,8,5,53,23,4,5,334,385
929,70,3,3,6,7,33,34,7,9,367,419
929,71,4,2,10,3,-54,-79,3,0,313,340
929,72,4,3,6,7,42,34,5,4,355,374
929,73,4,2,9,4,-55,22,0,6,300,396
929,74,2,4,4,9,22,-55,2,1,322,341
929,75,4,4,7,6,43,42,5,3,365,383
929,76,3,4,7,6,34,42,9,5,399,425
929,77,4,3,8,5,-56,32,3,7,343,457
929,78,2,5,3,10,21,-45,4,2,364,412
929,79,5,2,11,2,-44,20,0,2,320,432
929,80,2,5,6,7,24,52,4,4,344,484
929,81,2,6,5,8,23,62,7,6,367,546
930,1,2,5,3,10,21,55,1,5,21,55
930,2,2,4,4,9,22,-55,3,0,43,0
930,3,4,3,8,5,44,32,7,2,87,32
930,4,4,3,4,9,40,36,7,8,127,68
930,5,3,4,5,8,32,-56,9,2,159,12
930,6,4,2,6,7,-58,25,1,7,101,37
930,7,2,5,6,7,24,52,5,9,125,89
930,8,3,5,7,6,34,-49,9,0,159,40
930,9,6,2,9,4,-37,22,2,2,122,62
930,10,5,2,9,4,54,22,6,4,176,84
930,11,4,2,9,4,-55,22,1,6,121,106
930,12,4,3,7,6,43,33,4,9,164,139
930,13,3,4,7,6,34,-58,8,1,198,81
930,14,2,4,4,9,-78,45,0,6,120,126
930,15,3,3,8,5,35,32,5,8,155,158
930,16,3,3,8,5,-65,-68,0,0,90,90
930,17,3,3,6,7,33,34,3,4,123,124
930,18,2,5,6,7,24,52,7,6,147,176
930,19,3,3,7,6,-66,33,1,9,81,209
930,20,2,5,4,9,22,-46,3,3,103,163
930,21,5,3,9,4,54,31,7,4,157,194
930,22,4,2,7,6,-57,24,0,8,100,218
930,23,2,4,7,6,25,-58,5,0,125,160
930,24,3,3,8,5,-65,32,0,2,60,192
930,25,4,2,9,4,45,22,5,4,105,214
930,26,4,3,8,5,44,32,9,6,149,246
930,27,4,2,9,4,-55,22,4,8,94,268
930,28,4,3,5,8,41,-65,5,3,135,203
930,29,3,3,6,7,33,34,8,7,168,237
930,30,3,3,9,4,-64,31,4,8,104,268
930,31,3,5,5,8,32,-47,6,1,136,221
930,32,5,2,7,6,52,24,8,5,188,245
930,33,4,3,7,6,-57,33,1,8,131,278
930,34,4,3,6,7,42,-66,3,2,173,212
930,35,4,3,6,7,42,34,5,6,215,246
930,36,3,3,4,9,31,-64,6,2,246,182
930,37,4,4,8,5,-56,41,0,3,190,223
930,38,3,4,6,7,33,43,3,6,223,266
930,39,2,4,5,8,23,-56,6,0,246,210
930,40,2,4,5,8,23,44,9,4,269,254
930,41,4,2,8,5,-56,23,3,7,213,277
930,42,4,3,7,6,43,-67,6,0,256,210
930,43,3,4,9,4,-64,40,2,0,192,250
930,44,4,3,8,5,44,32,6,2,236,282
930,45,4,2,8,5,-56,23,0,5,180,305
930,46,4,4,6,7,42,43,2,8,222,348
930,47,2,5,4,9,22,-46,4,2,244,302
930,48,3,3,7,6,34,33,8,5,278,335
930,49,2,5,3,10,21,-45,9,0,299,290
930,50,4,3,9,4,-55,31,4,1,244,321
930,51,4,3,8,5,44,32,8,3,288,353
930,52,3,5,3,10,30,55,8,8,318,408
930,53,4,3,7,6,-57,-67,1,1,261,341
930,54,3,3,7,6,34,33,5,4,295,374
930,55,4,3,4,9,40,-64,5,0,335,310
930,56,3,4,8,5,-65,41,0,1,270,351
930,57,3,3,6,7,33,34,3,5,303,385
930,58,2,5,4,9,22,54,5,9,325,439
930,59,3,3,4,9,31,-64,6,5,356,375
930,60,3,4,6,7,33,43,9,8,389,418
930,61,4,3,5,8,-59,-65,0,3,330,353
930,62,3,4,7,6,34,42,4,5,364,395
930,63,3,3,5,8,32,-65,6,0,396,330
930,64,4,3,8,5,-56,32,0,2,340,362
930,65,3,4,8,5,35,41,5,3,375,403
930,66,2,4,4,9,22,45,7,8,397,448
930,67,2,4,6,7,-76,-57,1,1,321,391
930,68,3,3,6,7,33,34,4,5,354,425
930,69,4,2,10,3,-54,21,0,6,300,446
930,70,6,2,8,5,62,23,2,9,362,469
930,71,3,3,8,5,35,-68,7,1,397,401
930,72,4,3,7,6,-57,33,0,4,340,434
930,73,4,2,6,7,42,25,2,9,382,459
930,74,4,2,6,7,42,-75,4,4,424,384
930,75,3,4,7,6,34,42,8,6,458,426
930,76,3,3,6,7,-67,-66,1,0,391,360
930,77,5,2,8,5,53,23,4,3,444,383
930,78,2,4,4,9,22,45,6,8,466,428
930,79,5,2,10,3,-45,21,1,9,421,449
930,80,3,3,8,5,35,-68,6,1,456,381
930,81,3,4,7,6,-66,42,0,3,390,423
930,82,3,4,6,7,33,43,3,6,423,466
930,83,3,3,8,5,35,32,8,8,458,498
930,84,5,2,8,5,-47,-77,1,1,411,421
930,85,4,3,5,8,41,35,2,6,452,456
930,86,3,4,5,8,32,-56,4,0,484,400
930,87,4,3,8,5,44,32,8,2,528,432
931,1,2,5,4,9,22,54,2,4,22,54
931,2,2,4,4,9,22,45,4,9,44,99
931,3,4,3,7,6,43,-67,7,2,87,32
931,4,5,2,11,2,-44,20,3,2,43,52
931,5,5,2,8,5,53,23,6,5,96,75
931,6,3,4,8,5,-65,41,1,6,31,116
931,7,5,2,9,4,54,22,5,8,85,138
931,8,6,2,10,3,64,21,9,9,149,159
931,9,3,4,7,6,-66,-58,3,1,83,101
931,10,2,4,6,7,24,43,7,4,107,144
931,11,3,4,6,7,-67,43,0,7,40,187
931,12,4,3,5,8,41,-65,1,2,81,122
931,13,2,4,6,7,24,43,5,5,105,165
931,14,3,3,7,6,34,33,9,8,139,198
931,15,5,2,10,3,-45,21,4,9,94,219
931,16,3,3,5,8,32,-65,6,4,126,154
931,17,4,3,6,7,42,34,8,8,168,188
931,18,3,4,8,5,-65,41,3,9,103,229
931,19,4,2,6,7,42,-75,5,4,145,154
931,20,4,3,6,7,42,34,7,8,187,188
931,21,4,4,6,7,42,-57,9,1,229,131
931,22,3,3,7,6,-66,33,3,4,163,164
931,23,3,3,7,6,34,33,7,7,197,197
931,24,4,2,9,4,-55,22,2,9,142,219
931,25,2,6,3,10,21,-36,3,3,163,183
931,26,5,2,9,4,54,22,7,5,217,205
931,27,3,4,7,6,-66,42,1,7,151,247
931,28,3,4,6,7,33,-57,4,0,184,190
931,29,3,5,5,8,32,53,6,3,216,243
931,30,4,3,9,4,-55,31,1,4,161,274
931,31,4,3,8,5,44,32,5,6,205,306
931,32,3,3,7,6,34,33,9,9,239,339
931,33,4,2,9,4,-55,-78,4,1,184,261
931,34,3,4,8,5,35,41,9,2,219,302
931,35,4,3,5,8,-59,35,0,7,160,337
931,36,2,6,4,9,22,-37,2,0,182,300
931,37,4,3,6,7,42,34,4,4,224,334
931,38,3,4,6,7,33,43,7,7,257,377
931,39,3,4,5,8,32,-56,9,1,289,321
931,40,5,2,8,5,-47,23,2,4,242,344
931,41,4,2,8,5,44,23,6,7,286,367
931,42,5,2,9,4,-46,22,0,9,240,389
931,43,2,5,2,11,20,-44,0,5,260,345
931,44,3,4,7,6,34,42,4,7,294,387
931,45,4,2,11,2,-53,20,1,7,241,407
931,46,3,4,6,7,33,-57,4,0,274,350
931,47,4,3,6,7,42,34,6,4,316,384
931,48,6,2,10,3,-36,21,0,5,280,405
931,49,3,3,5,8,32,-65,2,0,312,340
931,50,3,4,6,7,33,43,5,3,345,383
931,51,2,5,3,10,21,55,6,8,366,438
931,52,3,3,8,5,-65,-68,1,0,301,370
931,53,5,3,10,3,55,30,6,0,356,400
931,54,4,3,6,7,42,34,8,4,398,434
931,55,3,3,5,8,-68,35,0,9,330,469
931,56,3,3,5,8,32,-65,2,4,362,404
931,57,4,2,8,5,44,23,6,7,406,427
931,58,3,3,8,5,-65,32,1,9,341,459
931,59,5,3,6,7,51,-66,2,3,392,393
931,60,2,4,8,5,26,41,8,4,418,434
931,61,4,2,6,7,-58,25,0,9,360,459
931,62,3,3,6,7,33,-66,3,3,393,393
931,63,5,2,7,6,52,24,5,7,445,417
931,64,3,4,6,7,33,-57,8,0,478,360
931,65,2,5,3,10,21,55,9,5,499,415
931,66,4,2,9,4,-55,22,4,7,444,437
931,67,3,4,7,6,34,42,8,9,478,479
931,68,2,6,2,11,20,-35,8,4,498,444
931,69,4,3,10,3,-54,30,4,4,444,474
931,70,4,4,7,6,43,42,7,6,487,516
932,1,3,3,6,7,33,34,3,4,33,34
932,2,3,4,3,10,30,-54,3,0,63,-20
932,3,4,3,7,6,43,33,6,3,106,13
932,4,3,3,5,8,32,35,8,8,138,48
932,5,3,3,7,6,-66,-67,2,1,72,-19
932,6,3,4,6,7,33,43,5,4,105,24
932,7,4,2,9,4,-55,22,0,6,50,46
932,8,2,5,3,10,21,-45,1,1,71,1
932,9,5,2,10,3,55,21,6,2,126,22
932,10,5,2,8,5,53,23,9,5,179,45
932,11,3,3,8,5,-65,32,4,7,114,77
932,12,4,4,7,6,43,42,7,9,157,119
932,13,3,3,7,6,-66,-67,1,2,91,52
932,14,3,3,9,4,36,31,7,3,127,83
932,15,3,3,5,8,32,35,9,8,159,118
932,16,3,4,7,6,-66,-58,3,0,93,60
932,17,3,3,5,8,32,35,5,5,125,95
932,18,2,5,7,6,-75,51,0,6,50,146
932,19,3,3,6,7,33,-66,3,0,83,80
932,20,4,2,5,8,41,26,4,6,124,106
932,21,2,4,6,7,24,43,8,9,148,149
932,22,3,4,6,7,-67,-57,1,2,81,92
932,23,2,5,5,8,23,53,4,5,104,145
932,24,3,3,6,7,33,34,7,9,137,179
932,25,3,3,5,8,32,-65,9,4,169,114
932,26,3,4,4,9,-69,45,0,9,100,159
932,27,3,3,10,3,37,30,7,9,137,189
932,28,4,2,9,4,-55,-78,2,1,82,111
932,29,4,2,9,4,45,22,7,3,127,133
932,30,3,4,6,7,-67,43,0,6,60,176
932,31,4,2,7,6,43,-76,3,0,103,100
932,32,3,3,9,4,36,31,9,1,139,131
932,33,3,4,7,6,-66,42,3,3,73,173
932,34,2,4,8,5,26,41,9,4,99,214
932,35,4,3,9,4,-55,31,4,5,44,245
932,36,3,3,7,6,34,33,8,8,78,278
932,37,2,5,5,8,-77,-47,1,1,1,231
932,38,4,2,8,5,44,23,5,4,45,254
932,39,5,2,9,4,54,22,9,6,99,276
932,40,3,3,6,7,-67,-66,2,0,32,210
932,41,3,4,5,8,32,44,4,4,64,254
932,42,2,4,3,10,21,-54,5,0,85,200
932,43,3,3,8,5,-65,32,0,2,20,232
932,44,2,4,4,9,22,45,2,7,42,277
932,45,5,2,10,3,55,21,7,8,97,298
932,46,2,4,4,9,22,-55,9,3,119,243
932,47,4,3,7,6,-57,33,2,6,62,276
932,48,2,4,5,8,23,-56,5,0,85,220
932,49,2,5,3,10,21,55,6,5,106,275
932,50,4,3,6,7,42,34,8,9,148,309
932,51,2,6,2,11,20,-35,8,4,168,274
932,52,5,3,8,5,-47,32,1,6,121,306
932,53,4,2,8,5,44,23,5,9,165,329
932,54,4,2,7,6,43,-76,8,3,208,253
932,55,2,5,3,10,21,55,9,8,229,308
932,56,4,2,7,6,-57,-76,2,2,172,232
932,57,2,5,4,9,22,54,4,6,194,286
932,58,2,4,3,10,21,-54,5,2,215,232
932,59,5,2,10,3,-45,21,0,3,170,253
932,60,3,3,9,4,36,31,6,4,206,284
932,61,4,3,6,7,42,34,8,8,248,318
932,62,2,4,5,8,-77,-56,1,2,171,262
932,63,3,4,5,8,32,44,3,6,203,306
932,64,2,4,7,6,25,42,8,8,228,348
932,65,4,2,8,5,-56,-77,2,1,172,271
932,66,3,3,7,6,34,33,6,4,206,304
932,67,4,2,6,7,42,25,8,9,248,329
932,68,3,4,7,6,-66,-58,2,1,182,271
932,69,3,4,6,7,33,43,5,4,215,314
932,70,4,2,7,6,43,24,8,8,258,338
932,71,3,3,7,6,-66,-67,2,1,192,271
932,72,4,3,7,6,43,33,5,4,235,304
932,73,4,3,7,6,43,33,8,7,278,337
932,74,3,4,6,7,-67,-57,1,0,211,280
932,75,5,2,9,4,54,22,5,2,265,302
932,76,3,3,8,5,-65,32,0,4,200,334
932,77,4,3,5,8,41,35,1,9,241,369
932,78,6,2,10,3,64,-79,5,0,305,290
932,79,3,4,6,7,33,43,8,3,338,333
932,80,3,3,6,7,-67,34,1,7,271,367
932,81,3,4,6,7,33,-57,4,0,304,310
932,82,4,3,8,5,44,32,8,2,348,342
932,83,5,2,10,3,-45,21,3,3,303,363
932,84,2,5,5,8,23,53,6,6,326,416
932,85,3,4,5,8,32,-56,8,0,358,360
932,86,3,3,6,7,-67,34,1,4,291,394
932,87,2,4,6,7,24,43,5,7,315,437
932,88,3,3,7,6,34,-67,9,0,349,370
932,89,2,5,3,10,-79,55,0,5,270,425
932,90,3,4,5,8,32,44,2,9,302,469
932,91,3,4,8,5,35,-59,7,0,337,410
932,92,2,4,4,9,22,45,9,5,359,455
932,93,4,2,7,6,-57,24,2,9,302,479
932,94,6,2,8,5,62,-77,4,2,364,402
932,95,4,3,7,6,43,33,7,5,407,435
932,96,3,3,7,6,-66,33,1,8,341,468
932,97,4,3,8,5,44,-68,5,0,385,400
932,98,3,3,7,6,34,33,9,3,419,433
932,99,5,2,11,2,-44,20,5,3,375,453
932,100,3,4,6,7,33,43,8,6,408,496
932,101,4,3,6,7,-58,-66,0,0,350,430
932,102,3,3,5,8,32,35,2,5,382,465
932,103,3,3,9,4,36,31,8,6,418,496
932,104,2,4,5,8,-77,-56,1,0,341,440
932,105,3,3,9,4,36,31,7,1,377,471
932,106,3,3,7,6,-66,33,1,4,311,504
933,1,5,2,9,4,54,22,4,2,54,22
933,2,3,3,9,4,-64,31,0,3,-10,53
933,3,2,4,6,7,24,43,4,6,14,96
933,4,2,5,5,8,23,53,7,9,37,149
933,5,3,3,7,6,-66,-67,1,2,-29,82
933,6,5,2,6,7,51,25,2,7,22,107
933,7,4,2,9,4,45,22,7,9,67,129
933,8,5,2,6,7,51,-75,8,4,118,54
933,9,5,2,10,3,-45,21,3,5,73,75
933,10,4,2,9,4,45,22,8,7,118,97
933,11,5,2,7,6,-48,-76,0,1,70,21
933,12,4,3,8,5,44,32,4,3,114,53
933,13,4,3,6,7,42,34,6,7,156,87
933,14,2,4,6,7,-76,-57,0,0,80,30
933,15,3,4,7,6,34,42,4,2,114,72
933,16,3,4,6,7,33,43,7,5,147,115
933,17,4,3,8,5,-56,32,1,7,91,147
933,18,4,2,7,6,43,-76,4,1,134,71
933,19,4,2,8,5,44,23,8,4,178,94
933,20,3,3,10,3,-63,30,5,4,115,124
933,21,2,5,2,11,20,-44,5,0,135,80
933,22,5,2,8,5,53,23,8,3,188,103
933,23,2,4,4,9,-78,45,0,8,110,148
933,24,4,2,8,5,44,-77,4,1,154,71
933,25,4,3,8,5,44,32,8,3,198,103
933,26,3,3,7,6,-66,33,2,6,132,136
933,27,3,4,4,9,31,-55,3,1,163,81
933,28,2,5,2,11,20,56,3,7,183,137
933,29,4,2,11,2,-53,20,0,7,130,157
933,30,5,2,7,6,52,-76,2,1,182,81
933,31,2,4,3,10,21,46,3,7,203,127
933,32,4,2,7,6,43,-76,6,1,246,51
933,33,2,4,7,6,-75,42,1,3,171,93
933,34,4,3,7,6,43,33,4,6,214,126
933,35,2,5,7,6,25,51,9,7,239,177
933,36,2,5,6,7,-76,52,3,9,163,229
933,37,2,4,5,8,23,-56,6,3,186,173
933,38,3,4,8,5,-65,41,1,4,121,214
933,39,5,2,9,4,54,22,5,6,175,236
933,40,4,2,7,6,43,-76,8,0,218,160
933,41,5,2,10,3,-45,21,3,1,173,181
933,42,4,2,8,5,44,23,7,4,217,204
933,43,3,4,4,9,31,45,8,9,248,249
933,44,3,3,5,8,-68,-65,0,4,180,184
933,45,2,4,6,7,24,43,4,7,204,227
933,46,2,5,5,8,23,-47,7,0,227,180
933,47,4,3,6,7,42,34,9,4,269,214
933,48,4,3,8,5,-56,32,3,6,213,246
933,49,5,2,9,4,54,22,7,8,267,268
933,50,4,3,8,5,-56,-68,1,0,211,200
933,51,4,2,9,4,45,22,6,2,256,222
933,52,3,4,5,8,32,44,8,6,288,266
933,53,4,3,7,6,-57,33,1,9,231,299
933,54,6,2,9,4,63,-78,4,1,294,221
933,55,2,4,4,9,22,45,6,6,316,266
933,56,3,3,7,6,-66,33,0,9,250,299
933,57,4,3,8,5,44,-68,4,1,294,231
933,58,3,4,6,7,33,43,7,4,327,274
933,59,3,4,5,8,32,44,9,8,359,318
933,60,5,2,10,3,-45,21,4,9,314,339
933,61,5,2,10,3,55,-79,9,0,369,260
933,62,2,5,5,8,-77,53,2,3,292,313
933,63,3,3,7,6,34,33,6,6,326,346
933,64,6,2,9,4,63,22,9,8,389,368
933,65,4,3,6,7,-58,-66,1,2,331,302
933,66,3,4,4,9,31,45,2,7,362,347
933,67,3,4,8,5,35,41,7,8,397,388
933,68,3,3,7,6,-66,-67,1,1,331,321
933,69,3,3,7,6,34,33,5,4,365,354
933,70,3,4,8,5,-65,41,0,5,300,395
933,71,2,5,3,10,21,-45,1,0,321,350
933,72,3,3,4,9,31,36,2,6,352,386
933,73,4,3,7,6,43,33,5,9,395,419
933,74,5,2,8,5,53,-77,8,2,448,342
933,75,3,3,5,8,-68,35,0,7,380,377
933,76,2,4,5,8,23,-56,3,1,403,321
933,77,2,4,6,7,24,43,7,4,427,364
933,78,2,5,3,10,21,55,8,9,448,419
933,79,3,3,8,5,-65,-68,3,1,383,351
933,80,4,2,5,8,41,26,4,7,424,377
933,81,3,3,7,6,34,-67,8,0,458,310
933,82,2,5,4,9,-78,54,0,4,380,364
933,83,4,2,9,4,45,22,5,6,425,386
933,84,3,4,5,8,32,-56,7,0,457,330
933,85,3,4,4,9,31,45,8,5,488,375
933,86,4,2,8,5,-56,23,2,8,432,398
933,87,3,3,5,8,32,-65,4,3,464,333
933,88,4,2,5,8,41,26,5,9,505,359
934,1,3,4,6,7,33,43,3,3,33,43
934,2,4,3,8,5,44,32,7,5,77,75
934,3,4,3,6,7,42,34,9,9,119,109
934,4,5,2,7,6,-48,-76,1,3,71,33
934,5,2,5,5,8,23,53,4,6,94,86
934,6,2,4,3,10,21,-54,5,2,115,32
934,7,4,3,6,7,42,34,7,6,157,66
934,8,3,4,6,7,-67,43,0,9,90,109
934,9,3,3,6,7,33,-66,3,3,123,43
934,10,4,3,8,5,44,32,7,5,167,75
934,11,3,4,8,5,-65,41,2,6,102,116
934,12,3,4,9,4,36,40,8,6,138,156
934,13,4,3,5,8,41,-65,9,1,179,91
934,14,2,4,4,9,-78,45,1,6,101,136
934,15,2,4,4,9,22,-55,3,1,123,81
934,16,3,3,8,5,35,32,8,3,158,113
934,17,4,2,6,7,-58,25,0,8,100,138
934,18,3,3,6,7,33,-66,3,2,133,72
934,19,4,3,5,8,41,35,4,7,174,107
934,20,4,2,7,6,43,-76,7,1,217,31
934,21,4,3,9,4,-55,31,2,2,162,62
934,22,3,4,4,9,31,45,3,7,193,107
934,23,3,4,8,5,35,41,8,8,228,148
934,24,5,2,5,8,50,-74,8,4,278,74
934,25,3,4,7,6,-66,42,2,6,212,116
934,26,5,2,9,4,54,22,6,8,266,138
934,27,2,4,6,7,-76,-57,0,1,190,81
934,28,2,4,3,10,21,46,1,7,211,127
934,29,4,2,7,6,43,-76,4,1,254,51
934,30,2,5,7,6,25,51,9,2,279,102
934,31,2,5,3,10,-79,55,0,7,200,157
934,32,5,2,8,5,53,-77,3,0,253,80
934,33,3,3,9,4,36,31,9,1,289,111
934,34,3,3,8,5,-65,32,4,3,224,143
934,35,3,3,7,6,34,33,8,6,258,176
934,36,2,5,4,9,-78,-46,0,0,180,130
934,37,3,3,6,7,33,34,3,4,213,164
934,38,4,3,8,5,44,32,7,6,257,196
934,39,3,3,6,7,-67,-66,0,0,190,130
934,40,4,2,10,3,46,21,6,1,236,151
934,41,4,2,9,4,-55,22,1,3,181,173
934,42,3,3,6,7,33,34,4,7,214,207
934,43,4,2,9,4,45,22,9,9,259,229
934,44,2,5,2,11,20,-44,9,5,279,185
934,45,3,4,6,7,-67,43,2,8,212,228
934,46,4,3,9,4,45,31,7,9,257,259
934,47,4,3,8,5,-56,-68,1,1,201,191
934,48,2,4,4,9,22,45,3,6,223,236
934,49,3,4,8,5,35,41,8,7,258,277
934,50,5,2,8,5,-47,-77,1,0,211,200
934,51,5,2,11,2,56,20,7,0,267,220
934,52,4,2,7,6,-57,24,0,4,210,244
934,53,2,5,3,10,21,55,1,9,231,299
934,54,3,3,3,10,30,-63,1,6,261,236
934,55,3,3,8,5,35,32,6,8,296,268
934,56,4,2,9,4,-55,-78,1,0,241,190
934,57,2,6,4,9,22,63,3,3,263,253
934,58,2,6,4,9,22,63,5,6,285,316
934,59,3,4,4,9,31,-55,6,1,316,261
934,60,2,4,7,6,-75,42,1,3,241,303
934,61,2,5,4,9,22,54,3,7,263,357
934,62,3,5,4,9,31,-46,4,1,294,311
934,63,3,4,5,8,32,44,6,5,326,355
934,64,4,3,6,7,42,34,8,9,368,389
934,65,4,3,7,6,-57,-67,1,2,311,322
934,66,3,4,6,7,33,43,4,5,344,365
934,67,3,3,7,6,34,33,8,8,378,398
934,68,3,4,6,7,-67,-57,1,1,311,341
934,69,3,5,6,7,33,52,4,3,344,393
934,70,5,2,10,3,55,21,9,4,399,414
934,71,6,2,10,3,-36,21,3,5,363,435
934,72,3,4,4,9,31,-55,4,0,394,380
934,73,3,4,8,5,35,41,9,1,429,421
934,74,3,3,8,5,-65,32,4,3,364,453
934,75,3,5,5,8,32,53,6,6,396,506
935,1,4,2,9,4,45,22,5,2,45,22
935,2,5,2,8,5,53,23,8,5,98,45
935,3,2,4,6,7,-76,43,2,8,22,88
935,4,3,3,6,7,33,-66,5,2,55,22
935,5,3,4,7,6,34,42,9,4,89,64
935,6,5,2,10,3,-45,21,4,5,44,85
935,7,2,5,4,9,22,54,6,9,66,139
935,8,5,2,8,5,53,-77,9,2,119,62
935,9,3,3,5,8,-68,35,1,7,51,97
935,10,3,4,6,7,33,-57,4,0,84,40
935,11,4,3,5,8,41,35,5,5,125,75
935,12,2,5,4,9,22,54,7,9,147,129
935,13,5,2,9,4,-46,-78,1,1,101,51
935,14,4,3,7,6,43,33,4,4,144,84
935,15,2,5,6,7,24,52,8,6,168,136
935,16,4,2,5,8,41,-74,9,2,209,62
935,17,2,4,5,8,-77,44,2,6,132,106
935,18,2,6,2,11,20,-35,2,1,152,71
935,19,3,3,7,6,34,33,6,4,186,104
935,20,3,3,5,8,32,35,8,9,218,139
935,21,3,4,6,7,-67,-57,1,2,151,82
935,22,4,3,6,7,42,34,3,6,193,116
935,23,2,4,7,6,25,42,8,8,218,158
935,24,2,4,4,9,-78,-55,0,3,140,103
935,25,4,2,8,5,44,23,4,6,184,126
935,26,4,3,9,4,45,31,9,7,229,157
935,27,2,4,5,8,-77,-56,2,1,152,101
935,28,3,4,5,8,32,44,4,5,184,145
935,29,3,3,6,7,33,34,7,9,217,179
935,30,4,2,5,8,41,-74,8,5,258,105
935,31,5,2,11,2,-44,20,4,5,214,125
935,32,2,5,3,10,21,-45,5,0,235,80
935,33,4,3,7,6,43,33,8,3,278,113
935,34,3,3,5,8,-68,35,0,8,210,148
935,35,4,3,7,6,43,-67,3,1,253,81
935,36,4,3,9,4,45,31,8,2,298,112
935,37,4,2,10,3,-54,21,4,3,244,133
935,38,4,3,8,5,44,32,8,5,288,165
935,39,3,3,7,6,-66,33,2,8,222,198
935,40,4,3,5,8,41,-65,3,3,263,133
935,41,2,5,4,9,22,54,5,7,285,187
935,42,2,5,4,9,22,-46,7,1,307,141
935,43,3,4,5,8,32,44,9,5,339,185
935,44,3,4,7,6,-66,42,3,7,273,227
935,45,3,3,6,7,33,-66,6,1,306,161
935,46,3,3,6,7,33,34,9,5,339,195
935,47,2,5,5,8,-77,53,2,8,262,248
935,48,4,3,8,5,44,-68,6,0,306,180
935,49,3,4,6,7,33,43,9,3,339,223
935,50,3,4,4,9,-69,45,0,8,270,268
935,51,4,3,8,5,44,-68,4,0,314,200
935,52,6,2,11,2,65,20,9,0,379,220
935,53,2,4,3,10,-79,46,0,6,300,266
935,54,4,2,6,7,42,-75,2,1,342,191
935,55,4,3,8,5,44,32,6,3,386,223
935,56,4,3,5,8,41,35,7,8,427,258
935,57,3,3,6,7,-67,-66,0,2,360,192
935,58,2,5,3,10,21,55,1,7,381,247
935,59,5,2,7,6,52,-76,3,1,433,171
935,60,5,2,8,5,53,23,6,4,486,194
935,61,2,4,5,8,23,44,9,8,509,238
936,1,4,3,10,3,46,30,6,0,46,30
936,2,3,4,3,10,30,46,6,6,76,76
936,3,4,4,8,5,-56,41,0,7,20,117
936,4,2,6,5,8,23,62,3,9,43,179
936,5,3,3,8,5,35,-68,8,1,78,111
936,6,3,4,5,8,-68,44,0,5,10,155
936,7,5,2,9,4,54,22,4,7,64,177
936,8,3,3,6,7,33,-66,7,1,97,111
936,9,3,5,6,7,-67,52,0,3,30,163
936,10,2,6,3,10,21,64,1,7,51,227
936,11,3,4,6,7,33,-57,4,0,84,170
936,12,4,2,6,7,42,25,6,5,126,195
936,13,4,3,9,4,-55,31,1,6,71,226
936,14,3,3,6,7,33,-66,4,0,104,160
936,15,2,5,3,10,21,55,5,5,125,215
936,16,2,4,6,7,24,43,9,8,149,258
936,17,3,4,6,7,-67,-57,2,1,82,201
936,18,5,2,7,6,52,24,4,5,134,225
936,19,2,4,7,6,25,42,9,7,159,267
936,20,2,5,3,10,-79,-45,0,2,80,222
936,21,4,3,7,6,43,33,3,5,123,255
936,22,2,4,5,8,23,44,6,9,146,299
936,23,2,4,9,4,-73,40,3,9,73,339
936,24,3,4,5,8,32,-56,5,3,105,283
936,25,3,4,6,7,33,43,8,6,138,326
936,26,3,3,9,4,-64,31,4,7,74,357
936,27,4,2,7,6,43,-76,7,1,117,281
936,28,4,3,8,5,-56,32,1,3,61,313
936,29,2,4,6,7,24,43,5,6,85,356
936,30,2,5,4,9,22,-46,7,0,107,310
936,31,2,4,6,7,-76,43,1,3,31,353
936,32,3,5,8,5,35,50,6,3,66,403
936,33,2,6,4,9,22,63,8,6,88,466
936,34,3,4,4,9,31,-55,9,1,119,411
936,35,3,3,6,7,-67,34,2,5,52,445
936,36,4,2,6,7,42,-75,4,0,94,370
936,37,3,3,7,6,34,33,8,3,128,403
936,38,3,3,6,7,-67,34,1,7,61,437
936,39,3,3,5,8,32,-65,3,2,93,372
936,40,5,2,9,4,54,22,7,4,147,394
936,41,2,5,3,10,21,55,8,9,168,449
936,42,3,3,5,8,-68,-65,0,4,100,384
936,43,5,2,8,5,53,23,3,7,153,407
936,44,5,2,8,5,53,-77,6,0,206,330
936,45,4,3,8,5,-56,32,0,2,150,362
936,46,3,3,9,4,36,31,6,3,186,393
936,47,4,2,6,7,42,25,8,8,228,418
936,48,3,3,7,6,-66,-67,2,1,162,351
936,49,4,2,8,5,44,23,6,4,206,374
936,50,2,5,4,9,22,54,8,8,228,428
936,51,3,4,6,7,-67,-57,1,1,161,371
936,52,3,3,6,7,33,34,4,5,194,405
936,53,5,2,10,3,55,21,9,6,249,426
936,54,3,3,5,8,-68,-65,1,1,181,361
936,55,4,3,7,6,43,33,4,4,224,394
936,56,3,3,7,6,34,33,8,7,258,427
936,57,3,3,6,7,-67,-66,1,1,191,361
936,58,3,3,9,4,36,31,7,2,227,392
936,59,2,4,7,6,-75,42,2,4,152,434
936,60,2,5,6,7,24,52,6,6,176,486
936,61,2,4,4,9,22,-55,8,1,198,431
936,62,3,4,4,9,31,45,9,6,229,476
936,63,4,2,6,7,-58,-75,1,1,171,401
936,64,3,3,6,7,33,34,4,5,204,435
936,65,2,4,5,8,23,44,7,9,227,479
936,66,3,3,5,8,32,-65,9,4,259,414
936,67,4,2,11,2,-53,20,6,4,206,434
936,68,3,4,4,9,31,45,7,9,237,479
936,69,4,3,6,7,42,-66,9,3,279,413
936,70,4,3,7,6,-57,33,2,6,222,446
936,71,3,4,4,9,31,-55,3,1,253,391
936,72,4,3,6,7,42,34,5,5,295,425
936,73,2,4,3,10,21,-54,6,1,316,371
936,74,6,2,11,2,-35,20,1,1,281,391
936,75,4,2,6,7,42,25,3,6,323,416
936,76,2,4,3,10,21,-54,4,2,344,362
936,77,2,5,5,8,23,53,7,5,367,415
936,78,3,3,10,3,-63,30,4,5,304,445
936,79,4,2,7,6,43,24,7,9,347,469
936,80,3,4,6,7,-67,-57,0,2,280,412
936,81,3,3,7,6,34,33,4,5,314,445
936,82,4,3,9,4,45,31,9,6,359,476
936,83,3,3,8,5,-65,32,4,8,294,508
937,1,3,3,5,8,32,35,2,5,32,35
937,2,3,4,8,5,35,41,7,6,67,76
937,3,5,2,9,4,-46,22,1,8,21,98
937,4,5,3,7,6,52,-67,3,1,73,31
937,5,3,4,6,7,33,43,6,4,106,74
937,6,4,2,6,7,42,25,8,9,148,99
937,7,3,4,8,5,-65,-59,3,0,83,40
937,8,3,4,6,7,33,43,6,3,116,83
937,9,2,4,5,8,23,44,9,7,139,127
937,10,2,4,4,9,-78,-55,1,2,61,72
937,11,4,3,7,6,43,33,4,5,104,105
937,12,5,2,8,5,53,23,7,8,157,128
937,13,3,3,7,6,-66,-67,1,1,91,61
937,14,2,4,6,7,24,43,5,4,115,104
937,15,5,3,8,5,53,32,8,6,168,136
937,16,4,3,6,7,-58,-66,0,0,110,70
937,17,5,3,7,6,52,33,2,3,162,103
937,18,3,3,4,9,31,36,3,9,193,139
937,19,4,3,7,6,43,-67,6,2,236,72
937,20,3,4,5,8,32,44,8,6,268,116
937,21,6,2,11,2,-35,20,3,6,233,136
937,22,5,2,11,2,56,20,9,6,289,156
937,23,3,3,7,6,-66,33,3,9,223,189
937,24,3,3,6,7,33,-66,6,3,256,123
937,25,3,4,7,6,-66,42,0,5,190,165
937,26,3,4,7,6,34,42,4,7,224,207
937,27,4,2,8,5,44,-77,8,0,268,130
937,28,3,4,5,8,-68,44,0,4,200,174
937,29,3,4,8,5,35,41,5,5,235,215
937,30,4,2,10,3,-54,21,1,6,181,236
937,31,4,4,5,8,41,-56,2,0,222,180
937,32,5,3,9,4,54,31,6,1,276,211
937,33,4,2,8,5,-56,23,0,4,220,234
937,34,4,3,8,5,44,32,4,6,264,266
937,35,4,3,9,4,45,31,9,7,309,297
937,36,4,2,7,6,-57,-76,2,1,252,221
937,37,4,3,7,6,43,33,5,4,295,254
937,38,5,3,8,5,53,32,8,6,348,286
937,39,5,2,7,6,-48,-76,0,0,300,210
937,40,3,4,5,8,32,44,2,4,332,254
937,41,4,3,6,7,42,34,4,8,374,288
937,42,5,2,10,3,55,21,9,9,429,309
937,43,2,5,4,9,-78,-46,1,3,351,263
937,44,3,3,8,5,35,32,6,5,386,295
937,45,3,3,8,5,-65,32,1,7,321,327
937,46,4,3,8,5,44,32,5,9,365,359
937,47,3,3,7,6,34,-67,9,2,399,292
937,48,3,3,5,8,-68,35,1,7,331,327
937,49,4,3,6,7,42,-66,3,1,373,261
937,50,4,2,9,4,45,22,8,3,418,283
937,51,4,2,7,6,-57,24,1,7,361,307
937,52,3,5,5,8,32,-47,3,0,393,260
937,53,3,3,5,8,32,35,5,5,425,295
937,54,4,2,6,7,42,-75,7,0,467,220
937,55,4,2,9,4,-55,22,2,2,412,242
937,56,3,3,9,4,36,31,8,3,448,273
937,57,3,3,9,4,-64,31,4,4,384,304
937,58,4,3,6,7,42,34,6,8,426,338
937,59,4,3,9,4,-55,31,1,9,371,369
937,60,4,3,6,7,42,-66,3,3,413,303
937,61,3,3,9,4,36,31,9,4,449,334
937,62,3,3,7,6,-66,33,3,7,383,367
937,63,3,3,7,6,34,-67,7,0,417,300
937,64,3,3,7,6,-66,33,1,3,351,333
937,65,3,4,4,9,31,45,2,8,382,378
937,66,4,2,10,3,46,21,8,9,428,399
937,67,3,4,4,9,31,-55,9,4,459,344
937,68,3,4,8,5,-65,41,4,5,394,385
937,69,3,3,8,5,35,32,9,7,429,417
937,70,4,3,6,7,-58,-66,1,1,371,351
937,71,2,5,5,8,23,53,4,4,394,404
937,72,5,2,9,4,54,22,8,6,448,426
937,73,3,4,6,7,-67,43,1,9,381,469
937,74,3,3,7,6,34,-67,5,2,415,402
937,75,4,3,7,6,43,33,8,5,458,435
937,76,3,3,5,8,-68,-65,0,0,390,370
937,77,4,2,10,3,46,21,6,1,436,391
937,78,4,3,8,5,-56,32,0,3,380,423
937,79,6,2,11,2,65,20,5,3,445,443
937,80,4,3,6,7,42,34,7,7,487,477
937,81,2,4,8,5,-74,41,3,8,413,518
938,1,4,2,9,4,45,22,5,2,45,22
938,2,3,3,9,4,-64,31,1,3,-19,53
938,3,4,2,8,5,44,23,5,6,25,76
938,4,4,2,6,7,42,-75,7,1,67,1
938,5,3,3,7,6,-66,33,1,4,1,34
938,6,3,4,6,7,33,43,4,7,34,77
938,7,4,3,7,6,43,-67,7,0,77,10
938,8,5,2,8,5,-47,23,0,3,30,33
938,9,4,3,8,5,44,32,4,5,74,65
938,10,3,4,4,9,31,-55,5,0,105,10
938,11,4,2,8,5,44,23,9,3,149,33
938,12,4,3,6,7,-58,34,1,7,91,67
938,13,4,3,8,5,44,32,5,9,135,99
938,14,3,3,5,8,32,-65,7,4,167,34
938,15,3,4,3,10,30,-54,7,0,197,-20
938,16,3,3,7,6,-66,33,1,3,131,13
938,17,2,4,5,8,23,44,4,7,154,57
938,18,4,3,5,8,41,-65,5,2,195,-8
938,19,3,4,6,7,33,43,8,5,228,35
938,20,2,4,4,9,-78,-55,0,0,150,-20
938,21,3,3,4,9,31,36,1,6,181,16
938,22,3,4,6,7,33,43,4,9,214,59
938,23,5,2,8,5,53,-77,7,2,267,-18
938,24,4,3,6,7,42,34,9,6,309,16
938,25,4,3,8,5,-56,32,3,8,253,48
938,26,4,2,9,4,45,-78,8,0,298,-30
938,27,5,2,8,5,-47,23,1,3,251,-7
938,28,3,4,7,6,34,42,5,5,285,35
938,29,3,4,7,6,34,42,9,7,319,77
938,30,5,3,6,7,-49,-66,0,1,270,11
938,31,5,3,6,7,51,34,1,5,321,45
938,32,3,4,8,5,35,41,6,6,356,86
938,33,3,3,8,5,-65,32,1,8,291,118
938,34,4,3,6,7,42,-66,3,2,333,52
938,35,3,3,7,6,34,33,7,5,367,85
938,36,3,3,5,8,32,-65,9,0,399,20
938,37,3,4,5,8,-68,44,1,4,331,64
938,38,3,4,4,9,31,45,2,9,362,109
938,39,2,4,6,7,24,-57,6,2,386,52
938,40,4,3,7,6,43,33,9,5,429,85
938,41,4,3,7,6,-57,33,2,8,372,118
938,42,3,3,5,8,32,-65,4,3,404,53
938,43,2,4,5,8,23,44,7,7,427,97
938,44,3,4,7,6,-66,42,1,9,361,139
938,45,4,3,7,6,43,-67,4,2,404,72
938,46,4,3,7,6,43,33,7,5,447,105
938,47,2,4,3,10,21,-54,8,1,468,51
938,48,2,4,7,6,-75,42,3,3,393,93
938,49,3,4,6,7,33,43,6,6,426,136
938,50,3,3,4,9,31,-64,7,2,457,72
938,51,3,4,4,9,31,45,8,7,488,117
938,52,3,4,6,7,-67,-57,1,0,421,60
938,53,2,4,6,7,24,43,5,3,445,103
938,54,3,3,7,6,34,33,9,6,479,136
938,55,2,4,4,9,-78,-55,1,1,401,81
938,56,3,3,7,6,34,33,5,4,435,114
938,57,2,4,3,10,21,-54,6,0,456,60
938,58,4,3,7,6,43,33,9,3,499,93
938,59,6,2,10,3,-36,21,3,4,463,114
938,60,4,2,9,4,45,22,8,6,508,136
939,1,2,4,4,9,22,45,2,5,22,45
939,2,2,4,7,6,25,42,7,7,47,87
939,3,3,4,6,7,-67,-57,0,0,-20,30
939,4,4,3,9,4,45,31,5,1,25,61
939,5,4,3,6,7,42,34,7,5,67,95
939,6,3,3,5,8,32,-65,9,0,99,30
939,7,3,4,3,10,30,46,9,6,129,76
939,8,4,3,5,8,-59,-65,0,1,70,11
939,9,2,4,5,8,23,44,3,5,93,55
939,10,3,3,8,5,35,32,8,7,128,87
939,11,5,2,10,3,-45,21,3,8,83,108
939,12,5,2,8,5,53,-77,6,1,136,31
939,13,5,2,10,3,-45,21,1,2,91,52
939,14,3,3,9,4,36,31,7,3,127,83
939,15,4,2,10,3,-54,21,3,4,73,104
939,16,2,4,5,8,23,44,6,8,96,148
939,17,4,4,7,6,43,-58,9,0,139,90
939,18,4,2,9,4,-55,22,4,2,84,112
939,19,4,2,9,4,45,22,9,4,129,134
939,20,4,3,7,6,-57,33,2,7,72,167
939,21,4,2,8,5,44,-77,6,0,116,90
939,22,4,2,10,3,-54,21,2,1,62,111
939,23,4,3,6,7,42,34,4,5,104,145
939,24,4,2,7,6,43,24,7,9,147,169
939,25,4,2,8,5,-56,-77,1,2,91,92
939,26,3,3,8,5,35,32,6,4,126,124
939,27,4,3,9,4,-55,31,1,5,71,155
939,28,2,5,2,11,20,-44,1,1,91,111
939,29,5,2,11,2,56,20,7,1,147,131
939,30,3,3,6,7,-67,34,0,5,80,165
939,31,3,3,7,6,34,33,4,8,114,198
939,32,4,2,7,6,43,-76,7,2,157,122
939,33,4,2,8,5,-56,23,1,5,101,145
939,34,4,3,8,5,44,32,5,7,145,177
939,35,3,3,8,5,-65,32,0,9,80,209
939,36,5,2,9,4,54,-78,4,1,134,131
939,37,5,2,10,3,55,21,9,2,189,152
939,38,4,3,6,7,-58,34,1,6,131,186
939,39,3,4,6,7,33,43,4,9,164,229
939,40,3,3,6,7,33,-66,7,3,197,163
939,41,4,3,6,7,42,34,9,7,239,197
939,42,3,4,5,8,-68,-56,1,1,171,141
939,43,2,5,4,9,22,54,3,5,193,195
939,44,4,3,7,6,43,33,6,8,236,228
939,45,2,4,4,9,22,-55,8,3,258,173
939,46,4,3,6,7,-58,34,0,7,200,207
939,47,3,3,6,7,33,-66,3,1,233,141
939,48,3,5,7,6,34,51,7,2,267,192
939,49,4,3,10,3,-54,30,3,2,213,222
939,50,2,4,7,6,25,42,8,4,238,264
939,51,3,3,6,7,-67,34,1,8,171,298
939,52,4,3,9,4,45,31,6,9,216,329
939,53,3,3,7,6,-66,-67,0,2,150,262
939,54,3,4,6,7,33,43,3,5,183,305
939,55,3,3,5,8,32,-65,5,0,215,240
939,56,5,2,6,7,51,25,6,5,266,265
939,57,3,3,5,8,32,-65,8,0,298,200
939,58,2,5,4,9,-78,54,0,4,220,254
939,59,2,4,7,6,25,42,5,6,245,296
939,60,4,3,8,5,44,32,9,8,289,328
939,61,2,5,4,9,-78,-46,1,2,211,282
939,62,3,3,7,6,34,33,5,5,245,315
939,63,5,2,11,2,-44,20,1,5,201,335
939,64,5,2,9,4,54,22,5,7,255,357
939,65,3,3,5,8,32,-65,7,2,287,292
939,66,4,3,8,5,-56,32,1,4,231,324
939,67,3,4,4,9,31,45,2,9,262,369
939,68,3,3,8,5,35,-68,7,1,297,301
939,69,4,2,9,4,-55,22,2,3,242,323
939,70,5,2,10,3,55,21,7,4,297,344
939,71,2,4,7,6,-75,42,2,6,222,386
939,72,3,3,6,7,33,-66,5,0,255,320
939,73,2,5,5,8,23,53,8,3,278,373
939,74,2,4,3,10,21,46,9,9,299,419
939,75,5,2,8,5,-47,-77,2,2,252,342
939,76,3,4,6,7,33,43,5,5,285,385
939,77,3,3,6,7,33,34,8,9,318,419
939,78,4,3,7,6,-57,-67,1,2,261,352
939,79,3,4,7,6,34,42,5,4,295,394
939,80,4,3,6,7,42,34,7,8,337,428
939,81,5,2,9,4,-46,-78,1,0,291,350
939,82,2,5,4,9,22,54,3,4,313,404
939,83,5,2,8,5,53,23,6,7,366,427
939,84,5,2,9,4,-46,22,0,9,320,449
939,85,2,4,5,8,23,-56,3,3,343,393
939,86,4,2,7,6,43,24,6,7,386,417
939,87,2,5,5,8,23,-47,9,0,409,370
939,88,2,5,4,9,-78,54,1,4,331,424
939,89,4,3,6,7,42,34,3,8,373,458
939,90,3,3,6,7,33,-66,6,2,406,392
939,91,3,3,4,9,31,36,7,8,437,428
939,92,2,5,4,9,22,-46,9,2,459,382
939,93,2,6,5,8,-77,62,2,4,382,444
939,94,3,3,6,7,33,34,5,8,415,478
939,95,2,5,6,7,24,-48,9,0,439,430
939,96,3,4,5,8,-68,44,1,4,371,474
939,97,3,3,5,8,32,35,3,9,403,509
940,1,4,3,7,6,43,33,3,3,43,33
940,2,4,3,7,6,43,33,6,6,86,66
940,3,4,2,8,5,-56,23,0,9,30,89
940,4,4,4,5,8,41,-56,1,3,71,33
940,5,3,3,6,7,33,34,4,7,104,67
940,6,4,3,9,4,45,31,9,8,149,98
940,7,3,4,6,7,-67,-57,2,1,82,41
940,8,2,4,3,10,21,46,3,7,103,87
940,9,3,3,7,6,34,-67,7,0,137,20
940,10,4,2,8,5,-56,23,1,3,81,43
940,11,4,2,6,7,42,25,3,8,123,68
940,12,3,3,3,10,30,-63,3,5,153,5
940,13,2,5,5,8,23,53,6,8,176,58
940,14,4,4,8,5,-56,41,0,9,120,99
940,15,3,3,5,8,32,-65,2,4,152,34
940,16,6,2,10,3,64,21,6,5,216,55
940,17,6,2,11,2,-35,20,1,5,181,75
940,18,3,3,6,7,33,34,4,9,214,109
940,19,4,2,7,6,43,-76,7,3,257,33
940,20,3,4,7,6,-66,42,1,5,191,75
940,21,4,3,5,8,41,-65,2,0,232,10
940,22,2,4,4,9,22,45,4,5,254,55
940,23,4,2,8,5,44,23,8,8,298,78
940,24,3,4,7,6,-66,-58,2,0,232,20
940,25,4,3,7,6,43,33,5,3,275,53
940,26,3,3,6,7,33,34,8,7,308,87
940,27,3,4,3,10,30,-54,8,3,338,33
940,28,5,2,8,5,-47,23,1,6,291,56
940,29,3,3,7,6,34,33,5,9,325,89
940,30,3,4,5,8,32,-56,7,3,357,33
940,31,4,3,6,7,42,34,9,7,399,67
940,32,3,4,6,7,-67,-57,2,0,332,10
940,33,3,4,4,9,31,45,3,5,363,55
940,34,3,4,6,7,33,43,6,8,396,98
940,35,4,2,9,4,-55,-78,1,0,341,20
940,36,3,4,7,6,34,42,5,2,375,62
940,37,4,3,5,8,41,35,6,7,416,97
940,38,4,3,9,4,-55,31,1,8,361,128
940,39,2,4,7,6,25,-58,6,0,386,70
940,40,3,3,6,7,33,34,9,4,419,104
940,41,2,5,4,9,-78,54,1,8,341,158
940,42,3,3,8,5,35,-68,6,0,376,90
940,43,3,4,8,5,-65,41,1,1,311,131
940,44,2,5,3,10,21,55,2,6,332,186
940,45,4,3,8,5,44,32,6,8,376,218
940,46,4,3,8,5,-56,-68,0,0,320,150
940,47,3,3,5,8,32,35,2,5,352,185
940,48,3,4,6,7,33,43,5,8,385,228
940,49,3,3,4,9,31,-64,6,4,416,164
940,50,4,2,7,6,43,24,9,8,459,188
940,51,2,4,6,7,-76,-57,3,1,383,131
940,52,3,4,7,6,34,42,7,3,417,173
940,53,2,5,2,11,20,56,7,9,437,229
940,54,4,3,10,3,-54,30,3,9,383,259
940,55,4,3,9,4,45,-69,8,0,428,190
940,56,4,3,8,5,-56,32,2,2,372,222
940,57,4,3,6,7,42,34,4,6,414,256
940,58,5,2,7,6,52,-76,6,0,466,180
940,59,4,3,8,5,-56,32,0,2,410,212
940,60,3,3,9,4,36,31,6,3,446,243
940,61,2,5,4,9,22,54,8,7,468,297
940,62,4,2,5,8,41,-74,9,3,509,223
941,1,3,4,7,6,34,42,4,2,34,42
941,2,4,4,6,7,42,43,6,5,76,85
941,3,4,4,7,6,43,42,9,7,119,127
941,4,3,4,7,6,-66,42,3,9,53,169
941,5,5,2,8,5,53,-77,6,2,106,92
941,6,5,2,8,5,53,23,9,5,159,115
941,7,5,2,9,4,-46,22,3,7,113,137
941,8,2,4,3,10,21,-54,4,3,134,83
941,9,3,3,4,9,31,36,5,9,165,119
941,10,2,6,3,10,21,-36,6,3,186,83
941,11,3,3,6,7,33,34,9,7,219,117
941,12,4,3,9,4,-55,31,4,8,164,148
941,13,2,5,4,9,22,-46,6,2,186,102
941,14,3,3,5,8,32,35,8,7,218,137
941,15,4,3,9,4,-55,31,3,8,163,168
941,16,5,2,11,2,56,20,9,8,219,188
941,17,2,4,4,9,-78,-55,1,3,141,133
941,18,5,2,9,4,54,22,5,5,195,155
941,19,4,3,7,6,43,33,8,8,238,188
941,20,2,5,4,9,-78,-46,0,2,160,142
941,21,5,3,9,4,54,31,4,3,214,173
941,22,4,3,10,3,-54,30,0,3,160,203
941,23,3,4,7,6,34,42,4,5,194,245
941,24,3,3,7,6,34,33,8,8,228,278
941,25,3,3,5,8,-68,-65,0,3,160,213
941,26,2,5,2,11,20,56,0,9,180,269
941,27,4,2,6,7,42,-75,2,4,222,194
941,28,3,4,6,7,33,43,5,7,255,237
941,29,3,3,6,7,33,-66,8,1,288,171
941,30,4,2,6,7,-58,25,0,6,230,196
941,31,3,3,4,9,31,-64,1,2,261,132
941,32,4,3,8,5,44,32,5,4,305,164
941,33,4,4,8,5,44,41,9,5,349,205
941,34,4,2,7,6,-57,24,2,9,292,229
941,35,2,4,6,7,24,-57,6,2,316,172
941,36,4,2,8,5,-56,23,0,5,260,195
941,37,4,2,9,4,45,22,5,7,305,217
941,38,4,2,7,6,43,-76,8,1,348,141
941,39,3,4,8,5,-65,41,3,2,283,182
941,40,2,6,3,10,21,64,4,6,304,246
941,41,3,3,6,7,33,-66,7,0,337,180
941,42,5,2,9,4,-46,22,1,2,291,202
941,43,3,3,10,3,37,30,8,2,328,232
941,44,3,3,9,4,-64,31,4,3,264,263
941,45,3,3,3,10,30,-63,4,0,294,200
941,46,4,3,8,5,44,32,8,2,338,232
941,47,2,4,3,10,21,46,9,8,359,278
941,48,2,5,3,10,-79,-45,0,3,280,233
941,49,3,4,4,9,31,45,1,8,311,278
941,50,2,4,6,7,24,-57,5,1,335,221
941,51,2,5,4,9,22,54,7,5,357,275
941,52,2,4,6,7,-76,43,1,8,281,318
941,53,2,4,6,7,24,-57,5,1,305,261
941,54,3,3,6,7,33,34,8,5,338,295
941,55,5,2,9,4,-46,22,2,7,292,317
941,56,5,2,10,3,55,21,7,8,347,338
941,57,3,3,6,7,-67,-66,0,2,280,272
941,58,4,4,8,5,44,41,4,3,324,313
941,59,4,3,7,6,43,33,7,6,367,346
941,60,4,2,9,4,-55,22,2,8,312,368
941,61,2,5,3,10,21,-45,3,3,333,323
941,62,4,3,6,7,42,34,5,7,375,357
941,63,2,5,3,10,21,-45,6,2,396,312
941,64,3,4,6,7,33,43,9,5,429,355
941,65,3,3,7,6,-66,33,3,8,363,388
941,66,4,2,10,3,46,21,9,9,409,409
941,67,5,2,7,6,-48,-76,1,3,361,333
941,68,5,2,10,3,55,21,6,4,416,354
941,69,2,4,6,7,-76,43,0,7,340,397
941,70,4,4,7,6,43,42,3,9,383,439
941,71,4,3,7,6,43,-67,6,2,426,372
941,72,5,3,7,6,52,33,8,5,478,405
941,73,5,2,7,6,-48,24,0,9,430,429
941,74,2,4,4,9,22,-55,2,4,452,374
941,75,2,5,3,10,21,55,3,9,473,429
941,76,3,3,4,9,31,-64,4,5,504,365
942,1,4,2,7,6,43,24,3,4,43,24
942,2,3,3,4,9,31,-64,4,0,74,-40
942,3,3,3,5,8,32,35,6,5,106,-5
942,4,2,4,5,8,23,44,9,9,129,39
942,5,3,3,4,9,-69,-64,0,5,60,-25
942,6,4,4,6,7,42,43,2,8,102,18
942,7,2,5,4,9,22,-46,4,2,124,-28
942,8,3,4,4,9,31,45,5,7,155,17
942,9,5,2,8,5,53,-77,8,0,208,-60
942,10,3,4,8,5,-65,41,3,1,143,-19
942,11,6,2,10,3,64,21,7,2,207,2
942,12,4,2,10,3,-54,21,3,3,153,23
942,13,2,4,4,9,22,45,5,8,175,68
942,14,3,4,4,9,31,-55,6,3,206,13
942,15,5,2,10,3,-45,21,1,4,161,34
942,16,3,3,9,4,36,31,7,5,197,65
942,17,4,2,9,4,-55,22,2,7,142,87
942,18,3,4,4,9,31,-55,3,2,173,32
942,19,2,5,4,9,22,54,5,6,195,86
942,20,4,3,8,5,44,32,9,8,239,118
942,21,4,2,7,6,-57,-76,2,2,182,42
942,22,2,4,3,10,21,46,3,8,203,88
942,23,3,4,8,5,35,41,8,9,238,129
942,24,4,2,8,5,-56,-77,2,2,182,52
942,25,3,4,4,9,31,45,3,7,213,97
942,26,5,2,9,4,54,22,7,9,267,119
942,27,3,3,4,9,31,-64,8,5,298,55
942,28,4,3,9,4,-55,31,3,6,243,86
942,29,5,3,8,5,53,32,6,8,296,118
942,30,4,4,4,9,40,-55,6,3,336,63
942,31,3,3,8,5,-65,32,1,5,271,95
942,32,3,3,5,8,32,-65,3,0,303,30
942,33,3,4,4,9,31,45,4,5,334,75
942,34,2,5,4,9,22,54,6,9,356,129
942,35,4,3,9,4,-55,-69,1,0,301,60
942,36,3,3,9,4,36,31,7,1,337,91
942,37,2,4,5,8,-77,44,0,5,260,135
942,38,4,2,9,4,45,22,5,7,305,157
942,39,2,4,2,11,20,-53,5,4,325,104
942,40,2,5,5,8,23,53,8,7,348,157
942,41,3,4,3,10,30,-54,8,3,378,103
942,42,3,3,3,10,30,-63,8,0,408,40
942,43,2,5,3,10,21,55,9,5,429,95
942,44,3,3,6,7,-67,34,2,9,362,129
942,45,4,2,10,3,46,-79,8,0,408,50
942,46,5,2,10,3,-45,21,3,1,363,71
942,47,3,3,7,6,34,33,7,4,397,104
942,48,2,4,3,10,21,-54,8,0,418,50
942,49,2,6,3,10,21,64,9,4,439,114
942,50,4,2,10,3,-54,21,5,5,385,135
942,51,3,3,7,6,34,33,9,8,419,168
942,52,4,3,6,7,-58,-66,1,2,361,102
942,53,4,4,8,5,44,41,5,3,405,143
942,54,4,3,9,4,-55,31,0,4,350,174
942,55,3,4,4,9,31,45,1,9,381,219
942,56,3,3,9,4,36,-69,7,0,417,150
942,57,3,4,6,7,-67,43,0,3,350,193
942,58,4,3,9,4,45,31,5,4,395,224
942,59,3,3,9,4,-64,31,1,5,331,255
942,60,4,3,4,9,40,-64,1,1,371,191
942,61,3,4,4,9,31,45,2,6,402,236
942,62,7,2,10,3,73,21,5,7,475,257
942,63,4,3,6,7,42,-66,7,1,517,191
943,1,4,3,5,8,41,35,1,5,41,35
943,2,2,4,5,8,23,44,4,9,64,79
943,3,2,4,4,9,22,-55,6,4,86,24
943,4,5,2,8,5,53,23,9,7,139,47
943,5,4,2,10,3,-54,21,5,8,85,68
943,6,3,3,5,8,32,-65,7,3,117,3
943,7,3,3,8,5,-65,32,2,5,52,35
943,8,3,4,5,8,32,44,4,9,84,79
943,9,4,2,8,5,44,-77,8,2,128,2
943,10,4,2,10,3,-54,21,4,3,74,23
943,11,4,3,5,8,41,35,5,8,115,58
943,12,4,2,6,7,42,-75,7,3,157,-17
943,13,4,3,7,6,-57,33,0,6,100,16
943,14,3,3,6,7,33,-66,3,0,133,-50
943,15,4,2,10,3,46,21,9,1,179,-29
943,16,2,4,3,10,-79,46,0,7,100,17
943,17,2,5,5,8,23,-47,3,0,123,-30
943,18,5,2,10,3,55,21,8,1,178,-9
943,19,3,3,5,8,-68,35,0,6,110,26
943,20,5,2,7,6,52,-76,2,0,162,-50
943,21,5,2,9,4,54,22,6,2,216,-28
943,22,2,5,5,8,23,53,9,5,239,25
943,23,2,5,2,11,20,-44,9,1,259,-19
943,24,3,3,5,8,-68,35,1,6,191,16
943,25,4,2,7,6,43,-76,4,0,234,-60
943,26,2,5,4,9,22,54,6,4,256,-6
943,27,3,4,8,5,-65,41,1,5,191,35
943,28,4,2,9,4,45,22,6,7,236,57
943,29,4,2,8,5,-56,-77,0,0,180,-20
943,30,4,2,9,4,45,22,5,2,225,2
943,31,3,4,6,7,33,43,8,5,258,45
943,32,2,5,4,9,-78,54,0,9,180,99
943,33,3,3,8,5,35,-68,5,1,215,31
943,34,4,3,5,8,41,35,6,6,256,66
943,35,3,3,6,7,33,-66,9,0,289,0
943,36,4,2,9,4,-55,22,4,2,234,22
943,37,3,4,7,6,34,42,8,4,268,64
943,38,3,3,3,10,30,-63,8,1,298,1
943,39,3,4,9,4,-64,40,4,1,234,41
943,40,4,3,7,6,43,33,7,4,277,74
943,41,3,5,4,9,31,54,8,8,308,128
943,42,2,4,7,6,-75,-58,3,0,233,70
943,43,2,4,5,8,23,44,6,4,256,114
943,44,4,3,5,8,41,35,7,9,297,149
943,45,3,3,9,4,-64,-69,3,0,233,80
943,46,3,4,4,9,31,45,4,5,264,125
943,47,2,4,2,11,20,-53,4,2,284,72
943,48,2,5,7,6,25,51,9,3,309,123
943,49,3,4,6,7,-67,43,2,6,242,166
943,50,5,2,9,4,54,22,6,8,296,188
943,51,3,5,5,8,32,-47,8,1,328,141
943,52,4,3,6,7,-58,34,0,5,270,175
943,53,5,2,7,6,52,24,2,9,322,199
943,54,2,5,5,8,23,-47,5,2,345,152
943,55,3,3,7,6,34,33,9,5,379,185
943,56,3,4,6,7,-67,43,2,8,312,228
943,57,3,4,4,9,31,-55,3,3,343,173
943,58,3,3,9,4,36,31,9,4,379,204
943,59,3,4,7,6,-66,42,3,6,313,246
943,60,3,4,5,8,32,-56,5,0,345,190
943,61,4,3,7,6,43,33,8,3,388,223
943,62,2,4,3,10,21,46,9,9,409,269
943,63,3,3,4,9,-69,-64,0,5,340,205
943,64,4,3,6,7,42,34,2,9,382,239
943,65,3,3,7,6,34,-67,6,2,416,172
943,66,2,5,4,9,22,54,8,6,438,226
943,67,3,4,7,6,-66,42,2,8,372,268
943,68,3,3,5,8,32,-65,4,3,404,203
943,69,3,4,6,7,33,43,7,6,437,246
943,70,4,2,9,4,-55,22,2,8,382,268
943,71,5,2,10,3,55,21,7,9,437,289
943,72,2,4,4,9,22,-55,9,4,459,234
943,73,3,3,10,3,-63,30,6,4,396,264
943,74,3,3,7,6,-66,33,0,7,330,297
943,75,2,5,3,10,21,-45,1,2,351,252
943,76,4,2,5,8,41,26,2,8,392,278
943,77,3,3,6,7,33,-66,5,2,425,212
943,78,2,4,5,8,23,44,8,6,448,256
943,79,2,5,4,9,-78,-46,0,0,370,210
943,80,3,3,8,5,35,32,5,2,405,242
943,81,3,3,6,7,33,34,8,6,438,276
943,82,2,5,4,9,-78,-46,0,0,360,230
943,83,2,5,4,9,22,54,2,4,382,284
943,84,3,3,5,8,32,35,4,9,414,319
943,85,4,3,7,6,43,-67,7,2,457,252
943,86,3,3,7,6,-66,33,1,5,391,285
943,87,2,4,5,8,23,44,4,9,414,329
943,88,4,2,9,4,45,-78,9,1,459,251
943,89,2,4,5,8,-77,44,2,5,382,295
943,90,3,3,6,7,33,34,5,9,415,329
943,91,4,4,6,7,42,-57,7,2,457,272
943,92,3,4,5,8,32,44,9,6,489,316
943,93,2,4,6,7,-76,43,3,9,413,359
943,94,3,4,7,6,34,-58,7,1,447,301
943,95,4,2,7,6,-57,24,0,5,390,325
943,96,3,3,8,5,35,32,5,7,425,357
943,97,3,4,8,5,-65,41,0,8,360,398
943,98,4,3,8,5,44,-68,4,0,404,330
943,99,2,4,3,10,21,46,5,6,425,376
943,100,3,3,10,3,-63,30,2,6,362,406
943,101,4,3,6,7,42,-66,4,0,404,340
943,102,3,3,6,7,33,34,7,4,437,374
943,103,4,3,7,6,-57,33,0,7,380,407
943,104,3,3,4,9,31,-64,1,3,411,343
943,105,5,2,6,7,51,25,2,8,462,368
943,106,3,3,4,9,31,-64,3,4,493,304
943,107,2,4,5,8,23,44,6,8,516,348
944,1,3,4,3,10,30,46,0,6,30,46
944,2,3,3,9,4,36,31,6,7,66,77
944,3,2,4,5,8,23,-56,9,1,89,21
944,4,5,2,11,2,-44,20,5,1,45,41
944,5,3,4,6,7,33,43,8,4,78,84
944,6,3,4,5,8,-68,44,0,8,10,128
944,7,3,4,3,10,30,-54,0,4,40,74
944,8,3,3,6,7,33,34,3,8,73,108
944,9,4,3,8,5,44,-68,7,0,117,40
944,10,2,4,6,7,-76,43,1,3,41,83
944,11,5,2,9,4,54,22,5,5,95,105
944,12,6,2,10,3,64,21,9,6,159,126
944,13,2,4,3,10,-79,-54,0,2,80,72
944,14,4,3,9,4,45,31,5,3,125,103
944,15,2,4,4,9,22,45,7,8,147,148
944,16,3,4,6,7,-67,-57,0,1,80,91
944,17,3,3,9,4,36,31,6,2,116,122
944,18,4,3,7,6,43,33,9,5,159,155
944,19,3,4,3,10,30,-54,9,1,189,101
944,20,3,3,8,5,-65,32,4,3,124,133
944,21,2,4,3,10,21,46,5,9,145,179
944,22,2,4,4,9,22,-55,7,4,167,124
944,23,2,5,6,7,-76,52,1,6,91,176
944,24,4,3,10,3,46,30,7,6,137,206
944,25,2,5,4,9,22,-46,9,0,159,160
944,26,3,3,9,4,-64,31,5,1,95,191
944,27,5,2,8,5,53,23,8,4,148,214
944,28,4,4,7,6,-57,42,1,6,91,256
944,29,4,3,6,7,42,-66,3,0,133,190
944,30,2,4,7,6,25,42,8,2,158,232
944,31,4,3,6,7,-58,34,0,6,100,266
944,32,5,2,7,6,52,-76,2,0,152,190
944,33,3,3,5,8,32,35,4,5,184,225
944,34,2,4,3,10,21,-54,5,1,205,171
944,35,5,2,8,5,53,23,8,4,258,194
944,36,3,4,5,8,-68,44,0,8,190,238
944,37,4,3,5,8,41,-65,1,3,231,173
944,38,4,2,6,7,42,25,3,8,273,198
944,39,2,5,3,10,21,-45,4,3,294,153
944,40,4,2,7,6,43,24,7,7,337,177
944,41,2,4,5,8,-77,-56,0,1,260,121
944,42,3,3,7,6,34,33,4,4,294,154
944,43,4,3,7,6,43,33,7,7,337,187
944,44,2,4,3,10,21,-54,8,3,358,133
944,45,2,6,4,9,-78,63,0,6,280,196
944,46,3,4,6,7,33,43,3,9,313,239
944,47,3,4,7,6,34,-58,7,1,347,181
944,48,4,2,7,6,-57,24,0,5,290,205
944,49,4,2,7,6,43,24,3,9,333,229
944,50,4,3,9,4,45,-69,8,0,378,160
944,51,3,4,5,8,-68,44,0,4,310,204
944,52,4,4,6,7,42,43,2,7,352,247
944,53,5,2,6,7,51,-75,3,2,403,172
944,54,3,3,4,9,31,36,4,8,434,208
944,55,3,3,8,5,35,-68,9,0,469,140
944,56,5,3,9,4,-46,31,3,1,423,171
944,57,3,3,4,9,31,36,4,7,454,207
944,58,5,2,10,3,55,21,9,8,509,228
945,1,4,3,7,6,43,33,3,3,43,33
945,2,2,4,6,7,24,43,7,6,67,76
945,3,4,3,7,6,-57,33,0,9,10,109
945,4,3,4,8,5,35,-59,5,0,45,50
945,5,3,4,6,7,33,43,8,3,78,93
945,6,4,3,10,3,-54,30,4,3,24,123
945,7,3,3,9,4,-64,31,0,4,-40,154
945,8,2,4,2,11,20,-53,0,1,-20,101
945,9,2,4,5,8,23,44,3,5,3,145
945,10,4,3,10,3,46,30,9,5,49,175
945,11,2,4,6,7,-76,43,3,8,-27,218
945,12,5,2,9,4,54,-78,7,0,27,140
945,13,3,4,8,5,-65,41,2,1,-38,181
945,14,2,4,5,8,23,44,5,5,-15,225
945,15,4,3,7,6,43,33,8,8,28,258
945,16,5,3,7,6,-48,-67,0,1,-20,191
945,17,3,4,6,7,33,43,3,4,13,234
945,18,4,2,5,8,41,-74,4,0,54,160
945,19,4,3,6,7,42,34,6,4,96,194
945,20,4,3,7,6,43,33,9,7,139,227
945,21,2,4,3,10,-79,-54,0,3,60,173
945,22,2,4,8,5,26,41,6,4,86,214
945,23,4,2,9,4,-55,22,1,6,31,236
945,24,3,3,5,8,32,-65,3,1,63,171
945,25,2,4,3,10,21,46,4,7,84,217
945,26,4,3,6,7,42,-66,6,1,126,151
945,27,2,5,5,8,23,53,9,4,149,204
945,28,5,2,7,6,-48,24,1,8,101,228
945,29,3,3,9,4,36,31,7,9,137,259
945,30,2,4,4,9,22,-55,9,4,159,204
945,31,4,3,10,3,-54,30,5,4,105,234
945,32,3,4,5,8,32,44,7,8,137,278
945,33,4,2,9,4,-55,-78,2,0,82,200
945,34,5,2,10,3,55,21,7,1,137,221
945,35,4,3,7,6,-57,33,0,4,80,254
945,36,2,5,6,7,24,52,4,6,104,306
945,37,3,3,6,7,33,-66,7,0,137,240
945,38,3,3,7,6,-66,33,1,3,71,273
945,39,2,5,2,11,20,56,1,9,91,329
945,40,4,3,8,5,44,-68,5,1,135,261
945,41,5,2,11,2,-44,20,1,1,91,281
945,42,2,4,6,7,24,43,5,4,115,324
945,43,3,3,7,6,34,33,9,7,149,357
945,44,3,4,7,6,-66,42,3,9,83,399
945,45,3,3,5,8,32,-65,5,4,115,334
945,46,5,2,9,4,54,22,9,6,169,356
945,47,2,5,3,10,-79,-45,0,1,90,311
945,48,4,2,7,6,43,24,3,5,133,335
945,49,2,5,6,7,24,52,7,7,157,387
945,50,4,2,6,7,42,-75,9,2,199,312
945,51,3,4,6,7,-67,43,2,5,132,355
945,52,4,2,8,5,44,23,6,8,176,378
945,53,3,4,6,7,33,-57,9,1,209,321
945,54,4,2,7,6,-57,24,2,5,152,345
945,55,4,3,6,7,42,34,4,9,194,379
945,56,4,3,6,7,42,-66,6,3,236,313
945,57,4,3,4,9,40,36,6,9,276,349
945,58,3,3,8,5,-65,-68,1,1,211,281
945,59,3,3,7,6,34,33,5,4,245,314
945,60,4,2,10,3,-54,21,1,5,191,335
945,61,2,4,7,6,25,42,6,7,216,377
945,62,4,2,6,7,42,-75,8,2,258,302
945,63,5,2,10,3,-45,21,3,3,213,323
945,64,4,2,8,5,44,23,7,6,257,346
945,65,2,4,7,6,-75,42,2,8,182,388
945,66,5,2,8,5,53,-77,5,1,235,311
945,67,4,3,7,6,43,33,8,4,278,344
945,68,3,3,7,6,-66,33,2,7,212,377
945,69,4,3,7,6,43,-67,5,0,255,310
945,70,3,4,4,9,31,45,6,5,286,355
945,71,2,4,3,10,21,-54,7,1,307,301
945,72,3,4,6,7,-67,43,0,4,240,344
945,73,2,5,5,8,23,53,3,7,263,397
945,74,2,5,2,11,20,-44,3,3,283,353
945,75,2,4,3,10,21,46,4,9,304,399
945,76,3,4,6,7,33,-57,7,2,337,342
945,77,3,4,5,8,32,44,9,6,369,386
945,78,3,4,3,10,30,-54,9,2,399,332
945,79,3,3,4,9,-69,36,0,8,330,368
945,80,4,3,8,5,44,-68,4,0,374,300
945,81,3,4,8,5,35,41,9,1,409,341
945,82,3,3,8,5,-65,32,4,3,344,373
945,83,3,3,7,6,34,33,8,6,378,406
945,84,3,3,6,7,-67,-66,1,0,311,340
945,85,2,4,8,5,26,41,7,1,337,381
945,86,4,2,7,6,-57,24,0,5,280,405
945,87,3,3,7,6,34,33,4,8,314,438
945,88,4,2,6,7,42,-75,6,3,356,363
945,89,3,4,7,6,-66,42,0,5,290,405
945,90,5,2,10,3,55,21,5,6,345,426
945,91,2,5,3,10,21,-45,6,1,366,381
945,92,2,5,3,10,21,55,7,6,387,436
945,93,2,4,7,6,-75,42,2,8,312,478
945,94,3,4,7,6,34,-58,6,0,346,420
945,95,3,4,3,10,30,46,6,6,376,466
945,96,3,4,6,7,33,43,9,9,409,509
946,1,4,3,6,7,42,34,2,4,42,34
946,2,2,5,7,6,25,51,7,5,67,85
946,3,2,5,3,10,21,-45,8,0,88,40
946,4,4,3,9,4,-55,31,3,1,33,71
946,5,4,2,8,5,44,23,7,4,77,94
946,6,2,4,2,11,20,-53,7,1,97,41
946,7,3,4,6,7,-67,43,0,4,30,84
946,8,4,2,8,5,44,23,4,7,74,107
946,9,3,4,6,7,33,-57,7,0,107,50
946,10,3,3,7,6,-66,33,1,3,41,83
946,11,3,3,5,8,32,35,3,8,73,118
946,12,2,5,4,9,22,-46,5,2,95,72
946,13,4,3,8,5,44,32,9,4,139,104
946,14,4,2,7,6,-57,24,2,8,82,128
946,15,3,3,7,6,34,-67,6,1,116,61
946,16,3,4,6,7,33,43,9,4,149,104
946,17,3,3,7,6,-66,33,3,7,83,137
946,18,3,3,9,4,36,31,9,8,119,168
946,19,3,3,9,4,-64,31,5,9,55,199
946,20,2,5,5,8,23,-47,8,2,78,152
946,21,3,3,9,4,-64,31,4,3,14,183
946,22,3,4,4,9,31,45,5,8,45,228
946,23,3,3,6,7,33,-66,8,2,78,162
946,24,2,5,7,6,-75,51,3,3,3,213
946,25,3,3,6,7,33,34,6,7,36,247
946,26,5,2,9,4,-46,22,0,9,-10,269
946,27,4,3,8,5,44,-68,4,1,34,201
946,28,4,3,10,3,-54,30,0,1,-20,231
946,29,6,2,10,3,64,21,4,2,44,252
946,30,3,3,4,9,31,36,5,8,75,288
946,31,3,4,4,9,31,-55,6,3,106,233
946,32,2,4,5,8,23,44,9,7,129,277
946,33,6,2,11,2,-35,20,4,7,94,297
946,34,4,2,10,3,-54,21,0,8,40,318
946,35,5,3,7,6,52,-67,2,1,92,251
946,36,3,5,5,8,32,53,4,4,124,304
946,37,3,3,8,5,35,32,9,6,159,336
946,38,2,4,5,8,-77,-56,2,0,82,280
946,39,3,3,4,9,31,36,3,6,113,316
946,40,2,4,5,8,23,-56,6,0,136,260
946,41,3,3,7,6,-66,33,0,3,70,293
946,42,5,2,10,3,55,21,5,4,125,314
946,43,4,3,7,6,43,33,8,7,168,347
946,44,2,5,3,10,21,-45,9,2,189,302
946,45,2,5,3,10,-79,55,0,7,110,357
946,46,2,5,5,8,23,-47,3,0,133,310
946,47,4,3,6,7,42,34,5,4,175,344
946,48,4,3,7,6,43,33,8,7,218,377
946,49,2,5,4,9,-78,-46,0,1,140,331
946,50,2,4,6,7,24,43,4,4,164,374
946,51,4,2,9,4,45,22,9,6,209,396
946,52,5,2,8,5,-47,23,2,9,162,419
946,53,4,3,8,5,44,-68,6,1,206,351
946,54,6,2,10,3,-36,21,0,2,170,372
946,55,3,4,6,7,33,43,3,5,203,415
946,56,5,2,11,2,56,20,9,5,259,435
946,57,4,3,6,7,-58,34,1,9,201,469
946,58,3,3,9,4,36,-69,7,0,237,400
946,59,2,4,6,7,-76,43,1,3,161,443
946,60,4,3,9,4,45,31,6,4,206,474
946,61,3,4,5,8,32,44,8,8,238,518
947,1,2,5,5,8,23,53,3,3,23,53
947,2,3,4,7,6,34,42,7,5,57,95
947,3,5,2,9,4,-46,22,1,7,11,117
947,4,4,3,6,7,42,-66,3,1,53,51
947,5,4,3,4,9,40,36,3,7,93,87
947,6,2,4,4,9,22,-55,5,2,115,32
947,7,4,3,6,7,42,34,7,6,157,66
947,8,2,4,5,8,-77,-56,0,0,80,10
947,9,2,5,5,8,23,53,3,3,103,63
947,10,3,4,8,5,35,41,8,4,138,104
947,11,4,2,9,4,-55,22,3,6,83,126
947,12,3,3,8,5,35,32,8,8,118,158
947,13,3,3,7,6,-66,-67,2,1,52,91
947,14,2,4,3,10,21,46,3,7,73,137
947,15,3,4,5,8,32,-56,5,1,105,81
947,16,4,3,7,6,43,33,8,4,148,114
947,17,3,4,6,7,-67,43,1,7,81,157
947,18,4,3,9,4,45,31,6,8,126,188
947,19,4,3,9,4,-55,31,1,9,71,219
947,20,4,4,4,9,40,-55,1,4,111,164
947,21,4,3,9,4,45,31,6,5,156,195
947,22,4,2,9,4,-55,22,1,7,101,217
947,23,5,2,9,4,54,22,5,9,155,239
947,24,5,2,7,6,52,-76,7,3,207,163
947,25,3,3,5,8,32,35,9,8,239,198
947,26,3,4,6,7,-67,-57,2,1,172,141
947,27,3,3,7,6,34,33,6,4,206,174
947,28,3,4,4,9,31,45,7,9,237,219
947,29,4,3,8,5,-56,-68,1,1,181,151
947,30,4,2,7,6,43,24,4,5,224,175
947,31,2,4,6,7,24,43,8,8,248,218
947,32,3,3,9,4,-64,31,4,9,184,249
947,33,3,4,6,7,33,-57,7,2,217,192
947,34,2,4,7,6,-75,42,2,4,142,234
947,35,3,3,6,7,33,34,5,8,175,268
947,36,3,4,4,9,31,-55,6,3,206,213
947,37,3,4,4,9,31,45,7,8,237,258
947,38,3,4,6,7,-67,-57,0,1,170,201
947,39,3,3,6,7,33,34,3,5,203,235
947,40,2,5,3,10,21,-45,4,0,224,190
947,41,3,3,5,8,32,35,6,5,256,225
947,42,3,4,7,6,-66,42,0,7,190,267
947,43,3,4,8,5,35,41,5,8,225,308
947,44,3,4,6,7,33,-57,8,1,258,251
947,45,3,3,8,5,-65,32,3,3,193,283
947,46,3,4,4,9,31,45,4,8,224,328
947,47,4,3,8,5,44,-68,8,0,268,260
947,48,3,4,6,7,-67,43,1,3,201,303
947,49,3,4,4,9,31,45,2,8,232,348
947,50,5,2,9,4,54,-78,6,0,286,270
947,51,4,3,8,5,-56,32,0,2,230,302
947,52,3,4,2,11,-30,47,0,9,200,349
947,53,2,4,5,8,23,-56,3,3,223,293
947,54,4,3,9,4,45,31,8,4,268,324
947,55,2,5,4,9,-78,54,0,8,190,378
947,56,4,3,10,3,46,30,6,8,236,408
947,57,3,3,7,6,-66,-67,0,1,170,341
947,58,2,5,2,11,20,56,0,7,190,397
947,59,3,4,3,10,30,-54,0,3,220,343
947,60,4,3,6,7,42,34,2,7,262,377
947,61,3,4,8,5,35,41,7,8,297,418
947,62,4,3,7,6,-57,-67,0,1,240,351
947,63,3,3,6,7,33,34,3,5,273,385
947,64,3,3,8,5,35,32,8,7,308,417
947,65,2,5,3,10,21,-45,9,2,329,372
947,66,2,4,5,8,-77,44,2,6,252,416
947,67,4,3,8,5,44,32,6,8,296,448
947,68,4,3,6,7,42,-66,8,2,338,382
947,69,4,3,7,6,-57,33,1,5,281,415
947,70,3,3,9,4,36,31,7,6,317,446
947,71,3,3,7,6,-66,33,1,9,251,479
947,72,2,5,4,9,22,-46,3,3,273,433
947,73,2,4,5,8,23,44,6,7,296,477
947,74,3,3,6,7,33,-66,9,1,329,411
947,75,5,2,9,4,-46,22,3,3,283,433
947,76,4,3,8,5,44,32,7,5,327,465
947,77,5,2,11,2,-44,20,3,5,283,485
947,78,2,6,2,11,20,-35,3,0,303,450
947,79,5,2,11,2,56,20,9,0,359,470
947,80,4,3,6,7,-58,34,1,4,301,504
948,1,4,3,8,5,44,32,4,2,44,32
948,2,3,4,6,7,33,43,7,5,77,75
948,3,2,4,5,8,-77,44,0,9,0,119
948,4,4,3,7,6,43,-67,3,2,43,52
948,5,2,5,3,10,21,55,4,7,64,107
948,6,3,4,6,7,33,-57,7,0,97,50
948,7,3,3,8,5,-65,32,2,2,32,82
948,8,6,2,10,3,64,21,6,3,96,103
948,9,4,2,9,4,-55,22,1,5,41,125
948,10,4,3,7,6,43,33,4,8,84,158
948,11,4,4,6,7,42,-57,6,1,126,101
948,12,4,2,9,4,-55,22,1,3,71,123
948,13,4,3,6,7,42,34,3,7,113,157
948,14,4,3,6,7,42,-66,5,1,155,91
948,15,4,2,7,6,43,24,8,5,198,115
948,16,3,3,4,9,31,-64,9,1,229,51
948,17,3,4,7,6,-66,42,3,3,163,93
948,18,5,2,10,3,55,21,8,4,218,114
948,19,4,2,8,5,-56,23,2,7,162,137
948,20,4,3,7,6,43,-67,5,0,205,70
948,21,4,2,9,4,-55,22,0,2,150,92
948,22,2,4,4,9,22,45,2,7,172,137
948,23,3,3,7,6,34,-67,6,0,206,70
948,24,3,4,4,9,31,45,7,5,237,115
948,25,3,3,5,8,32,-65,9,0,269,50
948,26,3,4,5,8,-68,44,1,4,201,94
948,27,2,4,5,8,23,44,4,8,224,138
948,28,5,2,10,3,55,21,9,9,279,159
948,29,4,3,8,5,-56,-68,3,1,223,91
948,30,3,3,8,5,35,32,8,3,258,123
948,31,2,6,6,7,-76,61,2,4,182,184
948,32,3,3,7,6,34,33,6,7,216,217
948,33,2,4,3,10,21,-54,7,3,237,163
948,34,4,3,10,3,-54,30,3,3,183,193
948,35,3,3,7,6,34,33,7,6,217,226
948,36,3,3,8,5,-65,32,2,8,152,258
948,37,2,4,4,9,22,-55,4,3,174,203
948,38,5,2,9,4,54,22,8,5,228,225
948,39,4,3,7,6,-57,33,1,8,171,258
948,40,2,5,2,11,20,-44,1,4,191,214
948,41,2,4,5,8,23,44,4,8,214,258
948,42,2,4,7,6,25,-58,9,0,239,200
948,43,4,3,6,7,-58,34,1,4,181,234
948,44,2,5,3,10,21,55,2,9,202,289
948,45,3,4,4,9,31,-55,3,4,233,234
948,46,2,4,6,7,24,43,7,7,257,277
948,47,3,3,8,5,-65,32,2,9,192,309
948,48,3,4,8,5,35,-59,7,0,227,250
948,49,2,4,4,9,22,45,9,5,249,295
948,50,3,5,4,9,-69,54,0,9,180,349
948,51,4,3,5,8,41,-65,1,4,221,284
948,52,2,4,3,10,21,-54,2,0,242,230
948,53,3,4,8,5,35,41,7,1,277,271
948,54,6,2,9,4,-37,22,0,3,240,293
948,55,5,2,9,4,54,22,4,5,294,315
948,56,2,4,6,7,24,43,8,8,318,358
948,57,3,5,4,9,31,-46,9,2,349,312
948,58,3,4,6,7,-67,43,2,5,282,355
948,59,5,2,10,3,55,21,7,6,337,376
948,60,5,2,8,5,-47,23,0,9,290,399
948,61,4,4,4,9,40,-55,0,4,330,344
948,62,2,4,7,6,25,42,5,6,355,386
948,63,4,2,9,4,-55,22,0,8,300,408
948,64,3,5,4,9,31,-46,1,2,331,362
948,65,4,3,7,6,43,33,4,5,374,395
948,66,2,4,6,7,24,43,8,8,398,438
948,67,3,3,8,5,-65,-68,3,0,333,370
948,68,2,4,6,7,24,43,7,3,357,413
948,69,2,4,6,7,-76,43,1,6,281,456
948,70,2,4,6,7,24,43,5,9,305,499
948,71,3,3,6,7,33,-66,8,3,338,433
948,72,2,5,6,7,-76,52,2,5,262,485
948,73,4,3,7,6,43,33,5,8,305,518
949,1,3,3,4,9,31,36,1,6,31,36
949,2,4,3,6,7,42,-66,3,0,73,-30
949,3,2,5,5,8,23,53,6,3,96,23
949,4,3,3,7,6,-66,33,0,6,30,56
949,5,4,2,8,5,44,23,4,9,74,79
949,6,3,5,6,7,33,-48,7,1,107,31
949,7,4,2,8,5,-56,23,1,4,51,54
949,8,3,3,5,8,32,35,3,9,83,89
949,9,3,4,5,8,32,-56,5,3,115,33
949,10,4,3,8,5,44,32,9,5,159,65
949,11,6,2,10,3,-36,21,3,6,123,86
949,12,4,2,8,5,44,23,7,9,167,109
949,13,4,3,7,6,-57,-67,0,2,110,42
949,14,2,5,3,10,21,55,1,7,131,97
949,15,3,3,8,5,35,32,6,9,166,129
949,16,4,2,7,6,43,-76,9,3,209,53
949,17,3,4,7,6,-66,42,3,5,143,95
949,18,2,4,6,7,24,43,7,8,167,138
949,19,4,2,8,5,-56,-77,1,1,111,61
949,20,4,3,10,3,46,30,7,1,157,91
949,21,3,4,7,6,-66,42,1,3,91,133
949,22,4,3,9,4,45,31,6,4,136,164
949,23,3,4,7,6,-66,42,0,6,70,206
949,24,3,3,7,6,34,33,4,9,104,239
949,25,4,3,6,7,42,-66,6,3,146,173
949,26,3,3,8,5,-65,32,1,5,81,205
949,27,3,4,3,10,30,-54,1,1,111,151
949,28,4,2,8,5,44,23,5,4,155,174
949,29,3,3,9,4,-64,31,1,5,91,205
949,30,2,4,3,10,21,-54,2,1,112,151
949,31,3,3,7,6,34,33,6,4,146,184
949,32,5,2,9,4,-46,22,0,6,100,206
949,33,3,3,10,3,37,30,7,6,137,236
949,34,3,5,6,7,-67,52,0,8,70,288
949,35,2,4,3,10,21,-54,1,4,91,234
949,36,3,3,6,7,33,34,4,8,124,268
949,37,3,3,6,7,33,-66,7,2,157,202
949,38,5,2,11,2,-44,20,3,2,113,222
949,39,3,3,8,5,35,32,8,4,148,254
949,40,3,4,8,5,-65,41,3,5,83,295
949,41,4,2,7,6,43,24,6,9,126,319
949,42,4,3,6,7,42,-66,8,3,168,253
949,43,2,4,4,9,-78,45,0,8,90,298
949,44,4,3,7,6,43,-67,3,1,133,231
949,45,2,5,2,11,20,56,3,7,153,287
949,46,4,3,9,4,45,31,8,8,198,318
949,47,4,3,10,3,-54,30,4,8,144,348
949,48,3,3,7,6,34,-67,8,1,178,281
949,49,6,2,9,4,-37,22,1,3,141,303
949,50,4,2,6,7,42,25,3,8,183,328
949,51,4,2,9,4,45,-78,8,0,228,250
949,52,3,4,5,8,-68,44,0,4,160,294
949,53,5,3,7,6,52,33,2,7,212,327
949,54,2,5,2,11,20,-44,2,3,232,283
949,55,5,3,8,5,53,32,5,5,285,315
949,56,2,5,4,9,22,54,7,9,307,369
949,57,4,3,8,5,-56,-68,1,1,251,301
949,58,4,3,9,4,45,31,6,2,296,332
949,59,5,2,10,3,-45,21,1,3,251,353
949,60,2,4,3,10,21,46,2,9,272,399
949,61,4,3,10,3,46,30,8,9,318,429
949,62,4,3,9,4,-55,-69,3,0,263,360
949,63,3,3,4,9,31,36,4,6,294,396
949,64,3,3,7,6,34,33,8,9,328,429
949,65,3,3,6,7,-67,-66,1,3,261,363
949,66,4,3,9,4,45,31,6,4,306,394
949,67,4,2,10,3,-54,21,2,5,252,415
949,68,4,3,7,6,43,33,5,8,295,448
949,69,3,3,7,6,34,-67,9,1,329,381
949,70,4,2,8,5,-56,23,3,4,273,404
949,71,2,5,6,7,24,52,7,6,297,456
949,72,3,3,3,10,30,-63,7,3,327,393
949,73,4,3,9,4,-55,31,2,4,272,424
949,74,2,5,5,8,23,53,5,7,295,477
949,75,5,2,7,6,52,-76,7,1,347,401
949,76,3,4,4,9,31,45,8,6,378,446
949,77,3,3,8,5,-65,32,3,8,313,478
949,78,3,3,5,8,32,-65,5,3,345,413
949,79,4,2,7,6,43,24,8,7,388,437
949,80,4,3,8,5,-56,32,2,9,332,469
949,81,3,4,4,9,31,-55,3,4,363,414
949,82,4,2,8,5,44,23,7,7,407,437
949,83,2,5,3,10,21,-45,8,2,428,392
949,84,4,2,9,4,-55,22,3,4,373,414
949,85,5,2,11,2,56,20,9,4,429,434
949,86,2,6,3,10,-79,64,0,8,350,498
949,87,2,4,8,5,26,41,6,9,376,539
950,1,2,4,4,9,22,45,2,5,22,45
950,2,3,3,6,7,33,34,5,9,55,79
950,3,4,3,9,4,-55,-69,0,0,0,10
950,4,4,2,6,7,42,25,2,5,42,35
950,5,2,4,6,7,24,43,6,8,66,78
950,6,3,4,6,7,33,-57,9,1,99,21
950,7,3,3,4,9,-69,36,0,7,30,57
950,8,2,4,9,4,27,40,7,7,57,97
950,9,2,4,5,8,-77,-56,0,1,-20,41
950,10,4,3,10,3,46,30,6,1,26,71
950,11,2,4,5,8,23,44,9,5,49,115
950,12,2,5,5,8,-77,53,2,8,-28,168
950,13,2,5,4,9,22,-46,4,2,-6,122
950,14,4,3,6,7,42,34,6,6,36,156
950,15,3,4,6,7,33,43,9,9,69,199
950,16,3,4,8,5,-65,-59,4,0,4,140
950,17,2,4,6,7,24,43,8,3,28,183
950,18,3,3,9,4,-64,31,4,4,-36,214
950,19,3,4,4,9,31,45,5,9,-5,259
950,20,4,2,10,3,-54,-79,1,0,-59,180
950,21,3,3,7,6,34,33,5,3,-25,213
950,22,5,2,6,7,51,25,6,8,26,238
950,23,4,3,6,7,42,-66,8,2,68,172
950,24,5,2,6,7,51,25,9,7,119,197
950,25,3,4,4,9,-69,-55,0,2,50,142
950,26,6,2,12,1,66,-20,6,2,116,122
950,27,5,2,10,3,-45,21,1,3,71,143
950,28,4,2,6,7,42,25,3,8,113,168
950,29,4,2,9,4,45,-78,8,0,158,90
950,30,4,3,9,4,-55,31,3,1,103,121
950,31,4,3,7,6,43,33,6,4,146,154
950,32,3,3,8,5,-65,32,1,6,81,186
950,33,3,4,4,9,31,-55,2,1,112,131
950,34,4,2,7,6,43,24,5,5,155,155
950,35,5,2,8,5,53,23,8,8,208,178
950,36,3,3,7,6,-66,-67,2,1,142,111
950,37,3,4,8,5,35,41,7,2,177,152
950,38,2,4,6,7,-76,43,1,5,101,195
950,39,2,4,6,7,24,43,5,8,125,238
950,40,3,3,9,4,-64,31,1,9,61,269
950,41,2,4,8,5,26,-59,7,0,87,210
950,42,2,4,5,8,-77,44,0,4,10,254
950,43,3,3,5,8,32,35,2,9,42,289
950,44,3,4,8,5,35,-59,7,0,77,230
950,45,3,3,8,5,-65,32,2,2,12,262
950,46,3,4,5,8,32,44,4,6,44,306
950,47,3,4,5,8,32,-56,6,0,76,250
950,48,2,5,4,9,22,54,8,4,98,304
950,49,4,3,7,6,-57,33,1,7,41,337
950,50,4,3,5,8,41,-65,2,2,82,272
950,51,2,5,3,10,21,55,3,7,103,327
950,52,5,3,9,4,54,31,7,8,157,358
950,53,4,2,9,4,-55,-78,2,0,102,280
950,54,4,3,6,7,42,34,4,4,144,314
950,55,4,4,5,8,41,44,5,8,185,358
950,56,4,2,9,4,-55,-78,0,0,130,280
950,57,6,2,9,4,63,22,3,2,193,302
950,58,5,2,8,5,53,23,6,5,246,325
950,59,2,4,4,9,22,-55,8,0,268,270
950,60,4,3,6,7,-58,34,0,4,210,304
950,61,4,2,8,5,44,23,4,7,254,327
950,62,5,3,9,4,54,31,8,8,308,358
950,63,5,2,7,6,-48,-76,0,2,260,282
950,64,5,2,9,4,54,22,4,4,314,304
950,65,2,5,7,6,25,51,9,5,339,355
950,66,4,4,9,4,-55,40,4,5,284,395
950,67,4,2,7,6,43,24,7,9,327,419
950,68,4,3,8,5,-56,-68,1,1,271,351
950,69,2,5,3,10,21,55,2,6,292,406
950,70,3,4,6,7,33,43,5,9,325,449
950,71,3,4,8,5,-65,-59,0,0,260,390
950,72,4,3,7,6,43,33,3,3,303,423
950,73,3,4,6,7,33,43,6,6,336,466
950,74,3,4,6,7,33,43,9,9,369,509
951,1,3,3,4,9,31,36,1,6,31,36
951,2,5,3,9,4,54,31,5,7,85,67
951,3,2,4,8,5,-74,41,1,8,11,108
951,4,3,3,8,5,35,-68,6,0,46,40
951,5,3,4,4,9,31,45,7,5,77,85
951,6,3,3,4,9,31,-64,8,1,108,21
951,7,3,4,6,7,-67,43,1,4,41,64
951,8,4,2,7,6,43,24,4,8,84,88
951,9,4,3,5,8,41,-65,5,3,125,23
951,10,2,5,4,9,22,54,7,7,147,77
951,11,3,4,5,8,32,-56,9,1,179,21
951,12,2,5,4,9,-78,54,1,5,101,75
951,13,3,5,3,10,30,-45,1,0,131,30
951,14,3,4,4,9,31,45,2,5,162,75
951,15,3,3,5,8,32,-65,4,0,194,10
951,16,2,4,5,8,23,44,7,4,217,54
951,17,3,4,6,7,-67,43,0,7,150,97
951,18,5,2,7,6,52,-76,2,1,202,21
951,19,3,3,5,8,32,35,4,6,234,56
951,20,3,3,7,6,34,33,8,9,268,89
951,21,4,2,7,6,-57,-76,1,3,211,13
951,22,3,3,6,7,33,34,4,7,244,47
951,23,6,2,10,3,64,21,8,8,308,68
951,24,2,5,3,10,21,-45,9,3,329,23
951,25,4,3,6,7,-58,34,1,7,271,57
951,26,4,2,8,5,44,-77,5,0,315,-20
951,27,4,3,6,7,42,34,7,4,357,14
951,28,4,3,6,7,42,34,9,8,399,48
951,29,4,3,7,6,-57,-67,2,1,342,-19
951,30,3,3,6,7,33,34,5,5,375,15
951,31,4,2,7,6,43,24,8,9,418,39
951,32,3,4,4,9,31,-55,9,4,449,-16
951,33,3,4,5,8,-68,44,1,8,381,28
951,34,2,4,5,8,23,-56,4,2,404,-28
951,35,4,4,7,6,43,42,7,4,447,14
951,36,4,3,5,8,41,35,8,9,488,49
951,37,2,6,3,10,21,-36,9,3,509,13
952,1,5,2,9,4,54,22,4,2,54,22
952,2,3,3,7,6,34,33,8,5,88,55
952,3,4,3,8,5,-56,32,2,7,32,87
952,4,4,2,7,6,43,-76,5,1,75,11
952,5,3,4,5,8,32,44,7,5,107,55
952,6,2,4,8,5,-74,41,3,6,33,96
952,7,3,4,4,9,31,-55,4,1,64,41
952,8,4,2,8,5,44,23,8,4,108,64
952,9,3,3,6,7,-67,34,1,8,41,98
952,10,4,3,8,5,44,-68,5,0,85,30
952,11,4,2,6,7,42,25,7,5,127,55
952,12,2,5,4,9,22,54,9,9,149,109
952,13,4,2,9,4,-55,-78,4,1,94,31
952,14,3,3,5,8,32,35,6,6,126,66
952,15,3,4,7,6,-66,42,0,8,60,108
952,16,4,2,7,6,43,-76,3,2,103,32
952,17,4,3,10,3,46,30,9,2,149,62
952,18,3,3,7,6,-66,33,3,5,83,95
952,19,4,3,5,8,41,-65,4,0,124,30
952,20,4,2,9,4,45,22,9,2,169,52
952,21,4,3,9,4,-55,31,4,3,114,83
952,22,4,3,5,8,41,35,5,8,155,118
952,23,3,4,8,5,-65,41,0,9,90,159
952,24,3,3,10,3,37,30,7,9,127,189
952,25,4,3,8,5,-56,-68,1,1,71,121
952,26,3,3,5,8,32,35,3,6,103,156
952,27,2,5,3,10,21,-45,4,1,124,111
952,28,3,4,8,5,35,41,9,2,159,152
952,29,3,4,6,7,-67,43,2,5,92,195
952,30,2,4,5,8,23,44,5,9,115,239
952,31,2,5,3,10,21,-45,6,4,136,194
952,32,3,3,8,5,-65,32,1,6,71,226
952,33,2,4,4,9,22,-55,3,1,93,171
952,34,2,4,5,8,23,44,6,5,116,215
952,35,4,2,6,7,42,-75,8,0,158,140
952,36,3,4,7,6,-66,42,2,2,92,182
952,37,2,6,2,11,20,65,2,7,112,247
952,38,4,2,8,5,44,-77,6,0,156,170
952,39,2,4,3,10,21,46,7,6,177,216
952,40,4,3,6,7,42,-66,9,0,219,150
952,41,2,4,5,8,-77,44,2,4,142,194
952,42,3,3,4,9,31,-64,3,0,173,130
952,43,3,4,3,10,30,46,3,6,203,176
952,44,3,5,7,6,34,51,7,7,237,227
952,45,3,4,8,5,-65,41,2,8,172,268
952,46,3,4,8,5,35,41,7,9,207,309
952,47,4,2,10,3,-54,-79,3,0,153,230
952,48,4,3,5,8,41,35,4,5,194,265
952,49,2,5,3,10,21,-45,5,0,215,220
952,50,4,2,6,7,42,25,7,5,257,245
952,51,3,4,7,6,-66,42,1,7,191,287
952,52,3,3,5,8,32,-65,3,2,223,222
952,53,2,6,4,9,22,63,5,5,245,285
952,54,4,2,10,3,-54,21,1,6,191,306
952,55,3,4,6,7,33,43,4,9,224,349
952,56,5,2,7,6,52,-76,6,3,276,273
952,57,3,3,6,7,33,34,9,7,309,307
952,58,3,4,7,6,-66,42,3,9,243,349
952,59,3,3,6,7,33,-66,6,3,276,283
952,60,4,2,8,5,-56,23,0,6,220,306
952,61,3,4,5,8,32,-56,2,0,252,250
952,62,3,4,6,7,33,43,5,3,285,293
952,63,4,3,7,6,43,33,8,6,328,326
952,64,3,4,8,5,-65,41,3,7,263,367
952,65,5,2,9,4,54,22,7,9,317,389
952,66,3,3,8,5,-65,-68,2,1,252,321
952,67,2,5,6,7,24,52,6,3,276,373
952,68,2,4,6,7,-76,43,0,6,200,416
952,69,4,2,7,6,43,-76,3,0,243,340
952,70,4,3,5,8,41,35,4,5,284,375
952,71,2,4,5,8,23,44,7,9,307,419
952,72,3,4,8,5,-65,-59,2,0,242,360
952,73,4,3,9,4,45,31,7,1,287,391
952,74,4,2,8,5,-56,23,1,4,231,414
952,75,3,3,4,9,31,-64,2,0,262,350
952,76,4,3,5,8,41,35,3,5,303,385
952,77,4,2,6,7,42,-75,5,0,345,310
952,78,3,3,8,5,-65,32,0,2,280,342
952,79,2,5,4,9,22,54,2,6,302,396
952,80,3,4,5,8,32,-56,4,0,334,340
952,81,3,3,8,5,35,32,9,2,369,372
952,82,4,2,9,4,-55,22,4,4,314,394
952,83,3,5,4,9,31,54,5,8,345,448
952,84,5,2,10,3,-45,21,0,9,300,469
952,85,2,4,4,9,22,-55,2,4,322,414
952,86,3,4,9,4,36,40,8,4,358,454
952,87,2,4,4,9,-78,45,0,9,280,499
952,88,3,3,10,3,37,30,7,9,317,529
953,1,4,3,5,8,41,35,1,5,41,35
953,2,4,4,5,8,41,44,2,9,82,79
953,3,3,4,5,8,32,-56,4,3,114,23
953,4,3,3,6,7,33,34,7,7,147,57
953,5,2,5,3,10,21,-45,8,2,168,12
953,6,4,3,7,6,-57,33,1,5,111,45
953,7,3,3,8,5,35,32,6,7,146,77
953,8,4,4,7,6,43,42,9,9,189,119
953,9,4,2,9,4,-55,-78,4,1,134,41
953,10,3,3,5,8,32,35,6,6,166,76
953,11,3,3,4,9,31,-64,7,2,197,12
953,12,2,5,4,9,22,54,9,6,219,66
953,13,3,3,7,6,-66,33,3,9,153,99
953,14,4,2,6,7,42,-75,5,4,195,24
953,15,4,3,6,7,42,34,7,8,237,58
953,16,2,5,6,7,-76,-48,1,0,161,10
953,17,3,5,7,6,34,51,5,1,195,61
953,18,3,3,3,10,30,37,5,8,225,98
953,19,3,3,8,5,-65,-68,0,0,160,30
953,20,4,3,9,4,45,31,5,1,205,61
953,21,2,6,3,10,21,64,6,5,226,125
953,22,3,5,5,8,32,53,8,8,258,178
953,23,2,4,4,9,-78,-55,0,3,180,123
953,24,3,3,8,5,35,32,5,5,215,155
953,25,4,2,10,3,-54,21,1,6,161,176
953,26,3,4,4,9,31,-55,2,1,192,121
953,27,3,3,5,8,32,35,4,6,224,156
953,28,3,3,6,7,33,-66,7,0,257,90
953,29,4,3,7,6,-57,33,0,3,200,123
953,30,3,3,9,4,36,31,6,4,236,154
953,31,3,4,4,9,31,45,7,9,267,199
953,32,2,5,3,10,21,-45,8,4,288,154
953,33,4,3,5,8,41,35,9,9,329,189
953,34,3,4,7,6,-66,-58,3,1,263,131
953,35,5,2,8,5,53,23,6,4,316,154
953,36,5,2,11,2,-44,20,2,4,272,174
953,37,2,4,6,7,24,43,6,7,296,217
953,38,3,3,4,9,31,-64,7,3,327,153
953,39,3,4,6,7,-67,43,0,6,260,196
953,40,4,3,8,5,44,32,4,8,304,228
953,41,3,4,6,7,33,-57,7,1,337,171
953,42,3,3,8,5,-65,32,2,3,272,203
953,43,3,3,6,7,33,34,5,7,305,237
953,44,4,3,8,5,44,32,9,9,349,269
953,45,4,3,7,6,-57,-67,2,2,292,202
953,46,4,4,8,5,44,41,6,3,336,243
953,47,4,2,8,5,-56,23,0,6,280,266
953,48,3,4,7,6,34,42,4,8,314,308
953,49,5,2,10,3,55,21,9,9,369,329
953,50,3,4,7,6,-66,-58,3,1,303,271
953,51,2,4,3,10,21,46,4,7,324,317
953,52,6,2,11,2,65,20,9,7,389,337
953,53,2,4,5,8,-77,-56,2,1,312,281
953,54,3,4,6,7,33,43,5,4,345,324
953,55,4,2,7,6,43,24,8,8,388,348
953,56,3,3,8,5,-65,-68,3,0,323,280
953,57,4,3,8,5,44,32,7,2,367,312
953,58,3,4,5,8,32,44,9,6,399,356
953,59,2,4,6,7,-76,43,3,9,323,399
953,60,4,2,6,7,42,-75,5,4,365,324
953,61,3,3,8,5,-65,32,0,6,300,356
953,62,4,2,7,6,43,-76,3,0,343,280
953,63,2,5,5,8,23,53,6,3,366,333
953,64,3,3,7,6,-66,33,0,6,300,366
953,65,5,2,10,3,55,21,5,7,355,387
953,66,3,3,5,8,32,-65,7,2,387,322
953,67,3,3,4,9,31,36,8,8,418,358
953,68,2,4,7,6,-75,-58,3,0,343,300
953,69,3,4,4,9,31,45,4,5,374,345
953,70,5,3,6,7,51,34,5,9,425,379
953,71,3,4,6,7,33,-57,8,2,458,322
953,72,3,3,7,6,-66,33,2,5,392,355
953,73,4,2,10,3,46,21,8,6,438,376
953,74,4,2,8,5,-56,23,2,9,382,399
953,75,2,6,3,10,21,-36,3,3,403,363
953,76,4,3,9,4,45,31,8,4,448,394
953,77,3,4,5,8,-68,44,0,8,380,438
953,78,4,3,9,4,45,31,5,9,425,469
953,79,3,3,7,6,34,-67,9,2,459,402
953,80,4,3,8,5,-56,32,3,4,403,434
953,81,2,5,2,11,20,-44,3,0,423,390
953,82,2,4,4,9,22,45,5,5,445,435
953,83,2,4,5,8,23,44,8,9,468,479
953,84,5,2,7,6,-48,-76,0,3,420,403
953,85,4,3,5,8,41,35,1,8,461,438
953,86,3,4,5,8,32,-56,3,2,493,382
953,87,3,4,7,6,34,42,7,4,527,424
954,1,4,3,9,4,45,31,5,1,45,31
954,2,4,2,9,4,-55,22,0,3,-10,53
954,3,3,4,5,8,32,44,2,7,22,97
954,4,4,4,8,5,44,41,6,8,66,138
954,5,4,2,10,3,-54,21,2,9,12,159
954,6,3,3,7,6,34,-67,6,2,46,92
954,7,2,4,6,7,-76,43,0,5,-30,135
954,8,4,3,8,5,44,32,4,7,14,167
954,9,4,2,8,5,44,-77,8,0,58,90
954,10,4,2,9,4,-55,22,3,2,3,112
954,11,5,2,8,5,53,23,6,5,56,135
954,12,4,2,7,6,43,24,9,9,99,159
954,13,4,2,9,4,-55,-78,4,1,44,81
954,14,3,3,7,6,34,33,8,4,78,114
954,15,4,3,5,8,41,35,9,9,119,149
954,16,4,3,7,6,-57,-67,2,2,62,82
954,17,3,3,4,9,31,36,3,8,93,118
954,18,4,4,8,5,44,41,7,9,137,159
954,19,5,2,10,3,-45,-79,2,0,92,80
954,20,5,2,7,6,52,24,4,4,144,104
954,21,3,3,8,5,35,32,9,6,179,136
954,22,4,3,10,3,-54,30,5,6,125,166
954,23,4,2,7,6,43,-76,8,0,168,90
954,24,2,5,4,9,-78,54,0,4,90,144
954,25,3,5,7,6,34,51,4,5,124,195
954,26,3,3,7,6,34,33,8,8,158,228
954,27,3,3,7,6,-66,-67,2,1,92,161
954,28,3,4,5,8,32,44,4,5,124,205
954,29,5,2,8,5,53,23,7,8,177,228
954,30,4,3,5,8,41,-65,8,3,218,163
954,31,2,4,6,7,-76,43,2,6,142,206
954,32,3,3,4,9,31,-64,3,2,173,142
954,33,2,4,6,7,24,43,7,5,197,185
954,34,4,3,8,5,-56,32,1,7,141,217
954,35,3,3,8,5,35,32,6,9,176,249
954,36,4,3,8,5,-56,-68,0,1,120,181
954,37,3,4,8,5,35,41,5,2,155,222
954,38,3,3,4,9,31,36,6,8,186,258
954,39,2,5,5,8,23,-47,9,1,209,211
954,40,2,6,2,11,20,65,9,6,229,276
954,41,3,4,7,6,-66,42,3,8,163,318
954,42,2,4,6,7,24,-57,7,1,187,261
954,43,5,2,8,5,-47,23,0,4,140,284
954,44,4,2,7,6,43,24,3,8,183,308
954,45,5,3,7,6,52,-67,5,1,235,241
954,46,3,4,5,8,32,44,7,5,267,285
954,47,3,4,5,8,32,44,9,9,299,329
954,48,5,3,10,3,-45,30,4,9,254,359
954,49,4,3,8,5,44,-68,8,1,298,291
954,50,4,2,7,6,-57,24,1,5,241,315
954,51,3,4,8,5,35,41,6,6,276,356
954,52,4,3,8,5,-56,32,0,8,220,388
954,53,3,3,8,5,35,-68,5,0,255,320
954,54,2,5,3,10,21,55,6,5,276,375
954,55,3,4,4,9,31,-55,7,0,307,320
954,56,4,3,8,5,-56,32,1,2,251,352
954,57,3,4,5,8,32,44,3,6,283,396
954,58,4,2,8,5,44,23,7,9,327,419
954,59,5,2,10,3,-45,-79,2,0,282,340
954,60,6,2,10,3,64,21,6,1,346,361
954,61,2,4,7,6,-75,42,1,3,271,403
954,62,2,5,5,8,23,53,4,6,294,456
954,63,3,4,4,9,31,-55,5,1,325,401
954,64,3,3,7,6,34,33,9,4,359,434
954,65,3,3,8,5,-65,32,4,6,294,466
954,66,5,2,8,5,53,23,7,9,347,489
954,67,2,5,4,9,22,-46,9,3,369,443
954,68,3,4,5,8,-68,44,1,7,301,487
954,69,3,4,3,10,30,-54,1,3,331,433
954,70,3,3,6,7,33,34,4,7,364,467
954,71,4,3,9,4,45,31,9,8,409,498
954,72,2,6,4,9,-78,-37,1,1,331,461
954,73,3,3,6,7,33,34,4,5,364,495
954,74,5,3,7,6,52,33,6,8,416,528
955,1,5,2,9,4,54,22,4,2,54,22
955,2,3,3,4,9,31,36,5,8,85,58
955,3,2,5,6,7,24,-48,9,0,109,10
955,4,2,5,5,8,-77,53,2,3,32,63
955,5,4,2,8,5,44,23,6,6,76,86
955,6,2,4,5,8,23,-56,9,0,99,30
955,7,5,2,9,4,-46,22,3,2,53,52
955,8,4,3,4,9,40,36,3,8,93,88
955,9,3,4,7,6,34,-58,7,0,127,30
955,10,3,4,4,9,31,45,8,5,158,75
955,11,2,4,4,9,-78,-55,0,0,80,20
955,12,3,3,7,6,34,33,4,3,114,53
955,13,5,3,9,4,54,31,8,4,168,84
955,14,3,3,3,10,30,-63,8,1,198,21
955,15,3,3,7,6,-66,33,2,4,132,54
955,16,3,3,8,5,35,32,7,6,167,86
955,17,3,4,5,8,32,-56,9,0,199,30
955,18,3,4,5,8,-68,44,1,4,131,74
955,19,3,4,6,7,33,43,4,7,164,117
955,20,3,3,6,7,33,-66,7,1,197,51
955,21,3,4,5,8,32,44,9,5,229,95
955,22,6,2,7,6,-39,24,0,9,190,119
955,23,5,2,9,4,54,-78,4,1,244,41
955,24,2,5,2,11,20,56,4,7,264,97
955,25,2,4,4,9,22,-55,6,2,286,42
955,26,4,3,9,4,-55,31,1,3,231,73
955,27,3,4,8,5,35,41,6,4,266,114
955,28,4,2,10,3,-54,21,2,5,212,135
955,29,5,2,7,6,52,24,4,9,264,159
955,30,4,2,7,6,43,-76,7,3,307,83
955,31,4,2,5,8,41,26,8,9,348,109
955,32,2,5,5,8,-77,-47,1,2,271,62
955,33,3,3,9,4,36,31,7,3,307,93
955,34,4,2,8,5,-56,23,1,6,251,116
955,35,2,5,6,7,24,52,5,8,275,168
955,36,5,2,9,4,54,-78,9,0,329,90
955,37,5,2,9,4,-46,22,3,2,283,112
955,38,4,3,8,5,44,32,7,4,327,144
955,39,2,4,4,9,22,45,9,9,349,189
955,40,2,4,4,9,-78,-55,1,4,271,134
955,41,3,3,8,5,35,32,6,6,306,166
955,42,3,3,8,5,-65,32,1,8,241,198
955,43,5,2,7,6,52,-76,3,2,293,122
955,44,4,3,5,8,41,35,4,7,334,157
955,45,2,4,4,9,22,-55,6,2,356,102
955,46,3,3,8,5,-65,32,1,4,291,134
955,47,4,3,8,5,44,32,5,6,335,166
955,48,3,4,4,9,31,-55,6,1,366,111
955,49,2,5,4,9,22,54,8,5,388,165
955,50,3,4,3,10,30,-54,8,1,418,111
955,51,2,5,5,8,-77,53,1,4,341,164
955,52,3,3,6,7,33,34,4,8,374,198
955,53,5,2,7,6,52,-76,6,2,426,122
955,54,3,3,5,8,32,35,8,7,458,157
955,55,3,5,5,8,-68,-47,0,0,390,110
955,56,5,2,8,5,53,23,3,3,443,133
955,57,2,4,5,8,23,44,6,7,466,177
955,58,3,3,6,7,33,-66,9,1,499,111
955,59,2,5,4,9,-78,54,1,5,421,165
955,60,4,3,9,4,45,31,6,6,466,196
955,61,4,2,8,5,-56,23,0,9,410,219
955,62,3,3,9,4,36,-69,6,0,446,150
955,63,3,3,7,6,-66,33,0,3,380,183
955,64,5,2,7,6,52,24,2,7,432,207
955,65,5,2,8,5,53,-77,5,0,485,130
955,66,3,3,8,5,-65,32,0,2,420,162
955,67,3,3,3,10,30,37,0,9,450,199
955,68,4,3,9,4,45,-69,5,0,495,130
955,69,2,5,3,10,21,55,6,5,516,185
956,1,3,3,5,8,32,35,2,5,32,35
956,2,3,3,7,6,34,33,6,8,66,68
956,3,2,5,3,10,21,-45,7,3,87,23
956,4,4,2,7,6,-57,24,0,7,30,47
956,5,2,4,7,6,25,42,5,9,55,89
956,6,3,3,3,10,30,-63,5,6,85,26
956,7,3,3,8,5,-65,32,0,8,20,58
956,8,3,3,6,7,33,-66,3,2,53,-8
956,9,2,4,8,5,26,41,9,3,79,33
956,10,3,4,4,9,-69,45,0,8,10,78
956,11,2,4,4,9,22,-55,2,3,32,23
956,12,3,4,7,6,34,42,6,5,66,65
956,13,3,4,5,8,32,44,8,9,98,109
956,14,4,3,8,5,-56,-68,2,1,42,41
956,15,5,2,9,4,54,22,6,3,96,63
956,16,3,3,7,6,-66,33,0,6,30,96
956,17,2,4,5,8,23,-56,3,0,53,40
956,18,4,2,9,4,45,22,8,2,98,62
956,19,2,4,6,7,-76,43,2,5,22,105
956,20,3,4,3,10,30,-54,2,1,52,51
956,21,5,2,7,6,52,24,4,5,104,75
956,22,3,3,6,7,33,34,7,9,137,109
956,23,5,2,9,4,-46,-78,1,1,91,31
956,24,4,2,6,7,42,25,3,6,133,56
956,25,3,4,6,7,33,43,6,9,166,99
956,26,3,3,6,7,33,-66,9,3,199,33
956,27,3,3,4,9,-69,36,0,9,130,69
956,28,5,2,11,2,56,20,6,9,186,89
956,29,5,2,9,4,-46,-78,0,1,140,11
956,30,4,2,10,3,46,21,6,2,186,32
956,31,2,5,2,11,20,56,6,8,206,88
956,32,3,3,5,8,32,-65,8,3,238,23
956,33,4,4,5,8,41,44,9,7,279,67
956,34,4,3,8,5,-56,32,3,9,223,99
956,35,2,4,5,8,23,-56,6,3,246,43
956,36,3,3,4,9,31,36,7,9,277,79
956,37,3,3,6,7,-67,-66,0,3,210,13
956,38,3,4,6,7,33,43,3,6,243,56
956,39,5,3,7,6,52,33,5,9,295,89
956,40,3,3,4,9,31,-64,6,5,326,25
956,41,3,3,7,6,-66,33,0,8,260,58
956,42,5,2,10,3,55,21,5,9,315,79
956,43,2,4,4,9,22,-55,7,4,337,24
956,44,2,5,4,9,22,54,9,8,359,78
956,45,4,4,8,5,-56,41,3,9,303,119
956,46,3,4,7,6,34,-58,7,1,337,61
956,47,3,4,7,6,-66,42,1,3,271,103
956,48,2,4,6,7,24,43,5,6,295,146
956,49,3,3,8,5,-65,32,0,8,230,178
956,50,4,2,6,7,42,-75,2,3,272,103
956,51,4,2,11,2,47,20,9,3,319,123
956,52,2,4,5,8,-77,44,2,7,242,167
956,53,6,2,10,3,64,21,6,8,306,188
956,54,6,2,10,3,-36,21,0,9,270,209
956,55,2,4,6,7,24,-57,4,2,294,152
956,56,3,3,7,6,34,33,8,5,328,185
956,57,3,4,7,6,-66,42,2,7,262,227
956,58,3,3,7,6,34,-67,6,0,296,160
956,59,5,2,10,3,-45,21,1,1,251,181
956,60,3,4,6,7,33,43,4,4,284,224
956,61,2,4,4,9,22,45,6,9,306,269
956,62,3,3,7,6,-66,-67,0,2,240,202
956,63,2,5,3,10,21,55,1,7,261,257
956,64,3,4,4,9,31,-55,2,2,292,202
956,65,3,3,3,10,30,37,2,9,322,239
956,66,3,3,4,9,31,-64,3,5,353,175
956,67,3,4,4,9,31,-55,4,0,384,120
956,68,5,2,6,7,51,25,5,5,435,145
956,69,3,3,9,4,-64,31,1,6,371,176
956,70,4,3,7,6,43,33,4,9,414,209
956,71,4,2,7,6,43,-76,7,3,457,133
956,72,3,4,6,7,-67,43,0,6,390,176
956,73,3,3,7,6,34,33,4,9,424,209
956,74,3,3,6,7,33,-66,7,3,457,143
956,75,2,4,8,5,-74,41,3,4,383,184
956,76,3,3,8,5,35,32,8,6,418,216
956,77,3,4,8,5,-65,41,3,7,353,257
956,78,4,2,5,8,41,-74,4,3,394,183
956,79,4,3,7,6,43,33,7,6,437,216
956,80,3,3,4,9,31,-64,8,2,468,152
956,81,3,3,5,8,-68,35,0,7,400,187
956,82,4,3,8,5,44,32,4,9,444,219
956,83,4,3,7,6,43,-67,7,2,487,152
956,84,5,2,11,2,-44,20,3,2,443,172
956,85,2,4,6,7,24,43,7,5,467,215
956,86,2,5,3,10,21,-45,8,0,488,170
956,87,4,3,7,6,-57,33,1,3,431,203
956,88,5,2,11,2,56,20,7,3,487,223
956,89,3,3,6,7,-67,34,0,7,420,257
956,90,2,4,6,7,24,-57,4,0,444,200
956,91,4,3,8,5,44,32,8,2,488,232
956,92,4,3,8,5,-56,32,2,4,432,264
956,93,4,2,5,8,41,-74,3,0,473,190
956,94,2,4,4,9,22,45,5,5,495,235
956,95,4,2,9,4,-55,22,0,7,440,257
956,96,3,4,7,6,34,42,4,9,474,299
956,97,4,2,8,5,44,-77,8,2,518,222
957,1,2,6,1,12,-20,66,0,6,-20,66
957,2,3,3,6,7,33,-66,3,0,13,0
957,3,2,4,3,10,21,46,4,6,34,46
957,4,3,3,5,8,32,-65,6,1,66,-19
957,5,4,3,9,4,-55,31,1,2,11,12
957,6,3,3,5,8,32,35,3,7,43,47
957,7,2,4,5,8,23,-56,6,1,66,-9
957,8,6,2,8,5,62,23,8,4,128,14
957,9,4,2,8,5,-56,23,2,7,72,37
957,10,3,3,8,5,35,32,7,9,107,69
957,11,4,2,7,6,-57,-76,0,3,50,-7
957,12,3,4,5,8,32,44,2,7,82,37
957,13,4,3,7,6,43,-67,5,0,125,-30
957,14,5,2,10,3,-45,21,0,1,80,-9
957,15,5,2,9,4,54,22,4,3,134,13
957,16,3,3,5,8,32,35,6,8,166,48
957,17,2,5,5,8,23,-47,9,1,189,1
957,18,3,4,6,7,-67,43,2,4,122,44
957,19,3,4,7,6,34,42,6,6,156,86
957,20,3,3,6,7,33,-66,9,0,189,20
957,21,4,4,6,7,-58,43,1,3,131,63
957,22,2,5,2,11,20,56,1,9,151,119
957,23,4,3,8,5,44,-68,5,1,195,51
957,24,4,3,5,8,41,35,6,6,236,86
957,25,4,2,10,3,-54,21,2,7,182,107
957,26,3,3,7,6,34,-67,6,0,216,40
957,27,4,4,7,6,43,42,9,2,259,82
957,28,4,3,9,4,-55,31,4,3,204,113
957,29,3,3,6,7,33,34,7,7,237,147
957,30,3,4,5,8,32,-56,9,1,269,91
957,31,2,5,2,11,20,56,9,7,289,147
957,32,4,2,7,6,-57,-76,2,1,232,71
957,33,3,3,5,8,32,35,4,6,264,106
957,34,2,5,3,10,21,-45,5,1,285,61
957,35,2,5,3,10,21,55,6,6,306,116
957,36,4,3,5,8,41,-65,7,1,347,51
957,37,4,2,6,7,42,25,9,6,389,76
957,38,4,2,10,3,-54,21,5,7,335,97
957,39,3,3,6,7,33,-66,8,1,368,31
957,40,2,5,5,8,-77,53,1,4,291,84
957,41,3,4,3,10,30,-54,1,0,321,30
957,42,4,2,10,3,46,21,7,1,367,51
957,43,2,4,5,8,-77,44,0,5,290,95
957,44,3,4,6,7,33,43,3,8,323,138
957,45,2,5,3,10,21,-45,4,3,344,93
957,46,4,3,9,4,45,31,9,4,389,124
957,47,4,2,6,7,-58,25,1,9,331,149
957,48,6,2,10,3,64,-79,5,0,395,70
957,49,4,3,9,4,-55,31,0,1,340,101
957,50,5,3,7,6,52,33,2,4,392,134
957,51,2,5,5,8,23,53,5,7,415,187
957,52,3,5,3,10,30,-45,5,2,445,142
957,53,2,4,4,9,22,45,7,7,467,187
957,54,4,2,10,3,-54,21,3,8,413,208
957,55,3,4,6,7,33,-57,6,1,446,151
957,56,3,3,7,6,-66,33,0,4,380,184
957,57,4,2,7,6,43,24,3,8,423,208
957,58,3,4,9,4,36,40,9,8,459,248
957,59,3,4,4,9,-69,-55,0,3,390,193
957,60,2,5,5,8,23,53,3,6,413,246
957,61,2,4,6,7,24,43,7,9,437,289
957,62,2,6,3,10,21,-36,8,3,458,253
957,63,4,2,6,7,-58,25,0,8,400,278
957,64,3,3,4,9,31,-64,1,4,431,214
957,65,3,3,9,4,36,31,7,5,467,245
957,66,3,4,6,7,-67,43,0,8,400,288
957,67,3,4,5,8,32,-56,2,2,432,232
957,68,3,4,8,5,35,41,7,3,467,273
957,69,4,2,7,6,-57,24,0,7,410,297
957,70,3,3,8,5,35,32,5,9,445,329
957,71,2,5,3,10,21,-45,6,4,466,284
957,72,3,4,4,9,31,45,7,9,497,329
957,73,4,3,5,8,41,-65,8,4,538,264
958,1,3,3,6,7,33,34,3,4,33,34
958,2,4,2,8,5,44,23,7,7,77,57
958,3,4,3,5,8,41,-65,8,2,118,-8
958,4,3,3,7,6,-66,33,2,5,52,25
958,5,4,2,9,4,45,22,7,7,97,47
958,6,5,2,11,2,-44,20,3,7,53,67
958,7,2,4,6,7,24,-57,7,0,77,10
958,8,5,3,7,6,52,33,9,3,129,43
958,9,4,3,7,6,-57,33,2,6,72,76
958,10,4,2,9,4,45,22,7,8,117,98
958,11,4,3,6,7,42,-66,9,2,159,32
958,12,4,2,7,6,-57,24,2,6,102,56
958,13,4,3,5,8,41,-65,3,1,143,-9
958,14,4,2,8,5,44,23,7,4,187,14
958,15,3,3,5,8,32,35,9,9,219,49
958,16,2,4,4,9,-78,-55,1,4,141,-6
958,17,3,4,6,7,33,43,4,7,174,37
958,18,2,4,7,6,25,42,9,9,199,79
958,19,4,3,8,5,-56,-68,3,1,143,11
958,20,4,2,7,6,43,24,6,5,186,35
958,21,4,2,8,5,-56,23,0,8,130,58
958,22,5,2,9,4,54,-78,4,0,184,-20
958,23,2,5,3,10,21,55,5,5,205,35
958,24,2,4,4,9,22,-55,7,0,227,-20
958,25,2,4,7,6,-75,42,2,2,152,22
958,26,3,4,5,8,32,44,4,6,184,66
958,27,5,2,11,2,-44,20,0,6,140,86
958,28,2,5,2,11,20,-44,0,2,160,42
958,29,2,4,2,11,20,47,0,9,180,89
958,30,2,5,3,10,21,-45,1,4,201,44
958,31,4,4,6,7,42,43,3,7,243,87
958,32,3,4,6,7,33,-57,6,0,276,30
958,33,4,2,9,4,-55,22,1,2,221,52
958,34,3,4,7,6,34,42,5,4,255,94
958,35,2,4,7,6,-75,42,0,6,180,136
958,36,2,5,5,8,23,53,3,9,203,189
958,37,3,3,8,5,35,-68,8,1,238,121
958,38,3,4,7,6,-66,42,2,3,172,163
958,39,4,4,9,4,45,40,7,3,217,203
958,40,2,4,5,8,-77,44,0,7,140,247
958,41,3,4,5,8,32,-56,2,1,172,191
958,42,3,3,9,4,36,31,8,2,208,222
958,43,5,2,7,6,-48,24,0,6,160,246
958,44,4,3,6,7,42,-66,2,0,202,180
958,45,4,3,6,7,42,34,4,4,244,214
958,46,5,2,9,4,54,22,8,6,298,236
958,47,4,2,8,5,-56,23,2,9,242,259
958,48,2,4,4,9,22,-55,4,4,264,204
958,49,2,5,4,9,22,54,6,8,286,258
958,50,5,2,7,6,52,-76,8,2,338,182
958,51,2,4,6,7,-76,43,2,5,262,225
958,52,4,3,8,5,44,32,6,7,306,257
958,53,4,3,9,4,-55,31,1,8,251,288
958,54,2,4,3,10,21,-54,2,4,272,234
958,55,4,3,5,8,41,35,3,9,313,269
958,56,4,3,5,8,41,-65,4,4,354,204
958,57,3,4,5,8,32,44,6,8,386,248
958,58,5,3,6,7,51,-66,7,2,437,182
958,59,3,3,6,7,-67,34,0,6,370,216
958,60,4,3,5,8,41,-65,1,1,411,151
958,61,4,3,9,4,45,31,6,2,456,182
958,62,2,5,7,6,-75,51,1,3,381,233
958,63,4,2,7,6,43,24,4,7,424,257
958,64,3,3,8,5,35,32,9,9,459,289
958,65,3,3,7,6,-66,-67,3,2,393,222
958,66,2,5,3,10,21,55,4,7,414,277
958,67,2,5,3,10,21,-45,5,2,435,232
958,68,2,4,7,6,-75,42,0,4,360,274
958,69,3,3,6,7,33,34,3,8,393,308
958,70,4,3,5,8,41,-65,4,3,434,243
958,71,2,5,3,10,21,55,5,8,455,298
958,72,5,2,6,7,51,-75,6,3,506,223
959,1,4,2,7,6,43,24,3,4,43,24
959,2,4,2,8,5,44,23,7,7,87,47
959,3,4,2,8,5,-56,-77,1,0,31,-30
959,4,4,3,5,8,41,35,2,5,72,5
959,5,4,2,8,5,44,23,6,8,116,28
959,6,2,4,7,6,-75,-58,1,0,41,-30
959,7,3,4,5,8,32,44,3,4,73,14
959,8,4,3,8,5,44,32,7,6,117,46
959,9,4,2,8,5,-56,23,1,9,61,69
959,10,5,2,8,5,53,-77,4,2,114,-8
959,11,3,4,9,4,-64,40,0,2,50,32
959,12,4,3,10,3,46,30,6,2,96,62
959,13,3,3,8,5,-65,32,1,4,31,94
959,14,4,3,6,7,42,34,3,8,73,128
959,15,3,3,9,4,36,31,9,9,109,159
959,16,3,4,4,9,-69,-55,0,4,40,104
959,17,3,3,3,10,30,-63,0,1,70,41
959,18,4,2,6,7,42,25,2,6,112,66
959,19,2,5,4,9,22,-46,4,0,134,20
959,20,3,3,7,6,34,33,8,3,168,53
959,21,4,2,6,7,-58,25,0,8,110,78
959,22,3,3,4,9,31,-64,1,4,141,14
959,23,3,4,7,6,34,42,5,6,175,56
959,24,4,3,8,5,44,32,9,8,219,88
959,25,3,3,8,5,-65,-68,4,0,154,20
959,26,3,3,5,8,32,35,6,5,186,55
959,27,2,5,3,10,21,-45,7,0,207,10
959,28,3,4,4,9,31,45,8,5,238,55
959,29,3,3,7,6,-66,33,2,8,172,88
959,30,4,3,7,6,43,-67,5,1,215,21
959,31,2,4,6,7,24,43,9,4,239,64
959,32,3,4,7,6,-66,42,3,6,173,106
959,33,4,2,8,5,44,23,7,9,217,129
959,34,5,2,11,2,-44,20,3,9,173,149
959,35,3,4,7,6,34,-58,7,1,207,91
959,36,2,4,7,6,-75,42,2,3,132,133
959,37,3,4,7,6,34,42,6,5,166,175
959,38,4,2,8,5,-56,23,0,8,110,198
959,39,3,4,7,6,34,-58,4,0,144,140
959,40,4,2,10,3,-54,21,0,1,90,161
959,41,4,3,7,6,43,33,3,4,133,194
959,42,3,4,5,8,32,44,5,8,165,238
959,43,5,2,7,6,52,-76,7,2,217,162
959,44,3,3,6,7,-67,34,0,6,150,196
959,45,3,4,5,8,32,-56,2,0,182,140
959,46,3,3,5,8,32,35,4,5,214,175
959,47,4,3,4,9,40,-64,4,1,254,111
959,48,5,2,6,7,51,25,5,6,305,136
959,49,2,5,4,9,22,-46,7,0,327,90
959,50,2,4,4,9,22,45,9,5,349,135
959,51,3,3,4,9,-69,-64,0,1,280,71
959,52,4,4,8,5,44,41,4,2,324,112
959,53,2,5,5,8,23,53,7,5,347,165
959,54,3,3,5,8,32,-65,9,0,379,100
959,55,3,4,8,5,-65,41,4,1,314,141
959,56,2,5,4,9,22,54,6,5,336,195
959,57,3,4,6,7,33,43,9,8,369,238
959,58,4,2,8,5,-56,-77,3,1,313,161
959,59,3,3,9,4,36,31,9,2,349,192
959,60,3,3,8,5,-65,32,4,4,284,224
959,61,5,3,10,3,55,30,9,4,339,254
959,62,4,3,6,7,-58,34,1,8,281,288
959,63,3,3,8,5,35,-68,6,0,316,220
959,64,4,4,8,5,-56,41,0,1,260,261
959,65,3,3,7,6,34,33,4,4,294,294
959,66,3,3,5,8,32,35,6,9,326,329
959,67,3,5,4,9,31,-46,7,3,357,283
959,68,2,4,5,8,-77,44,0,7,280,327
959,69,2,4,7,6,25,42,5,9,305,369
959,70,3,4,6,7,33,-57,8,2,338,312
959,71,6,2,9,4,-37,22,1,4,301,334
959,72,3,3,5,8,32,35,3,9,333,369
959,73,5,2,8,5,53,-77,6,2,386,292
959,74,5,2,9,4,-46,22,0,4,340,314
959,75,4,2,8,5,44,23,4,7,384,337
959,76,3,3,5,8,32,-65,6,2,416,272
959,77,5,3,7,6,52,33,8,5,468,305
959,78,4,2,7,6,-57,24,1,9,411,329
959,79,4,3,8,5,44,-68,5,1,455,261
959,80,4,3,8,5,44,32,9,3,499,293
959,81,5,2,10,3,-45,21,4,4,454,314
959,82,3,3,7,6,34,33,8,7,488,347
959,83,4,3,5,8,41,-65,9,2,529,282
960,1,3,3,7,6,34,33,4,3,34,33
960,2,3,3,7,6,34,33,8,6,68,66
960,3,4,2,10,3,-54,21,4,7,14,87
960,4,2,5,4,9,22,-46,6,1,36,41
960,5,3,3,5,8,32,35,8,6,68,76
960,6,2,6,4,9,-78,63,0,9,-10,139
960,7,2,4,4,9,22,-55,2,4,12,84
960,8,2,5,3,10,21,55,3,9,33,139
960,9,3,4,4,9,31,-55,4,4,64,84
960,10,4,3,8,5,44,32,8,6,108,116
960,11,3,4,7,6,-66,42,2,8,42,158
960,12,2,5,3,10,21,-45,3,3,63,113
960,13,4,4,5,8,41,44,4,7,104,157
960,14,2,4,5,8,23,-56,7,1,127,101
960,15,2,5,2,11,20,56,7,7,147,157
960,16,4,2,8,5,-56,-77,1,0,91,80
960,17,4,2,9,4,45,22,6,2,136,102
960,18,2,4,3,10,21,46,7,8,157,148
960,19,4,3,5,8,41,-65,8,3,198,83
960,20,2,5,6,7,-76,52,2,5,122,135
960,21,3,3,5,8,32,-65,4,0,154,70
960,22,3,4,6,7,33,43,7,3,187,113
960,23,3,3,8,5,-65,32,2,5,122,145
960,24,3,3,8,5,35,32,7,7,157,177
960,25,4,4,5,8,41,-56,8,1,198,121
960,26,5,2,9,4,-46,22,2,3,152,143
960,27,2,5,5,8,23,53,5,6,175,196
960,28,3,3,9,4,-64,31,1,7,111,227
960,29,2,5,4,9,22,-46,3,1,133,181
960,30,2,4,6,7,24,43,7,4,157,224
960,31,4,3,9,4,-55,31,2,5,102,255
960,32,4,3,10,3,46,30,8,5,148,285
960,33,5,2,10,3,-45,21,3,6,103,306
960,34,2,5,4,9,22,-46,5,0,125,260
960,35,4,3,9,4,-55,31,0,1,70,291
960,36,3,3,6,7,33,34,3,5,103,325
960,37,3,4,4,9,31,-55,4,0,134,270
960,38,3,3,7,6,34,33,8,3,168,303
960,39,3,3,4,9,31,36,9,9,199,339
960,40,5,2,8,5,-47,-77,2,2,152,262
960,41,3,3,7,6,34,33,6,5,186,295
960,42,3,3,5,8,32,-65,8,0,218,230
960,43,4,3,8,5,-56,32,2,2,162,262
960,44,3,3,6,7,33,34,5,6,195,296
960,45,5,2,8,5,53,23,8,9,248,319
960,46,2,5,6,7,-76,-48,2,1,172,271
960,47,2,5,4,9,22,54,4,5,194,325
960,48,3,3,7,6,34,33,8,8,228,358
960,49,3,4,5,8,-68,-56,0,2,160,302
960,50,2,4,3,10,21,46,1,8,181,348
960,51,4,2,6,7,42,-75,3,3,223,273
960,52,3,3,10,3,-63,30,0,3,160,303
960,53,2,5,4,9,22,54,2,7,182,357
960,54,4,3,9,4,45,31,7,8,227,388
960,55,5,2,9,4,-46,-78,1,0,181,310
960,56,2,4,3,10,21,46,2,6,202,356
960,57,3,4,4,9,31,-55,3,1,233,301
960,58,4,3,6,7,42,34,5,5,275,335
960,59,4,2,9,4,-55,22,0,7,220,357
960,60,4,2,7,6,43,-76,3,1,263,281
960,61,2,4,6,7,24,43,7,4,287,324
960,62,4,2,9,4,-55,22,2,6,232,346
960,63,3,3,6,7,33,-66,5,0,265,280
960,64,2,4,4,9,22,45,7,5,287,325
960,65,3,4,5,8,32,44,9,9,319,369
960,66,4,3,10,3,-54,30,5,9,265,399
960,67,3,4,6,7,33,-57,8,2,298,342
960,68,4,3,5,8,41,35,9,7,339,377
960,69,4,2,9,4,-55,22,4,9,284,399
960,70,4,3,8,5,44,-68,8,1,328,331
960,71,2,5,4,9,-78,54,0,5,250,385
960,72,2,4,6,7,24,43,4,8,274,428
960,73,4,3,6,7,42,-66,6,2,316,362
960,74,3,3,7,6,-66,33,0,5,250,395
960,75,2,5,3,10,21,-45,1,0,271,350
960,76,3,4,8,5,35,41,6,1,306,391
960,77,3,3,7,6,-66,33,0,4,240,424
960,78,4,3,6,7,42,34,2,8,282,458
960,79,2,5,4,9,22,-46,4,2,304,412
960,80,4,2,9,4,45,22,9,4,349,434
960,81,3,4,5,8,-68,44,1,8,281,478
960,82,2,5,2,11,20,-44,1,4,301,434
960,83,4,3,9,4,45,31,6,5,346,465
960,84,4,2,7,6,43,24,9,9,389,489
960,85,6,2,10,3,-36,-79,3,0,353,410
960,86,6,2,9,4,63,22,6,2,416,432
960,87,2,5,6,7,-76,52,0,4,340,484
960,88,4,3,10,3,46,30,6,4,386,514
961,1,5,2,6,7,51,25,1,5,51,25
961,2,3,3,8,5,35,32,6,7,86,57
961,3,5,2,9,4,-46,22,0,9,40,79
961,4,3,4,8,5,35,-59,5,0,75,20
961,5,5,3,9,4,54,31,9,1,129,51
961,6,3,4,6,7,-67,43,2,4,62,94
961,7,5,2,8,5,53,23,5,7,115,117
961,8,2,5,5,8,23,-47,8,0,138,70
961,9,2,5,5,8,-77,53,1,3,61,123
961,10,4,3,7,6,43,33,4,6,104,156
961,11,3,3,6,7,33,-66,7,0,137,90
961,12,3,3,6,7,-67,34,0,4,70,124
961,13,5,2,10,3,55,21,5,5,125,145
961,14,5,2,9,4,54,22,9,7,179,167
961,15,3,3,6,7,-67,-66,2,1,112,101
961,16,3,4,5,8,32,44,4,5,144,145
961,17,4,3,8,5,44,32,8,7,188,177
961,18,3,4,6,7,-67,-57,1,0,121,120
961,19,3,3,6,7,33,34,4,4,154,154
961,20,4,3,6,7,42,34,6,8,196,188
961,21,2,5,3,10,21,-45,7,3,217,143
961,22,5,2,10,3,-45,21,2,4,172,164
961,23,2,4,8,5,26,41,8,5,198,205
961,24,3,4,6,7,-67,43,1,8,131,248
961,25,2,5,4,9,22,-46,3,2,153,202
961,26,2,6,3,10,21,64,4,6,174,266
961,27,5,2,9,4,54,22,8,8,228,288
961,28,4,3,7,6,-57,-67,1,1,171,221
961,29,4,4,6,7,42,43,3,4,213,264
961,30,2,5,4,9,22,54,5,8,235,318
961,31,5,2,8,5,53,-77,8,1,288,241
961,32,4,2,9,4,-55,22,3,3,233,263
961,33,4,3,7,6,43,33,6,6,276,296
961,34,5,2,11,2,-44,20,2,6,232,316
961,35,4,3,10,3,46,30,8,6,278,346
961,36,2,4,7,6,-75,42,3,8,203,388
961,37,5,2,10,3,55,21,8,9,258,409
961,38,2,5,5,8,-77,-47,1,2,181,362
961,39,3,4,7,6,34,42,5,4,215,404
961,40,5,3,9,4,54,31,9,5,269,435
961,41,4,2,7,6,-57,24,2,9,212,459
961,42,4,2,9,4,45,-78,7,1,257,381
961,43,2,5,5,8,-77,53,0,4,180,434
961,44,3,3,7,6,34,33,4,7,214,467
961,45,4,3,5,8,41,-65,5,2,255,402
961,46,3,3,5,8,32,35,7,7,287,437
961,47,4,3,7,6,-57,-67,0,0,230,370
961,48,4,3,7,6,43,33,3,3,273,403
961,49,3,4,9,4,36,40,9,3,309,443
961,50,2,5,5,8,-77,53,2,6,232,496
961,51,4,2,10,3,46,21,8,7,278,517
962,1,2,5,3,10,21,55,1,5,21,55
962,2,2,4,4,9,22,-55,3,0,43,0
962,3,4,3,9,4,45,31,8,1,88,31
962,4,6,2,9,4,-37,22,1,3,51,53
962,5,3,4,6,7,33,43,4,6,84,96
962,6,3,3,7,6,34,33,8,9,118,129
962,7,4,4,7,6,-57,-58,1,1,61,71
962,8,2,4,7,6,25,42,6,3,86,113
962,9,4,3,5,8,41,35,7,8,127,148
962,10,3,4,5,8,32,-56,9,2,159,92
962,11,2,5,4,9,-78,54,1,6,81,146
962,12,3,4,4,9,31,-55,2,1,112,91
962,13,4,3,9,4,45,31,7,2,157,122
962,14,4,2,7,6,-57,24,0,6,100,146
962,15,3,3,9,4,36,31,6,7,136,177
962,16,3,3,10,3,-63,30,3,7,73,207
962,17,2,5,4,9,22,-46,5,1,95,161
962,18,3,3,8,5,-65,32,0,3,30,193
962,19,2,6,3,10,21,64,1,7,51,257
962,20,4,3,5,8,41,-65,2,2,92,192
962,21,4,2,9,4,45,22,7,4,137,214
962,22,3,3,7,6,-66,33,1,7,71,247
962,23,3,4,7,6,34,42,5,9,105,289
962,24,3,3,4,9,31,-64,6,5,136,225
962,25,3,3,9,4,-64,31,2,6,72,256
962,26,5,3,8,5,53,32,5,8,125,288
962,27,3,3,6,7,33,-66,8,2,158,222
962,28,3,3,5,8,-68,35,0,7,90,257
962,29,4,3,6,7,42,-66,2,1,132,191
962,30,6,2,11,2,65,20,7,1,197,211
962,31,3,4,6,7,-67,43,0,4,130,254
962,32,4,3,8,5,44,32,4,6,174,286
962,33,2,4,5,8,23,-56,7,0,197,230
962,34,4,2,8,5,-56,23,1,3,141,253
962,35,3,3,6,7,33,34,4,7,174,287
962,36,2,5,4,9,22,-46,6,1,196,241
962,37,2,5,2,11,20,56,6,7,216,297
962,38,3,3,6,7,33,-66,9,1,249,231
962,39,3,3,7,6,-66,33,3,4,183,264
962,40,4,3,6,7,42,34,5,8,225,298
962,41,3,4,4,9,31,-55,6,3,256,243
962,42,3,4,3,10,30,46,6,9,286,289
962,43,3,5,4,9,31,-46,7,3,317,243
962,44,3,4,6,7,-67,43,0,6,250,286
962,45,2,4,2,11,20,-53,0,3,270,233
962,46,4,3,8,5,44,32,4,5,314,265
962,47,6,2,11,2,65,20,9,5,379,285
962,48,3,4,4,9,-69,-55,0,0,310,230
962,49,2,5,7,6,25,51,5,1,335,281
962,50,3,4,5,8,32,44,7,5,367,325
962,51,5,2,8,5,-47,23,0,8,320,348
962,52,3,4,6,7,33,-57,3,1,353,291
962,53,3,3,5,8,32,35,5,6,385,326
962,54,2,4,7,6,-75,42,0,8,310,368
962,55,4,3,8,5,44,-68,4,0,354,300
962,56,3,3,5,8,32,35,6,5,386,335
962,57,3,3,5,8,32,-65,8,0,418,270
962,58,2,4,6,7,-76,43,2,3,342,313
962,59,5,3,8,5,53,32,5,5,395,345
962,60,4,3,9,4,-55,31,0,6,340,376
962,61,3,3,6,7,33,-66,3,0,373,310
962,62,5,2,9,4,54,22,7,2,427,332
962,63,2,4,6,7,-76,43,1,5,351,375
962,64,4,3,7,6,43,33,4,8,394,408
962,65,4,2,5,8,41,-74,5,4,435,334
962,66,4,3,5,8,41,35,6,9,476,369
962,67,2,4,7,6,-75,-58,1,1,401,311
962,68,3,3,9,4,36,31,7,2,437,342
962,69,3,4,7,6,-66,42,1,4,371,384
962,70,2,5,5,8,23,53,4,7,394,437
962,71,3,4,5,8,32,-56,6,1,426,381
962,72,2,4,5,8,23,44,9,5,449,425
962,73,4,4,7,6,-57,42,2,7,392,467
962,74,4,3,8,5,44,32,6,9,436,499
962,75,2,5,2,11,20,-44,6,5,456,455
962,76,4,3,8,5,-56,32,0,7,400,487
962,77,3,4,6,7,33,-57,3,0,433,430
962,78,3,4,9,4,36,40,9,0,469,470
962,79,2,4,7,6,-75,42,4,2,394,512
963,1,4,2,8,5,44,23,4,3,44,23
963,2,6,2,8,5,62,23,6,6,106,46
963,3,5,2,8,5,53,23,9,9,159,69
963,4,2,4,6,7,-76,-57,3,2,83,12
963,5,4,3,7,6,43,33,6,5,126,45
963,6,4,3,9,4,-55,31,1,6,71,76
963,7,4,2,11,2,47,20,8,6,118,96
963,8,3,3,6,7,-67,-66,1,0,51,30
963,9,4,3,8,5,44,32,5,2,95,62
963,10,4,3,5,8,41,35,6,7,136,97
963,11,3,3,8,5,-65,32,1,9,71,129
963,12,6,2,11,2,65,20,6,9,136,149
963,13,4,3,10,3,-54,30,2,9,82,179
963,14,3,3,8,5,35,-68,7,1,117,111
963,15,3,3,9,4,-64,31,3,2,53,142
963,16,5,2,9,4,54,22,7,4,107,164
963,17,2,4,4,9,22,45,9,9,129,209
963,18,4,2,9,4,-55,-78,4,1,74,131
963,19,2,6,3,10,21,64,5,5,95,195
963,20,4,2,10,3,-54,21,1,6,41,216
963,21,2,5,5,8,23,53,4,9,64,269
963,22,2,4,3,10,21,-54,5,5,85,215
963,23,3,4,7,6,34,42,9,7,119,257
963,24,3,3,8,5,-65,32,4,9,54,289
963,25,4,4,7,6,43,-58,7,1,97,231
963,26,3,3,9,4,-64,31,3,2,33,262
963,27,2,4,9,4,-73,40,0,2,-40,302
963,28,3,4,4,9,31,45,1,7,-9,347
963,29,2,5,3,10,21,-45,2,2,12,302
963,30,3,4,5,8,32,44,4,6,44,346
963,31,3,3,6,7,33,-66,7,0,77,280
963,32,3,4,8,5,-65,41,2,1,12,321
963,33,4,2,10,3,46,21,8,2,58,342
963,34,4,2,9,4,-55,22,3,4,3,364
963,35,5,2,9,4,54,22,7,6,57,386
963,36,4,2,7,6,-57,-76,0,0,0,310
963,37,2,4,7,6,25,42,5,2,25,352
963,38,3,3,5,8,32,35,7,7,57,387
963,39,4,2,9,4,-55,22,2,9,2,409
963,40,3,4,4,9,31,-55,3,4,33,354
963,41,3,3,9,4,36,31,9,5,69,385
963,42,2,4,8,5,-74,41,5,6,-5,426
963,43,3,3,9,4,-64,31,1,7,-69,457
963,44,4,3,8,5,44,32,5,9,-25,489
963,45,2,4,6,7,24,-57,9,2,-1,432
963,46,5,2,8,5,-47,23,2,5,-48,455
963,47,4,2,8,5,44,23,6,8,-4,478
963,48,5,2,8,5,53,-77,9,1,49,401
963,49,2,5,3,10,-79,55,0,6,-30,456
963,50,3,3,5,8,32,-65,2,1,2,391
963,51,2,5,4,9,22,54,4,5,24,445
963,52,3,3,5,8,32,-65,6,0,56,380
963,53,2,5,3,10,21,55,7,5,77,435
963,54,4,2,10,3,-54,21,3,6,23,456
963,55,2,4,5,8,23,-56,6,0,46,400
963,56,3,3,5,8,32,35,8,5,78,435
963,57,4,3,7,6,-57,33,1,8,21,468
963,58,3,4,5,8,32,-56,3,2,53,412
963,59,4,2,8,5,44,23,7,5,97,435
963,60,4,4,8,5,-56,41,1,6,41,476
963,61,4,3,7,6,43,33,4,9,84,509
964,1,4,2,8,5,44,23,4,3,44,23
964,2,4,2,10,3,-54,21,0,4,-10,44
964,3,3,4,8,5,35,41,5,5,25,85
964,4,4,2,6,7,42,-75,7,0,67,10
964,5,4,2,10,3,-54,21,3,1,13,31
964,6,3,3,5,8,32,35,5,6,45,66
964,7,3,4,7,6,34,42,9,8,79,108
964,8,5,2,11,2,-44,20,5,8,35,128
964,9,5,3,9,4,54,31,9,9,89,159
964,10,3,3,8,5,-65,-68,4,1,24,91
964,11,4,2,6,7,42,25,6,6,66,116
964,12,3,3,8,5,-65,32,1,8,1,148
964,13,2,6,2,11,20,-35,1,3,21,113
964,14,4,3,8,5,44,32,5,5,65,145
964,15,5,2,10,3,-45,21,0,6,20,166
964,16,4,3,9,4,45,31,5,7,65,197
964,17,2,5,2,11,20,-44,5,3,85,153
964,18,4,3,6,7,42,34,7,7,127,187
964,19,4,2,7,6,-57,-76,0,1,70,111
964,20,4,4,5,8,41,44,1,5,111,155
964,21,2,5,5,8,23,53,4,8,134,208
964,22,3,3,6,7,33,-66,7,2,167,142
964,23,4,3,7,6,-57,33,0,5,110,175
964,24,4,2,5,8,41,-74,1,1,151,101
964,25,4,2,8,5,44,23,5,4,195,124
964,26,3,3,7,6,34,33,9,7,229,157
964,27,2,4,5,8,-77,-56,2,1,152,101
964,28,3,3,4,9,31,36,3,7,183,137
964,29,3,3,4,9,31,-64,4,3,214,73
964,30,3,4,6,7,33,43,7,6,247,116
964,31,3,4,4,9,31,-55,8,1,278,61
964,32,4,2,9,4,-55,22,3,3,223,83
964,33,3,3,4,9,31,36,4,9,254,119
964,34,4,3,7,6,43,-67,7,2,297,52
964,35,3,3,7,6,-66,33,1,5,231,85
964,36,2,4,8,5,26,41,7,6,257,126
964,37,4,3,10,3,-54,30,3,6,203,156
964,38,5,2,10,3,55,21,8,7,258,177
964,39,2,4,5,8,-77,-56,1,1,181,121
964,40,5,2,9,4,54,22,5,3,235,143
964,41,3,4,8,5,-65,41,0,4,170,184
964,42,3,3,9,4,36,31,6,5,206,215
964,43,2,5,2,11,20,-44,6,1,226,171
964,44,5,2,9,4,-46,22,0,3,180,193
964,45,4,4,8,5,44,41,4,4,224,234
964,46,3,3,6,7,33,34,7,8,257,268
964,47,3,3,7,6,-66,-67,1,1,191,201
964,48,3,3,8,5,35,32,6,3,226,233
964,49,6,2,9,4,63,22,9,5,289,255
964,50,4,3,9,4,-55,31,4,6,234,286
964,51,3,4,6,7,33,43,7,9,267,329
964,52,5,2,7,6,52,-76,9,3,319,253
964,53,6,2,10,3,-36,21,3,4,283,274
964,54,2,6,4,9,22,63,5,7,305,337
964,55,2,4,4,9,22,-55,7,2,327,282
964,56,5,2,9,4,-46,22,1,4,281,304
964,57,5,2,10,3,55,21,6,5,336,325
964,58,3,3,7,6,-66,33,0,8,270,358
964,59,2,4,5,8,23,-56,3,2,293,302
964,60,6,2,11,2,65,20,8,2,358,322
964,61,4,3,8,5,-56,32,2,4,302,354
964,62,3,3,8,5,35,32,7,6,337,386
964,63,3,3,7,6,-66,33,1,9,271,419
964,64,3,4,3,10,30,-54,1,5,301,365
964,65,4,3,7,6,43,33,4,8,344,398
964,66,4,3,9,4,45,31,9,9,389,429
964,67,5,3,9,4,-46,-69,3,0,343,360
964,68,4,2,7,6,43,24,6,4,386,384
964,69,4,3,9,4,-55,31,1,5,331,415
964,70,3,4,6,7,33,43,4,8,364,458
964,71,2,5,2,11,20,-44,4,4,384,414
964,72,3,3,8,5,35,32,9,6,419,446
964,73,3,4,4,9,-69,-55,0,1,350,391
964,74,2,5,4,9,22,54,2,5,372,445
964,75,4,3,8,5,44,32,6,7,416,477
964,76,3,4,5,8,32,-56,8,1,448,421
964,77,3,4,4,9,31,45,9,6,479,466
964,78,5,2,9,4,-46,22,3,8,433,488
964,79,2,4,5,8,23,-56,6,2,456,432
964,80,3,4,5,8,32,44,8,6,488,476
964,81,2,4,5,8,-77,-56,1,0,411,420
964,82,5,3,8,5,53,32,4,2,464,452
964,83,3,4,4,9,31,45,5,7,495,497
964,84,5,2,7,6,52,-76,7,1,547,421
965,1,2,4,2,11,20,47,0,7,20,47
965,2,2,4,6,7,24,-57,4,0,44,-10
965,3,4,3,9,4,45,31,9,1,89,21
965,4,4,3,9,4,-55,31,4,2,34,52
965,5,6,2,9,4,63,22,7,4,97,74
965,6,4,3,6,7,42,34,9,8,139,108
965,7,2,5,3,10,-79,-45,0,3,60,63
965,8,2,6,4,9,22,63,2,6,82,126
965,9,2,4,5,8,23,-56,5,0,105,70
965,10,5,2,8,5,53,23,8,3,158,93
965,11,5,2,9,4,-46,22,2,5,112,115
965,12,3,3,5,8,32,-65,4,0,144,50
965,13,3,3,8,5,35,32,9,2,179,82
965,14,3,4,5,8,-68,44,1,6,111,126
965,15,5,2,8,5,53,23,4,9,164,149
965,16,3,4,6,7,33,-57,7,2,197,92
965,17,3,4,5,8,32,44,9,6,229,136
965,18,2,4,6,7,-76,43,3,9,153,179
965,19,3,5,6,7,33,-48,6,1,186,131
965,20,2,5,4,9,22,54,8,5,208,185
965,21,4,3,5,8,41,-65,9,0,249,120
965,22,2,4,3,10,-79,46,0,6,170,166
965,23,3,5,7,6,34,51,4,7,204,217
965,24,2,4,6,7,24,-57,8,0,228,160
965,25,2,6,3,10,21,64,9,4,249,224
965,26,2,6,1,12,-20,-34,9,0,229,190
965,27,3,4,8,5,-65,41,4,1,164,231
965,28,2,5,3,10,21,55,5,6,185,286
965,29,3,3,6,7,33,-66,8,0,218,220
965,30,4,2,6,7,-58,25,0,5,160,245
965,31,4,3,8,5,44,32,4,7,204,277
965,32,3,4,6,7,33,-57,7,0,237,220
965,33,3,3,5,8,32,35,9,5,269,255
965,34,2,4,6,7,-76,43,3,8,193,298
965,35,4,3,8,5,44,-68,7,0,237,230
965,36,4,2,6,7,42,25,9,5,279,255
965,37,3,3,8,5,-65,32,4,7,214,287
965,38,3,3,4,9,31,-64,5,3,245,223
965,39,3,3,7,6,34,33,9,6,279,256
965,40,4,3,7,6,-57,33,2,9,222,289
965,41,2,4,4,9,22,-55,4,4,244,234
965,42,3,3,6,7,33,34,7,8,277,268
965,43,2,5,5,8,-77,-47,0,1,200,221
965,44,4,3,10,3,46,30,6,1,246,251
965,45,3,4,9,4,-64,40,2,1,182,291
965,46,4,2,10,3,46,21,8,2,228,312
965,47,2,5,4,9,-78,54,0,6,150,366
965,48,4,3,5,8,41,-65,1,1,191,301
965,49,4,3,8,5,44,32,5,3,235,333
965,50,4,3,7,6,43,33,8,6,278,366
965,51,4,3,6,7,-58,-66,0,0,220,300
965,52,4,2,9,4,45,22,5,2,265,322
965,53,4,3,8,5,44,32,9,4,309,354
965,54,3,5,6,7,-67,52,2,6,242,406
965,55,3,3,6,7,33,-66,5,0,275,340
965,56,4,3,10,3,-54,30,1,0,221,370
965,57,2,4,5,8,23,44,4,4,244,414
965,58,2,4,5,8,23,44,7,8,267,458
965,59,4,2,9,4,-55,-78,2,0,212,380
965,60,4,3,9,4,45,31,7,1,257,411
965,61,4,2,9,4,-55,22,2,3,202,433
965,62,5,2,8,5,53,23,5,6,255,456
965,63,3,4,4,9,31,-55,6,1,286,401
965,64,2,6,6,7,-76,61,0,2,210,462
965,65,4,3,7,6,43,33,3,5,253,495
965,66,4,2,8,5,44,23,7,8,297,518
966,1,5,2,9,4,54,22,4,2,54,22
966,2,5,2,7,6,52,24,6,6,106,46
966,3,3,3,6,7,33,-66,9,0,139,-20
966,4,2,4,4,9,-78,45,1,5,61,25
966,5,3,5,5,8,32,53,3,8,93,78
966,6,2,4,4,9,22,-55,5,3,115,23
966,7,2,5,5,8,23,53,8,6,138,76
966,8,4,3,8,5,-56,32,2,8,82,108
966,9,4,3,8,5,44,-68,6,0,126,40
966,10,2,4,5,8,23,44,9,4,149,84
966,11,4,2,8,5,-56,23,3,7,93,107
966,12,5,3,9,4,54,31,7,8,147,138
966,13,3,3,8,5,-65,-68,2,0,82,70
966,14,5,2,10,3,55,21,7,1,137,91
966,15,4,3,7,6,-57,33,0,4,80,124
966,16,4,3,8,5,44,32,4,6,124,156
966,17,3,3,7,6,34,33,8,9,158,189
966,18,4,3,9,4,-55,-69,3,0,103,120
966,19,2,4,7,6,25,42,8,2,128,162
966,20,5,2,10,3,-45,21,3,3,83,183
966,21,3,4,6,7,33,43,6,6,116,226
966,22,2,4,5,8,23,-56,9,0,139,170
966,23,3,3,9,4,-64,31,5,1,75,201
966,24,2,4,6,7,24,43,9,4,99,244
966,25,3,3,5,8,-68,35,1,9,31,279
966,26,2,5,5,8,23,-47,4,2,54,232
966,27,4,3,9,4,45,31,9,3,99,263
966,28,3,4,4,9,-69,45,0,8,30,308
966,29,2,5,4,9,22,-46,2,2,52,262
966,30,5,2,11,2,56,20,8,2,108,282
966,31,3,3,7,6,-66,33,2,5,42,315
966,32,2,4,8,5,26,41,8,6,68,356
966,33,4,3,5,8,41,-65,9,1,109,291
966,34,2,5,2,11,20,56,9,7,129,347
966,35,2,4,4,9,-78,-55,1,2,51,292
966,36,2,5,5,8,23,53,4,5,74,345
966,37,4,3,4,9,40,-64,4,1,114,281
966,38,3,4,5,8,32,44,6,5,146,325
966,39,4,3,9,4,-55,31,1,6,91,356
966,40,2,5,4,9,22,-46,3,0,113,310
966,41,4,2,9,4,45,22,8,2,158,332
966,42,4,3,8,5,-56,32,2,4,102,364
966,43,3,4,5,8,32,44,4,8,134,408
966,44,3,4,5,8,32,-56,6,2,166,352
966,45,3,4,7,6,-66,42,0,4,100,394
966,46,4,2,7,6,43,24,3,8,143,418
966,47,2,5,3,10,21,-45,4,3,164,373
966,48,2,6,3,10,21,64,5,7,185,437
966,49,3,3,6,7,33,-66,8,1,218,371
966,50,4,3,6,7,-58,34,0,5,160,405
966,51,2,5,4,9,22,54,2,9,182,459
966,52,5,2,10,3,55,-79,7,0,237,380
966,53,2,4,7,6,-75,42,2,2,162,422
966,54,4,4,5,8,41,44,3,6,203,466
966,55,3,4,5,8,32,-56,5,0,235,410
966,56,3,3,5,8,32,35,7,5,267,445
966,57,4,3,5,8,41,-65,8,0,308,380
966,58,4,3,7,6,-57,33,1,3,251,413
966,59,3,4,4,9,31,45,2,8,282,458
966,60,3,3,7,6,34,-67,6,1,316,391
966,61,4,3,8,5,-56,32,0,3,260,423
966,62,4,3,6,7,42,34,2,7,302,457
966,63,4,3,6,7,42,-66,4,1,344,391
966,64,3,4,7,6,34,42,8,3,378,433
966,65,2,4,6,7,-76,43,2,6,302,476
966,66,3,3,6,7,33,-66,5,0,335,410
966,67,2,4,5,8,23,44,8,4,358,454
966,68,5,2,9,4,-46,22,2,6,312,476
966,69,3,3,6,7,33,-66,5,0,345,410
966,70,2,4,5,8,23,44,8,4,368,454
966,71,4,2,7,6,-57,24,1,8,311,478
966,72,2,5,3,10,21,-45,2,3,332,433
966,73,4,3,8,5,44,32,6,5,376,465
966,74,3,3,6,7,33,34,9,9,409,499
966,75,3,3,6,7,-67,-66,2,3,342,433
966,76,5,2,7,6,52,24,4,7,394,457
966,77,3,3,7,6,34,-67,8,0,428,390
966,78,3,4,5,8,-68,44,0,4,360,434
966,79,4,3,7,6,43,33,3,7,403,467
966,80,3,3,6,7,33,-66,6,1,436,401
966,81,2,5,4,9,22,54,8,5,458,455
966,82,3,4,5,8,-68,44,0,9,390,499
966,83,4,3,6,7,42,-66,2,3,432,433
966,84,3,3,6,7,33,34,5,7,465,467
966,85,3,3,7,6,34,-67,9,0,499,400
966,86,5,2,10,3,-45,21,4,1,454,421
966,87,4,3,8,5,44,32,8,3,498,453
966,88,3,4,5,8,-68,44,0,7,430,497
966,89,3,3,7,6,34,-67,4,0,464,430
966,90,2,4,6,7,24,43,8,3,488,473
966,91,4,3,8,5,-56,32,2,5,432,505
967,1,4,2,7,6,43,24,3,4,43,24
967,2,3,4,5,8,32,44,5,8,75,68
967,3,3,3,5,8,32,-65,7,3,107,3
967,4,5,2,9,4,-46,22,1,5,61,25
967,5,3,3,7,6,34,33,5,8,95,58
967,6,5,2,8,5,53,-77,8,1,148,-19
967,7,3,4,5,8,-68,44,0,5,80,25
967,8,4,3,7,6,43,33,3,8,123,58
967,9,3,4,6,7,33,-57,6,1,156,1
967,10,4,2,6,7,42,25,8,6,198,26
967,11,4,2,10,3,-54,21,4,7,144,47
967,12,4,3,7,6,43,-67,7,0,187,-20
967,13,3,4,4,9,31,45,8,5,218,25
967,14,2,5,5,8,-77,53,1,8,141,78
967,15,4,3,6,7,42,-66,3,2,183,12
967,16,2,5,4,9,22,54,5,6,205,66
967,17,4,3,8,5,44,32,9,8,249,98
967,18,2,4,6,7,-76,-57,3,1,173,41
967,19,5,2,5,8,50,26,3,7,223,67
967,20,2,4,5,8,23,-56,6,1,246,11
967,21,3,3,8,5,-65,32,1,3,181,43
967,22,3,4,4,9,31,45,2,8,212,88
967,23,6,2,11,2,65,20,7,8,277,108
967,24,4,3,5,8,41,-65,8,3,318,43
967,25,2,4,8,5,-74,41,4,4,244,84
967,26,3,4,5,8,32,44,6,8,276,128
967,27,3,3,6,7,33,-66,9,2,309,62
967,28,4,2,10,3,-54,21,5,3,255,83
967,29,3,3,7,6,34,33,9,6,289,116
967,30,4,3,6,7,-58,-66,1,0,231,50
967,31,6,2,7,6,61,24,2,4,292,74
967,32,5,2,9,4,54,22,6,6,346,96
967,33,4,3,6,7,42,-66,8,0,388,30
967,34,3,4,6,7,-67,43,1,3,321,73
967,35,4,3,9,4,45,31,6,4,366,104
967,36,3,5,4,9,31,54,7,8,397,158
967,37,3,3,6,7,-67,-66,0,2,330,92
967,38,2,5,5,8,23,53,3,5,353,145
967,39,4,3,9,4,45,31,8,6,398,176
967,40,5,2,9,4,-46,22,2,8,352,198
967,41,5,2,10,3,55,21,7,9,407,219
967,42,2,5,4,9,22,-46,9,3,429,173
967,43,3,3,6,7,-67,34,2,7,362,207
967,44,2,5,5,8,23,-47,5,0,385,160
967,45,2,5,3,10,21,55,6,5,406,215
967,46,3,3,3,10,30,-63,6,2,436,152
967,47,3,4,5,8,32,44,8,6,468,196
967,48,4,2,9,4,-55,22,3,8,413,218
967,49,2,4,3,10,21,-54,4,4,434,164
967,50,3,3,7,6,34,33,8,7,468,197
967,51,4,2,8,5,-56,-77,2,0,412,120
967,52,5,2,8,5,53,23,5,3,465,143
967,53,3,3,8,5,-65,32,0,5,400,175
967,54,2,4,7,6,25,42,5,7,425,217
967,55,3,3,7,6,34,-67,9,0,459,150
967,56,2,5,7,6,-75,51,4,1,384,201
967,57,3,3,7,6,34,33,8,4,418,234
967,58,4,3,6,7,-58,34,0,8,360,268
967,59,2,4,4,9,22,-55,2,3,382,213
967,60,6,2,10,3,64,21,6,4,446,234
967,61,3,3,5,8,32,35,8,9,478,269
967,62,3,5,6,7,-67,-48,1,1,411,221
967,63,2,4,4,9,22,45,3,6,433,266
967,64,4,3,7,6,43,33,6,9,476,299
967,65,4,3,7,6,43,-67,9,2,519,232
968,1,3,3,7,6,34,33,4,3,34,33
968,2,2,4,6,7,24,43,8,6,58,76
968,3,3,3,7,6,-66,33,2,9,-8,109
968,4,3,4,5,8,32,-56,4,3,24,53
968,5,2,6,4,9,22,63,6,6,46,116
968,6,4,3,8,5,-56,32,0,8,-10,148
968,7,3,3,4,9,31,-64,1,4,21,84
968,8,4,2,9,4,45,22,6,6,66,106
968,9,2,4,6,7,-76,43,0,9,-10,149
968,10,2,4,4,9,22,-55,2,4,12,94
968,11,3,3,10,3,37,30,9,4,49,124
968,12,3,3,7,6,-66,33,3,7,-17,157
968,13,3,4,6,7,33,-57,6,0,16,100
968,14,4,2,7,6,43,24,9,4,59,124
968,15,2,4,7,6,-75,42,4,6,-16,166
968,16,5,2,8,5,53,23,7,9,37,189
968,17,4,3,5,8,41,-65,8,4,78,124
968,18,3,3,4,9,31,-64,9,0,109,60
968,19,2,6,4,9,-78,63,1,3,31,123
968,20,2,6,2,11,20,65,1,8,51,188
968,21,3,3,6,7,33,-66,4,2,84,122
968,22,3,3,6,7,33,34,7,6,117,156
968,23,2,5,4,9,22,-46,9,0,139,110
968,24,4,2,8,5,-56,23,3,3,83,133
968,25,3,3,9,4,36,31,9,4,119,164
968,26,2,4,6,7,-76,43,3,7,43,207
968,27,2,5,6,7,24,52,7,9,67,259
968,28,2,5,4,9,22,-46,9,3,89,213
968,29,4,3,8,5,-56,32,3,5,33,245
968,30,5,3,8,5,53,32,6,7,86,277
968,31,3,3,6,7,33,-66,9,1,119,211
968,32,3,4,6,7,-67,43,2,4,52,254
968,33,3,3,10,3,37,30,9,4,89,284
968,34,3,3,7,6,-66,33,3,7,23,317
968,35,4,3,7,6,43,-67,6,0,66,250
968,36,5,2,9,4,-46,22,0,2,20,272
968,37,2,4,8,5,26,41,6,3,46,313
968,38,4,3,6,7,42,34,8,7,88,347
968,39,4,3,8,5,-56,32,2,9,32,379
968,40,5,2,9,4,54,-78,6,1,86,301
968,41,2,5,2,11,20,56,6,7,106,357
968,42,2,5,3,10,21,-45,7,2,127,312
968,43,2,4,5,8,-77,44,0,6,50,356
968,44,4,3,9,4,45,31,5,7,95,387
968,45,3,4,9,4,-64,40,1,7,31,427
968,46,3,4,7,6,34,42,5,9,65,469
968,47,3,4,7,6,34,-58,9,1,99,411
968,48,4,2,7,6,-57,24,2,5,42,435
968,49,5,2,7,6,52,24,4,9,94,459
968,50,2,5,5,8,23,-47,7,2,117,412
968,51,5,2,8,5,-47,23,0,5,70,435
968,52,3,3,8,5,35,32,5,7,105,467
968,53,3,3,7,6,34,-67,9,0,139,400
968,54,3,3,9,4,-64,31,5,1,75,431
968,55,4,3,7,6,43,33,8,4,118,464
968,56,3,3,6,7,-67,34,1,8,51,498
968,57,4,3,7,6,43,-67,4,1,94,431
968,58,3,4,5,8,32,44,6,5,126,475
968,59,6,2,12,1,-34,-20,2,5,92,455
968,60,4,2,6,7,42,-75,4,0,134,380
968,61,2,4,6,7,24,43,8,3,158,423
968,62,4,3,6,7,-58,34,0,7,100,457
968,63,2,5,6,7,24,52,4,9,124,509
969,1,3,3,5,8,32,35,2,5,32,35
969,2,4,3,8,5,44,32,6,7,76,67
969,3,3,3,5,8,32,-65,8,2,108,2
969,4,3,4,4,9,31,45,9,7,139,47
969,5,3,3,5,8,-68,-65,1,2,71,-18
969,6,4,2,7,6,43,24,4,6,114,6
969,7,2,6,4,9,22,63,6,9,136,69
969,8,4,2,10,3,-54,-79,2,0,82,-10
969,9,2,5,6,7,24,52,6,2,106,42
969,10,3,3,8,5,-65,32,1,4,41,74
969,11,2,4,6,7,24,43,5,7,65,117
969,12,3,4,4,9,31,-55,6,2,96,62
969,13,2,5,5,8,23,53,9,5,119,115
969,14,2,4,3,10,-79,-54,0,1,40,61
969,15,3,4,6,7,33,43,3,4,73,104
969,16,3,4,7,6,34,42,7,6,107,146
969,17,3,4,7,6,-66,42,1,8,41,188
969,18,3,4,7,6,34,-58,5,0,75,130
969,19,6,2,10,3,64,21,9,1,139,151
969,20,3,3,6,7,-67,34,2,5,72,185
969,21,5,2,9,4,54,22,6,7,126,207
969,22,5,2,8,5,53,-77,9,0,179,130
969,23,3,3,8,5,-65,32,4,2,114,162
969,24,5,2,7,6,52,24,6,6,166,186
969,25,6,2,11,2,-35,20,1,6,131,206
969,26,2,4,6,7,24,43,5,9,155,249
969,27,5,2,6,7,51,-75,6,4,206,174
969,28,4,3,8,5,-56,32,0,6,150,206
969,29,4,2,8,5,44,23,4,9,194,229
969,30,3,4,3,10,30,-54,4,5,224,175
969,31,2,5,4,9,22,54,6,9,246,229
969,32,3,3,6,7,33,-66,9,3,279,163
969,33,4,3,7,6,-57,33,2,6,222,196
969,34,2,4,5,8,23,-56,5,0,245,140
969,35,2,4,3,10,21,46,6,6,266,186
969,36,4,2,5,8,41,-74,7,2,307,112
969,37,2,5,6,7,-76,52,1,4,231,164
969,38,2,4,6,7,24,43,5,7,255,207
969,39,6,2,10,3,64,21,9,8,319,228
969,40,4,2,8,5,-56,-77,3,1,263,151
969,41,5,2,9,4,54,22,7,3,317,173
969,42,3,3,6,7,-67,34,0,7,250,207
969,43,4,3,7,6,43,-67,3,0,293,140
969,44,3,3,6,7,33,34,6,4,326,174
969,45,6,2,11,2,-35,20,1,4,291,194
969,46,2,6,2,11,20,65,1,9,311,259
969,47,4,3,8,5,44,-68,5,1,355,191
969,48,3,4,6,7,33,43,8,4,388,234
969,49,4,2,10,3,-54,21,4,5,334,255
969,50,3,4,5,8,32,44,6,9,366,299
969,51,3,3,6,7,33,-66,9,3,399,233
969,52,5,2,10,3,-45,21,4,4,354,254
969,53,3,4,7,6,34,42,8,6,388,296
969,54,5,2,9,4,-46,22,2,8,342,318
969,55,2,5,4,9,22,-46,4,2,364,272
969,56,3,4,4,9,31,45,5,7,395,317
969,57,3,4,4,9,31,-55,6,2,426,262
969,58,3,3,6,7,33,34,9,6,459,296
969,59,2,5,3,10,-79,-45,0,1,380,251
969,60,3,3,6,7,33,34,3,5,413,285
969,61,5,2,10,3,55,21,8,6,468,306
969,62,6,2,10,3,-36,21,2,7,432,327
969,63,2,4,6,7,24,-57,6,0,456,270
969,64,4,2,6,7,42,25,8,5,498,295
969,65,5,2,9,4,-46,22,2,7,452,317
969,66,2,4,7,6,25,42,7,9,477,359
969,67,4,4,8,5,-56,-59,1,0,421,300
969,68,3,3,8,5,35,32,6,2,456,332
969,69,3,3,8,5,-65,32,1,4,391,364
969,70,5,2,10,3,55,21,6,5,446,385
969,71,3,3,6,7,33,34,9,9,479,419
969,72,3,4,7,6,-66,-58,3,1,413,361
969,73,4,3,8,5,44,32,7,3,457,393
969,74,4,3,8,5,-56,32,1,5,401,425
969,75,3,4,5,8,32,44,3,9,433,469
969,76,4,3,7,6,43,-67,6,2,476,402
969,77,3,3,7,6,-66,33,0,5,410,435
969,78,6,2,10,3,64,21,4,6,474,456
969,79,3,3,4,9,31,-64,5,2,505,392
970,1,2,4,5,8,23,44,3,4,23,44
970,2,3,3,4,9,31,-64,4,0,54,-20
970,3,3,4,5,8,32,44,6,4,86,24
970,4,3,3,7,6,-66,33,0,7,20,57
970,5,2,5,2,11,20,-44,0,3,40,13
970,6,2,4,5,8,23,44,3,7,63,57
970,7,3,4,6,7,33,-57,6,0,96,0
970,8,2,5,4,9,22,54,8,4,118,54
970,9,4,2,10,3,-54,21,4,5,64,75
970,10,4,3,7,6,43,33,7,8,107,108
970,11,5,2,8,5,-47,-77,0,1,60,31
970,12,2,4,7,6,25,42,5,3,85,73
970,13,4,2,7,6,43,24,8,7,128,97
970,14,3,3,8,5,-65,32,3,9,63,129
970,15,4,2,7,6,43,-76,6,3,106,53
970,16,3,4,5,8,32,44,8,7,138,97
970,17,4,3,6,7,-58,-66,0,1,80,31
970,18,3,3,8,5,35,32,5,3,115,63
970,19,4,3,8,5,44,32,9,5,159,95
970,20,3,4,9,4,-64,40,5,5,95,135
970,21,2,5,7,6,-75,51,0,6,20,186
970,22,4,3,8,5,44,32,4,8,64,218
970,23,5,2,11,2,-44,20,0,8,20,238
970,24,4,3,5,8,41,-65,1,3,61,173
970,25,3,3,5,8,32,35,3,8,93,208
970,26,2,5,2,11,20,-44,3,4,113,164
970,27,3,4,9,4,36,40,9,4,149,204
970,28,3,4,4,9,-69,45,0,9,80,249
970,29,4,2,8,5,44,-77,4,2,124,172
970,30,5,2,9,4,54,22,8,4,178,194
970,31,3,4,5,8,-68,44,0,8,110,238
970,32,4,4,7,6,43,-58,3,0,153,180
970,33,3,4,6,7,33,43,6,3,186,223
970,34,3,4,6,7,33,43,9,6,219,266
970,35,3,4,6,7,-67,43,2,9,152,309
970,36,4,3,9,4,45,-69,7,0,197,240
970,37,2,4,6,7,-76,43,1,3,121,283
970,38,3,4,7,6,34,42,5,5,155,325
970,39,2,5,2,11,20,-44,5,1,175,281
970,40,3,3,7,6,34,33,9,4,209,314
970,41,2,5,5,8,-77,53,2,7,132,367
970,42,3,3,8,5,35,32,7,9,167,399
970,43,2,5,3,10,21,-45,8,4,188,354
970,44,5,2,7,6,-48,24,0,8,140,378
970,45,4,3,6,7,42,-66,2,2,182,312
970,46,3,3,5,8,32,35,4,7,214,347
970,47,5,2,10,3,55,21,9,8,269,368
970,48,3,3,6,7,-67,-66,2,2,202,302
970,49,3,4,7,6,34,42,6,4,236,344
970,50,3,4,6,7,33,43,9,7,269,387
970,51,4,2,6,7,-58,-75,1,2,211,312
970,52,3,3,7,6,34,33,5,5,245,345
970,53,3,3,7,6,34,33,9,8,279,378
970,54,3,3,7,6,-66,-67,3,1,213,311
970,55,2,5,6,7,24,52,7,3,237,363
970,56,3,4,5,8,32,44,9,7,269,407
970,57,4,3,7,6,-57,-67,2,0,212,340
970,58,3,3,3,10,30,37,2,7,242,377
970,59,2,5,5,8,23,-47,5,0,265,330
970,60,3,3,7,6,34,33,9,3,299,363
970,61,3,4,8,5,-65,41,4,4,234,404
970,62,3,3,7,6,34,33,8,7,268,437
970,63,4,4,8,5,-56,41,2,8,212,478
970,64,3,3,6,7,33,-66,5,2,245,412
970,65,3,4,4,9,31,45,6,7,276,457
970,66,2,4,6,7,-76,-57,0,0,200,400
970,67,4,3,9,4,45,31,5,1,245,431
970,68,5,2,8,5,53,23,8,4,298,454
970,69,2,4,5,8,-77,44,1,8,221,498
970,70,3,4,5,8,32,-56,3,2,253,442
970,71,2,4,5,8,23,44,6,6,276,486
970,72,2,4,4,9,22,-55,8,1,298,431
970,73,4,3,6,7,-58,34,0,5,240,465
970,74,5,2,10,3,55,21,5,6,295,486
970,75,5,3,9,4,54,31,9,7,349,517
971,1,4,3,5,8,41,35,1,5,41,35
971,2,3,3,7,6,34,33,5,8,75,68
971,3,4,2,10,3,-54,21,1,9,21,89
971,4,2,4,4,9,22,-55,3,4,43,34
971,5,3,4,4,9,31,45,4,9,74,79
971,6,2,5,4,9,22,-46,6,3,96,33
971,7,3,3,5,8,32,35,8,8,128,68
971,8,2,4,2,11,20,-53,8,5,148,15
971,9,4,2,9,4,-55,22,3,7,93,37
971,10,3,4,6,7,33,-57,6,0,126,-20
971,11,2,5,3,10,21,55,7,5,147,35
971,12,2,4,6,7,-76,43,1,8,71,78
971,13,3,3,5,8,32,-65,3,3,103,13
971,14,3,3,6,7,33,34,6,7,136,47
971,15,4,3,8,5,-56,32,0,9,80,79
971,16,4,3,7,6,43,-67,3,2,123,12
971,17,2,5,3,10,21,55,4,7,144,67
971,18,3,4,6,7,33,-57,7,0,177,10
971,19,2,4,6,7,-76,43,1,3,101,53
971,20,4,3,7,6,43,33,4,6,144,86
971,21,4,3,5,8,41,-65,5,1,185,21
971,22,3,3,8,5,-65,32,0,3,120,53
971,23,4,2,10,3,46,21,6,4,166,74
971,24,3,4,7,6,-66,42,0,6,100,116
971,25,3,3,5,8,32,-65,2,1,132,51
971,26,3,4,7,6,34,42,6,3,166,93
971,27,3,3,7,6,-66,33,0,6,100,126
971,28,2,4,4,9,22,-55,2,1,122,71
971,29,3,4,5,8,32,44,4,5,154,115
971,30,2,4,3,10,21,-54,5,1,175,61
971,31,5,2,10,3,-45,21,0,2,130,82
971,32,2,5,5,8,23,53,3,5,153,135
971,33,5,2,9,4,54,22,7,7,207,157
971,34,4,2,7,6,-57,-76,0,1,150,81
971,35,5,2,6,7,51,25,1,6,201,106
971,36,3,4,5,8,32,-56,3,0,233,50
971,37,3,4,6,7,33,43,6,3,266,93
971,38,5,3,10,3,-45,30,1,3,221,123
971,39,2,5,4,9,22,54,3,7,243,177
971,40,3,4,8,5,35,41,8,8,278,218
971,41,4,3,8,5,-56,-68,2,0,222,150
971,42,4,3,8,5,44,32,6,2,266,182
971,43,3,4,5,8,32,44,8,6,298,226
971,44,4,3,5,8,41,-65,9,1,339,161
971,45,4,3,10,3,-54,30,5,1,285,191
971,46,4,2,5,8,41,26,6,7,326,217
971,47,2,5,5,8,23,-47,9,0,349,170
971,48,4,2,6,7,-58,25,1,5,291,195
971,49,3,3,9,4,36,31,7,6,327,226
971,50,3,3,6,7,-67,-66,0,0,260,160
971,51,3,3,7,6,34,33,4,3,294,193
971,52,2,4,6,7,24,43,8,6,318,236
971,53,4,3,7,6,-57,33,1,9,261,269
971,54,4,3,7,6,43,-67,4,2,304,202
971,55,2,4,7,6,25,42,9,4,329,244
971,56,2,6,3,10,-79,64,0,8,250,308
971,57,4,2,8,5,44,-77,4,1,294,231
971,58,3,4,6,7,33,43,7,4,327,274
971,59,3,4,7,6,-66,42,1,6,261,316
971,60,2,4,3,10,21,-54,2,2,282,262
971,61,4,3,5,8,41,35,3,7,323,297
971,62,4,3,6,7,42,-66,5,1,365,231
971,63,5,2,10,3,-45,21,0,2,320,252
971,64,3,3,8,5,35,32,5,4,355,284
971,65,4,3,6,7,42,34,7,8,397,318
971,66,2,4,3,10,21,-54,8,4,418,264
971,67,3,3,5,8,-68,35,0,9,350,299
971,68,3,3,6,7,33,-66,3,3,383,233
971,69,2,4,3,10,21,46,4,9,404,279
971,70,3,4,6,7,33,-57,7,2,437,222
971,71,4,3,8,5,-56,32,1,4,381,254
971,72,2,5,5,8,23,53,4,7,404,307
971,73,2,5,6,7,24,52,8,9,428,359
971,74,5,3,7,6,-48,-67,0,2,380,292
971,75,2,4,5,8,23,44,3,6,403,336
971,76,3,3,7,6,34,33,7,9,437,369
971,77,4,2,8,5,-56,-77,1,2,381,292
971,78,3,4,7,6,34,42,5,4,415,334
971,79,2,4,2,11,20,-53,5,1,435,281
971,80,4,2,8,5,44,23,9,4,479,304
971,81,3,4,8,5,-65,41,4,5,414,345
971,82,4,2,10,3,-54,21,0,6,360,366
971,83,5,2,9,4,54,22,4,8,414,388
971,84,3,5,5,8,32,-47,6,1,446,341
971,85,5,2,8,5,53,23,9,4,499,364
971,86,3,4,8,5,-65,41,4,5,434,405
971,87,3,4,5,8,32,44,6,9,466,449
971,88,3,4,6,7,33,-57,9,2,499,392
971,89,3,4,7,6,-66,42,3,4,433,434
971,90,5,2,10,3,55,21,8,5,488,455
971,91,2,6,2,11,20,-35,8,0,508,420
972,1,3,4,7,6,34,42,4,2,34,42
972,2,3,3,5,8,32,35,6,7,66,77
972,3,3,4,7,6,-66,42,0,9,0,119
972,4,3,3,6,7,33,-66,3,3,33,53
972,5,4,3,9,4,45,31,8,4,78,84
972,6,3,4,6,7,-67,43,1,7,11,127
972,7,2,5,5,8,23,-47,4,0,34,80
972,8,4,3,7,6,43,33,7,3,77,113
972,9,5,3,7,6,52,33,9,6,129,146
972,10,4,2,10,3,-54,21,5,7,75,167
972,11,3,3,6,7,33,-66,8,1,108,101
972,12,4,2,8,5,-56,23,2,4,52,124
972,13,6,2,10,3,64,21,6,5,116,145
972,14,3,3,8,5,-65,32,1,7,51,177
972,15,2,4,7,6,25,42,6,9,76,219
972,16,5,2,9,4,-46,-78,0,1,30,141
972,17,3,3,7,6,34,33,4,4,64,174
972,18,3,4,4,9,31,45,5,9,95,219
972,19,3,3,8,5,-65,-68,0,1,30,151
972,20,5,2,8,5,53,23,3,4,83,174
972,21,3,3,5,8,32,35,5,9,115,209
972,22,4,2,10,3,-54,-79,1,0,61,130
972,23,3,4,6,7,33,43,4,3,94,173
972,24,4,2,5,8,41,26,5,9,135,199
972,25,4,2,8,5,44,-77,9,2,179,122
972,26,4,3,7,6,-57,33,2,5,122,155
972,27,4,2,10,3,46,21,8,6,168,176
972,28,2,4,5,8,-77,-56,1,0,91,120
972,29,4,2,5,8,41,26,2,6,132,146
972,30,3,3,7,6,34,33,6,9,166,179
972,31,3,3,10,3,-63,30,3,9,103,209
972,32,5,2,7,6,52,-76,5,3,155,133
972,33,3,3,4,9,31,36,6,9,186,169
972,34,3,3,6,7,33,-66,9,3,219,103
972,35,3,5,6,7,-67,52,2,5,152,155
972,36,4,2,7,6,43,24,5,9,195,179
972,37,2,4,2,11,20,-53,5,6,215,126
972,38,3,5,5,8,32,53,7,9,247,179
972,39,2,4,8,5,-74,-59,3,0,173,120
972,40,4,2,5,8,41,26,4,6,214,146
972,41,4,2,9,4,45,22,9,8,259,168
972,42,3,3,7,6,-66,-67,3,1,193,101
972,43,3,3,8,5,35,32,8,3,228,133
972,44,3,4,6,7,-67,43,1,6,161,176
972,45,3,3,6,7,33,-66,4,0,194,110
972,46,4,3,6,7,42,34,6,4,236,144
972,47,2,4,6,7,-76,43,0,7,160,187
972,48,2,4,4,9,22,-55,2,2,182,132
972,49,2,5,6,7,24,52,6,4,206,184
972,50,5,2,11,2,-44,20,2,4,162,204
972,51,6,2,11,2,65,20,7,4,227,224
972,52,4,3,7,6,-57,33,0,7,170,257
972,53,3,3,5,8,32,-65,2,2,202,192
972,54,4,2,10,3,46,21,8,3,248,213
972,55,2,5,4,9,-78,54,0,7,170,267
972,56,2,4,7,6,25,42,5,9,195,309
972,57,4,3,5,8,41,-65,6,4,236,244
972,58,3,3,6,7,33,34,9,8,269,278
972,59,3,3,4,9,-69,-64,0,4,200,214
972,60,4,3,7,6,43,33,3,7,243,247
972,61,3,3,7,6,34,-67,7,0,277,180
972,62,3,3,8,5,-65,32,2,2,212,212
972,63,3,3,8,5,35,32,7,4,247,244
972,64,3,4,5,8,32,44,9,8,279,288
972,65,5,2,8,5,-47,-77,2,1,232,211
972,66,4,3,8,5,44,32,6,3,276,243
972,67,4,2,8,5,-56,23,0,6,220,266
972,68,4,4,8,5,44,41,4,7,264,307
972,69,3,3,7,6,34,-67,8,0,298,240
972,70,2,4,7,6,-75,42,3,2,223,282
972,71,5,2,9,4,54,22,7,4,277,304
972,72,3,3,5,8,32,35,9,9,309,339
972,73,2,4,6,7,-76,-57,3,2,233,282
972,74,3,3,7,6,34,33,7,5,267,315
972,75,5,2,9,4,-46,22,1,7,221,337
972,76,4,2,10,3,46,21,7,8,267,358
972,77,4,3,9,4,-55,31,2,9,212,389
972,78,4,2,8,5,44,-77,6,2,256,312
972,79,4,3,7,6,43,33,9,5,299,345
972,80,3,4,6,7,-67,43,2,8,232,388
972,81,6,2,11,2,65,20,7,8,297,408
972,82,4,2,10,3,-54,21,3,9,243,429
972,83,2,6,2,11,20,-35,3,4,263,394
972,84,2,5,4,9,22,54,5,8,285,448
972,85,4,3,7,6,43,-67,8,1,328,381
972,86,4,3,6,7,-58,34,0,5,270,415
972,87,4,3,8,5,44,32,4,7,314,447
972,88,4,3,7,6,43,-67,7,0,357,380
972,89,4,3,9,4,-55,31,2,1,302,411
972,90,2,4,5,8,23,44,5,5,325,455
972,91,2,4,6,7,24,43,9,8,349,498
972,92,4,2,8,5,-56,-77,3,1,293,421
972,93,4,2,6,7,42,25,5,6,335,446
972,94,6,2,11,2,-35,20,0,6,300,466
972,95,2,4,6,7,24,43,4,9,324,509
973,1,2,5,5,8,23,53,3,3,23,53
973,2,4,3,8,5,44,32,7,5,67,85
973,3,3,4,8,5,-65,41,2,6,2,126
973,4,2,4,7,6,25,42,7,8,27,168
973,5,3,3,4,9,31,-64,8,4,58,104
973,6,4,3,7,6,-57,33,1,7,1,137
973,7,4,2,10,3,46,21,7,8,47,158
973,8,2,4,4,9,22,-55,9,3,69,103
973,9,4,3,7,6,-57,33,2,6,12,136
973,10,4,3,9,4,45,31,7,7,57,167
973,11,4,3,9,4,-55,31,2,8,2,198
973,12,4,3,5,8,41,-65,3,3,43,133
973,13,2,4,6,7,24,43,7,6,67,176
973,14,6,2,9,4,-37,22,0,8,30,198
973,15,3,4,3,10,30,-54,0,4,60,144
973,16,3,4,4,9,31,45,1,9,91,189
973,17,4,3,7,6,43,-67,4,2,134,122
973,18,4,2,8,5,44,23,8,5,178,145
973,19,2,5,2,11,20,-44,8,1,198,101
973,20,5,2,7,6,-48,24,0,5,150,125
973,21,4,3,9,4,45,31,5,6,195,156
973,22,3,3,5,8,32,-65,7,1,227,91
973,23,3,4,5,8,32,44,9,5,259,135
973,24,4,2,5,8,-59,-74,0,1,200,61
973,25,2,4,5,8,23,44,3,5,223,105
973,26,2,4,6,7,24,43,7,8,247,148
973,27,4,2,8,5,-56,-77,1,1,191,71
973,28,3,4,6,7,33,43,4,4,224,114
973,29,3,4,8,5,35,41,9,5,259,155
973,30,5,2,8,5,-47,23,2,8,212,178
973,31,4,3,7,6,43,-67,5,1,255,111
973,32,6,2,10,3,64,21,9,2,319,132
973,33,4,3,5,8,-59,35,0,7,260,167
973,34,4,3,8,5,44,32,4,9,304,199
973,35,2,4,5,8,23,-56,7,3,327,143
973,36,2,4,5,8,-77,44,0,7,250,187
973,37,3,4,7,6,34,42,4,9,284,229
973,38,3,3,7,6,34,-67,8,2,318,162
973,39,4,3,9,4,-55,31,3,3,263,193
973,40,4,3,7,6,43,33,6,6,306,226
973,41,3,3,7,6,-66,33,0,9,240,259
973,42,2,4,6,7,24,-57,4,2,264,202
973,43,4,2,9,4,45,22,9,4,309,224
973,44,2,5,3,10,-79,55,0,9,230,279
973,45,4,2,5,8,41,-74,1,5,271,205
973,46,4,2,8,5,44,23,5,8,315,228
973,47,2,4,3,10,21,-54,6,4,336,174
973,48,5,2,7,6,52,24,8,8,388,198
973,49,3,3,8,5,-65,-68,3,0,323,130
973,50,2,4,4,9,22,45,5,5,345,175
973,51,3,4,4,9,31,-55,6,0,376,120
973,52,4,2,10,3,-54,21,2,1,322,141
973,53,3,3,4,9,31,36,3,7,353,177
973,54,2,6,5,8,23,62,6,9,376,239
973,55,3,4,6,7,33,-57,9,2,409,182
973,56,3,4,5,8,-68,44,1,6,341,226
973,57,3,3,7,6,34,33,5,9,375,259
973,58,4,3,9,4,-55,-69,0,0,320,190
973,59,5,2,8,5,53,23,3,3,373,213
973,60,4,3,8,5,44,32,7,5,417,245
973,61,2,4,5,8,-77,44,0,9,340,289
973,62,2,4,6,7,24,-57,4,2,364,232
973,63,2,5,2,11,20,56,4,8,384,288
973,64,4,3,8,5,44,-68,8,0,428,220
973,65,3,4,8,5,-65,41,3,1,363,261
973,66,5,3,9,4,54,31,7,2,417,292
973,67,3,3,8,5,-65,32,2,4,352,324
973,68,4,3,6,7,42,34,4,8,394,358
973,69,3,4,7,6,34,-58,8,0,428,300
973,70,4,3,4,9,40,36,8,6,468,336
973,71,3,4,6,7,-67,43,1,9,401,379
973,72,3,4,5,8,32,-56,3,3,433,323
973,73,2,4,3,10,21,46,4,9,454,369
973,74,3,3,6,7,33,-66,7,3,487,303
973,75,3,3,7,6,-66,33,1,6,421,336
973,76,3,4,7,6,34,42,5,8,455,378
973,77,2,4,6,7,24,-57,9,1,479,321
973,78,5,2,11,2,-44,20,5,1,435,341
973,79,4,3,10,3,-54,30,1,1,381,371
973,80,4,2,7,6,43,24,4,5,424,395
973,81,3,3,7,6,34,33,8,8,458,428
973,82,3,4,4,9,31,-55,9,3,489,373
973,83,2,5,4,9,-78,54,1,7,411,427
973,84,2,4,4,9,22,-55,3,2,433,372
973,85,3,4,5,8,32,44,5,6,465,416
973,86,3,4,6,7,33,43,8,9,498,459
973,87,4,2,7,6,-57,-76,1,3,441,383
973,88,2,5,3,10,21,55,2,8,462,438
973,89,3,5,5,8,32,-47,4,1,494,391
973,90,3,4,5,8,32,44,6,5,526,435
974,1,3,4,5,8,32,44,2,4,32,44
974,2,3,4,4,9,31,45,3,9,63,89
974,3,2,5,2,11,20,-44,3,5,83,45
974,4,3,3,7,6,34,33,7,8,117,78
974,5,3,3,7,6,-66,-67,1,1,51,11
974,6,4,2,5,8,41,26,2,7,92,37
974,7,5,2,11,2,56,20,8,7,148,57
974,8,4,2,8,5,-56,-77,2,0,92,-20
974,9,6,2,11,2,65,20,7,0,157,0
974,10,2,4,7,6,-75,42,2,2,82,42
974,11,2,4,6,7,24,43,6,5,106,85
974,12,4,3,8,5,-56,32,0,7,50,117
974,13,2,4,7,6,25,42,5,9,75,159
974,14,2,4,7,6,-75,-58,0,1,0,101
974,15,5,2,7,6,52,24,2,5,52,125
974,16,2,4,5,8,23,44,5,9,75,169
974,17,4,2,10,3,-54,-79,1,0,21,90
974,18,4,3,5,8,41,35,2,5,62,125
974,19,3,3,6,7,33,34,5,9,95,159
974,20,2,5,5,8,23,-47,8,2,118,112
974,21,3,4,5,8,-68,44,0,6,50,156
974,22,3,3,4,9,31,-64,1,2,81,92
974,23,3,3,5,8,32,35,3,7,113,127
974,24,2,5,3,10,21,-45,4,2,134,82
974,25,3,4,3,10,30,46,4,8,164,128
974,26,5,2,10,3,55,21,9,9,219,149
974,27,3,4,7,6,-66,-58,3,1,153,91
974,28,3,4,6,7,33,43,6,4,186,134
974,29,4,3,8,5,-56,32,0,6,130,166
974,30,2,4,8,5,26,41,6,7,156,207
974,31,4,2,7,6,43,-76,9,1,199,131
974,32,3,3,7,6,-66,33,3,4,133,164
974,33,4,2,8,5,44,23,7,7,177,187
974,34,5,2,10,3,-45,21,2,8,132,208
974,35,3,4,7,6,34,-58,6,0,166,150
974,36,2,5,5,8,23,53,9,3,189,203
974,37,4,2,10,3,-54,21,5,4,135,224
974,38,5,2,8,5,53,23,8,7,188,247
974,39,2,4,8,5,-74,41,4,8,114,288
974,40,3,4,6,7,33,-57,7,1,147,231
974,41,3,3,6,7,-67,34,0,5,80,265
974,42,5,2,9,4,54,22,4,7,134,287
974,43,3,4,4,9,31,-55,5,2,165,232
974,44,2,5,4,9,22,54,7,6,187,286
974,45,2,5,4,9,22,-46,9,0,209,240
974,46,4,3,6,7,-58,34,1,4,151,274
974,47,4,3,9,4,45,31,6,5,196,305
974,48,4,3,8,5,-56,32,0,7,140,337
974,49,2,5,7,6,25,51,5,8,165,388
974,50,3,3,7,6,34,-67,9,1,199,321
974,51,3,3,3,10,30,37,9,8,229,358
974,52,3,3,7,6,-66,-67,3,1,163,291
974,53,3,4,5,8,32,44,5,5,195,335
974,54,5,2,8,5,53,23,8,8,248,358
974,55,4,3,4,9,40,-64,8,4,288,294
974,56,3,4,5,8,-68,44,0,8,220,338
974,57,3,3,6,7,33,-66,3,2,253,272
974,58,4,2,5,8,41,26,4,8,294,298
974,59,4,3,5,8,41,-65,5,3,335,233
974,60,3,4,6,7,33,43,8,6,368,276
974,61,3,3,6,7,-67,-66,1,0,301,210
974,62,4,3,6,7,42,34,3,4,343,244
974,63,2,5,7,6,25,51,8,5,368,295
974,64,2,5,6,7,-76,52,2,7,292,347
974,65,3,4,5,8,32,-56,4,1,324,291
974,66,2,4,6,7,24,43,8,4,348,334
974,67,5,2,10,3,-45,21,3,5,303,355
974,68,5,2,7,6,52,24,5,9,355,379
974,69,4,3,7,6,43,-67,8,2,398,312
974,70,4,3,6,7,-58,34,0,6,340,346
974,71,4,3,8,5,44,32,4,8,384,378
974,72,3,4,7,6,34,-58,8,0,418,320
974,73,4,3,9,4,-55,31,3,1,363,351
974,74,2,4,3,10,21,46,4,7,384,397
974,75,5,2,9,4,54,22,8,9,438,419
974,76,3,4,3,10,30,-54,8,5,468,365
974,77,3,3,5,8,-68,-65,0,0,400,300
974,78,2,5,7,6,25,51,5,1,425,351
974,79,3,3,6,7,33,34,8,5,458,385
974,80,2,4,6,7,-76,43,2,8,382,428
974,81,4,2,7,6,43,-76,5,2,425,352
974,82,4,3,8,5,44,32,9,4,469,384
974,83,4,3,5,8,-59,35,0,9,410,419
974,84,4,3,4,9,40,-64,0,5,450,355
974,85,2,4,4,9,22,-55,2,0,472,300
974,86,3,3,8,5,35,32,7,2,507,332
975,1,3,3,4,9,31,36,1,6,31,36
975,2,4,3,9,4,45,31,6,7,76,67
975,3,3,3,5,8,32,-65,8,2,108,2
975,4,3,4,5,8,-68,44,0,6,40,46
975,5,3,3,7,6,34,33,4,9,74,79
975,6,3,4,5,8,32,-56,6,3,106,23
975,7,3,3,6,7,33,34,9,7,139,57
975,8,3,4,7,6,-66,42,3,9,73,99
975,9,2,5,5,8,23,-47,6,2,96,52
975,10,4,2,6,7,42,25,8,7,138,77
975,11,3,3,8,5,-65,32,3,9,73,109
975,12,4,2,10,3,46,-79,9,0,119,30
975,13,2,5,5,8,-77,53,2,3,42,83
975,14,3,3,5,8,32,35,4,8,74,118
975,15,2,4,4,9,22,-55,6,3,96,63
975,16,2,5,4,9,22,54,8,7,118,117
975,17,2,6,3,10,21,-36,9,1,139,81
975,18,2,5,6,7,-76,52,3,3,63,133
975,19,5,2,8,5,53,23,6,6,116,156
975,20,5,2,10,3,-45,21,1,7,71,177
975,21,3,3,7,6,34,-67,5,0,105,110
975,22,3,3,8,5,-65,32,0,2,40,142
975,23,4,2,7,6,43,24,3,6,83,166
975,24,3,4,4,9,31,-55,4,1,114,111
975,25,2,5,4,9,22,54,6,5,136,165
975,26,4,3,4,9,40,-64,6,1,176,101
975,27,2,5,5,8,23,53,9,4,199,154
975,28,4,2,10,3,-54,21,5,5,145,175
975,29,4,3,9,4,-55,31,0,6,90,206
975,30,3,5,6,7,33,52,3,8,123,258
975,31,3,4,5,8,32,-56,5,2,155,202
975,32,4,3,7,6,43,33,8,5,198,235
975,33,3,4,5,8,-68,44,0,9,130,279
975,34,5,2,10,3,55,-79,5,0,185,200
975,35,3,3,7,6,34,33,9,3,219,233
975,36,4,3,8,5,-56,32,3,5,163,265
975,37,2,4,3,10,21,-54,4,1,184,211
975,38,4,2,9,4,45,22,9,3,229,233
975,39,2,6,4,9,-78,63,1,6,151,296
975,40,3,4,5,8,32,-56,3,0,183,240
975,41,3,4,6,7,33,43,6,3,216,283
975,42,5,2,10,3,-45,21,1,4,171,304
975,43,5,2,8,5,53,23,4,7,224,327
975,44,4,2,9,4,45,22,9,9,269,349
975,45,3,4,5,8,-68,-56,1,3,201,293
975,46,4,4,7,6,43,42,4,5,244,335
975,47,4,2,8,5,44,23,8,8,288,358
975,48,3,3,6,7,-67,-66,1,2,221,292
975,49,3,4,5,8,32,44,3,6,253,336
975,50,3,5,5,8,32,53,5,9,285,389
975,51,3,4,8,5,-65,-59,0,0,220,330
975,52,2,5,4,9,22,54,2,4,242,384
975,53,4,3,6,7,42,34,4,8,284,418
975,54,3,4,4,9,31,-55,5,3,315,363
975,55,2,4,4,9,22,45,7,8,337,408
975,56,3,3,7,6,-66,-67,1,1,271,341
975,57,3,3,5,8,32,35,3,6,303,376
975,58,3,3,8,5,35,32,8,8,338,408
975,59,3,3,7,6,-66,-67,2,1,272,341
975,60,3,4,7,6,34,42,6,3,306,383
975,61,6,2,9,4,63,22,9,5,369,405
975,62,3,3,7,6,-66,33,3,8,303,438
975,63,3,3,5,8,32,-65,5,3,335,373
975,64,3,3,7,6,34,33,9,6,369,406
975,65,5,2,10,3,-45,21,4,7,324,427
975,66,5,2,9,4,54,22,8,9,378,449
975,67,2,5,5,8,-77,-47,1,2,301,402
975,68,5,2,8,5,53,23,4,5,354,425
975,69,2,4,3,10,21,-54,5,1,375,371
975,70,3,5,6,7,33,52,8,3,408,423
975,71,3,3,8,5,-65,32,3,5,343,455
975,72,4,3,9,4,45,31,8,6,388,486
975,73,5,2,10,3,-45,21,3,7,343,507
976,1,5,2,9,4,54,22,4,2,54,22
976,2,3,4,8,5,35,41,9,3,89,63
976,3,4,3,7,6,-57,33,2,6,32,96
976,4,4,3,5,8,41,-65,3,1,73,31
976,5,4,3,8,5,44,32,7,3,117,63
976,6,3,4,8,5,-65,41,2,4,52,104
976,7,3,3,6,7,33,34,5,8,85,138
976,8,2,5,6,7,24,-48,9,0,109,90
976,9,5,2,10,3,-45,21,4,1,64,111
976,10,5,2,9,4,54,22,8,3,118,133
976,11,3,4,4,9,31,45,9,8,149,178
976,12,4,2,11,2,-53,20,6,8,96,198
976,13,3,4,7,6,-66,-58,0,0,30,140
976,14,2,4,6,7,24,43,4,3,54,183
976,15,3,3,9,4,-64,31,0,4,-10,214
976,16,4,2,7,6,43,24,3,8,33,238
976,17,3,3,7,6,34,-67,7,1,67,171
976,18,3,3,7,6,-66,33,1,4,1,204
976,19,4,3,5,8,41,35,2,9,42,239
976,20,4,2,8,5,44,-77,6,2,86,162
976,21,3,3,9,4,-64,31,2,3,22,193
976,22,3,4,5,8,32,44,4,7,54,237
976,23,2,4,7,6,25,42,9,9,79,279
976,24,3,3,6,7,-67,-66,2,3,12,213
976,25,3,3,8,5,35,32,7,5,47,245
976,26,4,3,10,3,-54,30,3,5,-7,275
976,27,3,4,5,8,32,44,5,9,25,319
976,28,4,4,5,8,41,-56,6,3,66,263
976,29,3,3,6,7,33,34,9,7,99,297
976,30,3,3,9,4,-64,31,5,8,35,328
976,31,3,4,6,7,33,-57,8,1,68,271
976,32,4,3,8,5,-56,32,2,3,12,303
976,33,2,4,8,5,26,41,8,4,38,344
976,34,3,3,8,5,-65,32,3,6,-27,376
976,35,4,3,8,5,44,32,7,8,17,408
976,36,3,3,7,6,-66,-67,1,1,-49,341
976,37,3,4,6,7,33,43,4,4,-16,384
976,38,4,3,9,4,45,31,9,5,29,415
976,39,3,4,6,7,-67,43,2,8,-38,458
976,40,5,3,9,4,54,31,6,9,16,489
976,41,4,3,9,4,-55,-69,1,0,-39,420
976,42,2,5,3,10,21,55,2,5,-18,475
976,43,2,5,4,9,22,54,4,9,4,529
977,1,5,2,11,2,56,20,6,0,56,20
977,2,3,3,9,4,-64,31,2,1,-8,51
977,3,2,4,6,7,24,43,6,4,16,94
977,4,2,4,4,9,22,45,8,9,38,139
977,5,3,3,5,8,-68,-65,0,4,-30,74
977,6,3,3,6,7,33,34,3,8,3,108
977,7,3,3,8,5,35,-68,8,0,38,40
977,8,3,3,6,7,-67,34,1,4,-29,74
977,9,3,4,6,7,33,43,4,7,4,117
977,10,4,2,10,3,-54,21,0,8,-50,138
977,11,3,3,7,6,34,-67,4,1,-16,71
977,12,2,4,4,9,22,45,6,6,6,116
977,13,3,3,9,4,-64,31,2,7,-58,147
977,14,2,4,4,9,22,-55,4,2,-36,92
977,15,4,3,8,5,44,32,8,4,8,124
977,16,3,4,5,8,-68,44,0,8,-60,168
977,17,3,4,8,5,35,41,5,9,-25,209
977,18,3,3,7,6,34,-67,9,2,9,142
977,19,4,2,8,5,-56,23,3,5,-47,165
977,20,3,3,8,5,35,32,8,7,-12,197
977,21,3,3,6,7,-67,-66,1,1,-79,131
977,22,3,3,5,8,32,35,3,6,-47,166
977,23,5,2,10,3,55,21,8,7,8,187
977,24,2,4,4,9,-78,-55,0,2,-70,132
977,25,4,3,8,5,44,32,4,4,-26,164
977,26,4,3,9,4,45,31,9,5,19,195
977,27,5,2,10,3,-45,21,4,6,-26,216
977,28,2,5,4,9,22,-46,6,0,-4,170
977,29,3,3,9,4,-64,31,2,1,-68,201
977,30,5,2,10,3,55,21,7,2,-13,222
977,31,4,2,7,6,-57,24,0,6,-70,246
977,32,2,5,2,11,20,-44,0,2,-50,202
977,33,4,3,7,6,43,33,3,5,-7,235
977,34,5,2,10,3,55,21,8,6,48,256
977,35,3,3,6,7,-67,-66,1,0,-19,190
977,36,3,3,7,6,34,33,5,3,15,223
977,37,4,3,8,5,44,32,9,5,59,255
977,38,3,3,8,5,-65,32,4,7,-6,287
977,39,3,5,3,10,30,-45,4,2,24,242
977,40,2,5,3,10,21,55,5,7,45,297
977,41,3,3,5,8,32,-65,7,2,77,232
977,42,2,4,5,8,-77,44,0,6,0,276
977,43,3,3,7,6,34,33,4,9,34,309
977,44,2,5,3,10,21,-45,5,4,55,264
977,45,3,4,5,8,32,44,7,8,87,308
977,46,3,4,5,8,32,-56,9,2,119,252
977,47,3,3,6,7,-67,34,2,6,52,286
977,48,2,4,4,9,22,-55,4,1,74,231
977,49,3,4,5,8,32,44,6,5,106,275
977,50,5,2,10,3,-45,21,1,6,61,296
977,51,4,3,6,7,42,-66,3,0,103,230
977,52,5,2,8,5,53,23,6,3,156,253
977,53,5,2,6,7,51,25,7,8,207,278
977,54,3,4,5,8,32,-56,9,2,239,222
977,55,5,2,10,3,-45,21,4,3,194,243
977,56,3,3,7,6,34,33,8,6,228,276
977,57,4,2,7,6,-57,-76,1,0,171,200
977,58,3,3,5,8,32,35,3,5,203,235
977,59,4,4,8,5,44,41,7,6,247,276
977,60,4,3,8,5,-56,32,1,8,191,308
977,61,3,4,8,5,35,41,6,9,226,349
977,62,4,2,9,4,-55,-78,1,1,171,271
977,63,2,4,4,9,22,45,3,6,193,316
977,64,3,3,8,5,35,32,8,8,228,348
977,65,2,4,4,9,-78,-55,0,3,150,293
977,66,4,3,8,5,44,32,4,5,194,325
977,67,2,4,4,9,22,-55,6,0,216,270
977,68,2,5,4,9,22,54,8,4,238,324
977,69,3,3,3,10,30,-63,8,1,268,261
977,70,4,3,8,5,-56,32,2,3,212,293
977,71,4,4,6,7,42,43,4,6,254,336
977,72,4,3,10,3,-54,30,0,6,200,366
977,73,2,5,2,11,20,-44,0,2,220,322
977,74,2,5,3,10,21,55,1,7,241,377
977,75,2,4,5,8,23,-56,4,1,264,321
977,76,4,3,9,4,45,31,9,2,309,352
977,77,4,3,7,6,-57,33,2,5,252,385
977,78,2,6,3,10,21,64,3,9,273,449
977,79,4,3,7,6,43,-67,6,2,316,382
977,80,3,4,6,7,33,43,9,5,349,425
977,81,4,3,5,8,-59,-65,0,0,290,360
977,82,4,2,10,3,46,21,6,1,336,381
977,83,4,2,8,5,-56,23,0,4,280,404
977,84,4,2,8,5,44,23,4,7,324,427
977,85,3,4,7,6,34,42,8,9,358,469
977,86,3,3,5,8,-68,-65,0,4,290,404
977,87,5,2,6,7,51,25,1,9,341,429
977,88,5,2,9,4,54,-78,5,1,395,351
977,89,2,4,5,8,23,44,8,5,418,395
977,90,4,3,9,4,-55,31,3,6,363,426
977,91,5,2,9,4,54,22,7,8,417,448
977,92,6,2,9,4,-37,-78,0,0,380,370
977,93,4,3,5,8,41,35,1,5,421,405
977,94,4,3,8,5,44,32,5,7,465,437
977,95,3,3,6,7,33,-66,8,1,498,371
977,96,4,3,8,5,-56,32,2,3,442,403
977,97,4,3,6,7,42,34,4,7,484,437
977,98,2,5,3,10,21,-45,5,2,505,392
978,1,2,4,3,10,21,46,1,6,21,46
978,2,3,3,6,7,33,-66,4,0,54,-20
978,3,4,2,11,2,-53,20,1,0,1,0
978,4,6,2,10,3,64,21,5,1,65,21
978,5,3,3,9,4,-64,31,1,2,1,52
978,6,2,4,6,7,24,43,5,5,25,95
978,7,3,4,8,5,-65,41,0,6,-40,136
978,8,3,4,6,7,33,43,3,9,-7,179
978,9,2,6,2,11,20,-35,3,4,13,144
978,10,3,4,5,8,32,44,5,8,45,188
978,11,3,3,6,7,33,-66,8,2,78,122
978,12,4,2,5,8,41,26,9,8,119,148
978,13,3,3,10,3,-63,30,6,8,56,178
978,14,3,4,7,6,-66,-58,0,0,-10,120
978,15,2,5,4,9,22,54,2,4,12,174
978,16,4,2,9,4,45,22,7,6,57,196
978,17,4,2,9,4,-55,22,2,8,2,218
978,18,3,4,6,7,33,-57,5,1,35,161
978,19,2,5,4,9,22,54,7,5,57,215
978,20,4,3,9,4,-55,31,2,6,2,246
978,21,3,4,5,8,32,-56,4,0,34,190
978,22,2,4,3,10,21,46,5,6,55,236
978,23,4,3,6,7,42,-66,7,0,97,170
978,24,5,2,8,5,-47,23,0,3,50,193
978,25,4,3,9,4,45,31,5,4,95,224
978,26,3,3,7,6,34,33,9,7,129,257
978,27,4,3,6,7,-58,-66,1,1,71,191
978,28,3,3,7,6,34,33,5,4,105,224
978,29,4,3,7,6,43,33,8,7,148,257
978,30,3,3,8,5,-65,32,3,9,83,289
978,31,3,3,6,7,33,-66,6,3,116,223
978,32,4,2,7,6,43,24,9,7,159,247
978,33,3,4,6,7,-67,-57,2,0,92,190
978,34,3,4,6,7,33,43,5,3,125,233
978,35,4,3,8,5,44,32,9,5,169,265
978,36,4,3,8,5,-56,32,3,7,113,297
978,37,4,3,6,7,42,-66,5,1,155,231
978,38,3,3,5,8,32,35,7,6,187,266
978,39,2,5,4,9,22,-46,9,0,209,220
978,40,3,3,9,4,-64,31,5,1,145,251
978,41,5,2,7,6,52,24,7,5,197,275
978,42,2,4,2,11,20,-53,7,2,217,222
978,43,2,5,6,7,-76,52,1,4,141,274
978,44,3,3,4,9,31,-64,2,0,172,210
978,45,3,3,6,7,33,34,5,4,205,244
978,46,2,4,5,8,23,44,8,8,228,288
978,47,4,2,8,5,-56,-77,2,1,172,211
978,48,2,5,6,7,24,52,6,3,196,263
978,49,4,2,9,4,-55,22,1,5,141,285
978,50,2,5,6,7,24,52,5,7,165,337
978,51,4,3,7,6,43,-67,8,0,208,270
978,52,5,2,9,4,-46,22,2,2,162,292
978,53,4,3,8,5,44,32,6,4,206,324
978,54,4,4,5,8,41,44,7,8,247,368
978,55,2,4,7,6,-75,-58,2,0,172,310
978,56,4,2,10,3,46,21,8,1,218,331
978,57,3,3,6,7,-67,34,1,5,151,365
978,58,3,3,4,9,31,-64,2,1,182,301
978,59,3,3,9,4,36,31,8,2,218,332
978,60,3,4,4,9,31,45,9,7,249,377
978,61,3,3,5,8,-68,-65,1,2,181,312
978,62,3,4,7,6,34,42,5,4,215,354
978,63,5,2,10,3,-45,21,0,5,170,375
978,64,3,3,7,6,34,33,4,8,204,408
978,65,2,4,6,7,24,-57,8,1,228,351
978,66,3,3,5,8,-68,35,0,6,160,386
978,67,4,3,6,7,42,-66,2,0,202,320
978,68,3,4,5,8,32,44,4,4,234,364
978,69,2,5,4,9,22,54,6,8,256,418
978,70,2,5,4,9,22,-46,8,2,278,372
978,71,4,2,7,6,-57,24,1,6,221,396
978,72,2,4,4,9,22,-55,3,1,243,341
978,73,2,4,4,9,22,45,5,6,265,386
978,74,3,4,8,5,-65,41,0,7,200,427
978,75,2,4,3,10,21,-54,1,3,221,373
978,76,4,2,5,8,41,26,2,9,262,399
978,77,4,2,9,4,45,-78,7,1,307,321
978,78,4,3,7,6,-57,33,0,4,250,354
978,79,3,3,4,9,31,-64,1,0,281,290
978,80,3,4,5,8,32,44,3,4,313,334
978,81,4,2,10,3,46,21,9,5,359,355
978,82,5,2,8,5,-47,23,2,8,312,378
978,83,3,3,8,5,35,-68,7,0,347,310
978,84,3,3,7,6,-66,33,1,3,281,343
978,85,4,2,7,6,43,24,4,7,324,367
978,86,2,5,3,10,21,-45,5,2,345,322
978,87,4,2,9,4,-55,22,0,4,290,344
978,88,2,4,8,5,26,41,6,5,316,385
978,89,3,3,6,7,33,34,9,9,349,419
978,90,3,4,5,8,-68,-56,1,3,281,363
978,91,3,3,5,8,32,35,3,8,313,398
978,92,5,2,10,3,55,21,8,9,368,419
978,93,3,4,7,6,-66,-58,2,1,302,361
978,94,3,4,4,9,31,45,3,6,333,406
978,95,4,3,8,5,44,32,7,8,377,438
978,96,5,2,9,4,-46,-78,1,0,331,360
978,97,3,3,5,8,32,35,3,5,363,395
978,98,3,4,5,8,32,44,5,9,395,439
978,99,5,2,9,4,54,-78,9,1,449,361
978,100,4,3,6,7,-58,34,1,5,391,395
978,101,2,5,4,9,22,54,3,9,413,449
978,102,3,4,9,4,36,40,9,9,449,489
978,103,2,5,4,9,-78,-46,1,3,371,443
978,104,2,4,4,9,22,45,3,8,393,488
978,105,3,3,8,5,35,-68,8,0,428,420
978,106,2,4,3,10,21,46,9,6,449,466
978,107,3,3,6,7,-67,-66,2,0,382,400
978,108,4,3,5,8,41,35,3,5,423,435
978,109,4,3,9,4,45,31,8,6,468,466
978,110,3,3,6,7,-67,-66,1,0,401,400
978,111,4,2,10,3,46,21,7,1,447,421
978,112,3,4,7,6,-66,42,1,3,381,463
978,113,3,3,8,5,35,32,6,5,416,495
978,114,3,4,5,8,32,44,8,9,448,539
979,1,4,3,7,6,43,33,3,3,43,33
979,2,2,4,7,6,25,42,8,5,68,75
979,3,3,3,6,7,-67,34,1,9,1,109
979,4,4,3,8,5,44,-68,5,1,45,41
979,5,5,2,8,5,53,23,8,4,98,64
979,6,4,3,7,6,-57,33,1,7,41,97
979,7,3,3,9,4,36,31,7,8,77,128
979,8,3,3,5,8,32,-65,9,3,109,63
979,9,4,2,9,4,-55,22,4,5,54,85
979,10,3,3,7,6,34,33,8,8,88,118
979,11,4,3,9,4,-55,31,3,9,33,149
979,12,3,3,8,5,35,-68,8,1,68,81
979,13,3,3,4,9,31,36,9,7,99,117
979,14,2,5,3,10,-79,-45,0,2,20,72
979,15,5,2,7,6,52,24,2,6,72,96
979,16,2,4,4,9,22,-55,4,1,94,41
979,17,5,2,11,2,-44,20,0,1,50,61
979,18,4,3,9,4,45,31,5,2,95,92
979,19,3,3,3,10,30,37,5,9,125,129
979,20,2,5,7,6,-75,-49,0,0,50,80
979,21,2,5,3,10,21,55,1,5,71,135
979,22,5,2,10,3,55,21,6,6,126,156
979,23,4,2,8,5,-56,23,0,9,70,179
979,24,4,2,7,6,43,-76,3,3,113,103
979,25,3,3,8,5,35,32,8,5,148,135
979,26,2,5,5,8,-77,53,1,8,71,188
979,27,3,3,7,6,34,-67,5,1,105,121
979,28,3,4,7,6,34,42,9,3,139,163
979,29,5,2,10,3,-45,21,4,4,94,184
979,30,3,4,3,10,30,-54,4,0,124,130
979,31,2,5,5,8,23,53,7,3,147,183
979,32,3,3,7,6,-66,33,1,6,81,216
979,33,3,4,9,4,36,40,7,6,117,256
979,34,3,3,5,8,32,-65,9,1,149,191
979,35,3,3,6,7,-67,34,2,5,82,225
979,36,2,5,4,9,22,54,4,9,104,279
979,37,3,4,7,6,34,-58,8,1,138,221
979,38,4,3,6,7,-58,34,0,5,80,255
979,39,3,3,6,7,33,34,3,9,113,289
979,40,4,4,8,5,44,-59,7,0,157,230
979,41,4,2,9,4,-55,22,2,2,102,252
979,42,5,2,10,3,55,21,7,3,157,273
979,43,2,4,3,10,21,46,8,9,178,319
979,44,3,5,3,10,30,-45,8,4,208,274
979,45,3,3,5,8,-68,35,0,9,140,309
979,46,3,3,10,3,37,30,7,9,177,339
979,47,3,3,6,7,-67,-66,0,3,110,273
979,48,2,4,6,7,24,43,4,6,134,316
979,49,3,3,9,4,-64,31,0,7,70,347
979,50,4,2,8,5,44,-77,4,0,114,270
979,51,3,4,7,6,34,42,8,2,148,312
979,52,3,4,4,9,31,45,9,7,179,357
979,53,3,3,7,6,-66,-67,3,0,113,290
979,54,2,4,5,8,23,44,6,4,136,334
979,55,3,4,6,7,33,43,9,7,169,377
979,56,5,2,10,3,-45,21,4,8,124,398
979,57,3,3,8,5,35,-68,9,0,159,330
979,58,3,3,7,6,-66,33,3,3,93,363
979,59,4,2,9,4,45,22,8,5,138,385
979,60,3,4,4,9,31,-55,9,0,169,330
979,61,3,3,9,4,-64,31,5,1,105,361
979,62,2,4,7,6,-75,42,0,3,30,403
979,63,2,6,2,11,20,65,0,8,50,468
979,64,5,2,9,4,54,-78,4,0,104,390
979,65,4,3,8,5,44,32,8,2,148,422
979,66,3,3,3,10,30,37,8,9,178,459
979,67,2,6,4,9,-78,-37,0,2,100,422
979,68,3,4,4,9,31,45,1,7,131,467
979,69,3,3,5,8,32,-65,3,2,163,402
979,70,4,3,5,8,41,35,4,7,204,437
979,71,4,2,9,4,45,22,9,9,249,459
979,72,5,2,9,4,-46,-78,3,1,203,381
979,73,4,2,8,5,44,23,7,4,247,404
979,74,3,3,9,4,-64,31,3,5,183,435
979,75,2,5,4,9,22,54,5,9,205,489
979,76,4,2,10,3,-54,-79,1,0,151,410
979,77,3,3,7,6,34,33,5,3,185,443
979,78,2,5,4,9,22,54,7,7,207,497
979,79,3,3,9,4,-64,31,3,8,143,528
980,1,3,3,7,6,34,33,4,3,34,33
980,2,3,4,5,8,32,44,6,7,66,77
980,3,4,2,10,3,-54,21,2,8,12,98
980,4,2,4,5,8,23,-56,5,2,35,42
980,5,3,5,7,6,34,51,9,3,69,93
980,6,4,3,10,3,-54,30,5,3,15,123
980,7,4,2,7,6,43,24,8,7,58,147
980,8,3,4,5,8,-68,-56,0,1,-10,91
980,9,3,4,6,7,33,43,3,4,23,134
980,10,5,2,8,5,53,23,6,7,76,157
980,11,3,4,5,8,32,-56,8,1,108,101
980,12,4,3,9,4,-55,31,3,2,53,132
980,13,4,2,9,4,45,22,8,4,98,154
980,14,4,2,10,3,-54,21,4,5,44,175
980,15,3,3,9,4,-64,31,0,6,-20,206
980,16,3,4,4,9,31,-55,1,1,11,151
980,17,3,4,3,10,30,46,1,7,41,197
980,18,4,3,8,5,44,32,5,9,85,229
980,19,4,3,8,5,44,-68,9,1,129,161
980,20,2,5,6,7,-76,52,3,3,53,213
980,21,3,3,8,5,35,32,8,5,88,245
980,22,5,2,8,5,-47,23,1,8,41,268
980,23,3,3,8,5,35,-68,6,0,76,200
980,24,5,2,7,6,52,24,8,4,128,224
980,25,2,4,7,6,-75,42,3,6,53,266
980,26,5,2,10,3,55,21,8,7,108,287
980,27,2,5,5,8,-77,-47,1,0,31,240
980,28,2,4,5,8,23,44,4,4,54,284
980,29,2,5,5,8,23,53,7,7,77,337
980,30,5,2,9,4,-46,22,1,9,31,359
980,31,3,4,3,10,30,-54,1,5,61,305
980,32,3,4,6,7,33,43,4,8,94,348
980,33,2,5,4,9,22,-46,6,2,116,302
980,34,4,3,6,7,42,34,8,6,158,336
980,35,2,4,6,7,-76,43,2,9,82,379
980,36,2,5,4,9,22,-46,4,3,104,333
980,37,3,3,6,7,33,34,7,7,137,367
980,38,5,2,7,6,52,-76,9,1,189,291
980,39,3,3,8,5,-65,32,4,3,124,323
980,40,4,4,5,8,41,44,5,7,165,367
980,41,3,4,8,5,-65,41,0,8,100,408
980,42,4,2,4,9,40,-73,0,5,140,335
980,43,4,3,9,4,45,31,5,6,185,366
980,44,4,3,6,7,42,-66,7,0,227,300
980,45,4,2,7,6,-57,24,0,4,170,324
980,46,2,4,4,9,22,45,2,9,192,369
980,47,3,3,7,6,34,-67,6,2,226,302
980,48,3,3,6,7,33,34,9,6,259,336
980,49,3,4,4,9,-69,-55,0,1,190,281
980,50,5,2,9,4,54,22,4,3,244,303
980,51,4,2,8,5,44,23,8,6,288,326
980,52,6,2,10,3,-36,21,2,7,252,347
980,53,2,4,5,8,23,-56,5,1,275,291
980,54,4,2,9,4,-55,22,0,3,220,313
980,55,3,4,3,10,30,46,0,9,250,359
980,56,5,2,9,4,54,-78,4,1,304,281
980,57,3,3,8,5,35,32,9,3,339,313
980,58,3,4,4,9,-69,45,0,8,270,358
980,59,3,4,5,8,32,-56,2,2,302,302
980,60,4,4,8,5,44,41,6,3,346,343
980,61,6,2,10,3,-36,21,0,4,310,364
980,62,2,4,6,7,24,43,4,7,334,407
980,63,4,4,6,7,42,-57,6,0,376,350
980,64,2,4,6,7,-76,43,0,3,300,393
980,65,3,3,6,7,33,34,3,7,333,427
980,66,3,4,3,10,30,-54,3,3,363,373
980,67,3,3,7,6,34,33,7,6,397,406
980,68,2,4,9,4,-73,40,4,6,324,446
980,69,3,4,7,6,34,42,8,8,358,488
980,70,3,3,3,10,30,-63,8,5,388,425
980,71,4,4,6,7,-58,43,0,8,330,468
980,72,4,3,7,6,43,-67,3,1,373,401
980,73,2,4,7,6,25,42,8,3,398,443
980,74,3,4,5,8,-68,44,0,7,330,487
980,75,4,2,9,4,45,22,5,9,375,509
981,1,4,3,8,5,44,32,4,2,44,32
981,2,2,5,4,9,22,54,6,6,66,86
981,3,4,2,7,6,43,-76,9,0,109,10
981,4,3,4,5,8,-68,44,1,4,41,54
981,5,4,3,8,5,44,32,5,6,85,86
981,6,5,2,10,3,-45,21,0,7,40,107
981,7,3,4,5,8,32,-56,2,1,72,51
981,8,3,4,8,5,35,41,7,2,107,92
981,9,3,4,4,9,31,45,8,7,138,137
981,10,3,4,4,9,31,-55,9,2,169,82
981,11,4,3,9,4,-55,31,4,3,114,113
981,12,2,4,5,8,23,44,7,7,137,157
981,13,4,2,10,3,-54,21,3,8,83,178
981,14,2,4,8,5,26,41,9,9,109,219
981,15,3,3,6,7,-67,-66,2,3,42,153
981,16,5,2,7,6,52,24,4,7,94,177
981,17,3,4,7,6,34,42,8,9,128,219
981,18,3,4,9,4,-64,40,4,9,64,259
981,19,2,5,5,8,23,-47,7,2,87,212
981,20,3,4,7,6,-66,42,1,4,21,254
981,21,3,4,6,7,33,43,4,7,54,297
981,22,3,3,5,8,32,-65,6,2,86,232
981,23,5,2,10,3,-45,21,1,3,41,253
981,24,5,2,7,6,52,24,3,7,93,277
981,25,4,3,5,8,41,-65,4,2,134,212
981,26,2,5,6,7,24,52,8,4,158,264
981,27,4,3,5,8,41,35,9,9,199,299
981,28,3,4,8,5,-65,-59,4,0,134,240
981,29,2,4,5,8,23,44,7,4,157,284
981,30,3,4,6,7,-67,43,0,7,90,327
981,31,4,2,10,3,46,21,6,8,136,348
981,32,5,2,10,3,-45,21,1,9,91,369
981,33,3,3,7,6,34,-67,5,2,125,302
981,34,4,3,9,4,-55,31,0,3,70,333
981,35,3,4,6,7,33,43,3,6,103,376
981,36,3,3,4,9,31,-64,4,2,134,312
981,37,4,3,5,8,41,35,5,7,175,347
981,38,4,2,7,6,43,-76,8,1,218,271
981,39,3,3,8,5,-65,32,3,3,153,303
981,40,3,3,5,8,32,35,5,8,185,338
981,41,3,4,7,6,34,-58,9,0,219,280
981,42,5,2,9,4,-46,22,3,2,173,302
981,43,3,4,5,8,32,44,5,6,205,346
981,44,4,3,7,6,43,33,8,9,248,379
981,45,3,3,8,5,-65,-68,3,1,183,311
981,46,4,3,6,7,42,34,5,5,225,345
981,47,4,2,8,5,44,23,9,8,269,368
981,48,2,5,3,10,-79,-45,0,3,190,323
981,49,4,3,9,4,45,31,5,4,235,354
981,50,3,4,6,7,33,43,8,7,268,397
981,51,2,5,5,8,-77,-47,1,0,191,350
981,52,2,4,8,5,26,41,7,1,217,391
981,53,3,3,7,6,-66,33,1,4,151,424
981,54,3,4,4,9,31,45,2,9,182,469
981,55,2,4,5,8,23,-56,5,3,205,413
981,56,3,4,8,5,-65,41,0,4,140,454
981,57,3,3,7,6,34,33,4,7,174,487
981,58,5,2,9,4,54,22,8,9,228,509
982,1,3,4,3,10,30,46,0,6,30,46
982,2,2,4,7,6,25,42,5,8,55,88
982,3,4,2,9,4,-55,-78,0,0,0,10
982,4,2,6,5,8,23,62,3,2,23,72
982,5,2,4,6,7,24,43,7,5,47,115
982,6,2,4,5,8,-77,44,0,9,-30,159
982,7,4,3,5,8,41,-65,1,4,11,94
982,8,5,2,11,2,56,20,7,4,67,114
982,9,3,3,8,5,-65,32,2,6,2,146
982,10,3,3,6,7,33,-66,5,0,35,80
982,11,4,3,7,6,43,33,8,3,78,113
982,12,5,2,9,4,-46,22,2,5,32,135
982,13,4,3,9,4,45,31,7,6,77,166
982,14,3,4,4,9,31,-55,8,1,108,111
982,15,3,4,9,4,-64,40,4,1,44,151
982,16,3,4,5,8,32,44,6,5,76,195
982,17,4,3,7,6,43,33,9,8,119,228
982,18,3,3,5,8,-68,-65,1,3,51,163
982,19,3,4,8,5,35,41,6,4,86,204
982,20,4,3,6,7,42,34,8,8,128,238
982,21,3,3,6,7,-67,-66,1,2,61,172
982,22,4,3,9,4,45,31,6,3,106,203
982,23,4,2,8,5,-56,23,0,6,50,226
982,24,4,3,7,6,43,33,3,9,93,259
982,25,2,4,6,7,24,-57,7,2,117,202
982,26,4,3,7,6,-57,33,0,5,60,235
982,27,4,2,8,5,44,23,4,8,104,258
982,28,3,3,6,7,33,-66,7,2,137,192
982,29,6,2,10,3,-36,21,1,3,101,213
982,30,3,3,6,7,33,34,4,7,134,247
982,31,2,4,4,9,22,-55,6,2,156,192
982,32,5,2,8,5,53,23,9,5,209,215
982,33,2,4,3,10,-79,-54,0,1,130,161
982,34,2,5,7,6,25,51,5,2,155,212
982,35,4,3,7,6,43,33,8,5,198,245
982,36,5,2,8,5,-47,23,1,8,151,268
982,37,3,3,3,10,30,-63,1,5,181,205
982,38,4,3,8,5,44,32,5,7,225,237
982,39,4,2,9,4,-55,22,0,9,170,259
982,40,3,4,8,5,35,-59,5,0,205,200
982,41,5,2,7,6,52,24,7,4,257,224
982,42,3,3,5,8,32,35,9,9,289,259
982,43,2,4,3,10,-79,-54,0,5,210,205
982,44,4,3,8,5,44,32,4,7,254,237
982,45,4,2,8,5,44,-77,8,0,298,160
982,46,3,3,4,9,31,36,9,6,329,196
982,47,4,3,7,6,-57,33,2,9,272,229
982,48,3,4,7,6,34,-58,6,1,306,171
982,49,4,3,8,5,-56,32,0,3,250,203
982,50,5,2,11,2,56,20,6,3,306,223
982,51,4,2,7,6,43,24,9,7,349,247
982,52,4,2,7,6,-57,-76,2,1,292,171
982,53,4,2,7,6,43,24,5,5,335,195
982,54,3,3,9,4,-64,31,1,6,271,226
982,55,2,6,2,11,20,-35,1,1,291,191
982,56,3,4,7,6,34,42,5,3,325,233
982,57,5,2,7,6,52,24,7,7,377,257
982,58,3,4,6,7,-67,-57,0,0,310,200
982,59,2,4,3,10,21,46,1,6,331,246
982,60,3,3,7,6,34,33,5,9,365,279
982,61,3,3,7,6,34,-67,9,2,399,212
982,62,2,4,4,9,-78,45,1,7,321,257
982,63,3,4,7,6,34,42,5,9,355,299
982,64,3,4,7,6,34,-58,9,1,389,241
982,65,2,5,4,9,-78,54,1,5,311,295
982,66,4,3,6,7,42,34,3,9,353,329
982,67,2,5,3,10,21,-45,4,4,374,284
982,68,4,3,8,5,44,32,8,6,418,316
982,69,3,3,5,8,-68,-65,0,1,350,251
982,70,4,3,9,4,45,31,5,2,395,282
982,71,3,4,8,5,-65,41,0,3,330,323
982,72,5,2,9,4,54,22,4,5,384,345
982,73,4,2,9,4,45,22,9,7,429,367
982,74,5,2,8,5,-47,-77,2,0,382,290
982,75,3,3,4,9,31,36,3,6,413,326
982,76,4,3,9,4,45,31,8,7,458,357
982,77,3,3,6,7,-67,-66,1,1,391,291
982,78,2,4,4,9,22,45,3,6,413,336
982,79,3,3,5,8,32,-65,5,1,445,271
982,80,4,3,8,5,44,32,9,3,489,303
982,81,4,2,5,8,-59,26,0,9,430,329
982,82,2,5,4,9,22,-46,2,3,452,283
982,83,4,2,9,4,45,22,7,5,497,305
982,84,4,3,7,6,-57,33,0,8,440,338
982,85,3,3,6,7,33,-66,3,2,473,272
982,86,2,5,6,7,24,52,7,4,497,324
982,87,2,5,5,8,-77,53,0,7,420,377
982,88,5,2,10,3,55,21,5,8,475,398
982,89,2,5,2,11,20,-44,5,4,495,354
982,90,2,6,2,11,20,65,5,9,515,419
983,1,4,3,5,8,41,35,1,5,41,35
983,2,4,4,4,9,40,-55,1,0,81,-20
983,3,4,4,7,6,43,42,4,2,124,22
983,4,4,2,5,8,41,26,5,8,165,48
983,5,2,4,5,8,23,-56,8,2,188,-8
983,6,4,3,7,6,-57,33,1,5,131,25
983,7,5,2,8,5,53,23,4,8,184,48
983,8,4,3,6,7,42,-66,6,2,226,-18
983,9,3,3,5,8,32,35,8,7,258,17
983,10,4,2,8,5,-56,-77,2,0,202,-60
983,11,4,3,9,4,45,31,7,1,247,-29
983,12,3,4,6,7,-67,43,0,4,180,14
983,13,4,2,5,8,41,-74,1,0,221,-60
983,14,4,3,5,8,41,35,2,5,262,-25
983,15,5,2,9,4,54,22,6,7,316,-3
983,16,3,4,7,6,-66,42,0,9,250,39
983,17,3,3,7,6,34,-67,4,2,284,-28
983,18,4,2,8,5,44,23,8,5,328,-5
983,19,2,4,5,8,-77,44,1,9,251,39
983,20,2,4,7,6,25,-58,6,1,276,-19
983,21,4,3,6,7,42,34,8,5,318,15
983,22,3,3,6,7,-67,34,1,9,251,49
983,23,3,4,5,8,32,-56,3,3,283,-7
983,24,3,4,4,9,31,45,4,8,314,38
983,25,5,2,9,4,54,-78,8,0,368,-40
983,26,4,2,7,6,-57,24,1,4,311,-16
983,27,4,3,9,4,45,31,6,5,356,15
983,28,3,4,6,7,33,43,9,8,389,58
983,29,2,4,4,9,-78,-55,1,3,311,3
983,30,3,3,6,7,33,34,4,7,344,37
983,31,5,2,9,4,54,22,8,9,398,59
983,32,3,3,7,6,-66,-67,2,2,332,-8
983,33,2,4,3,10,21,46,3,8,353,38
983,34,4,2,8,5,44,-77,7,1,397,-39
983,35,2,5,4,9,22,54,9,5,419,15
983,36,4,3,8,5,-56,32,3,7,363,47
983,37,3,3,6,7,33,-66,6,1,396,-19
983,38,2,4,5,8,23,44,9,5,419,25
983,39,3,4,6,7,-67,43,2,8,352,68
983,40,4,2,8,5,44,-77,6,1,396,-9
983,41,3,4,8,5,-65,41,1,2,331,32
983,42,5,2,10,3,55,21,6,3,386,53
983,43,3,3,6,7,33,34,9,7,419,87
983,44,3,3,7,6,-66,-67,3,0,353,20
983,45,3,3,5,8,32,35,5,5,385,55
983,46,6,2,9,4,63,22,8,7,448,77
983,47,2,6,4,9,-78,-37,0,0,370,40
983,48,4,3,7,6,43,33,3,3,413,73
983,49,4,2,6,7,42,25,5,8,455,98
983,50,2,4,3,10,21,-54,6,4,476,44
983,51,3,3,6,7,33,34,9,8,509,78
984,1,4,3,7,6,43,33,3,3,43,33
984,2,4,2,6,7,42,25,5,8,85,58
984,3,4,3,9,4,-55,31,0,9,30,89
984,4,3,4,4,9,31,-55,1,4,61,34
984,5,4,2,8,5,44,23,5,7,105,57
984,6,3,4,6,7,33,-57,8,0,138,0
984,7,4,3,8,5,-56,32,2,2,82,32
984,8,3,4,6,7,33,43,5,5,115,75
984,9,2,5,7,6,-75,51,0,6,40,126
984,10,3,3,9,4,36,31,6,7,76,157
984,11,2,5,5,8,23,-47,9,0,99,110
984,12,4,2,7,6,-57,24,2,4,42,134
984,13,3,3,7,6,34,33,6,7,76,167
984,14,5,2,10,3,-45,21,1,8,31,188
984,15,4,3,6,7,42,-66,3,2,73,122
984,16,4,2,7,6,43,24,6,6,116,146
984,17,2,4,7,6,-75,42,1,8,41,188
984,18,4,2,7,6,43,-76,4,2,84,112
984,19,3,3,6,7,33,34,7,6,117,146
984,20,3,3,7,6,-66,33,1,9,51,179
984,21,2,5,3,10,21,-45,2,4,72,134
984,22,2,4,5,8,23,44,5,8,95,178
984,23,5,2,9,4,54,-78,9,0,149,100
984,24,3,4,7,6,-66,42,3,2,83,142
984,25,3,4,7,6,34,42,7,4,117,184
984,26,2,5,8,5,-74,50,3,4,43,234
984,27,5,3,8,5,53,32,6,6,96,266
984,28,4,2,7,6,43,-76,9,0,139,190
984,29,4,3,9,4,-55,31,4,1,84,221
984,30,3,4,4,9,31,45,5,6,115,266
984,31,4,3,7,6,43,33,8,9,158,299
984,32,4,3,9,4,-55,-69,3,0,103,230
984,33,3,3,6,7,33,34,6,4,136,264
984,34,2,5,4,9,22,54,8,8,158,318
984,35,2,5,3,10,21,-45,9,3,179,273
984,36,5,2,10,3,-45,21,4,4,134,294
984,37,3,4,7,6,34,42,8,6,168,336
984,38,2,4,7,6,-75,42,3,8,93,378
984,39,2,4,5,8,23,-56,6,2,116,322
984,40,3,3,6,7,33,34,9,6,149,356
984,41,4,2,6,7,-58,-75,1,1,91,281
984,42,3,3,7,6,34,33,5,4,125,314
984,43,3,3,6,7,33,34,8,8,158,348
984,44,3,3,6,7,-67,-66,1,2,91,282
984,45,4,2,6,7,42,25,3,7,133,307
984,46,2,5,4,9,22,-46,5,1,155,261
984,47,2,5,4,9,22,54,7,5,177,315
984,48,2,4,4,9,22,-55,9,0,199,260
984,49,3,3,7,6,-66,33,3,3,133,293
984,50,2,6,3,10,21,64,4,7,154,357
984,51,3,3,8,5,35,32,9,9,189,389
984,52,4,3,8,5,-56,-68,3,1,133,321
984,53,4,3,8,5,44,32,7,3,177,353
984,54,4,2,8,5,-56,23,1,6,121,376
984,55,4,2,6,7,42,-75,3,1,163,301
984,56,4,3,6,7,42,34,5,5,205,335
984,57,3,4,4,9,31,-55,6,0,236,280
984,58,4,2,9,4,-55,22,1,2,181,302
984,59,4,3,6,7,42,34,3,6,223,336
984,60,2,4,6,7,24,43,7,9,247,379
984,61,3,3,6,7,-67,-66,0,3,180,313
984,62,5,2,8,5,53,23,3,6,233,336
984,63,4,3,7,6,43,33,6,9,276,369
984,64,2,5,4,9,22,-46,8,3,298,323
984,65,3,4,7,6,-66,42,2,5,232,365
984,66,4,2,6,7,42,-75,4,0,274,290
984,67,2,5,4,9,22,54,6,4,296,344
984,68,3,4,6,7,33,43,9,7,329,387
984,69,5,2,9,4,-46,22,3,9,283,409
984,70,4,3,8,5,44,-68,7,1,327,341
984,71,4,3,9,4,-55,31,2,2,272,372
984,72,3,4,6,7,33,43,5,5,305,415
984,73,2,4,5,8,23,44,8,9,328,459
984,74,4,2,6,7,-58,-75,0,4,270,384
984,75,3,3,6,7,33,34,3,8,303,418
984,76,2,5,3,10,21,-45,4,3,324,373
984,77,4,2,8,5,44,23,8,6,368,396
984,78,4,3,7,6,-57,33,1,9,311,429
984,79,2,4,4,9,22,-55,3,4,333,374
984,80,2,4,3,10,21,-54,4,0,354,320
984,81,2,4,4,9,22,45,6,5,376,365
984,82,5,2,8,5,53,23,9,8,429,388
984,83,4,3,7,6,-57,-67,2,1,372,321
984,84,2,4,9,4,27,40,9,1,399,361
984,85,3,3,9,4,-64,31,5,2,335,392
984,86,4,2,10,3,-54,21,1,3,281,413
984,87,2,4,4,9,22,45,3,8,303,458
984,88,3,5,5,8,32,-47,5,1,335,411
984,89,5,2,9,4,54,22,9,3,389,433
984,90,2,4,7,6,-75,42,4,5,314,475
984,91,2,4,5,8,23,44,7,9,337,519
985,1,3,4,4,9,31,45,1,5,31,45
985,2,4,3,8,5,44,32,5,7,75,77
985,3,4,4,6,7,42,-57,7,0,117,20
985,4,2,4,5,8,-77,44,0,4,40,64
985,5,3,4,5,8,32,44,2,8,72,108
985,6,2,5,4,9,22,-46,4,2,94,62
985,7,3,3,7,6,34,33,8,5,128,95
985,8,3,3,5,8,-68,-65,0,0,60,30
985,9,3,3,4,9,31,36,1,6,91,66
985,10,4,3,7,6,43,33,4,9,134,99
985,11,3,3,9,4,-64,-69,0,0,70,30
985,12,3,3,7,6,34,33,4,3,104,63
985,13,4,3,7,6,43,33,7,6,147,96
985,14,3,3,5,8,32,-65,9,1,179,31
985,15,2,5,4,9,-78,54,1,5,101,85
985,16,5,2,6,7,51,-75,2,0,152,10
985,17,4,2,7,6,43,24,5,4,195,34
985,18,5,2,7,6,52,24,7,8,247,58
985,19,3,3,5,8,32,-65,9,3,279,-7
985,20,4,3,9,4,-55,31,4,4,224,24
985,21,4,3,8,5,44,32,8,6,268,56
985,22,3,3,8,5,-65,32,3,8,203,88
985,23,2,4,7,6,25,-58,8,0,228,30
985,24,3,3,3,10,30,37,8,7,258,67
985,25,3,3,5,8,-68,-65,0,2,190,2
985,26,4,3,8,5,44,32,4,4,234,34
985,27,2,4,3,10,21,-54,5,0,255,-20
985,28,5,2,9,4,54,22,9,2,309,2
985,29,3,4,5,8,-68,44,1,6,241,46
985,30,4,3,6,7,42,-66,3,0,283,-20
985,31,2,5,4,9,22,54,5,4,305,34
985,32,3,4,5,8,32,44,7,8,337,78
985,33,4,3,6,7,42,-66,9,2,379,12
985,34,4,2,7,6,-57,24,2,6,322,36
985,35,2,5,4,9,22,-46,4,0,344,-10
985,36,3,3,7,6,34,33,8,3,378,23
985,37,4,3,7,6,-57,33,1,6,321,56
985,38,3,3,8,5,35,32,6,8,356,88
985,39,2,4,4,9,22,-55,8,3,378,33
985,40,5,2,9,4,-46,22,2,5,332,55
985,41,5,2,10,3,55,21,7,6,387,76
985,42,3,3,4,9,31,-64,8,2,418,12
985,43,2,4,6,7,-76,43,2,5,342,55
985,44,5,2,6,7,51,-75,3,0,393,-20
985,45,3,3,6,7,33,34,6,4,426,14
985,46,2,4,5,8,23,44,9,8,449,58
985,47,4,3,9,4,-55,31,4,9,394,89
985,48,2,4,5,8,23,-56,7,3,417,33
985,49,3,3,10,3,-63,30,4,3,354,63
985,50,4,2,8,5,44,23,8,6,398,86
985,51,4,2,8,5,-56,23,2,9,342,109
985,52,3,3,8,5,35,-68,7,1,377,41
985,53,3,4,5,8,32,44,9,5,409,85
985,54,4,2,11,2,-53,20,6,5,356,105
985,55,3,4,5,8,32,44,8,9,388,149
985,56,3,4,5,8,-68,-56,0,3,320,93
985,57,3,3,4,9,31,36,1,9,351,129
985,58,2,4,4,9,22,-55,3,4,373,74
985,59,3,4,5,8,32,44,5,8,405,118
985,60,5,2,9,4,54,-78,9,0,459,40
985,61,2,4,6,7,-76,43,3,3,383,83
985,62,4,3,6,7,42,34,5,7,425,117
985,63,4,3,7,6,43,-67,8,0,468,50
985,64,3,3,6,7,-67,34,1,4,401,84
985,65,4,3,9,4,45,31,6,5,446,115
985,66,2,4,3,10,21,-54,7,1,467,61
985,67,3,4,7,6,-66,42,1,3,401,103
985,68,3,4,9,4,36,40,7,3,437,143
985,69,3,3,5,8,32,35,9,8,469,178
985,70,5,2,8,5,-47,-77,2,1,422,101
985,71,4,3,6,7,42,34,4,5,464,135
985,72,4,2,7,6,43,24,7,9,507,159
986,1,5,2,9,4,54,22,4,2,54,22
986,2,2,5,2,11,20,56,4,8,74,78
986,3,2,5,5,8,23,-47,7,1,97,31
986,4,4,3,9,4,-55,31,2,2,42,62
986,5,4,3,6,7,42,34,4,6,84,96
986,6,3,3,6,7,33,-66,7,0,117,30
986,7,4,2,8,5,-56,23,1,3,61,53
986,8,4,3,10,3,46,30,7,3,107,83
986,9,3,4,4,9,31,45,8,8,138,128
986,10,3,3,9,4,-64,31,4,9,74,159
986,11,4,3,8,5,44,-68,8,1,118,91
986,12,3,4,6,7,-67,43,1,4,51,134
986,13,3,4,5,8,32,44,3,8,83,178
986,14,4,3,6,7,42,-66,5,2,125,112
986,15,3,3,5,8,32,35,7,7,157,147
986,16,3,3,5,8,32,-65,9,2,189,82
986,17,4,3,6,7,-58,34,1,6,131,116
986,18,3,3,5,8,32,-65,3,1,163,51
986,19,4,4,4,9,40,45,3,6,203,96
986,20,3,3,9,4,36,31,9,7,239,127
986,21,4,2,6,7,-58,-75,1,2,181,52
986,22,2,4,4,9,22,45,3,7,203,97
986,23,2,5,5,8,23,-47,6,0,226,50
986,24,4,2,6,7,42,25,8,5,268,75
986,25,3,3,6,7,-67,34,1,9,201,109
986,26,3,4,6,7,33,-57,4,2,234,52
986,27,3,3,10,3,-63,30,1,2,171,82
986,28,2,6,4,9,22,63,3,5,193,145
986,29,4,3,7,6,43,33,6,8,236,178
986,30,3,5,4,9,31,-46,7,2,267,132
986,31,2,5,5,8,-77,53,0,5,190,185
986,32,3,3,6,7,33,34,3,9,223,219
986,33,2,4,2,11,20,-53,3,6,243,166
986,34,3,4,4,9,31,-55,4,1,274,111
986,35,3,3,4,9,31,36,5,7,305,147
986,36,3,4,4,9,31,-55,6,2,336,92
986,37,4,3,7,6,43,33,9,5,379,125
986,38,4,2,9,4,-55,22,4,7,324,147
986,39,3,4,7,6,34,42,8,9,358,189
986,40,2,5,4,9,-78,-46,0,3,280,143
986,41,3,3,6,7,33,34,3,7,313,177
986,42,4,2,10,3,46,21,9,8,359,198
986,43,6,2,11,2,-35,20,4,8,324,218
986,44,3,4,6,7,33,-57,7,1,357,161
986,45,3,4,8,5,-65,41,2,2,292,202
986,46,3,3,6,7,33,34,5,6,325,236
986,47,3,4,7,6,34,42,9,8,359,278
986,48,2,4,6,7,-76,-57,3,1,283,221
986,49,4,2,8,5,44,23,7,4,327,244
986,50,3,4,6,7,-67,43,0,7,260,287
986,51,3,3,4,9,31,-64,1,3,291,223
986,52,4,3,6,7,42,34,3,7,333,257
986,53,4,3,7,6,43,-67,6,0,376,190
986,54,3,3,9,4,-64,31,2,1,312,221
986,55,4,3,8,5,44,32,6,3,356,253
986,56,3,4,5,8,32,44,8,7,388,297
986,57,4,3,10,3,-54,30,4,7,334,327
986,58,4,4,6,7,42,-57,6,0,376,270
986,59,3,3,5,8,32,35,8,5,408,305
986,60,4,2,9,4,-55,22,3,7,353,327
986,61,4,3,10,3,46,30,9,7,399,357
986,62,4,4,6,7,-58,-57,1,0,341,300
986,63,2,4,6,7,24,43,5,3,365,343
986,64,3,3,7,6,34,33,9,6,399,376
986,65,2,4,5,8,-77,-56,2,0,322,320
986,66,5,2,7,6,52,24,4,4,374,344
986,67,5,2,9,4,54,22,8,6,428,366
986,68,3,3,6,7,-67,-66,1,0,361,300
986,69,4,2,9,4,45,22,6,2,406,322
986,70,4,2,6,7,42,25,8,7,448,347
986,71,4,3,6,7,-58,-66,0,1,390,281
986,72,3,4,4,9,31,45,1,6,421,326
986,73,2,4,7,6,25,42,6,8,446,368
986,74,3,4,6,7,33,-57,9,1,479,311
986,75,2,5,5,8,-77,53,2,4,402,364
986,76,5,3,8,5,53,32,5,6,455,396
986,77,2,4,4,9,22,-55,7,1,477,341
986,78,3,4,8,5,-65,41,2,2,412,382
986,79,4,3,6,7,42,34,4,6,454,416
986,80,3,4,4,9,31,-55,5,1,485,361
986,81,5,3,9,4,54,31,9,2,539,392
987,1,4,3,6,7,42,34,2,4,42,34
987,2,5,2,8,5,53,23,5,7,95,57
987,3,4,3,9,4,-55,31,0,8,40,88
987,4,5,2,7,6,52,-76,2,2,92,12
987,5,4,3,8,5,44,32,6,4,136,44
987,6,4,2,7,6,43,24,9,8,179,68
987,7,2,5,4,9,-78,-46,1,2,101,22
987,8,2,4,4,9,22,45,3,7,123,67
987,9,2,4,6,7,24,-57,7,0,147,10
987,10,4,2,9,4,-55,22,2,2,92,32
987,11,2,4,6,7,24,43,6,5,116,75
987,12,3,4,6,7,33,43,9,8,149,118
987,13,5,2,8,5,-47,-77,2,1,102,41
987,14,4,3,8,5,44,32,6,3,146,73
987,15,5,2,11,2,-44,20,2,3,102,93
987,16,3,3,9,4,36,31,8,4,138,124
987,17,2,5,5,8,-77,53,1,7,61,177
987,18,3,4,7,6,34,42,5,9,95,219
987,19,4,2,8,5,44,-77,9,2,139,142
987,20,4,2,7,6,-57,24,2,6,82,166
987,21,2,5,5,8,23,53,5,9,105,219
987,22,4,3,7,6,43,-67,8,2,148,152
987,23,2,5,6,7,-76,52,2,4,72,204
987,24,3,5,4,9,31,54,3,8,103,258
987,25,4,4,6,7,42,-57,5,1,145,201
987,26,2,4,7,6,-75,42,0,3,70,243
987,27,4,3,8,5,44,32,4,5,114,275
987,28,4,3,5,8,41,-65,5,0,155,210
987,29,4,2,9,4,-55,22,0,2,100,232
987,30,5,2,8,5,53,23,3,5,153,255
987,31,2,4,6,7,24,43,7,8,177,298
987,32,2,5,5,8,-77,-47,0,1,100,251
987,33,2,4,6,7,24,43,4,4,124,294
987,34,3,4,7,6,34,42,8,6,158,336
987,35,3,3,7,6,-66,33,2,9,92,369
987,36,3,3,6,7,33,-66,5,3,125,303
987,37,3,3,7,6,34,33,9,6,159,336
987,38,3,4,4,9,-69,-55,0,1,90,281
987,39,4,3,9,4,45,31,5,2,135,312
987,40,2,4,6,7,24,43,9,5,159,355
987,41,4,3,8,5,-56,32,3,7,103,387
987,42,5,3,6,7,51,-66,4,1,154,321
987,43,4,3,8,5,44,32,8,3,198,353
987,44,2,5,6,7,-76,52,2,5,122,405
987,45,5,2,9,4,54,22,6,7,176,427
987,46,4,3,8,5,-56,32,0,9,120,459
987,47,2,4,5,8,23,-56,3,3,143,403
987,48,3,4,7,6,34,42,7,5,177,445
987,49,3,4,7,6,-66,42,1,7,111,487
987,50,4,2,5,8,41,-74,2,3,152,413
987,51,3,4,7,6,34,42,6,5,186,455
987,52,3,4,5,8,32,44,8,9,218,499
987,53,3,3,8,5,-65,-68,3,1,153,431
987,54,2,5,3,10,21,55,4,6,174,486
987,55,3,3,6,7,33,-66,7,0,207,420
987,56,3,4,5,8,32,44,9,4,239,464
987,57,4,2,11,2,-53,20,6,4,186,484
987,58,4,2,8,5,-56,23,0,7,130,507
988,1,4,3,8,5,44,32,4,2,44,32
988,2,3,3,4,9,31,36,5,8,75,68
988,3,3,4,7,6,34,-58,9,0,109,10
988,4,3,4,4,9,-69,45,0,5,40,55
988,5,4,2,6,7,42,-75,2,0,82,-20
988,6,2,5,3,10,21,55,3,5,103,35
988,7,4,3,7,6,43,33,6,8,146,68
988,8,3,4,5,8,32,-56,8,2,178,12
988,9,4,3,6,7,-58,34,0,6,120,46
988,10,2,5,4,9,22,-46,2,0,142,0
988,11,4,3,8,5,44,32,6,2,186,32
988,12,3,4,5,8,32,44,8,6,218,76
988,13,4,3,9,4,-55,31,3,7,163,107
988,14,2,5,4,9,22,-46,5,1,185,61
988,15,3,3,8,5,-65,32,0,3,120,93
988,16,5,2,10,3,55,21,5,4,175,114
988,17,3,3,7,6,34,33,9,7,209,147
988,18,3,4,8,5,-65,41,4,8,144,188
988,19,3,3,8,5,35,-68,9,0,179,120
988,20,3,3,4,9,-69,36,0,6,110,156
988,21,2,4,3,10,21,-54,1,2,131,102
988,22,3,4,7,6,34,42,5,4,165,144
988,23,3,4,5,8,32,44,7,8,197,188
988,24,4,2,6,7,42,-75,9,3,239,113
988,25,4,3,9,4,-55,31,4,4,184,144
988,26,5,2,7,6,52,24,6,8,236,168
988,27,2,4,4,9,22,-55,8,3,258,113
988,28,5,2,9,4,-46,22,2,5,212,135
988,29,4,3,8,5,44,32,6,7,256,167
988,30,2,4,7,6,-75,42,1,9,181,209
988,31,3,4,5,8,32,-56,3,3,213,153
988,32,3,4,5,8,32,44,5,7,245,197
988,33,6,2,10,3,64,21,9,8,309,218
988,34,5,2,6,7,-49,-75,0,3,260,143
988,35,4,3,7,6,43,33,3,6,303,176
988,36,3,4,6,7,33,43,6,9,336,219
988,37,3,4,5,8,32,-56,8,3,368,163
988,38,3,4,4,9,31,45,9,8,399,208
988,39,4,3,8,5,-56,-68,3,0,343,140
988,40,2,6,3,10,21,64,4,4,364,204
988,41,3,3,5,8,32,35,6,9,396,239
988,42,3,3,9,4,-64,-69,2,0,332,170
988,43,3,3,8,5,35,32,7,2,367,202
988,44,3,3,8,5,-65,32,2,4,302,234
988,45,4,3,8,5,44,32,6,6,346,266
988,46,3,3,7,6,-66,33,0,9,280,299
988,47,3,4,6,7,33,-57,3,2,313,242
988,48,4,4,6,7,42,43,5,5,355,285
988,49,3,3,7,6,34,33,9,8,389,318
988,50,3,3,5,8,-68,-65,1,3,321,253
988,51,2,4,4,9,22,45,3,8,343,298
988,52,3,4,3,10,30,-54,3,4,373,244
988,53,4,2,10,3,46,21,9,5,419,265
988,54,4,3,6,7,-58,34,1,9,361,299
988,55,4,3,6,7,42,-66,3,3,403,233
988,56,3,3,7,6,34,33,7,6,437,266
988,57,2,4,7,6,-75,42,2,8,362,308
988,58,3,4,7,6,34,-58,6,0,396,250
988,59,3,4,6,7,33,43,9,3,429,293
988,60,6,2,13,0,-33,-20,6,3,396,273
988,61,2,5,4,9,22,54,8,7,418,327
988,62,4,2,8,5,-56,-77,2,0,362,250
988,63,2,4,6,7,24,43,6,3,386,293
988,64,2,5,4,9,22,54,8,7,408,347
988,65,3,3,6,7,-67,-66,1,1,341,281
988,66,4,3,8,5,44,32,5,3,385,313
988,67,3,3,5,8,32,35,7,8,417,348
988,68,3,3,5,8,32,-65,9,3,449,283
988,69,3,3,4,9,-69,36,0,9,380,319
988,70,2,4,6,7,24,-57,4,2,404,262
988,71,2,4,7,6,25,42,9,4,429,304
988,72,4,2,6,7,-58,25,1,9,371,329
988,73,4,2,10,3,46,-79,7,0,417,250
988,74,3,4,7,6,-66,42,1,2,351,292
988,75,3,3,7,6,34,33,5,5,385,325
988,76,4,3,5,8,41,-65,6,0,426,260
988,77,2,4,6,7,-76,43,0,3,350,303
988,78,3,3,5,8,32,35,2,8,382,338
988,79,3,3,5,8,32,-65,4,3,414,273
988,80,5,2,10,3,55,21,9,4,469,294
988,81,3,4,8,5,-65,41,4,5,404,335
988,82,4,3,7,6,43,33,7,8,447,368
988,83,2,4,7,6,-75,-58,2,0,372,310
988,84,4,2,7,6,43,24,5,4,415,334
988,85,2,5,4,9,22,54,7,8,437,388
988,86,4,2,9,4,-55,-78,2,0,382,310
988,87,3,4,4,9,31,45,3,5,413,355
988,88,3,4,4,9,31,-55,4,0,444,300
988,89,4,2,7,6,43,24,7,4,487,324
988,90,3,4,7,6,-66,42,1,6,421,366
988,91,4,2,8,5,44,23,5,9,465,389
988,92,4,4,6,7,42,-57,7,2,507,332
989,1,4,4,8,5,44,41,4,1,44,41
989,2,4,3,6,7,42,34,6,5,86,75
989,3,4,3,7,6,43,33,9,8,129,108
989,4,3,3,5,8,-68,-65,1,3,61,43
989,5,3,3,4,9,31,36,2,9,92,79
989,6,3,3,7,6,34,-67,6,2,126,12
989,7,4,2,7,6,43,24,9,6,169,36
989,8,2,5,3,10,-79,-45,0,1,90,-9
989,9,4,2,10,3,46,21,6,2,136,12
989,10,3,4,7,6,-66,42,0,4,70,54
989,11,6,2,11,2,65,20,5,4,135,74
989,12,5,2,8,5,53,23,8,7,188,97
989,13,4,2,11,2,-53,20,5,7,135,117
989,14,3,3,7,6,34,-67,9,0,169,50
989,15,2,4,7,6,-75,42,4,2,94,92
989,16,3,3,6,7,33,34,7,6,127,126
989,17,4,3,8,5,-56,32,1,8,71,158
989,18,4,3,6,7,42,-66,3,2,113,92
989,19,4,4,6,7,42,43,5,5,155,135
989,20,3,4,7,6,34,42,9,7,189,177
989,21,4,2,8,5,-56,-77,3,0,133,100
989,22,4,3,6,7,42,34,5,4,175,134
989,23,4,3,6,7,42,34,7,8,217,168
989,24,5,2,10,3,-45,21,2,9,172,189
989,25,5,2,10,3,55,-79,7,0,227,110
989,26,3,3,7,6,-66,33,1,3,161,143
989,27,3,3,7,6,34,33,5,6,195,176
989,28,2,5,3,10,21,-45,6,1,216,131
989,29,2,5,6,7,-76,52,0,3,140,183
989,30,5,2,11,2,56,20,6,3,196,203
989,31,3,3,5,8,32,35,8,8,228,238
989,32,3,4,4,9,31,-55,9,3,259,183
989,33,2,4,3,10,-79,46,0,9,180,229
989,34,3,3,5,8,32,-65,2,4,212,164
989,35,6,2,10,3,64,21,6,5,276,185
989,36,4,3,7,6,43,33,9,8,319,218
989,37,3,3,6,7,-67,-66,2,2,252,152
989,38,2,4,8,5,26,41,8,3,278,193
989,39,4,2,6,7,-58,25,0,8,220,218
989,40,4,3,7,6,43,-67,3,1,263,151
989,41,2,4,3,10,21,46,4,7,284,197
989,42,4,4,7,6,43,42,7,9,327,239
989,43,2,4,6,7,-76,-57,1,2,251,182
989,44,4,2,5,8,41,26,2,8,292,208
989,45,2,5,3,10,21,-45,3,3,313,163
989,46,3,4,6,7,33,43,6,6,346,206
989,47,3,3,7,6,-66,33,0,9,280,239
989,48,3,3,3,10,30,-63,0,6,310,176
989,49,2,4,7,6,25,42,5,8,335,218
989,50,4,3,6,7,42,-66,7,2,377,152
989,51,3,3,8,5,-65,32,2,4,312,184
989,52,3,3,6,7,33,34,5,8,345,218
989,53,3,4,7,6,34,-58,9,0,379,160
989,54,3,4,7,6,-66,42,3,2,313,202
989,55,4,2,6,7,42,25,5,7,355,227
989,56,2,4,3,10,21,-54,6,3,376,173
989,57,2,5,2,11,20,56,6,9,396,229
989,58,2,5,2,11,20,-44,6,5,416,185
989,59,5,3,5,8,50,-65,6,0,466,120
989,60,3,3,5,8,32,35,8,5,498,155
989,61,3,4,6,7,-67,43,1,8,431,198
989,62,3,3,7,6,34,-67,5,1,465,131
989,63,5,2,8,5,53,23,8,4,518,154
990,1,3,3,7,6,34,33,4,3,34,33
990,2,3,4,8,5,35,41,9,4,69,74
990,3,3,4,6,7,-67,43,2,7,2,117
990,4,3,3,8,5,35,32,7,9,37,149
990,5,3,3,4,9,31,-64,8,5,68,85
990,6,3,4,5,8,-68,44,0,9,0,129
990,7,3,4,3,10,30,-54,0,5,30,75
990,8,2,5,2,11,20,-44,0,1,50,31
990,9,4,2,8,5,44,23,4,4,94,54
990,10,4,3,9,4,45,31,9,5,139,85
990,11,3,3,6,7,-67,34,2,9,72,119
990,12,2,5,5,8,23,-47,5,2,95,72
990,13,4,2,10,3,-54,21,1,3,41,93
990,14,5,2,11,2,56,20,7,3,97,113
990,15,2,5,2,11,20,56,7,9,117,169
990,16,5,2,7,6,52,-76,9,3,169,93
990,17,2,5,6,7,-76,52,3,5,93,145
990,18,4,3,6,7,42,34,5,9,135,179
990,19,2,5,4,9,22,-46,7,3,157,133
990,20,4,2,9,4,-55,22,2,5,102,155
990,21,2,4,6,7,24,43,6,8,126,198
990,22,4,2,8,5,-56,-77,0,1,70,121
990,23,4,3,7,6,43,33,3,4,113,154
990,24,4,3,5,8,41,35,4,9,154,189
990,25,3,5,5,8,32,-47,6,2,186,142
990,26,2,5,4,9,22,54,8,6,208,196
990,27,3,3,9,4,-64,31,4,7,144,227
990,28,3,3,7,6,34,-67,8,0,178,160
990,29,3,3,5,8,-68,35,0,5,110,195
990,30,3,3,7,6,34,33,4,8,144,228
990,31,4,3,7,6,43,-67,7,1,187,161
990,32,3,3,7,6,-66,33,1,4,121,194
990,33,3,3,6,7,33,34,4,8,154,228
990,34,3,3,4,9,31,-64,5,4,185,164
990,35,3,4,3,10,30,-54,5,0,215,110
990,36,3,3,5,8,32,35,7,5,247,145
990,37,5,2,8,5,-47,23,0,8,200,168
990,38,4,2,9,4,45,-78,5,0,245,90
990,39,3,4,5,8,32,44,7,4,277,134
990,40,3,3,8,5,-65,32,2,6,212,166
990,41,5,2,7,6,52,-76,4,0,264,90
990,42,4,2,6,7,42,25,6,5,306,115
990,43,3,3,6,7,33,34,9,9,339,149
990,44,3,4,6,7,-67,-57,2,2,272,92
990,45,4,2,7,6,43,24,5,6,315,116
990,46,4,3,7,6,43,33,8,9,358,149
990,47,4,2,7,6,-57,-76,1,3,301,73
990,48,5,2,8,5,53,23,4,6,354,96
990,49,4,2,8,5,44,23,8,9,398,119
990,50,3,4,6,7,-67,-57,1,2,331,62
990,51,3,3,9,4,36,31,7,3,367,93
990,52,3,3,5,8,32,35,9,8,399,128
990,53,4,3,9,4,-55,31,4,9,344,159
990,54,3,3,5,8,32,-65,6,4,376,94
990,55,2,5,3,10,21,55,7,9,397,149
990,56,2,5,3,10,21,-45,8,4,418,104
990,57,4,3,8,5,-56,32,2,6,362,136
990,58,2,4,7,6,25,42,7,8,387,178
990,59,2,5,6,7,-76,-48,1,0,311,130
990,60,4,3,9,4,45,31,6,1,356,161
990,61,3,4,5,8,32,44,8,5,388,205
990,62,4,2,7,6,-57,24,1,9,331,229
990,63,3,5,4,9,31,-46,2,3,362,183
990,64,2,5,4,9,22,54,4,7,384,237
990,65,3,3,5,8,32,-65,6,2,416,172
990,66,2,5,2,11,20,56,6,8,436,228
990,67,3,4,4,9,31,-55,7,3,467,173
990,68,5,2,9,4,-46,22,1,5,421,195
990,69,3,4,7,6,34,42,5,7,455,237
990,70,4,2,9,4,-55,22,0,9,400,259
990,71,2,5,5,8,23,-47,3,2,423,212
990,72,3,4,6,7,33,43,6,5,456,255
990,73,2,4,5,8,23,44,9,9,479,299
990,74,3,3,5,8,-68,-65,1,4,411,234
990,75,3,4,5,8,32,44,3,8,443,278
990,76,4,3,9,4,45,31,8,9,488,309
990,77,4,3,8,5,-56,-68,2,1,432,241
990,78,4,3,8,5,44,32,6,3,476,273
990,79,2,4,3,10,21,46,7,9,497,319
990,80,3,3,6,7,-67,-66,0,3,430,253
990,81,2,5,5,8,23,53,3,6,453,306
990,82,2,5,3,10,21,-45,4,1,474,261
990,83,3,4,9,4,-64,40,0,1,410,301
990,84,3,4,6,7,33,43,3,4,443,344
990,85,3,5,6,7,33,52,6,6,476,396
990,86,3,4,4,9,31,-55,7,1,507,341
991,1,3,4,6,7,33,43,3,3,33,43
991,2,5,2,10,3,55,21,8,4,88,64
991,3,2,5,5,8,-77,53,1,7,11,117
991,4,2,4,6,7,24,-57,5,0,35,60
991,5,5,2,9,4,54,22,9,2,89,82
991,6,6,2,10,3,-36,21,3,3,53,103
991,7,4,3,5,8,41,35,4,8,94,138
991,8,3,3,9,4,-64,31,0,9,30,169
991,9,2,5,2,11,20,-44,0,5,50,125
991,10,2,5,6,7,24,52,4,7,74,177
991,11,3,4,8,5,35,41,9,8,109,218
991,12,3,3,5,8,-68,-65,1,3,41,153
991,13,3,4,7,6,34,42,5,5,75,195
991,14,4,2,7,6,43,24,8,9,118,219
991,15,3,4,3,10,30,-54,8,5,148,165
991,16,2,4,5,8,-77,44,1,9,71,209
991,17,4,4,5,8,41,-56,2,3,112,153
991,18,3,4,6,7,33,43,5,6,145,196
991,19,2,5,4,9,22,-46,7,0,167,150
991,20,3,3,8,5,-65,32,2,2,102,182
991,21,3,4,5,8,32,44,4,6,134,226
991,22,5,2,10,3,55,21,9,7,189,247
991,23,4,3,9,4,-55,31,4,8,134,278
991,24,2,4,5,8,23,-56,7,2,157,222
991,25,3,4,6,7,-67,43,0,5,90,265
991,26,2,4,2,11,20,-53,0,2,110,212
991,27,3,4,4,9,31,45,1,7,141,257
991,28,4,3,7,6,43,-67,4,0,184,190
991,29,3,3,4,9,31,36,5,6,215,226
991,30,4,3,7,6,43,33,8,9,258,259
991,31,4,2,7,6,-57,-76,1,3,201,183
991,32,3,4,3,10,30,46,1,9,231,229
991,33,4,2,7,6,43,-76,4,3,274,153
991,34,5,2,9,4,54,22,8,5,328,175
991,35,2,5,6,7,-76,52,2,7,252,227
991,36,3,4,7,6,34,42,6,9,286,269
991,37,2,5,6,7,-76,-48,0,1,210,221
991,38,2,5,3,10,21,55,1,6,231,276
991,39,4,2,9,4,45,22,6,8,276,298
991,40,2,5,5,8,23,-47,9,1,299,251
991,41,3,3,5,8,-68,35,1,6,231,286
991,42,2,5,3,10,21,-45,2,1,252,241
991,43,3,5,3,10,30,55,2,6,282,296
991,44,2,4,5,8,23,-56,5,0,305,240
991,45,3,4,7,6,34,42,9,2,339,282
991,46,2,4,4,9,-78,45,1,7,261,327
991,47,5,2,8,5,53,-77,4,0,314,250
991,48,4,3,7,6,43,33,7,3,357,283
991,49,3,5,7,6,-66,51,1,4,291,334
991,50,3,3,8,5,35,32,6,6,326,366
991,51,3,4,5,8,32,-56,8,0,358,310
991,52,4,3,7,6,-57,33,1,3,301,343
991,53,3,3,7,6,34,33,5,6,335,376
991,54,3,4,6,7,33,43,8,9,368,419
991,55,3,4,5,8,-68,-56,0,3,300,363
991,56,4,2,9,4,45,22,5,5,345,385
991,57,2,4,5,8,23,44,8,9,368,429
991,58,2,5,3,10,21,-45,9,4,389,384
991,59,3,5,4,9,-69,54,0,8,320,438
991,60,5,2,9,4,54,-78,4,0,374,360
991,61,3,4,6,7,33,43,7,3,407,403
991,62,2,4,4,9,22,45,9,8,429,448
991,63,2,4,7,6,-75,-58,4,0,354,390
991,64,2,4,5,8,23,44,7,4,377,434
991,65,4,3,9,4,-55,31,2,5,322,465
991,66,3,3,3,10,30,-63,2,2,352,402
991,67,3,4,6,7,33,43,5,5,385,445
991,68,4,3,7,6,43,33,8,8,428,478
991,69,3,3,7,6,-66,-67,2,1,362,411
991,70,4,3,8,5,44,32,6,3,406,443
991,71,3,4,7,6,-66,42,0,5,340,485
991,72,3,4,5,8,32,44,2,9,372,529
992,1,5,2,8,5,53,23,3,3,53,23
992,2,5,2,11,2,56,20,9,3,109,43
992,3,2,4,6,7,-76,43,3,6,33,86
992,4,4,2,8,5,44,23,7,9,77,109
992,5,2,5,3,10,21,-45,8,4,98,64
992,6,4,2,7,6,-57,24,1,8,41,88
992,7,3,4,7,6,34,-58,5,0,75,30
992,8,3,4,8,5,-65,41,0,1,10,71
992,9,2,4,5,8,23,44,3,5,33,115
992,10,3,3,5,8,32,-65,5,0,65,50
992,11,2,4,6,7,24,43,9,3,89,93
992,12,3,3,7,6,-66,33,3,6,23,126
992,13,4,2,7,6,43,-76,6,0,66,50
992,14,4,2,8,5,-56,23,0,3,10,73
992,15,4,4,5,8,41,44,1,7,51,117
992,16,4,4,8,5,44,41,5,8,95,158
992,17,3,3,5,8,32,-65,7,3,127,93
992,18,4,3,5,8,41,35,8,8,168,128
992,19,3,4,7,6,-66,-58,2,0,102,70
992,20,4,3,6,7,42,34,4,4,144,104
992,21,2,4,6,7,24,43,8,7,168,147
992,22,2,5,5,8,-77,-47,1,0,91,100
992,23,4,2,9,4,45,22,6,2,136,122
992,24,2,4,7,6,-75,42,1,4,61,164
992,25,3,3,4,9,31,-64,2,0,92,100
992,26,4,3,9,4,45,31,7,1,137,131
992,27,3,3,7,6,-66,33,1,4,71,164
992,28,4,3,8,5,44,32,5,6,115,196
992,29,4,3,9,4,-55,31,0,7,60,227
992,30,5,2,9,4,54,22,4,9,114,249
992,31,3,4,8,5,35,-59,9,0,149,190
992,32,4,3,5,8,-59,35,0,5,90,225
992,33,6,2,11,2,65,20,5,5,155,245
992,34,4,3,8,5,44,32,9,7,199,277
992,35,4,3,6,7,-58,-66,1,1,141,211
992,36,3,4,4,9,31,45,2,6,172,256
992,37,5,2,7,6,52,-76,4,0,224,180
992,38,3,5,6,7,33,52,7,2,257,232
992,39,4,3,6,7,42,34,9,6,299,266
992,40,3,3,7,6,-66,33,3,9,233,299
992,41,4,2,8,5,44,-77,7,2,277,222
992,42,4,3,8,5,-56,32,1,4,221,254
992,43,3,4,7,6,34,42,5,6,255,296
992,44,4,2,10,3,-54,21,1,7,201,317
992,45,4,2,7,6,43,-76,4,1,244,241
992,46,6,2,10,3,64,21,8,2,308,262
992,47,3,4,3,10,30,46,8,8,338,308
992,48,3,3,5,8,-68,-65,0,3,270,243
992,49,3,4,7,6,34,42,4,5,304,285
992,50,4,2,9,4,45,22,9,7,349,307
992,51,4,2,5,8,-59,-74,0,3,290,233
992,52,4,3,7,6,43,33,3,6,333,266
992,53,2,4,4,9,22,-55,5,1,355,211
992,54,4,2,9,4,-55,22,0,3,300,233
992,55,4,3,8,5,44,32,4,5,344,265
992,56,4,4,4,9,40,-55,4,0,384,210
992,57,3,3,8,5,35,32,9,2,419,242
992,58,4,3,9,4,-55,31,4,3,364,273
992,59,4,4,6,7,42,43,6,6,406,316
992,60,3,4,5,8,32,-56,8,0,438,260
992,61,3,3,7,6,-66,33,2,3,372,293
992,62,4,3,6,7,42,34,4,7,414,327
992,63,3,3,4,9,31,-64,5,3,445,263
992,64,5,2,7,6,52,24,7,7,497,287
992,65,2,5,3,10,21,-45,8,2,518,242
993,1,3,3,5,8,32,35,2,5,32,35
993,2,3,4,5,8,32,44,4,9,64,79
993,3,3,3,9,4,-64,-69,0,0,0,10
993,4,3,4,5,8,32,44,2,4,32,54
993,5,3,3,8,5,35,32,7,6,67,86
993,6,2,4,7,6,-75,42,2,8,-8,128
993,7,2,4,7,6,25,-58,7,0,17,70
993,8,2,4,7,6,-75,42,2,2,-58,112
993,9,4,3,9,4,45,31,7,3,-13,143
993,10,4,2,7,6,-57,24,0,7,-70,167
993,11,4,3,9,4,45,31,5,8,-25,198
993,12,5,2,10,3,-45,21,0,9,-70,219
993,13,2,6,2,11,20,-35,0,4,-50,184
993,14,2,4,2,11,20,-53,0,1,-30,131
993,15,2,5,4,9,22,54,2,5,-8,185
993,16,4,2,9,4,45,22,7,7,37,207
993,17,3,3,7,6,-66,-67,1,0,-29,140
993,18,3,3,4,9,31,36,2,6,2,176
993,19,3,4,6,7,33,43,5,9,35,219
993,20,5,2,7,6,52,-76,7,3,87,143
993,21,5,2,11,2,-44,20,3,3,43,163
993,22,2,5,5,8,23,53,6,6,66,216
993,23,3,3,8,5,-65,32,1,8,1,248
993,24,4,3,8,5,44,-68,5,0,45,180
993,25,5,2,10,3,-45,21,0,1,0,201
993,26,3,3,5,8,32,35,2,6,32,236
993,27,2,4,4,9,22,-55,4,1,54,181
993,28,2,4,5,8,23,44,7,5,77,225
993,29,2,6,3,10,21,64,8,9,98,289
993,30,3,4,7,6,-66,-58,2,1,32,231
993,31,5,2,7,6,52,24,4,5,84,255
993,32,3,4,6,7,33,43,7,8,117,298
993,33,4,3,7,6,-57,-67,0,1,60,231
993,34,3,5,5,8,32,53,2,4,92,284
993,35,4,3,7,6,43,33,5,7,135,317
993,36,4,3,9,4,-55,31,0,8,80,348
993,37,3,4,7,6,34,-58,4,0,114,290
993,38,3,3,7,6,34,33,8,3,148,323
993,39,2,5,5,8,-77,53,1,6,71,376
993,40,4,2,10,3,46,21,7,7,117,397
993,41,2,4,5,8,-77,-56,0,1,40,341
993,42,4,2,6,7,42,25,2,6,82,366
993,43,4,3,7,6,43,33,5,9,125,399
993,44,2,5,2,11,20,-44,5,5,145,355
993,45,4,2,7,6,43,24,8,9,188,379
993,46,4,4,5,8,41,-56,9,3,229,323
993,47,3,4,6,7,-67,43,2,6,162,366
993,48,3,3,6,7,33,-66,5,0,195,300
993,49,3,3,6,7,33,34,8,4,228,334
993,50,5,2,11,2,-44,20,4,4,184,354
993,51,2,4,7,6,25,42,9,6,209,396
993,52,3,4,5,8,-68,-56,1,0,141,340
993,53,5,2,9,4,54,22,5,2,195,362
993,54,5,2,10,3,-45,21,0,3,150,383
993,55,3,3,8,5,35,32,5,5,185,415
993,56,4,2,8,5,44,23,9,8,229,438
993,57,3,4,6,7,-67,-57,2,1,162,381
993,58,3,5,4,9,31,54,3,5,193,435
993,59,2,4,5,8,23,44,6,9,216,479
993,60,4,3,9,4,-55,-69,1,0,161,410
993,61,3,3,8,5,35,32,6,2,196,442
993,62,3,4,4,9,31,45,7,7,227,487
993,63,4,2,9,4,-55,22,2,9,172,509
994,1,2,5,2,11,20,56,0,6,20,56
994,2,4,2,7,6,43,-76,3,0,63,-20
994,3,3,3,5,8,32,35,5,5,95,15
994,4,4,3,8,5,44,32,9,7,139,47
994,5,5,2,9,4,-46,22,3,9,93,69
994,6,2,4,3,10,21,-54,4,5,114,15
994,7,4,2,11,2,-53,20,1,5,61,35
994,8,5,2,9,4,54,22,5,7,115,57
994,9,2,4,5,8,23,-56,8,1,138,1
994,10,5,2,9,4,-46,22,2,3,92,23
994,11,5,2,10,3,55,21,7,4,147,44
994,12,4,2,9,4,-55,22,2,6,92,66
994,13,3,5,7,6,34,51,6,7,126,117
994,14,4,3,7,6,43,-67,9,0,169,50
994,15,3,3,6,7,-67,34,2,4,102,84
994,16,4,2,10,3,46,21,8,5,148,105
994,17,2,4,5,8,-77,44,1,9,71,149
994,18,4,3,8,5,44,-68,5,1,115,81
994,19,5,2,9,4,54,22,9,3,169,103
994,20,2,4,5,8,-77,44,2,7,92,147
994,21,4,2,7,6,43,-76,5,1,135,71
994,22,3,3,7,6,34,33,9,4,169,104
994,23,3,4,8,5,-65,41,4,5,104,145
994,24,4,3,7,6,43,33,7,8,147,178
994,25,4,2,7,6,-57,-76,0,2,90,102
994,26,3,4,7,6,34,42,4,4,124,144
994,27,5,2,8,5,53,23,7,7,177,167
994,28,5,2,8,5,-47,-77,0,0,130,90
994,29,4,4,4,9,40,45,0,5,170,135
994,30,3,3,5,8,32,-65,2,0,202,70
994,31,3,3,7,6,34,33,6,3,236,103
994,32,4,2,8,5,-56,23,0,6,180,126
994,33,3,3,6,7,33,-66,3,0,213,60
994,34,4,2,8,5,44,23,7,3,257,83
994,35,2,4,4,9,22,45,9,8,279,128
994,36,5,2,9,4,-46,-78,3,0,233,50
994,37,4,3,6,7,42,34,5,4,275,84
994,38,3,4,8,5,-65,41,0,5,210,125
994,39,3,3,5,8,32,-65,2,0,242,60
994,40,2,5,4,9,22,54,4,4,264,114
994,41,3,4,4,9,31,45,5,9,295,159
994,42,3,3,5,8,32,-65,7,4,327,94
994,43,3,3,7,6,-66,33,1,7,261,127
994,44,5,2,11,2,56,20,7,7,317,147
994,45,3,4,6,7,-67,-57,0,0,250,90
994,46,2,4,5,8,23,44,3,4,273,134
994,47,4,2,10,3,46,21,9,5,319,155
994,48,2,5,3,10,-79,-45,0,0,240,110
994,49,4,2,8,5,44,23,4,3,284,133
994,50,4,2,7,6,43,24,7,7,327,157
994,51,4,3,9,4,-55,31,2,8,272,188
994,52,3,3,7,6,34,-67,6,1,306,121
994,53,4,3,9,4,-55,31,1,2,251,152
994,54,3,3,10,3,37,30,8,2,288,182
994,55,2,4,5,8,-77,44,1,6,211,226
994,56,2,4,5,8,23,-56,4,0,234,170
994,57,4,2,7,6,43,24,7,4,277,194
994,58,2,4,8,5,-74,41,3,5,203,235
994,59,4,3,6,7,42,34,5,9,245,269
994,60,4,2,6,7,42,-75,7,4,287,194
994,61,4,3,5,8,41,35,8,9,328,229
994,62,4,2,7,6,-57,-76,1,3,271,153
994,63,3,3,6,7,33,34,4,7,304,187
994,64,4,2,9,4,45,22,9,9,349,209
994,65,3,4,4,9,-69,-55,0,4,280,154
994,66,2,4,6,7,24,43,4,7,304,197
994,67,2,5,3,10,21,-45,5,2,325,152
994,68,2,5,3,10,21,55,6,7,346,207
994,69,5,2,9,4,-46,22,0,9,300,229
994,70,2,5,3,10,21,-45,1,4,321,184
994,71,2,5,3,10,21,55,2,9,342,239
994,72,2,4,6,7,24,-57,6,2,366,182
994,73,3,3,8,5,-65,32,1,4,301,214
994,74,3,4,4,9,31,45,2,9,332,259
994,75,5,2,8,5,53,-77,5,2,385,182
994,76,6,2,10,3,64,21,9,3,449,203
994,77,3,3,5,8,-68,35,1,8,381,238
994,78,3,3,7,6,34,-67,5,1,415,171
994,79,3,4,4,9,31,45,6,6,446,216
994,80,4,3,6,7,42,-66,8,0,488,150
994,81,4,3,8,5,-56,32,2,2,432,182
994,82,2,4,4,9,22,45,4,7,454,227
994,83,3,4,6,7,33,-57,7,0,487,170
994,84,3,3,6,7,-67,34,0,4,420,204
994,85,4,3,10,3,46,30,6,4,466,234
994,86,4,3,10,3,-54,30,2,4,412,264
994,87,4,2,6,7,42,25,4,9,454,289
994,88,4,3,6,7,42,-66,6,3,496,223
994,89,3,3,6,7,33,34,9,7,529,257
995,1,2,4,4,9,22,45,2,5,22,45
995,2,2,5,4,9,22,54,4,9,44,99
995,3,3,3,5,8,32,-65,6,4,76,34
995,4,4,3,6,7,42,34,8,8,118,68
995,5,3,4,6,7,-67,-57,1,1,51,11
995,6,3,4,7,6,34,42,5,3,85,53
995,7,3,4,5,8,32,44,7,7,117,97
995,8,4,3,9,4,-55,31,2,8,62,128
995,9,5,2,9,4,54,-78,6,0,116,50
995,10,3,3,5,8,32,35,8,5,148,85
995,11,3,4,5,8,-68,44,0,9,80,129
995,12,4,2,5,8,41,-74,1,5,121,55
995,13,4,3,7,6,43,33,4,8,164,88
995,14,3,4,7,6,34,-58,8,0,198,30
995,15,2,4,6,7,-76,43,2,3,122,73
995,16,3,3,7,6,34,33,6,6,156,106
995,17,2,5,4,9,22,-46,8,0,178,60
995,18,3,4,5,8,-68,44,0,4,110,104
995,19,2,4,6,7,24,43,4,7,134,147
995,20,3,4,5,8,32,-56,6,1,166,91
995,21,4,2,10,3,-54,21,2,2,112,112
995,22,3,4,5,8,32,44,4,6,144,156
995,23,3,3,3,10,30,-63,4,3,174,93
995,24,2,5,4,9,22,54,6,7,196,147
995,25,3,4,8,5,-65,41,1,8,131,188
995,26,4,3,10,3,46,30,7,8,177,218
995,27,3,4,5,8,32,-56,9,2,209,162
995,28,3,3,9,4,-64,31,5,3,145,193
995,29,2,4,8,5,-74,41,1,4,71,234
995,30,5,3,6,7,51,34,2,8,122,268
995,31,3,4,8,5,35,41,7,9,157,309
995,32,3,4,8,5,-65,-59,2,0,92,250
995,33,5,2,9,4,54,22,6,2,146,272
995,34,3,3,7,6,-66,33,0,5,80,305
995,35,2,5,5,8,23,53,3,8,103,358
995,36,5,2,8,5,53,-77,6,1,156,281
995,37,2,4,3,10,21,46,7,7,177,327
995,38,4,2,6,7,42,-75,9,2,219,252
995,39,3,5,6,7,-67,52,2,4,152,304
995,40,5,2,9,4,54,22,6,6,206,326
995,41,4,3,9,4,-55,31,1,7,151,357
995,42,4,2,7,6,43,-76,4,1,194,281
995,43,2,5,3,10,21,55,5,6,215,336
995,44,3,4,6,7,33,43,8,9,248,379
995,45,4,2,10,3,-54,-79,4,0,194,300
995,46,4,3,9,4,45,31,9,1,239,331
995,47,3,3,7,6,-66,33,3,4,173,364
995,48,4,2,10,3,46,21,9,5,219,385
995,49,2,5,5,8,-77,53,2,8,142,438
995,50,6,2,10,3,64,21,6,9,206,459
995,51,4,2,8,5,-56,-77,0,2,150,382
995,52,3,4,8,5,35,41,5,3,185,423
995,53,3,4,6,7,33,43,8,6,218,466
995,54,2,4,4,9,-78,-55,0,1,140,411
995,55,5,3,7,6,52,33,2,4,192,444
995,56,3,3,5,8,32,35,4,9,224,479
995,57,3,4,4,9,31,-55,5,4,255,424
995,58,4,3,7,6,43,33,8,7,298,457
995,59,5,2,11,2,-44,20,4,7,254,477
995,60,3,4,6,7,33,-57,7,0,287,420
995,61,4,2,10,3,-54,21,3,1,233,441
995,62,5,2,7,6,52,24,5,5,285,465
995,63,2,5,3,10,21,-45,6,0,306,420
995,64,2,5,4,9,22,54,8,4,328,474
995,65,4,2,8,5,-56,23,2,7,272,497
995,66,3,3,5,8,32,-65,4,2,304,432
995,67,3,3,6,7,33,34,7,6,337,466
995,68,4,3,5,8,41,-65,8,1,378,401
995,69,4,3,4,9,40,36,8,7,418,437
995,70,5,2,10,3,-45,21,3,8,373,458
995,71,3,5,6,7,33,-48,6,0,406,410
995,72,4,2,7,6,43,24,9,4,449,434
995,73,4,2,8,5,-56,23,3,7,393,457
995,74,2,4,5,8,23,-56,6,1,416,401
995,75,3,3,7,6,-66,33,0,4,350,434
995,76,3,4,7,6,34,42,4,6,384,476
995,77,3,3,5,8,32,-65,6,1,416,411
995,78,4,3,8,5,-56,32,0,3,360,443
995,79,2,5,3,10,21,55,1,8,381,498
995,80,4,3,7,6,43,-67,4,1,424,431
995,81,5,2,8,5,53,23,7,4,477,454
995,82,4,2,8,5,-56,23,1,7,421,477
995,83,4,2,11,2,47,20,8,7,468,497
995,84,2,4,7,6,-75,42,3,9,393,539
996,1,4,4,9,4,45,40,5,0,45,40
996,2,3,4,4,9,31,45,6,5,76,85
996,3,2,5,2,11,20,-44,6,1,96,41
996,4,4,4,6,7,42,43,8,4,138,84
996,5,3,3,8,5,-65,32,3,6,73,116
996,6,4,2,8,5,44,23,7,9,117,139
996,7,5,2,9,4,-46,-78,1,1,71,61
996,8,4,2,6,7,42,25,3,6,113,86
996,9,4,2,8,5,44,23,7,9,157,109
996,10,4,2,7,6,-57,-76,0,3,100,33
996,11,4,2,10,3,46,21,6,4,146,54
996,12,3,4,7,6,-66,42,0,6,80,96
996,13,4,2,8,5,44,23,4,9,124,119
996,14,3,4,6,7,33,-57,7,2,157,62
996,15,2,4,4,9,22,45,9,7,179,107
996,16,3,4,3,10,30,-54,9,3,209,53
996,17,3,3,9,4,-64,31,5,4,145,84
996,18,4,2,10,3,-54,21,1,5,91,105
996,19,3,3,6,7,33,34,4,9,124,139
996,20,2,5,4,9,22,-46,6,3,146,93
996,21,4,2,6,7,42,25,8,8,188,118
996,22,4,2,8,5,-56,-77,2,1,132,41
996,23,2,6,3,10,21,64,3,5,153,105
996,24,2,5,3,10,21,-45,4,0,174,60
996,25,2,5,6,7,24,52,8,2,198,112
996,26,2,5,3,10,21,55,9,7,219,167
996,27,5,2,8,5,-47,-77,2,0,172,90
996,28,2,4,6,7,24,43,6,3,196,133
996,29,3,3,6,7,33,34,9,7,229,167
996,30,2,6,4,9,-78,-37,1,0,151,130
996,31,3,3,8,5,35,32,6,2,186,162
996,32,5,2,9,4,-46,22,0,4,140,184
996,33,4,3,7,6,43,33,3,7,183,217
996,34,2,5,6,7,24,52,7,9,207,269
996,35,2,4,5,8,-77,-56,0,3,130,213
996,36,2,6,3,10,21,64,1,7,151,277
996,37,3,3,9,4,36,31,7,8,187,308
996,38,3,4,5,8,32,-56,9,2,219,252
996,39,4,2,6,7,-58,25,1,7,161,277
996,40,4,2,7,6,43,-76,4,1,204,201
996,41,2,4,2,11,20,47,4,8,224,248
996,42,2,5,3,10,21,-45,5,3,245,203
996,43,4,2,10,3,-54,21,1,4,191,224
996,44,2,5,5,8,23,53,4,7,214,277
996,45,3,3,7,6,34,-67,8,0,248,210
996,46,5,2,9,4,-46,22,2,2,202,232
996,47,3,4,8,5,35,41,7,3,237,273
996,48,4,3,8,5,-56,32,1,5,181,305
996,49,5,2,8,5,53,23,4,8,234,328
996,50,3,4,8,5,35,41,9,9,269,369
996,51,2,5,5,8,-77,-47,2,2,192,322
996,52,5,2,8,5,53,23,5,5,245,345
996,53,3,4,5,8,32,44,7,9,277,389
996,54,4,2,6,7,42,-75,9,4,319,314
996,55,2,6,3,10,-79,64,0,8,240,378
996,56,4,2,6,7,42,-75,2,3,282,303
996,57,3,4,6,7,33,43,5,6,315,346
996,58,3,3,4,9,31,-64,6,2,346,282
996,59,5,2,10,3,-45,21,1,3,301,303
996,60,2,4,4,9,22,45,3,8,323,348
996,61,2,4,5,8,23,-56,6,2,346,292
996,62,6,2,10,3,-36,21,0,3,310,313
996,63,3,4,4,9,31,45,1,8,341,358
996,64,2,5,2,11,20,-44,1,4,361,314
996,65,3,5,5,8,32,53,3,7,393,367
996,66,4,3,7,6,43,-67,6,0,436,300
996,67,4,3,7,6,43,33,9,3,479,333
996,68,4,3,8,5,-56,32,3,5,423,365
996,69,5,2,7,6,52,24,5,9,475,389
996,70,3,3,8,5,-65,-68,0,1,410,321
996,71,3,4,5,8,32,44,2,5,442,365
996,72,2,4,5,8,23,44,5,9,465,409
996,73,2,5,3,10,21,-45,6,4,486,364
996,74,5,2,10,3,-45,21,1,5,441,385
996,75,4,2,9,4,45,22,6,7,486,407
996,76,2,4,3,10,21,-54,7,3,507,353
997,1,4,3,7,6,43,33,3,3,43,33
997,2,2,5,4,9,22,54,5,7,65,87
997,3,4,4,4,9,40,-55,5,2,105,32
997,4,2,6,3,10,21,64,6,6,126,96
997,5,5,2,10,3,-45,21,1,7,81,117
997,6,4,3,10,3,46,30,7,7,127,147
997,7,5,2,9,4,-46,22,1,9,81,169
997,8,2,5,2,11,20,-44,1,5,101,125
997,9,4,4,8,5,44,41,5,6,145,166
997,10,2,5,2,11,20,-44,5,2,165,122
997,11,5,2,10,3,-45,21,0,3,120,143
997,12,3,4,4,9,31,45,1,8,151,188
997,13,3,4,8,5,35,41,6,9,186,229
997,14,2,4,5,8,23,-56,9,3,209,173
997,15,3,3,7,6,-66,33,3,6,143,206
997,16,4,3,9,4,45,31,8,7,188,237
997,17,2,4,8,5,-74,41,4,8,114,278
997,18,5,3,8,5,53,-68,7,0,167,210
997,19,4,2,8,5,-56,23,1,3,111,233
997,20,3,4,6,7,33,43,4,6,144,276
997,21,3,4,6,7,33,43,7,9,177,319
997,22,5,3,6,7,51,-66,8,3,228,253
997,23,4,2,7,6,-57,24,1,7,171,277
997,24,4,3,9,4,45,31,6,8,216,308
997,25,3,4,4,9,31,-55,7,3,247,253
997,26,3,4,8,5,-65,41,2,4,182,294
997,27,3,3,7,6,34,33,6,7,216,327
997,28,5,2,9,4,-46,22,0,9,170,349
997,29,3,4,5,8,32,-56,2,3,202,293
997,30,4,2,6,7,42,25,4,8,244,318
997,31,2,4,3,10,21,-54,5,4,265,264
997,32,4,3,8,5,44,32,9,6,309,296
997,33,3,4,5,8,-68,-56,1,0,241,240
997,34,2,5,5,8,23,53,4,3,264,293
997,35,3,3,5,8,32,35,6,8,296,328
997,36,3,4,6,7,33,-57,9,1,329,271
997,37,5,2,9,4,-46,22,3,3,283,293
997,38,3,3,7,6,34,33,7,6,317,326
997,39,3,3,7,6,-66,33,1,9,251,359
997,40,3,3,8,5,35,-68,6,1,286,291
997,41,4,4,6,7,42,43,8,4,328,334
997,42,3,4,7,6,-66,42,2,6,262,376
997,43,2,4,2,11,20,-53,2,3,282,323
997,44,3,3,6,7,33,34,5,7,315,357
997,45,2,5,3,10,21,-45,6,2,336,312
997,46,3,3,8,5,-65,32,1,4,271,344
997,47,3,3,8,5,35,32,6,6,306,376
997,48,5,2,7,6,52,-76,8,0,358,300
997,49,4,3,7,6,-57,33,1,3,301,333
997,50,2,4,5,8,23,44,4,7,324,377
997,51,3,3,6,7,33,-66,7,1,357,311
997,52,3,3,6,7,-67,34,0,5,290,345
997,53,4,3,8,5,44,32,4,7,334,377
997,54,2,4,6,7,24,-57,8,0,358,320
997,55,3,4,7,6,-66,42,2,2,292,362
997,56,3,3,8,5,35,32,7,4,327,394
997,57,3,3,5,8,32,35,9,9,359,429
997,58,3,4,5,8,-68,-56,1,3,291,373
997,59,5,2,11,2,56,20,7,3,347,393
997,60,4,3,7,6,-57,33,0,6,290,426
997,61,3,4,6,7,33,43,3,9,323,469
997,62,4,2,7,6,43,-76,6,3,366,393
997,63,3,3,8,5,-65,32,1,5,301,425
997,64,2,4,4,9,22,-55,3,0,323,370
997,65,3,3,10,3,-63,30,0,0,260,400
997,66,5,2,9,4,54,22,4,2,314,422
997,67,3,3,7,6,34,33,8,5,348,455
997,68,2,4,5,8,-77,44,1,9,271,499
997,69,6,2,10,3,64,-79,5,0,335,420
997,70,2,4,6,7,24,43,9,3,359,463
997,71,3,3,7,6,-66,33,3,6,293,496
997,72,4,3,7,6,43,33,6,9,336,529
998,1,2,5,4,9,22,54,2,4,22,54
998,2,4,2,5,8,41,-74,3,0,63,-20
998,3,2,5,3,10,21,55,4,5,84,35
998,4,3,3,8,5,35,32,9,7,119,67
998,5,3,4,5,8,-68,-56,1,1,51,11
998,6,5,2,10,3,55,21,6,2,106,32
998,7,3,4,6,7,33,43,9,5,139,75
998,8,5,2,11,2,-44,20,5,5,95,95
998,9,4,3,8,5,44,32,9,7,139,127
998,10,3,4,6,7,-67,-57,2,0,72,70
998,11,2,4,5,8,23,44,5,4,95,114
998,12,3,4,5,8,32,44,7,8,127,158
998,13,2,4,2,11,20,-53,7,5,147,105
998,14,4,3,6,7,42,34,9,9,189,139
998,15,3,3,6,7,-67,-66,2,3,122,73
998,16,3,5,6,7,33,52,5,5,155,125
998,17,3,4,7,6,34,42,9,7,189,167
998,18,4,2,8,5,-56,-77,3,0,133,90
998,19,5,2,9,4,54,22,7,2,187,112
998,20,5,3,8,5,-47,32,0,4,140,144
998,21,2,4,7,6,25,42,5,6,165,186
998,22,4,2,7,6,43,-76,8,0,208,110
998,23,4,3,6,7,-58,34,0,4,150,144
998,24,4,2,9,4,45,22,5,6,195,166
998,25,5,2,7,6,52,-76,7,0,247,90
998,26,3,3,7,6,-66,33,1,3,181,123
998,27,3,4,6,7,33,43,4,6,214,166
998,28,3,3,6,7,33,-66,7,0,247,100
998,29,2,5,2,11,20,56,7,6,267,156
998,30,4,3,5,8,41,-65,8,1,308,91
998,31,3,3,8,5,-65,32,3,3,243,123
998,32,3,4,4,9,31,45,4,8,274,168
998,33,2,5,3,10,21,-45,5,3,295,123
998,34,3,4,6,7,33,43,8,6,328,166
998,35,2,4,5,8,-77,-56,1,0,251,110
998,36,5,2,10,3,55,21,6,1,306,131
998,37,3,4,5,8,32,44,8,5,338,175
998,38,2,4,6,7,-76,43,2,8,262,218
998,39,4,2,5,8,41,-74,3,4,303,144
998,40,5,2,10,3,55,21,8,5,358,165
998,41,6,2,8,5,-38,23,0,8,320,188
998,42,5,2,9,4,54,-78,4,0,374,110
998,43,4,2,9,4,45,22,9,2,419,132
998,44,3,3,7,6,-66,33,3,5,353,165
998,45,4,2,11,2,-53,20,0,5,300,185
998,46,3,3,5,8,32,-65,2,0,332,120
998,47,5,2,11,2,56,20,8,0,388,140
998,48,5,2,10,3,-45,21,3,1,343,161
998,49,3,4,7,6,34,42,7,3,377,203
998,50,2,5,7,6,-75,51,2,4,302,254
998,51,3,4,7,6,34,42,6,6,336,296
998,52,5,2,9,4,-46,22,0,8,290,318
998,53,5,2,11,2,56,20,6,8,346,338
998,54,3,3,8,5,-65,-68,1,0,281,270
998,55,4,3,9,4,45,31,6,1,326,301
998,56,4,2,6,7,42,25,8,6,368,326
998,57,3,3,9,4,-64,31,4,7,304,357
998,58,5,2,9,4,54,22,8,9,358,379
998,59,4,3,6,7,-58,-66,0,3,300,313
998,60,4,2,10,3,46,21,6,4,346,334
998,61,3,4,6,7,33,43,9,7,379,377
998,62,3,4,7,6,-66,42,3,9,313,419
998,63,3,4,5,8,32,-56,5,3,345,363
998,64,3,3,4,9,31,36,6,9,376,399
998,65,3,3,6,7,33,-66,9,3,409,333
998,66,3,3,4,9,-69,36,0,9,340,369
998,67,5,2,10,3,55,-79,5,0,395,290
998,68,3,4,6,7,33,43,8,3,428,333
998,69,3,4,5,8,-68,44,0,7,360,377
998,70,6,2,9,4,63,22,3,9,423,399
998,71,4,2,9,4,45,-78,8,1,468,321
998,72,3,4,7,6,-66,42,2,3,402,363
998,73,3,3,4,9,31,36,3,9,433,399
998,74,4,2,8,5,44,-77,7,2,477,322
998,75,4,2,6,7,42,25,9,7,519,347
999,1,6,2,9,4,63,22,3,2,63,22
999,2,2,5,5,8,23,53,6,5,86,75
999,3,3,4,5,8,32,44,8,9,118,119
999,4,3,3,9,4,-64,-69,4,0,54,50
999,5,5,2,11,2,-44,20,0,0,10,70
999,6,2,5,3,10,21,55,1,5,31,125
999,7,3,4,6,7,33,43,4,8,64,168
999,8,6,2,10,3,64,21,8,9,128,189
999,9,4,3,7,6,-57,-67,1,2,71,122
999,10,2,4,8,5,26,41,7,3,97,163
999,11,2,4,7,6,-75,42,2,5,22,205
999,12,4,2,6,7,42,-75,4,0,64,130
999,13,3,3,5,8,32,35,6,5,96,165
999,14,2,5,3,10,21,-45,7,0,117,120
999,15,4,3,8,5,-56,32,1,2,61,152
999,16,3,4,4,9,31,45,2,7,92,197
999,17,4,2,6,7,42,-75,4,2,134,122
999,18,4,3,8,5,44,32,8,4,178,154
999,19,3,4,7,6,-66,42,2,6,112,196
999,20,3,4,4,9,31,-55,3,1,143,141
999,21,2,5,2,11,20,56,3,7,163,197
999,22,4,2,9,4,45,22,8,9,208,219
999,23,3,4,6,7,-67,-57,1,2,141,162
999,24,5,2,8,5,53,23,4,5,194,185
999,25,5,3,9,4,54,31,8,6,248,216
999,26,3,3,4,9,31,-64,9,2,279,152
999,27,4,3,9,4,-55,31,4,3,224,183
999,28,4,2,7,6,43,24,7,7,267,207
999,29,4,3,7,6,-57,-67,0,0,210,140
999,30,4,3,10,3,46,30,6,0,256,170
999,31,3,3,8,5,-65,32,1,2,191,202
999,32,5,2,7,6,52,24,3,6,243,226
999,33,3,3,4,9,31,-64,4,2,274,162
999,34,3,4,4,9,31,45,5,7,305,207
999,35,6,2,8,5,62,-77,7,0,367,130
999,36,2,5,5,8,-77,53,0,3,290,183
999,37,4,3,7,6,43,33,3,6,333,216
999,38,3,4,5,8,32,-56,5,0,365,160
999,39,2,4,3,10,21,46,6,6,386,206
999,40,5,2,7,6,52,-76,8,0,438,130
999,41,2,5,3,10,21,55,9,5,459,185
999,42,4,3,5,8,-59,-65,0,0,400,120
999,43,4,2,7,6,43,24,3,4,443,144
999,44,5,2,10,3,55,21,8,5,498,165
999,45,3,5,5,8,-68,53,0,8,430,218
999,46,2,4,3,10,21,-54,1,4,451,164
999,47,4,3,6,7,42,34,3,8,493,198
999,48,3,4,9,4,36,40,9,8,529,238
1000,1,2,5,3,10,21,55,1,5,21,55
1000,2,5,2,9,4,54,22,5,7,75,77
1000,3,4,3,8,5,44,32,9,9,119,109
1000,4,4,2,8,5,-56,-77,3,2,63,32
1000,5,4,2,8,5,44,23,7,5,107,55
1000,6,3,4,6,7,-67,43,0,8,40,98
1000,7,5,2,9,4,54,-78,4,0,94,20
1000,8,3,3,7,6,34,33,8,3,128,53
1000,9,4,4,8,5,-56,41,2,4,72,94
1000,10,3,4,5,8,32,44,4,8,104,138
1000,11,5,2,7,6,52,-76,6,2,156,62
1000,12,2,4,5,8,23,44,9,6,179,106
1000,13,2,5,3,10,-79,-45,0,1,100,61
1000,14,4,4,8,5,44,41,4,2,144,102
1000,15,3,4,3,10,30,46,4,8,174,148
1000,16,4,2,9,4,45,-78,9,0,219,70
1000,17,3,3,6,7,-67,34,2,4,152,104
1000,18,2,4,4,9,22,45,4,9,174,149
1000,19,2,5,3,10,21,-45,5,4,195,104
1000,20,4,2,8,5,44,23,9,7,239,127
1000,21,2,4,7,6,-75,42,4,9,164,169
1000,22,4,2,8,5,44,-77,8,2,208,92
1000,23,5,2,9,4,-46,22,2,4,162,114
1000,24,2,5,5,8,23,53,5,7,185,167
1000,25,3,4,5,8,32,-56,7,1,217,111
1000,26,3,3,5,8,32,35,9,6,249,146
1000,27,3,3,7,6,-66,33,3,9,183,179
1000,28,3,4,8,5,35,-59,8,0,218,120
1000,29,2,5,2,11,20,56,8,6,238,176
1000,30,5,3,7,6,-48,33,0,9,190,209
1000,31,3,3,5,8,32,-65,2,4,222,144
1000,32,2,6,2,11,20,65,2,9,242,209
1000,33,4,4,4,9,40,-55,2,4,282,154
1000,34,3,5,5,8,32,53,4,7,314,207
1000,35,3,3,6,7,33,-66,7,1,347,141
1000,36,3,3,7,6,-66,33,1,4,281,174
1000,37,4,2,10,3,46,21,7,5,327,195
1000,38,4,3,9,4,-55,31,2,6,272,226
1000,39,4,3,9,4,45,31,7,7,317,257
1000,40,3,3,5,8,32,-65,9,2,349,192
1000,41,2,5,5,8,-77,53,2,5,272,245
1000,42,4,3,7,6,43,33,5,8,315,278
1000,43,3,4,8,5,-65,41,0,9,250,319
1000,44,4,3,8,5,44,-68,4,1,294,251
1000,45,4,2,9,4,45,22,9,3,339,273
1000,46,4,2,8,5,-56,23,3,6,283,296
1000,47,3,3,6,7,33,-66,6,0,316,230
1000,48,5,2,9,4,-46,22,0,2,270,252
1000,49,3,4,7,6,34,42,4,4,304,294
1000,50,2,4,4,9,22,45,6,9,326,339
1000,51,4,3,7,6,43,-67,9,2,369,272
1000,52,3,3,7,6,-66,33,3,5,303,305
1000,53,4,3,5,8,41,-65,4,0,344,240
1000,54,4,2,8,5,44,23,8,3,388,263
1000,55,5,2,6,7,51,25,9,8,439,288
1000,56,2,5,6,7,-76,-48,3,0,363,240
1000,57,2,4,4,9,22,45,5,5,385,285
1000,58,3,4,4,9,31,-55,6,0,416,230
1000,59,3,4,7,6,-66,42,0,2,350,272
1000,60,4,3,7,6,43,33,3,5,393,305
1000,61,3,4,7,6,34,42,7,7,427,347
1000,62,5,2,11,2,-44,20,3,7,383,367
1000,63,5,2,8,5,53,-77,6,0,436,290
1000,64,2,5,5,8,23,53,9,3,459,343
1000,65,4,4,9,4,-55,40,4,3,404,383
1000,66,2,4,6,7,24,43,8,6,428,426
1000,67,5,2,9,4,-46,22,2,8,382,448
1000,68,2,5,4,9,22,-46,4,2,404,402
1000,69,4,2,10,3,-54,21,0,3,350,423
1000,70,2,5,3,10,21,55,1,8,371,478
1000,71,2,4,3,10,21,-54,2,4,392,424
1000,72,4,3,9,4,45,31,7,5,437,455
1000,73,4,2,7,6,-57,24,0,9,380,479
1000,74,3,3,7,6,34,-67,4,2,414,412
1000,75,4,3,7,6,43,33,7,5,457,445
1000,76,4,3,7,6,-57,33,0,8,400,478
1000,77,5,2,8,5,53,-77,3,1,453,401
1000,78,2,4,4,9,22,45,5,6,475,446
1000,79,4,3,6,7,42,-66,7,0,517,380
